"","series","ts","value","max","twd","gro_yr","frost","flags","version"
"1","646",2022-09-01,870,870,0,0,FALSE,NA,"0.1.4"
"2","646",2022-09-01 00:15:00,867,870,3,0,FALSE,NA,"0.1.4"
"3","646",2022-09-01 00:30:00,864,870,6,0,FALSE,NA,"0.1.4"
"4","646",2022-09-01 00:45:00,863,870,7,0,FALSE,NA,"0.1.4"
"5","646",2022-09-01 01:00:00,863,870,7,0,FALSE,NA,"0.1.4"
"6","646",2022-09-01 01:15:00,862,870,8,0,FALSE,NA,"0.1.4"
"7","646",2022-09-01 01:30:00,862,870,8,0,FALSE,NA,"0.1.4"
"8","646",2022-09-01 01:45:00,862,870,8,0,FALSE,NA,"0.1.4"
"9","646",2022-09-01 02:00:00,862,870,8,0,FALSE,NA,"0.1.4"
"10","646",2022-09-01 02:15:00,862,870,8,0,FALSE,NA,"0.1.4"
"11","646",2022-09-01 02:30:00,862,870,8,0,FALSE,NA,"0.1.4"
"12","646",2022-09-01 02:45:00,862,870,8,0,FALSE,NA,"0.1.4"
"13","646",2022-09-01 03:00:00,862,870,8,0,FALSE,NA,"0.1.4"
"14","646",2022-09-01 03:15:00,862,870,8,0,FALSE,NA,"0.1.4"
"15","646",2022-09-01 03:30:00,862,870,8,0,FALSE,NA,"0.1.4"
"16","646",2022-09-01 03:45:00,862,870,8,0,FALSE,NA,"0.1.4"
"17","646",2022-09-01 04:00:00,862,870,8,0,FALSE,NA,"0.1.4"
"18","646",2022-09-01 04:15:00,862,870,8,0,FALSE,NA,"0.1.4"
"19","646",2022-09-01 04:30:00,863,870,7,0,FALSE,NA,"0.1.4"
"20","646",2022-09-01 04:45:00,863,870,7,0,FALSE,NA,"0.1.4"
"21","646",2022-09-01 05:00:00,864,870,6,0,FALSE,NA,"0.1.4"
"22","646",2022-09-01 05:15:00,865,870,5,0,FALSE,NA,"0.1.4"
"23","646",2022-09-01 05:30:00,865,870,5,0,FALSE,NA,"0.1.4"
"24","646",2022-09-01 05:45:00,865,870,5,0,FALSE,NA,"0.1.4"
"25","646",2022-09-01 06:00:00,866,870,4,0,FALSE,NA,"0.1.4"
"26","646",2022-09-01 06:15:00,867,870,3,0,FALSE,NA,"0.1.4"
"27","646",2022-09-01 06:30:00,868,870,2,0,FALSE,NA,"0.1.4"
"28","646",2022-09-01 06:45:00,868,870,2,0,FALSE,NA,"0.1.4"
"29","646",2022-09-01 07:00:00,869,870,1,0,FALSE,NA,"0.1.4"
"30","646",2022-09-01 07:15:00,869,870,1,0,FALSE,NA,"0.1.4"
"31","646",2022-09-01 07:30:00,870,870,0,0,FALSE,NA,"0.1.4"
"32","646",2022-09-01 07:45:00,871,871,0,1,FALSE,NA,"0.1.4"
"33","646",2022-09-01 08:00:00,872,872,0,2,FALSE,NA,"0.1.4"
"34","646",2022-09-01 08:15:00,873,873,0,3,FALSE,NA,"0.1.4"
"35","646",2022-09-01 08:30:00,873,873,0,3,FALSE,NA,"0.1.4"
"36","646",2022-09-01 08:45:00,873,873,0,3,FALSE,NA,"0.1.4"
"37","646",2022-09-01 09:00:00,875,875,0,5,FALSE,NA,"0.1.4"
"38","646",2022-09-01 09:15:00,875,875,0,5,FALSE,NA,"0.1.4"
"39","646",2022-09-01 09:30:00,876,876,0,6,FALSE,NA,"0.1.4"
"40","646",2022-09-01 09:45:00,877,877,0,7,FALSE,NA,"0.1.4"
"41","646",2022-09-01 10:00:00,878,878,0,8,FALSE,NA,"0.1.4"
"42","646",2022-09-01 10:15:00,878,878,0,8,FALSE,NA,"0.1.4"
"43","646",2022-09-01 10:30:00,878,878,0,8,FALSE,NA,"0.1.4"
"44","646",2022-09-01 10:45:00,879,879,0,9,FALSE,NA,"0.1.4"
"45","646",2022-09-01 11:00:00,879,879,0,9,FALSE,NA,"0.1.4"
"46","646",2022-09-01 11:15:00,880,880,0,10,FALSE,NA,"0.1.4"
"47","646",2022-09-01 11:30:00,880,880,0,10,FALSE,NA,"0.1.4"
"48","646",2022-09-01 11:45:00,881,881,0,11,FALSE,NA,"0.1.4"
"49","646",2022-09-01 12:00:00,881,881,0,11,FALSE,NA,"0.1.4"
"50","646",2022-09-01 12:15:00,882,882,0,12,FALSE,NA,"0.1.4"
"51","646",2022-09-01 12:30:00,882,882,0,12,FALSE,NA,"0.1.4"
"52","646",2022-09-01 12:45:00,882,882,0,12,FALSE,NA,"0.1.4"
"53","646",2022-09-01 13:00:00,883,883,0,13,FALSE,NA,"0.1.4"
"54","646",2022-09-01 13:15:00,884,884,0,14,FALSE,NA,"0.1.4"
"55","646",2022-09-01 13:30:00,884,884,0,14,FALSE,NA,"0.1.4"
"56","646",2022-09-01 13:45:00,884,884,0,14,FALSE,NA,"0.1.4"
"57","646",2022-09-01 14:00:00,884,884,0,14,FALSE,NA,"0.1.4"
"58","646",2022-09-01 14:15:00,885,885,0,15,FALSE,NA,"0.1.4"
"59","646",2022-09-01 14:30:00,885,885,0,15,FALSE,NA,"0.1.4"
"60","646",2022-09-01 14:45:00,885,885,0,15,FALSE,NA,"0.1.4"
"61","646",2022-09-01 15:00:00,885,885,0,15,FALSE,NA,"0.1.4"
"62","646",2022-09-01 15:15:00,885,885,0,15,FALSE,NA,"0.1.4"
"63","646",2022-09-01 15:30:00,885,885,0,15,FALSE,NA,"0.1.4"
"64","646",2022-09-01 15:45:00,885,885,0,15,FALSE,NA,"0.1.4"
"65","646",2022-09-01 16:00:00,885,885,0,15,FALSE,NA,"0.1.4"
"66","646",2022-09-01 16:15:00,885,885,0,15,FALSE,NA,"0.1.4"
"67","646",2022-09-01 16:30:00,885,885,0,15,FALSE,NA,"0.1.4"
"68","646",2022-09-01 16:45:00,885,885,0,15,FALSE,NA,"0.1.4"
"69","646",2022-09-01 17:00:00,885,885,0,15,FALSE,NA,"0.1.4"
"70","646",2022-09-01 17:15:00,885,885,0,15,FALSE,NA,"0.1.4"
"71","646",2022-09-01 17:30:00,885,885,0,15,FALSE,NA,"0.1.4"
"72","646",2022-09-01 17:45:00,885,885,0,15,FALSE,NA,"0.1.4"
"73","646",2022-09-01 18:00:00,885,885,0,15,FALSE,NA,"0.1.4"
"74","646",2022-09-01 18:15:00,885,885,0,15,FALSE,NA,"0.1.4"
"75","646",2022-09-01 18:30:00,885,885,0,15,FALSE,NA,"0.1.4"
"76","646",2022-09-01 18:45:00,884,885,1,15,FALSE,NA,"0.1.4"
"77","646",2022-09-01 19:00:00,884,885,1,15,FALSE,NA,"0.1.4"
"78","646",2022-09-01 19:15:00,883,885,2,15,FALSE,NA,"0.1.4"
"79","646",2022-09-01 19:30:00,882,885,3,15,FALSE,NA,"0.1.4"
"80","646",2022-09-01 19:45:00,881,885,4,15,FALSE,NA,"0.1.4"
"81","646",2022-09-01 20:00:00,879,885,6,15,FALSE,NA,"0.1.4"
"82","646",2022-09-01 20:15:00,878,885,7,15,FALSE,NA,"0.1.4"
"83","646",2022-09-01 20:30:00,877,885,8,15,FALSE,NA,"0.1.4"
"84","646",2022-09-01 20:45:00,875,885,10,15,FALSE,NA,"0.1.4"
"85","646",2022-09-01 21:00:00,873,885,12,15,FALSE,NA,"0.1.4"
"86","646",2022-09-01 21:15:00,872,885,13,15,FALSE,NA,"0.1.4"
"87","646",2022-09-01 21:30:00,869,885,16,15,FALSE,NA,"0.1.4"
"88","646",2022-09-01 21:45:00,868,885,17,15,FALSE,NA,"0.1.4"
"89","646",2022-09-01 22:00:00,866,885,19,15,FALSE,NA,"0.1.4"
"90","646",2022-09-01 22:15:00,865,885,20,15,FALSE,NA,"0.1.4"
"91","646",2022-09-01 22:30:00,863,885,22,15,FALSE,NA,"0.1.4"
"92","646",2022-09-01 22:45:00,862,885,23,15,FALSE,NA,"0.1.4"
"93","646",2022-09-01 23:00:00,860,885,25,15,FALSE,NA,"0.1.4"
"94","646",2022-09-01 23:15:00,858,885,27,15,FALSE,NA,"0.1.4"
"95","646",2022-09-01 23:30:00,850,885,35,15,FALSE,NA,"0.1.4"
"96","646",2022-09-01 23:45:00,848,885,37,15,FALSE,NA,"0.1.4"
"97","646",2022-09-02,842,885,43,15,FALSE,NA,"0.1.4"
"98","646",2022-09-02 00:15:00,841,885,44,15,FALSE,NA,"0.1.4"
"99","646",2022-09-02 00:30:00,841,885,44,15,FALSE,NA,"0.1.4"
"100","646",2022-09-02 00:45:00,840,885,45,15,FALSE,NA,"0.1.4"
"101","646",2022-09-02 01:00:00,840,885,45,15,FALSE,NA,"0.1.4"
"102","646",2022-09-02 01:15:00,840,885,45,15,FALSE,NA,"0.1.4"
"103","646",2022-09-02 01:30:00,840,885,45,15,FALSE,NA,"0.1.4"
"104","646",2022-09-02 01:45:00,840,885,45,15,FALSE,NA,"0.1.4"
"105","646",2022-09-02 02:00:00,840,885,45,15,FALSE,NA,"0.1.4"
"106","646",2022-09-02 02:15:00,840,885,45,15,FALSE,NA,"0.1.4"
"107","646",2022-09-02 02:30:00,840,885,45,15,FALSE,NA,"0.1.4"
"108","646",2022-09-02 02:45:00,840,885,45,15,FALSE,NA,"0.1.4"
"109","646",2022-09-02 03:00:00,840,885,45,15,FALSE,NA,"0.1.4"
"110","646",2022-09-02 03:15:00,840,885,45,15,FALSE,NA,"0.1.4"
"111","646",2022-09-02 03:30:00,840,885,45,15,FALSE,NA,"0.1.4"
"112","646",2022-09-02 03:45:00,840,885,45,15,FALSE,NA,"0.1.4"
"113","646",2022-09-02 04:00:00,840,885,45,15,FALSE,NA,"0.1.4"
"114","646",2022-09-02 04:15:00,840,885,45,15,FALSE,NA,"0.1.4"
"115","646",2022-09-02 04:30:00,841,885,44,15,FALSE,NA,"0.1.4"
"116","646",2022-09-02 04:45:00,842,885,43,15,FALSE,NA,"0.1.4"
"117","646",2022-09-02 05:00:00,842,885,43,15,FALSE,NA,"0.1.4"
"118","646",2022-09-02 05:15:00,843,885,42,15,FALSE,NA,"0.1.4"
"119","646",2022-09-02 05:30:00,845,885,40,15,FALSE,NA,"0.1.4"
"120","646",2022-09-02 05:45:00,845,885,40,15,FALSE,NA,"0.1.4"
"121","646",2022-09-02 06:00:00,847,885,38,15,FALSE,NA,"0.1.4"
"122","646",2022-09-02 06:15:00,847,885,38,15,FALSE,NA,"0.1.4"
"123","646",2022-09-02 06:30:00,848,885,37,15,FALSE,NA,"0.1.4"
"124","646",2022-09-02 06:45:00,851,885,34,15,FALSE,NA,"0.1.4"
"125","646",2022-09-02 07:00:00,851,885,34,15,FALSE,NA,"0.1.4"
"126","646",2022-09-02 07:15:00,853,885,32,15,FALSE,NA,"0.1.4"
"127","646",2022-09-02 07:30:00,854,885,31,15,FALSE,NA,"0.1.4"
"128","646",2022-09-02 07:45:00,855,885,30,15,FALSE,NA,"0.1.4"
"129","646",2022-09-02 08:00:00,855,885,30,15,FALSE,NA,"0.1.4"
"130","646",2022-09-02 08:15:00,856,885,29,15,FALSE,NA,"0.1.4"
"131","646",2022-09-02 08:30:00,857,885,28,15,FALSE,NA,"0.1.4"
"132","646",2022-09-02 08:45:00,858,885,27,15,FALSE,NA,"0.1.4"
"133","646",2022-09-02 09:00:00,858,885,27,15,FALSE,NA,"0.1.4"
"134","646",2022-09-02 09:15:00,859,885,26,15,FALSE,NA,"0.1.4"
"135","646",2022-09-02 09:30:00,859,885,26,15,FALSE,NA,"0.1.4"
"136","646",2022-09-02 09:45:00,860,885,25,15,FALSE,NA,"0.1.4"
"137","646",2022-09-02 10:00:00,860,885,25,15,FALSE,NA,"0.1.4"
"138","646",2022-09-02 10:15:00,860,885,25,15,FALSE,NA,"0.1.4"
"139","646",2022-09-02 10:30:00,860,885,25,15,FALSE,NA,"0.1.4"
"140","646",2022-09-02 10:45:00,861,885,24,15,FALSE,NA,"0.1.4"
"141","646",2022-09-02 11:00:00,861,885,24,15,FALSE,NA,"0.1.4"
"142","646",2022-09-02 11:15:00,862,885,23,15,FALSE,NA,"0.1.4"
"143","646",2022-09-02 11:30:00,862,885,23,15,FALSE,NA,"0.1.4"
"144","646",2022-09-02 11:45:00,863,885,22,15,FALSE,NA,"0.1.4"
"145","646",2022-09-02 12:00:00,863,885,22,15,FALSE,NA,"0.1.4"
"146","646",2022-09-02 12:15:00,863,885,22,15,FALSE,NA,"0.1.4"
"147","646",2022-09-02 12:30:00,864,885,21,15,FALSE,NA,"0.1.4"
"148","646",2022-09-02 12:45:00,864,885,21,15,FALSE,NA,"0.1.4"
"149","646",2022-09-02 13:00:00,865,885,20,15,FALSE,NA,"0.1.4"
"150","646",2022-09-02 13:15:00,865,885,20,15,FALSE,NA,"0.1.4"
"151","646",2022-09-02 13:30:00,865,885,20,15,FALSE,NA,"0.1.4"
"152","646",2022-09-02 13:45:00,865,885,20,15,FALSE,NA,"0.1.4"
"153","646",2022-09-02 14:00:00,866,885,19,15,FALSE,NA,"0.1.4"
"154","646",2022-09-02 14:15:00,866,885,19,15,FALSE,NA,"0.1.4"
"155","646",2022-09-02 14:30:00,866,885,19,15,FALSE,NA,"0.1.4"
"156","646",2022-09-02 14:45:00,866,885,19,15,FALSE,NA,"0.1.4"
"157","646",2022-09-02 15:00:00,866,885,19,15,FALSE,NA,"0.1.4"
"158","646",2022-09-02 15:15:00,866,885,19,15,FALSE,NA,"0.1.4"
"159","646",2022-09-02 15:30:00,866,885,19,15,FALSE,NA,"0.1.4"
"160","646",2022-09-02 15:45:00,866,885,19,15,FALSE,NA,"0.1.4"
"161","646",2022-09-02 16:00:00,866,885,19,15,FALSE,NA,"0.1.4"
"162","646",2022-09-02 16:15:00,866,885,19,15,FALSE,NA,"0.1.4"
"163","646",2022-09-02 16:30:00,866,885,19,15,FALSE,NA,"0.1.4"
"164","646",2022-09-02 16:45:00,866,885,19,15,FALSE,NA,"0.1.4"
"165","646",2022-09-02 17:00:00,866,885,19,15,FALSE,NA,"0.1.4"
"166","646",2022-09-02 17:15:00,866,885,19,15,FALSE,NA,"0.1.4"
"167","646",2022-09-02 17:30:00,866,885,19,15,FALSE,NA,"0.1.4"
"168","646",2022-09-02 17:45:00,866,885,19,15,FALSE,NA,"0.1.4"
"169","646",2022-09-02 18:00:00,866,885,19,15,FALSE,NA,"0.1.4"
"170","646",2022-09-02 18:15:00,866,885,19,15,FALSE,NA,"0.1.4"
"171","646",2022-09-02 18:30:00,866,885,19,15,FALSE,NA,"0.1.4"
"172","646",2022-09-02 18:45:00,866,885,19,15,FALSE,NA,"0.1.4"
"173","646",2022-09-02 19:00:00,866,885,19,15,FALSE,NA,"0.1.4"
"174","646",2022-09-02 19:15:00,865,885,20,15,FALSE,NA,"0.1.4"
"175","646",2022-09-02 19:30:00,865,885,20,15,FALSE,NA,"0.1.4"
"176","646",2022-09-02 19:45:00,865,885,20,15,FALSE,NA,"0.1.4"
"177","646",2022-09-02 20:00:00,865,885,20,15,FALSE,NA,"0.1.4"
"178","646",2022-09-02 20:15:00,864,885,21,15,FALSE,NA,"0.1.4"
"179","646",2022-09-02 20:30:00,863,885,22,15,FALSE,NA,"0.1.4"
"180","646",2022-09-02 20:45:00,862,885,23,15,FALSE,NA,"0.1.4"
"181","646",2022-09-02 21:00:00,860,885,25,15,FALSE,NA,"0.1.4"
"182","646",2022-09-02 21:15:00,859,885,26,15,FALSE,NA,"0.1.4"
"183","646",2022-09-02 21:30:00,859,885,26,15,FALSE,NA,"0.1.4"
"184","646",2022-09-02 21:45:00,858,885,27,15,FALSE,NA,"0.1.4"
"185","646",2022-09-02 22:00:00,856,885,29,15,FALSE,NA,"0.1.4"
"186","646",2022-09-02 22:15:00,856,885,29,15,FALSE,NA,"0.1.4"
"187","646",2022-09-02 22:30:00,855,885,30,15,FALSE,NA,"0.1.4"
"188","646",2022-09-02 22:45:00,854,885,31,15,FALSE,NA,"0.1.4"
"189","646",2022-09-02 23:00:00,854,885,31,15,FALSE,NA,"0.1.4"
"190","646",2022-09-02 23:15:00,854,885,31,15,FALSE,NA,"0.1.4"
"191","646",2022-09-02 23:30:00,854,885,31,15,FALSE,NA,"0.1.4"
"192","646",2022-09-02 23:45:00,854,885,31,15,FALSE,NA,"0.1.4"
"193","646",2022-09-03,853,885,32,15,FALSE,NA,"0.1.4"
"194","646",2022-09-03 00:15:00,851,885,34,15,FALSE,NA,"0.1.4"
"195","646",2022-09-03 00:30:00,850,885,35,15,FALSE,NA,"0.1.4"
"196","646",2022-09-03 00:45:00,850,885,35,15,FALSE,NA,"0.1.4"
"197","646",2022-09-03 01:00:00,850,885,35,15,FALSE,NA,"0.1.4"
"198","646",2022-09-03 01:15:00,850,885,35,15,FALSE,NA,"0.1.4"
"199","646",2022-09-03 01:30:00,850,885,35,15,FALSE,NA,"0.1.4"
"200","646",2022-09-03 01:45:00,850,885,35,15,FALSE,NA,"0.1.4"
"201","646",2022-09-03 02:00:00,850,885,35,15,FALSE,NA,"0.1.4"
"202","646",2022-09-03 02:15:00,850,885,35,15,FALSE,NA,"0.1.4"
"203","646",2022-09-03 02:30:00,850,885,35,15,FALSE,NA,"0.1.4"
"204","646",2022-09-03 02:45:00,850,885,35,15,FALSE,NA,"0.1.4"
"205","646",2022-09-03 03:00:00,850,885,35,15,FALSE,NA,"0.1.4"
"206","646",2022-09-03 03:15:00,850,885,35,15,FALSE,NA,"0.1.4"
"207","646",2022-09-03 03:30:00,850,885,35,15,FALSE,NA,"0.1.4"
"208","646",2022-09-03 03:45:00,850,885,35,15,FALSE,NA,"0.1.4"
"209","646",2022-09-03 04:00:00,850,885,35,15,FALSE,NA,"0.1.4"
"210","646",2022-09-03 04:15:00,850,885,35,15,FALSE,NA,"0.1.4"
"211","646",2022-09-03 04:30:00,850,885,35,15,FALSE,NA,"0.1.4"
"212","646",2022-09-03 04:45:00,851,885,34,15,FALSE,NA,"0.1.4"
"213","646",2022-09-03 05:00:00,851,885,34,15,FALSE,NA,"0.1.4"
"214","646",2022-09-03 05:15:00,853,885,32,15,FALSE,NA,"0.1.4"
"215","646",2022-09-03 05:30:00,854,885,31,15,FALSE,NA,"0.1.4"
"216","646",2022-09-03 05:45:00,854,885,31,15,FALSE,NA,"0.1.4"
"217","646",2022-09-03 06:00:00,856,885,29,15,FALSE,NA,"0.1.4"
"218","646",2022-09-03 06:15:00,856,885,29,15,FALSE,NA,"0.1.4"
"219","646",2022-09-03 06:30:00,857,885,28,15,FALSE,NA,"0.1.4"
"220","646",2022-09-03 06:45:00,858,885,27,15,FALSE,NA,"0.1.4"
"221","646",2022-09-03 07:00:00,859,885,26,15,FALSE,NA,"0.1.4"
"222","646",2022-09-03 07:15:00,859,885,26,15,FALSE,NA,"0.1.4"
"223","646",2022-09-03 07:30:00,860,885,25,15,FALSE,NA,"0.1.4"
"224","646",2022-09-03 07:45:00,860,885,25,15,FALSE,NA,"0.1.4"
"225","646",2022-09-03 08:00:00,860,885,25,15,FALSE,NA,"0.1.4"
"226","646",2022-09-03 08:15:00,860,885,25,15,FALSE,NA,"0.1.4"
"227","646",2022-09-03 08:30:00,861,885,24,15,FALSE,NA,"0.1.4"
"228","646",2022-09-03 08:45:00,861,885,24,15,FALSE,NA,"0.1.4"
"229","646",2022-09-03 09:00:00,862,885,23,15,FALSE,NA,"0.1.4"
"230","646",2022-09-03 09:15:00,862,885,23,15,FALSE,NA,"0.1.4"
"231","646",2022-09-03 09:30:00,863,885,22,15,FALSE,NA,"0.1.4"
"232","646",2022-09-03 09:45:00,863,885,22,15,FALSE,NA,"0.1.4"
"233","646",2022-09-03 10:00:00,863,885,22,15,FALSE,NA,"0.1.4"
"234","646",2022-09-03 10:15:00,863,885,22,15,FALSE,NA,"0.1.4"
"235","646",2022-09-03 10:30:00,864,885,21,15,FALSE,NA,"0.1.4"
"236","646",2022-09-03 10:45:00,864,885,21,15,FALSE,NA,"0.1.4"
"237","646",2022-09-03 11:00:00,864,885,21,15,FALSE,NA,"0.1.4"
"238","646",2022-09-03 11:15:00,865,885,20,15,FALSE,NA,"0.1.4"
"239","646",2022-09-03 11:30:00,865,885,20,15,FALSE,NA,"0.1.4"
"240","646",2022-09-03 11:45:00,866,885,19,15,FALSE,NA,"0.1.4"
"241","646",2022-09-03 12:00:00,866,885,19,15,FALSE,NA,"0.1.4"
"242","646",2022-09-03 12:15:00,866,885,19,15,FALSE,NA,"0.1.4"
"243","646",2022-09-03 12:30:00,867,885,18,15,FALSE,NA,"0.1.4"
"244","646",2022-09-03 12:45:00,867,885,18,15,FALSE,NA,"0.1.4"
"245","646",2022-09-03 13:00:00,868,885,17,15,FALSE,NA,"0.1.4"
"246","646",2022-09-03 13:15:00,868,885,17,15,FALSE,NA,"0.1.4"
"247","646",2022-09-03 13:30:00,868,885,17,15,FALSE,NA,"0.1.4"
"248","646",2022-09-03 13:45:00,869,885,16,15,FALSE,NA,"0.1.4"
"249","646",2022-09-03 14:00:00,868,885,17,15,FALSE,NA,"0.1.4"
"250","646",2022-09-03 14:15:00,868,885,17,15,FALSE,NA,"0.1.4"
"251","646",2022-09-03 14:30:00,868,885,17,15,FALSE,NA,"0.1.4"
"252","646",2022-09-03 14:45:00,869,885,16,15,FALSE,NA,"0.1.4"
"253","646",2022-09-03 15:00:00,869,885,16,15,FALSE,NA,"0.1.4"
"254","646",2022-09-03 15:15:00,869,885,16,15,FALSE,NA,"0.1.4"
"255","646",2022-09-03 15:30:00,869,885,16,15,FALSE,NA,"0.1.4"
"256","646",2022-09-03 15:45:00,869,885,16,15,FALSE,NA,"0.1.4"
"257","646",2022-09-03 16:00:00,869,885,16,15,FALSE,NA,"0.1.4"
"258","646",2022-09-03 16:15:00,869,885,16,15,FALSE,NA,"0.1.4"
"259","646",2022-09-03 16:30:00,869,885,16,15,FALSE,NA,"0.1.4"
"260","646",2022-09-03 16:45:00,869,885,16,15,FALSE,NA,"0.1.4"
"261","646",2022-09-03 17:00:00,869,885,16,15,FALSE,NA,"0.1.4"
"262","646",2022-09-03 17:15:00,869,885,16,15,FALSE,NA,"0.1.4"
"263","646",2022-09-03 17:30:00,869,885,16,15,FALSE,NA,"0.1.4"
"264","646",2022-09-03 17:45:00,869,885,16,15,FALSE,NA,"0.1.4"
"265","646",2022-09-03 18:00:00,869,885,16,15,FALSE,NA,"0.1.4"
"266","646",2022-09-03 18:15:00,869,885,16,15,FALSE,NA,"0.1.4"
"267","646",2022-09-03 18:30:00,869,885,16,15,FALSE,NA,"0.1.4"
"268","646",2022-09-03 18:45:00,868,885,17,15,FALSE,NA,"0.1.4"
"269","646",2022-09-03 19:00:00,868,885,17,15,FALSE,NA,"0.1.4"
"270","646",2022-09-03 19:15:00,868,885,17,15,FALSE,NA,"0.1.4"
"271","646",2022-09-03 19:30:00,868,885,17,15,FALSE,NA,"0.1.4"
"272","646",2022-09-03 19:45:00,868,885,17,15,FALSE,NA,"0.1.4"
"273","646",2022-09-03 20:00:00,868,885,17,15,FALSE,NA,"0.1.4"
"274","646",2022-09-03 20:15:00,867,885,18,15,FALSE,NA,"0.1.4"
"275","646",2022-09-03 20:30:00,867,885,18,15,FALSE,NA,"0.1.4"
"276","646",2022-09-03 20:45:00,867,885,18,15,FALSE,NA,"0.1.4"
"277","646",2022-09-03 21:00:00,867,885,18,15,FALSE,NA,"0.1.4"
"278","646",2022-09-03 21:15:00,866,885,19,15,FALSE,NA,"0.1.4"
"279","646",2022-09-03 21:30:00,866,885,19,15,FALSE,NA,"0.1.4"
"280","646",2022-09-03 21:45:00,866,885,19,15,FALSE,NA,"0.1.4"
"281","646",2022-09-03 22:00:00,865,885,20,15,FALSE,NA,"0.1.4"
"282","646",2022-09-03 22:15:00,864,885,21,15,FALSE,NA,"0.1.4"
"283","646",2022-09-03 22:30:00,864,885,21,15,FALSE,NA,"0.1.4"
"284","646",2022-09-03 22:45:00,863,885,22,15,FALSE,NA,"0.1.4"
"285","646",2022-09-03 23:00:00,863,885,22,15,FALSE,NA,"0.1.4"
"286","646",2022-09-03 23:15:00,862,885,23,15,FALSE,NA,"0.1.4"
"287","646",2022-09-03 23:30:00,862,885,23,15,FALSE,NA,"0.1.4"
"288","646",2022-09-03 23:45:00,861,885,24,15,FALSE,NA,"0.1.4"
"289","646",2022-09-04,860,885,25,15,FALSE,NA,"0.1.4"
"290","646",2022-09-04 00:15:00,860,885,25,15,FALSE,NA,"0.1.4"
"291","646",2022-09-04 00:30:00,860,885,25,15,FALSE,NA,"0.1.4"
"292","646",2022-09-04 00:45:00,859,885,26,15,FALSE,NA,"0.1.4"
"293","646",2022-09-04 01:00:00,859,885,26,15,FALSE,NA,"0.1.4"
"294","646",2022-09-04 01:15:00,860,885,25,15,FALSE,NA,"0.1.4"
"295","646",2022-09-04 01:30:00,859,885,26,15,FALSE,NA,"0.1.4"
"296","646",2022-09-04 01:45:00,859,885,26,15,FALSE,NA,"0.1.4"
"297","646",2022-09-04 02:00:00,859,885,26,15,FALSE,NA,"0.1.4"
"298","646",2022-09-04 02:15:00,859,885,26,15,FALSE,NA,"0.1.4"
"299","646",2022-09-04 02:30:00,859,885,26,15,FALSE,NA,"0.1.4"
"300","646",2022-09-04 02:45:00,859,885,26,15,FALSE,NA,"0.1.4"
"301","646",2022-09-04 03:00:00,859,885,26,15,FALSE,NA,"0.1.4"
"302","646",2022-09-04 03:15:00,859,885,26,15,FALSE,NA,"0.1.4"
"303","646",2022-09-04 03:30:00,859,885,26,15,FALSE,NA,"0.1.4"
"304","646",2022-09-04 03:45:00,859,885,26,15,FALSE,NA,"0.1.4"
"305","646",2022-09-04 04:00:00,860,885,25,15,FALSE,NA,"0.1.4"
"306","646",2022-09-04 04:15:00,860,885,25,15,FALSE,NA,"0.1.4"
"307","646",2022-09-04 04:30:00,859,885,26,15,FALSE,NA,"0.1.4"
"308","646",2022-09-04 04:45:00,859,885,26,15,FALSE,NA,"0.1.4"
"309","646",2022-09-04 05:00:00,860,885,25,15,FALSE,NA,"0.1.4"
"310","646",2022-09-04 05:15:00,860,885,25,15,FALSE,NA,"0.1.4"
"311","646",2022-09-04 05:30:00,860,885,25,15,FALSE,NA,"0.1.4"
"312","646",2022-09-04 05:45:00,860,885,25,15,FALSE,NA,"0.1.4"
"313","646",2022-09-04 06:00:00,860,885,25,15,FALSE,NA,"0.1.4"
"314","646",2022-09-04 06:15:00,861,885,24,15,FALSE,NA,"0.1.4"
"315","646",2022-09-04 06:30:00,862,885,23,15,FALSE,NA,"0.1.4"
"316","646",2022-09-04 06:45:00,862,885,23,15,FALSE,NA,"0.1.4"
"317","646",2022-09-04 07:00:00,863,885,22,15,FALSE,NA,"0.1.4"
"318","646",2022-09-04 07:15:00,864,885,21,15,FALSE,NA,"0.1.4"
"319","646",2022-09-04 07:30:00,864,885,21,15,FALSE,NA,"0.1.4"
"320","646",2022-09-04 07:45:00,865,885,20,15,FALSE,NA,"0.1.4"
"321","646",2022-09-04 08:00:00,865,885,20,15,FALSE,NA,"0.1.4"
"322","646",2022-09-04 08:15:00,866,885,19,15,FALSE,NA,"0.1.4"
"323","646",2022-09-04 08:30:00,866,885,19,15,FALSE,NA,"0.1.4"
"324","646",2022-09-04 08:45:00,867,885,18,15,FALSE,NA,"0.1.4"
"325","646",2022-09-04 09:00:00,867,885,18,15,FALSE,NA,"0.1.4"
"326","646",2022-09-04 09:15:00,868,885,17,15,FALSE,NA,"0.1.4"
"327","646",2022-09-04 09:30:00,868,885,17,15,FALSE,NA,"0.1.4"
"328","646",2022-09-04 09:45:00,868,885,17,15,FALSE,NA,"0.1.4"
"329","646",2022-09-04 10:00:00,869,885,16,15,FALSE,NA,"0.1.4"
"330","646",2022-09-04 10:15:00,869,885,16,15,FALSE,NA,"0.1.4"
"331","646",2022-09-04 10:30:00,870,885,15,15,FALSE,NA,"0.1.4"
"332","646",2022-09-04 10:45:00,869,885,16,15,FALSE,NA,"0.1.4"
"333","646",2022-09-04 11:00:00,870,885,15,15,FALSE,NA,"0.1.4"
"334","646",2022-09-04 11:15:00,870,885,15,15,FALSE,NA,"0.1.4"
"335","646",2022-09-04 11:30:00,870,885,15,15,FALSE,NA,"0.1.4"
"336","646",2022-09-04 11:45:00,871,885,14,15,FALSE,NA,"0.1.4"
"337","646",2022-09-04 12:00:00,871,885,14,15,FALSE,NA,"0.1.4"
"338","646",2022-09-04 12:15:00,871,885,14,15,FALSE,NA,"0.1.4"
"339","646",2022-09-04 12:30:00,871,885,14,15,FALSE,NA,"0.1.4"
"340","646",2022-09-04 12:45:00,872,885,13,15,FALSE,NA,"0.1.4"
"341","646",2022-09-04 13:00:00,871,885,14,15,FALSE,NA,"0.1.4"
"342","646",2022-09-04 13:15:00,873,885,12,15,FALSE,NA,"0.1.4"
"343","646",2022-09-04 13:30:00,873,885,12,15,FALSE,NA,"0.1.4"
"344","646",2022-09-04 13:45:00,873,885,12,15,FALSE,NA,"0.1.4"
"345","646",2022-09-04 14:00:00,873,885,12,15,FALSE,NA,"0.1.4"
"346","646",2022-09-04 14:15:00,874,885,11,15,FALSE,NA,"0.1.4"
"347","646",2022-09-04 14:30:00,874,885,11,15,FALSE,NA,"0.1.4"
"348","646",2022-09-04 14:45:00,874,885,11,15,FALSE,NA,"0.1.4"
"349","646",2022-09-04 15:00:00,875,885,10,15,FALSE,NA,"0.1.4"
"350","646",2022-09-04 15:15:00,875,885,10,15,FALSE,NA,"0.1.4"
"351","646",2022-09-04 15:30:00,876,885,9,15,FALSE,NA,"0.1.4"
"352","646",2022-09-04 15:45:00,876,885,9,15,FALSE,NA,"0.1.4"
"353","646",2022-09-04 16:00:00,876,885,9,15,FALSE,NA,"0.1.4"
"354","646",2022-09-04 16:15:00,876,885,9,15,FALSE,NA,"0.1.4"
"355","646",2022-09-04 16:30:00,876,885,9,15,FALSE,NA,"0.1.4"
"356","646",2022-09-04 16:45:00,876,885,9,15,FALSE,NA,"0.1.4"
"357","646",2022-09-04 17:00:00,876,885,9,15,FALSE,NA,"0.1.4"
"358","646",2022-09-04 17:15:00,876,885,9,15,FALSE,NA,"0.1.4"
"359","646",2022-09-04 17:30:00,876,885,9,15,FALSE,NA,"0.1.4"
"360","646",2022-09-04 17:45:00,876,885,9,15,FALSE,NA,"0.1.4"
"361","646",2022-09-04 18:00:00,876,885,9,15,FALSE,NA,"0.1.4"
"362","646",2022-09-04 18:15:00,876,885,9,15,FALSE,NA,"0.1.4"
"363","646",2022-09-04 18:30:00,876,885,9,15,FALSE,NA,"0.1.4"
"364","646",2022-09-04 18:45:00,876,885,9,15,FALSE,NA,"0.1.4"
"365","646",2022-09-04 19:00:00,876,885,9,15,FALSE,NA,"0.1.4"
"366","646",2022-09-04 19:15:00,875,885,10,15,FALSE,NA,"0.1.4"
"367","646",2022-09-04 19:30:00,875,885,10,15,FALSE,NA,"0.1.4"
"368","646",2022-09-04 19:45:00,875,885,10,15,FALSE,NA,"0.1.4"
"369","646",2022-09-04 20:00:00,875,885,10,15,FALSE,NA,"0.1.4"
"370","646",2022-09-04 20:15:00,875,885,10,15,FALSE,NA,"0.1.4"
"371","646",2022-09-04 20:30:00,874,885,11,15,FALSE,NA,"0.1.4"
"372","646",2022-09-04 20:45:00,873,885,12,15,FALSE,NA,"0.1.4"
"373","646",2022-09-04 21:00:00,872,885,13,15,FALSE,NA,"0.1.4"
"374","646",2022-09-04 21:15:00,871,885,14,15,FALSE,NA,"0.1.4"
"375","646",2022-09-04 21:30:00,869,885,16,15,FALSE,NA,"0.1.4"
"376","646",2022-09-04 21:45:00,866,885,19,15,FALSE,NA,"0.1.4"
"377","646",2022-09-04 22:00:00,865,885,20,15,FALSE,NA,"0.1.4"
"378","646",2022-09-04 22:15:00,863,885,22,15,FALSE,NA,"0.1.4"
"379","646",2022-09-04 22:30:00,861,885,24,15,FALSE,NA,"0.1.4"
"380","646",2022-09-04 22:45:00,860,885,25,15,FALSE,NA,"0.1.4"
"381","646",2022-09-04 23:00:00,859,885,26,15,FALSE,NA,"0.1.4"
"382","646",2022-09-04 23:15:00,858,885,27,15,FALSE,NA,"0.1.4"
"383","646",2022-09-04 23:30:00,857,885,28,15,FALSE,NA,"0.1.4"
"384","646",2022-09-04 23:45:00,856,885,29,15,FALSE,NA,"0.1.4"
"385","646",2022-09-05,856,885,29,15,FALSE,NA,"0.1.4"
"386","646",2022-09-05 00:15:00,855,885,30,15,FALSE,NA,"0.1.4"
"387","646",2022-09-05 00:30:00,855,885,30,15,FALSE,NA,"0.1.4"
"388","646",2022-09-05 00:45:00,854,885,31,15,FALSE,NA,"0.1.4"
"389","646",2022-09-05 01:00:00,854,885,31,15,FALSE,NA,"0.1.4"
"390","646",2022-09-05 01:15:00,854,885,31,15,FALSE,NA,"0.1.4"
"391","646",2022-09-05 01:30:00,854,885,31,15,FALSE,NA,"0.1.4"
"392","646",2022-09-05 01:45:00,854,885,31,15,FALSE,NA,"0.1.4"
"393","646",2022-09-05 02:00:00,854,885,31,15,FALSE,NA,"0.1.4"
"394","646",2022-09-05 02:15:00,854,885,31,15,FALSE,NA,"0.1.4"
"395","646",2022-09-05 02:30:00,854,885,31,15,FALSE,NA,"0.1.4"
"396","646",2022-09-05 02:45:00,854,885,31,15,FALSE,NA,"0.1.4"
"397","646",2022-09-05 03:00:00,854,885,31,15,FALSE,NA,"0.1.4"
"398","646",2022-09-05 03:15:00,854,885,31,15,FALSE,NA,"0.1.4"
"399","646",2022-09-05 03:30:00,854,885,31,15,FALSE,NA,"0.1.4"
"400","646",2022-09-05 03:45:00,854,885,31,15,FALSE,NA,"0.1.4"
"401","646",2022-09-05 04:00:00,854,885,31,15,FALSE,NA,"0.1.4"
"402","646",2022-09-05 04:15:00,855,885,30,15,FALSE,NA,"0.1.4"
"403","646",2022-09-05 04:30:00,855,885,30,15,FALSE,NA,"0.1.4"
"404","646",2022-09-05 04:45:00,856,885,29,15,FALSE,NA,"0.1.4"
"405","646",2022-09-05 05:00:00,857,885,28,15,FALSE,NA,"0.1.4"
"406","646",2022-09-05 05:15:00,858,885,27,15,FALSE,NA,"0.1.4"
"407","646",2022-09-05 05:30:00,860,885,25,15,FALSE,NA,"0.1.4"
"408","646",2022-09-05 05:45:00,860,885,25,15,FALSE,NA,"0.1.4"
"409","646",2022-09-05 06:00:00,861,885,24,15,FALSE,NA,"0.1.4"
"410","646",2022-09-05 06:15:00,861,885,24,15,FALSE,NA,"0.1.4"
"411","646",2022-09-05 06:30:00,862,885,23,15,FALSE,NA,"0.1.4"
"412","646",2022-09-05 06:45:00,863,885,22,15,FALSE,NA,"0.1.4"
"413","646",2022-09-05 07:00:00,863,885,22,15,FALSE,NA,"0.1.4"
"414","646",2022-09-05 07:15:00,863,885,22,15,FALSE,NA,"0.1.4"
"415","646",2022-09-05 07:30:00,864,885,21,15,FALSE,NA,"0.1.4"
"416","646",2022-09-05 07:45:00,865,885,20,15,FALSE,NA,"0.1.4"
"417","646",2022-09-05 08:00:00,865,885,20,15,FALSE,NA,"0.1.4"
"418","646",2022-09-05 08:15:00,866,885,19,15,FALSE,NA,"0.1.4"
"419","646",2022-09-05 08:30:00,867,885,18,15,FALSE,NA,"0.1.4"
"420","646",2022-09-05 08:45:00,867,885,18,15,FALSE,NA,"0.1.4"
"421","646",2022-09-05 09:00:00,868,885,17,15,FALSE,NA,"0.1.4"
"422","646",2022-09-05 09:15:00,868,885,17,15,FALSE,NA,"0.1.4"
"423","646",2022-09-05 09:30:00,869,885,16,15,FALSE,NA,"0.1.4"
"424","646",2022-09-05 09:45:00,870,885,15,15,FALSE,NA,"0.1.4"
"425","646",2022-09-05 10:00:00,870,885,15,15,FALSE,NA,"0.1.4"
"426","646",2022-09-05 10:15:00,870,885,15,15,FALSE,NA,"0.1.4"
"427","646",2022-09-05 10:30:00,870,885,15,15,FALSE,NA,"0.1.4"
"428","646",2022-09-05 10:45:00,870,885,15,15,FALSE,NA,"0.1.4"
"429","646",2022-09-05 11:00:00,871,885,14,15,FALSE,NA,"0.1.4"
"430","646",2022-09-05 11:15:00,872,885,13,15,FALSE,NA,"0.1.4"
"431","646",2022-09-05 11:30:00,872,885,13,15,FALSE,NA,"0.1.4"
"432","646",2022-09-05 11:45:00,872,885,13,15,FALSE,NA,"0.1.4"
"433","646",2022-09-05 12:00:00,872,885,13,15,FALSE,NA,"0.1.4"
"434","646",2022-09-05 12:15:00,872,885,13,15,FALSE,NA,"0.1.4"
"435","646",2022-09-05 12:30:00,874,885,11,15,FALSE,NA,"0.1.4"
"436","646",2022-09-05 12:45:00,874,885,11,15,FALSE,NA,"0.1.4"
"437","646",2022-09-05 13:00:00,874,885,11,15,FALSE,NA,"0.1.4"
"438","646",2022-09-05 13:15:00,875,885,10,15,FALSE,NA,"0.1.4"
"439","646",2022-09-05 13:30:00,875,885,10,15,FALSE,NA,"0.1.4"
"440","646",2022-09-05 13:45:00,875,885,10,15,FALSE,NA,"0.1.4"
"441","646",2022-09-05 14:00:00,875,885,10,15,FALSE,NA,"0.1.4"
"442","646",2022-09-05 14:15:00,876,885,9,15,FALSE,NA,"0.1.4"
"443","646",2022-09-05 14:30:00,876,885,9,15,FALSE,NA,"0.1.4"
"444","646",2022-09-05 14:45:00,877,885,8,15,FALSE,NA,"0.1.4"
"445","646",2022-09-05 15:00:00,878,885,7,15,FALSE,NA,"0.1.4"
"446","646",2022-09-05 15:15:00,877,885,8,15,FALSE,NA,"0.1.4"
"447","646",2022-09-05 15:30:00,878,885,7,15,FALSE,NA,"0.1.4"
"448","646",2022-09-05 15:45:00,877,885,8,15,FALSE,NA,"0.1.4"
"449","646",2022-09-05 16:00:00,878,885,7,15,FALSE,NA,"0.1.4"
"450","646",2022-09-05 16:15:00,878,885,7,15,FALSE,NA,"0.1.4"
"451","646",2022-09-05 16:30:00,878,885,7,15,FALSE,NA,"0.1.4"
"452","646",2022-09-05 16:45:00,878,885,7,15,FALSE,NA,"0.1.4"
"453","646",2022-09-05 17:00:00,878,885,7,15,FALSE,NA,"0.1.4"
"454","646",2022-09-05 17:15:00,878,885,7,15,FALSE,NA,"0.1.4"
"455","646",2022-09-05 17:30:00,877,885,8,15,FALSE,NA,"0.1.4"
"456","646",2022-09-05 17:45:00,878,885,7,15,FALSE,NA,"0.1.4"
"457","646",2022-09-05 18:00:00,878,885,7,15,FALSE,NA,"0.1.4"
"458","646",2022-09-05 18:15:00,878,885,7,15,FALSE,NA,"0.1.4"
"459","646",2022-09-05 18:30:00,877,885,8,15,FALSE,NA,"0.1.4"
"460","646",2022-09-05 18:45:00,877,885,8,15,FALSE,NA,"0.1.4"
"461","646",2022-09-05 19:00:00,877,885,8,15,FALSE,NA,"0.1.4"
"462","646",2022-09-05 19:15:00,877,885,8,15,FALSE,NA,"0.1.4"
"463","646",2022-09-05 19:30:00,877,885,8,15,FALSE,NA,"0.1.4"
"464","646",2022-09-05 19:45:00,876,885,9,15,FALSE,NA,"0.1.4"
"465","646",2022-09-05 20:00:00,876,885,9,15,FALSE,NA,"0.1.4"
"466","646",2022-09-05 20:15:00,876,885,9,15,FALSE,NA,"0.1.4"
"467","646",2022-09-05 20:30:00,876,885,9,15,FALSE,NA,"0.1.4"
"468","646",2022-09-05 20:45:00,875,885,10,15,FALSE,NA,"0.1.4"
"469","646",2022-09-05 21:00:00,874,885,11,15,FALSE,NA,"0.1.4"
"470","646",2022-09-05 21:15:00,872,885,13,15,FALSE,NA,"0.1.4"
"471","646",2022-09-05 21:30:00,871,885,14,15,FALSE,NA,"0.1.4"
"472","646",2022-09-05 21:45:00,870,885,15,15,FALSE,NA,"0.1.4"
"473","646",2022-09-05 22:00:00,868,885,17,15,FALSE,NA,"0.1.4"
"474","646",2022-09-05 22:15:00,868,885,17,15,FALSE,NA,"0.1.4"
"475","646",2022-09-05 22:30:00,865,885,20,15,FALSE,NA,"0.1.4"
"476","646",2022-09-05 22:45:00,864,885,21,15,FALSE,NA,"0.1.4"
"477","646",2022-09-05 23:00:00,864,885,21,15,FALSE,NA,"0.1.4"
"478","646",2022-09-05 23:15:00,863,885,22,15,FALSE,NA,"0.1.4"
"479","646",2022-09-05 23:30:00,862,885,23,15,FALSE,NA,"0.1.4"
"480","646",2022-09-05 23:45:00,862,885,23,15,FALSE,NA,"0.1.4"
"481","646",2022-09-06,861,885,24,15,FALSE,NA,"0.1.4"
"482","646",2022-09-06 00:15:00,861,885,24,15,FALSE,NA,"0.1.4"
"483","646",2022-09-06 00:30:00,861,885,24,15,FALSE,NA,"0.1.4"
"484","646",2022-09-06 00:45:00,861,885,24,15,FALSE,NA,"0.1.4"
"485","646",2022-09-06 01:00:00,861,885,24,15,FALSE,NA,"0.1.4"
"486","646",2022-09-06 01:15:00,861,885,24,15,FALSE,NA,"0.1.4"
"487","646",2022-09-06 01:30:00,861,885,24,15,FALSE,NA,"0.1.4"
"488","646",2022-09-06 01:45:00,861,885,24,15,FALSE,NA,"0.1.4"
"489","646",2022-09-06 02:00:00,861,885,24,15,FALSE,NA,"0.1.4"
"490","646",2022-09-06 02:15:00,861,885,24,15,FALSE,NA,"0.1.4"
"491","646",2022-09-06 02:30:00,861,885,24,15,FALSE,NA,"0.1.4"
"492","646",2022-09-06 02:45:00,861,885,24,15,FALSE,NA,"0.1.4"
"493","646",2022-09-06 03:00:00,861,885,24,15,FALSE,NA,"0.1.4"
"494","646",2022-09-06 03:15:00,861,885,24,15,FALSE,NA,"0.1.4"
"495","646",2022-09-06 03:30:00,861,885,24,15,FALSE,NA,"0.1.4"
"496","646",2022-09-06 03:45:00,861,885,24,15,FALSE,NA,"0.1.4"
"497","646",2022-09-06 04:00:00,861,885,24,15,FALSE,NA,"0.1.4"
"498","646",2022-09-06 04:15:00,861,885,24,15,FALSE,NA,"0.1.4"
"499","646",2022-09-06 04:30:00,862,885,23,15,FALSE,NA,"0.1.4"
"500","646",2022-09-06 04:45:00,862,885,23,15,FALSE,NA,"0.1.4"
"501","646",2022-09-06 05:00:00,863,885,22,15,FALSE,NA,"0.1.4"
"502","646",2022-09-06 05:15:00,865,885,20,15,FALSE,NA,"0.1.4"
"503","646",2022-09-06 05:30:00,866,885,19,15,FALSE,NA,"0.1.4"
"504","646",2022-09-06 05:45:00,866,885,19,15,FALSE,NA,"0.1.4"
"505","646",2022-09-06 06:00:00,868,885,17,15,FALSE,NA,"0.1.4"
"506","646",2022-09-06 06:15:00,869,885,16,15,FALSE,NA,"0.1.4"
"507","646",2022-09-06 06:30:00,870,885,15,15,FALSE,NA,"0.1.4"
"508","646",2022-09-06 06:45:00,871,885,14,15,FALSE,NA,"0.1.4"
"509","646",2022-09-06 07:00:00,871,885,14,15,FALSE,NA,"0.1.4"
"510","646",2022-09-06 07:15:00,871,885,14,15,FALSE,NA,"0.1.4"
"511","646",2022-09-06 07:30:00,872,885,13,15,FALSE,NA,"0.1.4"
"512","646",2022-09-06 07:45:00,873,885,12,15,FALSE,NA,"0.1.4"
"513","646",2022-09-06 08:00:00,873,885,12,15,FALSE,NA,"0.1.4"
"514","646",2022-09-06 08:15:00,873,885,12,15,FALSE,NA,"0.1.4"
"515","646",2022-09-06 08:30:00,873,885,12,15,FALSE,NA,"0.1.4"
"516","646",2022-09-06 08:45:00,875,885,10,15,FALSE,NA,"0.1.4"
"517","646",2022-09-06 09:00:00,875,885,10,15,FALSE,NA,"0.1.4"
"518","646",2022-09-06 09:15:00,876,885,9,15,FALSE,NA,"0.1.4"
"519","646",2022-09-06 09:30:00,876,885,9,15,FALSE,NA,"0.1.4"
"520","646",2022-09-06 09:45:00,877,885,8,15,FALSE,NA,"0.1.4"
"521","646",2022-09-06 10:00:00,877,885,8,15,FALSE,NA,"0.1.4"
"522","646",2022-09-06 10:15:00,878,885,7,15,FALSE,NA,"0.1.4"
"523","646",2022-09-06 10:30:00,879,885,6,15,FALSE,NA,"0.1.4"
"524","646",2022-09-06 10:45:00,879,885,6,15,FALSE,NA,"0.1.4"
"525","646",2022-09-06 11:00:00,878,885,7,15,FALSE,NA,"0.1.4"
"526","646",2022-09-06 11:15:00,878,885,7,15,FALSE,NA,"0.1.4"
"527","646",2022-09-06 11:30:00,879,885,6,15,FALSE,NA,"0.1.4"
"528","646",2022-09-06 11:45:00,879,885,6,15,FALSE,NA,"0.1.4"
"529","646",2022-09-06 12:00:00,879,885,6,15,FALSE,NA,"0.1.4"
"530","646",2022-09-06 12:15:00,880,885,5,15,FALSE,NA,"0.1.4"
"531","646",2022-09-06 12:30:00,880,885,5,15,FALSE,NA,"0.1.4"
"532","646",2022-09-06 12:45:00,880,885,5,15,FALSE,NA,"0.1.4"
"533","646",2022-09-06 13:00:00,880,885,5,15,FALSE,NA,"0.1.4"
"534","646",2022-09-06 13:15:00,880,885,5,15,FALSE,NA,"0.1.4"
"535","646",2022-09-06 13:30:00,880,885,5,15,FALSE,NA,"0.1.4"
"536","646",2022-09-06 13:45:00,880,885,5,15,FALSE,NA,"0.1.4"
"537","646",2022-09-06 14:00:00,881,885,4,15,FALSE,NA,"0.1.4"
"538","646",2022-09-06 14:15:00,881,885,4,15,FALSE,NA,"0.1.4"
"539","646",2022-09-06 14:30:00,881,885,4,15,FALSE,NA,"0.1.4"
"540","646",2022-09-06 14:45:00,881,885,4,15,FALSE,NA,"0.1.4"
"541","646",2022-09-06 15:00:00,881,885,4,15,FALSE,NA,"0.1.4"
"542","646",2022-09-06 15:15:00,881,885,4,15,FALSE,NA,"0.1.4"
"543","646",2022-09-06 15:30:00,881,885,4,15,FALSE,NA,"0.1.4"
"544","646",2022-09-06 15:45:00,882,885,3,15,FALSE,NA,"0.1.4"
"545","646",2022-09-06 16:00:00,881,885,4,15,FALSE,NA,"0.1.4"
"546","646",2022-09-06 16:15:00,881,885,4,15,FALSE,NA,"0.1.4"
"547","646",2022-09-06 16:30:00,881,885,4,15,FALSE,NA,"0.1.4"
"548","646",2022-09-06 16:45:00,881,885,4,15,FALSE,NA,"0.1.4"
"549","646",2022-09-06 17:00:00,881,885,4,15,FALSE,NA,"0.1.4"
"550","646",2022-09-06 17:15:00,881,885,4,15,FALSE,NA,"0.1.4"
"551","646",2022-09-06 17:30:00,881,885,4,15,FALSE,NA,"0.1.4"
"552","646",2022-09-06 17:45:00,881,885,4,15,FALSE,NA,"0.1.4"
"553","646",2022-09-06 18:00:00,881,885,4,15,FALSE,NA,"0.1.4"
"554","646",2022-09-06 18:15:00,881,885,4,15,FALSE,NA,"0.1.4"
"555","646",2022-09-06 18:30:00,881,885,4,15,FALSE,NA,"0.1.4"
"556","646",2022-09-06 18:45:00,881,885,4,15,FALSE,NA,"0.1.4"
"557","646",2022-09-06 19:00:00,881,885,4,15,FALSE,NA,"0.1.4"
"558","646",2022-09-06 19:15:00,881,885,4,15,FALSE,NA,"0.1.4"
"559","646",2022-09-06 19:30:00,881,885,4,15,FALSE,NA,"0.1.4"
"560","646",2022-09-06 19:45:00,881,885,4,15,FALSE,NA,"0.1.4"
"561","646",2022-09-06 20:00:00,881,885,4,15,FALSE,NA,"0.1.4"
"562","646",2022-09-06 20:15:00,881,885,4,15,FALSE,NA,"0.1.4"
"563","646",2022-09-06 20:30:00,880,885,5,15,FALSE,NA,"0.1.4"
"564","646",2022-09-06 20:45:00,879,885,6,15,FALSE,NA,"0.1.4"
"565","646",2022-09-06 21:00:00,878,885,7,15,FALSE,NA,"0.1.4"
"566","646",2022-09-06 21:15:00,876,885,9,15,FALSE,NA,"0.1.4"
"567","646",2022-09-06 21:30:00,875,885,10,15,FALSE,NA,"0.1.4"
"568","646",2022-09-06 21:45:00,873,885,12,15,FALSE,NA,"0.1.4"
"569","646",2022-09-06 22:00:00,871,885,14,15,FALSE,NA,"0.1.4"
"570","646",2022-09-06 22:15:00,868,885,17,15,FALSE,NA,"0.1.4"
"571","646",2022-09-06 22:30:00,866,885,19,15,FALSE,NA,"0.1.4"
"572","646",2022-09-06 22:45:00,865,885,20,15,FALSE,NA,"0.1.4"
"573","646",2022-09-06 23:00:00,865,885,20,15,FALSE,NA,"0.1.4"
"574","646",2022-09-06 23:15:00,863,885,22,15,FALSE,NA,"0.1.4"
"575","646",2022-09-06 23:30:00,862,885,23,15,FALSE,NA,"0.1.4"
"576","646",2022-09-06 23:45:00,862,885,23,15,FALSE,NA,"0.1.4"
"577","646",2022-09-07,860,885,25,15,FALSE,NA,"0.1.4"
"578","646",2022-09-07 00:15:00,860,885,25,15,FALSE,NA,"0.1.4"
"579","646",2022-09-07 00:30:00,859,885,26,15,FALSE,NA,"0.1.4"
"580","646",2022-09-07 00:45:00,859,885,26,15,FALSE,NA,"0.1.4"
"581","646",2022-09-07 01:00:00,859,885,26,15,FALSE,NA,"0.1.4"
"582","646",2022-09-07 01:15:00,859,885,26,15,FALSE,NA,"0.1.4"
"583","646",2022-09-07 01:30:00,859,885,26,15,FALSE,NA,"0.1.4"
"584","646",2022-09-07 01:45:00,859,885,26,15,FALSE,NA,"0.1.4"
"585","646",2022-09-07 02:00:00,859,885,26,15,FALSE,NA,"0.1.4"
"586","646",2022-09-07 02:15:00,859,885,26,15,FALSE,NA,"0.1.4"
"587","646",2022-09-07 02:30:00,859,885,26,15,FALSE,NA,"0.1.4"
"588","646",2022-09-07 02:45:00,859,885,26,15,FALSE,NA,"0.1.4"
"589","646",2022-09-07 03:00:00,859,885,26,15,FALSE,NA,"0.1.4"
"590","646",2022-09-07 03:15:00,859,885,26,15,FALSE,NA,"0.1.4"
"591","646",2022-09-07 03:30:00,859,885,26,15,FALSE,NA,"0.1.4"
"592","646",2022-09-07 03:45:00,859,885,26,15,FALSE,NA,"0.1.4"
"593","646",2022-09-07 04:00:00,859,885,26,15,FALSE,NA,"0.1.4"
"594","646",2022-09-07 04:15:00,860,885,25,15,FALSE,NA,"0.1.4"
"595","646",2022-09-07 04:30:00,861,885,24,15,FALSE,NA,"0.1.4"
"596","646",2022-09-07 04:45:00,861,885,24,15,FALSE,NA,"0.1.4"
"597","646",2022-09-07 05:00:00,863,885,22,15,FALSE,NA,"0.1.4"
"598","646",2022-09-07 05:15:00,864,885,21,15,FALSE,NA,"0.1.4"
"599","646",2022-09-07 05:30:00,865,885,20,15,FALSE,NA,"0.1.4"
"600","646",2022-09-07 05:45:00,866,885,19,15,FALSE,NA,"0.1.4"
"601","646",2022-09-07 06:00:00,867,885,18,15,FALSE,NA,"0.1.4"
"602","646",2022-09-07 06:15:00,868,885,17,15,FALSE,NA,"0.1.4"
"603","646",2022-09-07 06:30:00,869,885,16,15,FALSE,NA,"0.1.4"
"604","646",2022-09-07 06:45:00,870,885,15,15,FALSE,NA,"0.1.4"
"605","646",2022-09-07 07:00:00,872,885,13,15,FALSE,NA,"0.1.4"
"606","646",2022-09-07 07:15:00,872,885,13,15,FALSE,NA,"0.1.4"
"607","646",2022-09-07 07:30:00,871,885,14,15,FALSE,NA,"0.1.4"
"608","646",2022-09-07 07:45:00,873,885,12,15,FALSE,NA,"0.1.4"
"609","646",2022-09-07 08:00:00,873,885,12,15,FALSE,NA,"0.1.4"
"610","646",2022-09-07 08:15:00,874,885,11,15,FALSE,NA,"0.1.4"
"611","646",2022-09-07 08:30:00,874,885,11,15,FALSE,NA,"0.1.4"
"612","646",2022-09-07 08:45:00,875,885,10,15,FALSE,NA,"0.1.4"
"613","646",2022-09-07 09:00:00,876,885,9,15,FALSE,NA,"0.1.4"
"614","646",2022-09-07 09:15:00,876,885,9,15,FALSE,NA,"0.1.4"
"615","646",2022-09-07 09:30:00,876,885,9,15,FALSE,NA,"0.1.4"
"616","646",2022-09-07 09:45:00,877,885,8,15,FALSE,NA,"0.1.4"
"617","646",2022-09-07 10:00:00,878,885,7,15,FALSE,NA,"0.1.4"
"618","646",2022-09-07 10:15:00,878,885,7,15,FALSE,NA,"0.1.4"
"619","646",2022-09-07 10:30:00,878,885,7,15,FALSE,NA,"0.1.4"
"620","646",2022-09-07 10:45:00,878,885,7,15,FALSE,NA,"0.1.4"
"621","646",2022-09-07 11:00:00,878,885,7,15,FALSE,NA,"0.1.4"
"622","646",2022-09-07 11:15:00,879,885,6,15,FALSE,NA,"0.1.4"
"623","646",2022-09-07 11:30:00,879,885,6,15,FALSE,NA,"0.1.4"
"624","646",2022-09-07 11:45:00,879,885,6,15,FALSE,NA,"0.1.4"
"625","646",2022-09-07 12:00:00,880,885,5,15,FALSE,NA,"0.1.4"
"626","646",2022-09-07 12:15:00,881,885,4,15,FALSE,NA,"0.1.4"
"627","646",2022-09-07 12:30:00,880,885,5,15,FALSE,NA,"0.1.4"
"628","646",2022-09-07 12:45:00,880,885,5,15,FALSE,NA,"0.1.4"
"629","646",2022-09-07 13:00:00,880,885,5,15,FALSE,NA,"0.1.4"
"630","646",2022-09-07 13:15:00,881,885,4,15,FALSE,NA,"0.1.4"
"631","646",2022-09-07 13:30:00,881,885,4,15,FALSE,NA,"0.1.4"
"632","646",2022-09-07 13:45:00,881,885,4,15,FALSE,NA,"0.1.4"
"633","646",2022-09-07 14:00:00,882,885,3,15,FALSE,NA,"0.1.4"
"634","646",2022-09-07 14:15:00,881,885,4,15,FALSE,NA,"0.1.4"
"635","646",2022-09-07 14:30:00,881,885,4,15,FALSE,NA,"0.1.4"
"636","646",2022-09-07 14:45:00,882,885,3,15,FALSE,NA,"0.1.4"
"637","646",2022-09-07 15:00:00,882,885,3,15,FALSE,NA,"0.1.4"
"638","646",2022-09-07 15:15:00,881,885,4,15,FALSE,NA,"0.1.4"
"639","646",2022-09-07 15:30:00,881,885,4,15,FALSE,NA,"0.1.4"
"640","646",2022-09-07 15:45:00,881,885,4,15,FALSE,NA,"0.1.4"
"641","646",2022-09-07 16:00:00,881,885,4,15,FALSE,NA,"0.1.4"
"642","646",2022-09-07 16:15:00,881,885,4,15,FALSE,NA,"0.1.4"
"643","646",2022-09-07 16:30:00,881,885,4,15,FALSE,NA,"0.1.4"
"644","646",2022-09-07 16:45:00,881,885,4,15,FALSE,NA,"0.1.4"
"645","646",2022-09-07 17:00:00,881,885,4,15,FALSE,NA,"0.1.4"
"646","646",2022-09-07 17:15:00,882,885,3,15,FALSE,NA,"0.1.4"
"647","646",2022-09-07 17:30:00,882,885,3,15,FALSE,NA,"0.1.4"
"648","646",2022-09-07 17:45:00,881,885,4,15,FALSE,NA,"0.1.4"
"649","646",2022-09-07 18:00:00,881,885,4,15,FALSE,NA,"0.1.4"
"650","646",2022-09-07 18:15:00,881,885,4,15,FALSE,NA,"0.1.4"
"651","646",2022-09-07 18:30:00,881,885,4,15,FALSE,NA,"0.1.4"
"652","646",2022-09-07 18:45:00,881,885,4,15,FALSE,NA,"0.1.4"
"653","646",2022-09-07 19:00:00,881,885,4,15,FALSE,NA,"0.1.4"
"654","646",2022-09-07 19:15:00,881,885,4,15,FALSE,NA,"0.1.4"
"655","646",2022-09-07 19:30:00,881,885,4,15,FALSE,NA,"0.1.4"
"656","646",2022-09-07 19:45:00,881,885,4,15,FALSE,NA,"0.1.4"
"657","646",2022-09-07 20:00:00,881,885,4,15,FALSE,NA,"0.1.4"
"658","646",2022-09-07 20:15:00,881,885,4,15,FALSE,NA,"0.1.4"
"659","646",2022-09-07 20:30:00,879,885,6,15,FALSE,NA,"0.1.4"
"660","646",2022-09-07 20:45:00,879,885,6,15,FALSE,NA,"0.1.4"
"661","646",2022-09-07 21:00:00,877,885,8,15,FALSE,NA,"0.1.4"
"662","646",2022-09-07 21:15:00,876,885,9,15,FALSE,NA,"0.1.4"
"663","646",2022-09-07 21:30:00,875,885,10,15,FALSE,NA,"0.1.4"
"664","646",2022-09-07 21:45:00,875,885,10,15,FALSE,NA,"0.1.4"
"665","646",2022-09-07 22:00:00,874,885,11,15,FALSE,NA,"0.1.4"
"666","646",2022-09-07 22:15:00,872,885,13,15,FALSE,NA,"0.1.4"
"667","646",2022-09-07 22:30:00,871,885,14,15,FALSE,NA,"0.1.4"
"668","646",2022-09-07 22:45:00,870,885,15,15,FALSE,NA,"0.1.4"
"669","646",2022-09-07 23:00:00,870,885,15,15,FALSE,NA,"0.1.4"
"670","646",2022-09-07 23:15:00,869,885,16,15,FALSE,NA,"0.1.4"
"671","646",2022-09-07 23:30:00,869,885,16,15,FALSE,NA,"0.1.4"
"672","646",2022-09-07 23:45:00,868,885,17,15,FALSE,NA,"0.1.4"
"673","646",2022-09-08,868,885,17,15,FALSE,NA,"0.1.4"
"674","646",2022-09-08 00:15:00,866,885,19,15,FALSE,NA,"0.1.4"
"675","646",2022-09-08 00:30:00,867,885,18,15,FALSE,NA,"0.1.4"
"676","646",2022-09-08 00:45:00,867,885,18,15,FALSE,NA,"0.1.4"
"677","646",2022-09-08 01:00:00,867,885,18,15,FALSE,NA,"0.1.4"
"678","646",2022-09-08 01:15:00,866,885,19,15,FALSE,NA,"0.1.4"
"679","646",2022-09-08 01:30:00,867,885,18,15,FALSE,NA,"0.1.4"
"680","646",2022-09-08 01:45:00,867,885,18,15,FALSE,NA,"0.1.4"
"681","646",2022-09-08 02:00:00,867,885,18,15,FALSE,NA,"0.1.4"
"682","646",2022-09-08 02:15:00,867,885,18,15,FALSE,NA,"0.1.4"
"683","646",2022-09-08 02:30:00,866,885,19,15,FALSE,NA,"0.1.4"
"684","646",2022-09-08 02:45:00,866,885,19,15,FALSE,NA,"0.1.4"
"685","646",2022-09-08 03:00:00,866,885,19,15,FALSE,NA,"0.1.4"
"686","646",2022-09-08 03:15:00,866,885,19,15,FALSE,NA,"0.1.4"
"687","646",2022-09-08 03:30:00,866,885,19,15,FALSE,NA,"0.1.4"
"688","646",2022-09-08 03:45:00,866,885,19,15,FALSE,NA,"0.1.4"
"689","646",2022-09-08 04:00:00,866,885,19,15,FALSE,NA,"0.1.4"
"690","646",2022-09-08 04:15:00,867,885,18,15,FALSE,NA,"0.1.4"
"691","646",2022-09-08 04:30:00,867,885,18,15,FALSE,NA,"0.1.4"
"692","646",2022-09-08 04:45:00,869,885,16,15,FALSE,NA,"0.1.4"
"693","646",2022-09-08 05:00:00,870,885,15,15,FALSE,NA,"0.1.4"
"694","646",2022-09-08 05:15:00,870,885,15,15,FALSE,NA,"0.1.4"
"695","646",2022-09-08 05:30:00,871,885,14,15,FALSE,NA,"0.1.4"
"696","646",2022-09-08 05:45:00,872,885,13,15,FALSE,NA,"0.1.4"
"697","646",2022-09-08 06:00:00,872,885,13,15,FALSE,NA,"0.1.4"
"698","646",2022-09-08 06:15:00,873,885,12,15,FALSE,NA,"0.1.4"
"699","646",2022-09-08 06:30:00,875,885,10,15,FALSE,NA,"0.1.4"
"700","646",2022-09-08 06:45:00,875,885,10,15,FALSE,NA,"0.1.4"
"701","646",2022-09-08 07:00:00,876,885,9,15,FALSE,NA,"0.1.4"
"702","646",2022-09-08 07:15:00,876,885,9,15,FALSE,NA,"0.1.4"
"703","646",2022-09-08 07:30:00,878,885,7,15,FALSE,NA,"0.1.4"
"704","646",2022-09-08 07:45:00,878,885,7,15,FALSE,NA,"0.1.4"
"705","646",2022-09-08 08:00:00,879,885,6,15,FALSE,NA,"0.1.4"
"706","646",2022-09-08 08:15:00,878,885,7,15,FALSE,NA,"0.1.4"
"707","646",2022-09-08 08:30:00,878,885,7,15,FALSE,NA,"0.1.4"
"708","646",2022-09-08 08:45:00,878,885,7,15,FALSE,NA,"0.1.4"
"709","646",2022-09-08 09:00:00,879,885,6,15,FALSE,NA,"0.1.4"
"710","646",2022-09-08 09:15:00,880,885,5,15,FALSE,NA,"0.1.4"
"711","646",2022-09-08 09:30:00,879,885,6,15,FALSE,NA,"0.1.4"
"712","646",2022-09-08 09:45:00,880,885,5,15,FALSE,NA,"0.1.4"
"713","646",2022-09-08 10:00:00,880,885,5,15,FALSE,NA,"0.1.4"
"714","646",2022-09-08 10:15:00,881,885,4,15,FALSE,NA,"0.1.4"
"715","646",2022-09-08 10:30:00,881,885,4,15,FALSE,NA,"0.1.4"
"716","646",2022-09-08 10:45:00,882,885,3,15,FALSE,NA,"0.1.4"
"717","646",2022-09-08 11:00:00,882,885,3,15,FALSE,NA,"0.1.4"
"718","646",2022-09-08 11:15:00,882,885,3,15,FALSE,NA,"0.1.4"
"719","646",2022-09-08 11:30:00,882,885,3,15,FALSE,NA,"0.1.4"
"720","646",2022-09-08 11:45:00,882,885,3,15,FALSE,NA,"0.1.4"
"721","646",2022-09-08 12:00:00,882,885,3,15,FALSE,NA,"0.1.4"
"722","646",2022-09-08 12:15:00,882,885,3,15,FALSE,NA,"0.1.4"
"723","646",2022-09-08 12:30:00,883,885,2,15,FALSE,NA,"0.1.4"
"724","646",2022-09-08 12:45:00,883,885,2,15,FALSE,NA,"0.1.4"
"725","646",2022-09-08 13:00:00,883,885,2,15,FALSE,NA,"0.1.4"
"726","646",2022-09-08 13:15:00,884,885,1,15,FALSE,NA,"0.1.4"
"727","646",2022-09-08 13:30:00,883,885,2,15,FALSE,NA,"0.1.4"
"728","646",2022-09-08 13:45:00,884,885,1,15,FALSE,NA,"0.1.4"
"729","646",2022-09-08 14:00:00,884,885,1,15,FALSE,NA,"0.1.4"
"730","646",2022-09-08 14:15:00,884,885,1,15,FALSE,NA,"0.1.4"
"731","646",2022-09-08 14:30:00,884,885,1,15,FALSE,NA,"0.1.4"
"732","646",2022-09-08 14:45:00,884,885,1,15,FALSE,NA,"0.1.4"
"733","646",2022-09-08 15:00:00,884,885,1,15,FALSE,NA,"0.1.4"
"734","646",2022-09-08 15:15:00,884,885,1,15,FALSE,NA,"0.1.4"
"735","646",2022-09-08 15:30:00,885,885,0,15,FALSE,NA,"0.1.4"
"736","646",2022-09-08 15:45:00,885,885,0,15,FALSE,NA,"0.1.4"
"737","646",2022-09-08 16:00:00,885,885,0,15,FALSE,NA,"0.1.4"
"738","646",2022-09-08 16:15:00,885,885,0,15,FALSE,NA,"0.1.4"
"739","646",2022-09-08 16:30:00,885,885,0,15,FALSE,NA,"0.1.4"
"740","646",2022-09-08 16:45:00,885,885,0,15,FALSE,NA,"0.1.4"
"741","646",2022-09-08 17:00:00,885,885,0,15,FALSE,NA,"0.1.4"
"742","646",2022-09-08 17:15:00,885,885,0,15,FALSE,NA,"0.1.4"
"743","646",2022-09-08 17:30:00,885,885,0,15,FALSE,NA,"0.1.4"
"744","646",2022-09-08 17:45:00,885,885,0,15,FALSE,NA,"0.1.4"
"745","646",2022-09-08 18:00:00,885,885,0,15,FALSE,NA,"0.1.4"
"746","646",2022-09-08 18:15:00,885,885,0,15,FALSE,NA,"0.1.4"
"747","646",2022-09-08 18:30:00,885,885,0,15,FALSE,NA,"0.1.4"
"748","646",2022-09-08 18:45:00,885,885,0,15,FALSE,NA,"0.1.4"
"749","646",2022-09-08 19:00:00,885,885,0,15,FALSE,NA,"0.1.4"
"750","646",2022-09-08 19:15:00,885,885,0,15,FALSE,NA,"0.1.4"
"751","646",2022-09-08 19:30:00,885,885,0,15,FALSE,NA,"0.1.4"
"752","646",2022-09-08 19:45:00,885,885,0,15,FALSE,NA,"0.1.4"
"753","646",2022-09-08 20:00:00,885,885,0,15,FALSE,NA,"0.1.4"
"754","646",2022-09-08 20:15:00,885,885,0,15,FALSE,NA,"0.1.4"
"755","646",2022-09-08 20:30:00,884,885,1,15,FALSE,NA,"0.1.4"
"756","646",2022-09-08 20:45:00,884,885,1,15,FALSE,NA,"0.1.4"
"757","646",2022-09-08 21:00:00,884,885,1,15,FALSE,NA,"0.1.4"
"758","646",2022-09-08 21:15:00,884,885,1,15,FALSE,NA,"0.1.4"
"759","646",2022-09-08 21:30:00,884,885,1,15,FALSE,NA,"0.1.4"
"760","646",2022-09-08 21:45:00,883,885,2,15,FALSE,NA,"0.1.4"
"761","646",2022-09-08 22:00:00,882,885,3,15,FALSE,NA,"0.1.4"
"762","646",2022-09-08 22:15:00,881,885,4,15,FALSE,NA,"0.1.4"
"763","646",2022-09-08 22:30:00,879,885,6,15,FALSE,NA,"0.1.4"
"764","646",2022-09-08 22:45:00,879,885,6,15,FALSE,NA,"0.1.4"
"765","646",2022-09-08 23:00:00,879,885,6,15,FALSE,NA,"0.1.4"
"766","646",2022-09-08 23:15:00,878,885,7,15,FALSE,NA,"0.1.4"
"767","646",2022-09-08 23:30:00,878,885,7,15,FALSE,NA,"0.1.4"
"768","646",2022-09-08 23:45:00,878,885,7,15,FALSE,NA,"0.1.4"
"769","646",2022-09-09,878,885,7,15,FALSE,NA,"0.1.4"
"770","646",2022-09-09 00:15:00,878,885,7,15,FALSE,NA,"0.1.4"
"771","646",2022-09-09 00:30:00,878,885,7,15,FALSE,NA,"0.1.4"
"772","646",2022-09-09 00:45:00,878,885,7,15,FALSE,NA,"0.1.4"
"773","646",2022-09-09 01:00:00,878,885,7,15,FALSE,NA,"0.1.4"
"774","646",2022-09-09 01:15:00,878,885,7,15,FALSE,NA,"0.1.4"
"775","646",2022-09-09 01:30:00,878,885,7,15,FALSE,NA,"0.1.4"
"776","646",2022-09-09 01:45:00,878,885,7,15,FALSE,NA,"0.1.4"
"777","646",2022-09-09 02:00:00,878,885,7,15,FALSE,NA,"0.1.4"
"778","646",2022-09-09 02:15:00,878,885,7,15,FALSE,NA,"0.1.4"
"779","646",2022-09-09 02:30:00,878,885,7,15,FALSE,NA,"0.1.4"
"780","646",2022-09-09 02:45:00,878,885,7,15,FALSE,NA,"0.1.4"
"781","646",2022-09-09 03:00:00,878,885,7,15,FALSE,NA,"0.1.4"
"782","646",2022-09-09 03:15:00,878,885,7,15,FALSE,NA,"0.1.4"
"783","646",2022-09-09 03:30:00,878,885,7,15,FALSE,NA,"0.1.4"
"784","646",2022-09-09 03:45:00,878,885,7,15,FALSE,NA,"0.1.4"
"785","646",2022-09-09 04:00:00,878,885,7,15,FALSE,NA,"0.1.4"
"786","646",2022-09-09 04:15:00,878,885,7,15,FALSE,NA,"0.1.4"
"787","646",2022-09-09 04:30:00,877,885,8,15,FALSE,NA,"0.1.4"
"788","646",2022-09-09 04:45:00,877,885,8,15,FALSE,NA,"0.1.4"
"789","646",2022-09-09 05:00:00,877,885,8,15,FALSE,NA,"0.1.4"
"790","646",2022-09-09 05:15:00,878,885,7,15,FALSE,NA,"0.1.4"
"791","646",2022-09-09 05:30:00,878,885,7,15,FALSE,NA,"0.1.4"
"792","646",2022-09-09 05:45:00,879,885,6,15,FALSE,NA,"0.1.4"
"793","646",2022-09-09 06:00:00,878,885,7,15,FALSE,NA,"0.1.4"
"794","646",2022-09-09 06:15:00,879,885,6,15,FALSE,NA,"0.1.4"
"795","646",2022-09-09 06:30:00,879,885,6,15,FALSE,NA,"0.1.4"
"796","646",2022-09-09 06:45:00,880,885,5,15,FALSE,NA,"0.1.4"
"797","646",2022-09-09 07:00:00,879,885,6,15,FALSE,NA,"0.1.4"
"798","646",2022-09-09 07:15:00,880,885,5,15,FALSE,NA,"0.1.4"
"799","646",2022-09-09 07:30:00,880,885,5,15,FALSE,NA,"0.1.4"
"800","646",2022-09-09 07:45:00,881,885,4,15,FALSE,NA,"0.1.4"
"801","646",2022-09-09 08:00:00,881,885,4,15,FALSE,NA,"0.1.4"
"802","646",2022-09-09 08:15:00,882,885,3,15,FALSE,NA,"0.1.4"
"803","646",2022-09-09 08:30:00,882,885,3,15,FALSE,NA,"0.1.4"
"804","646",2022-09-09 08:45:00,881,885,4,15,FALSE,NA,"0.1.4"
"805","646",2022-09-09 09:00:00,882,885,3,15,FALSE,NA,"0.1.4"
"806","646",2022-09-09 09:15:00,883,885,2,15,FALSE,NA,"0.1.4"
"807","646",2022-09-09 09:30:00,883,885,2,15,FALSE,NA,"0.1.4"
"808","646",2022-09-09 09:45:00,883,885,2,15,FALSE,NA,"0.1.4"
"809","646",2022-09-09 10:00:00,883,885,2,15,FALSE,NA,"0.1.4"
"810","646",2022-09-09 10:15:00,884,885,1,15,FALSE,NA,"0.1.4"
"811","646",2022-09-09 10:30:00,883,885,2,15,FALSE,NA,"0.1.4"
"812","646",2022-09-09 10:45:00,884,885,1,15,FALSE,NA,"0.1.4"
"813","646",2022-09-09 11:00:00,884,885,1,15,FALSE,NA,"0.1.4"
"814","646",2022-09-09 11:15:00,885,885,0,15,FALSE,NA,"0.1.4"
"815","646",2022-09-09 11:30:00,885,885,0,15,FALSE,NA,"0.1.4"
"816","646",2022-09-09 11:45:00,885,885,0,15,FALSE,NA,"0.1.4"
"817","646",2022-09-09 12:00:00,885,885,0,15,FALSE,NA,"0.1.4"
"818","646",2022-09-09 12:15:00,885,885,0,15,FALSE,NA,"0.1.4"
"819","646",2022-09-09 12:30:00,885,885,0,15,FALSE,NA,"0.1.4"
"820","646",2022-09-09 12:45:00,885,885,0,15,FALSE,NA,"0.1.4"
"821","646",2022-09-09 13:00:00,886,886,0,16,FALSE,NA,"0.1.4"
"822","646",2022-09-09 13:15:00,885,886,1,16,FALSE,NA,"0.1.4"
"823","646",2022-09-09 13:30:00,885,886,1,16,FALSE,NA,"0.1.4"
"824","646",2022-09-09 13:45:00,886,886,0,16,FALSE,NA,"0.1.4"
"825","646",2022-09-09 14:00:00,886,886,0,16,FALSE,NA,"0.1.4"
"826","646",2022-09-09 14:15:00,886,886,0,16,FALSE,NA,"0.1.4"
"827","646",2022-09-09 14:30:00,886,886,0,16,FALSE,NA,"0.1.4"
"828","646",2022-09-09 14:45:00,886,886,0,16,FALSE,NA,"0.1.4"
"829","646",2022-09-09 15:00:00,886,886,0,16,FALSE,NA,"0.1.4"
"830","646",2022-09-09 15:15:00,886,886,0,16,FALSE,NA,"0.1.4"
"831","646",2022-09-09 15:30:00,886,886,0,16,FALSE,NA,"0.1.4"
"832","646",2022-09-09 15:45:00,886,886,0,16,FALSE,NA,"0.1.4"
"833","646",2022-09-09 16:00:00,886,886,0,16,FALSE,NA,"0.1.4"
"834","646",2022-09-09 16:15:00,886,886,0,16,FALSE,NA,"0.1.4"
"835","646",2022-09-09 16:30:00,886,886,0,16,FALSE,NA,"0.1.4"
"836","646",2022-09-09 16:45:00,886,886,0,16,FALSE,NA,"0.1.4"
"837","646",2022-09-09 17:00:00,886,886,0,16,FALSE,NA,"0.1.4"
"838","646",2022-09-09 17:15:00,886,886,0,16,FALSE,NA,"0.1.4"
"839","646",2022-09-09 17:30:00,886,886,0,16,FALSE,NA,"0.1.4"
"840","646",2022-09-09 17:45:00,886,886,0,16,FALSE,NA,"0.1.4"
"841","646",2022-09-09 18:00:00,886,886,0,16,FALSE,NA,"0.1.4"
"842","646",2022-09-09 18:15:00,887,887,0,17,FALSE,NA,"0.1.4"
"843","646",2022-09-09 18:30:00,886,887,1,17,FALSE,NA,"0.1.4"
"844","646",2022-09-09 18:45:00,886,887,1,17,FALSE,NA,"0.1.4"
"845","646",2022-09-09 19:00:00,886,887,1,17,FALSE,NA,"0.1.4"
"846","646",2022-09-09 19:15:00,885,887,2,17,FALSE,NA,"0.1.4"
"847","646",2022-09-09 19:30:00,885,887,2,17,FALSE,NA,"0.1.4"
"848","646",2022-09-09 19:45:00,885,887,2,17,FALSE,NA,"0.1.4"
"849","646",2022-09-09 20:00:00,885,887,2,17,FALSE,NA,"0.1.4"
"850","646",2022-09-09 20:15:00,884,887,3,17,FALSE,NA,"0.1.4"
"851","646",2022-09-09 20:30:00,883,887,4,17,FALSE,NA,"0.1.4"
"852","646",2022-09-09 20:45:00,882,887,5,17,FALSE,NA,"0.1.4"
"853","646",2022-09-09 21:00:00,882,887,5,17,FALSE,NA,"0.1.4"
"854","646",2022-09-09 21:15:00,880,887,7,17,FALSE,NA,"0.1.4"
"855","646",2022-09-09 21:30:00,879,887,8,17,FALSE,NA,"0.1.4"
"856","646",2022-09-09 21:45:00,877,887,10,17,FALSE,NA,"0.1.4"
"857","646",2022-09-09 22:00:00,877,887,10,17,FALSE,NA,"0.1.4"
"858","646",2022-09-09 22:15:00,875,887,12,17,FALSE,NA,"0.1.4"
"859","646",2022-09-09 22:30:00,873,887,14,17,FALSE,NA,"0.1.4"
"860","646",2022-09-09 22:45:00,873,887,14,17,FALSE,NA,"0.1.4"
"861","646",2022-09-09 23:00:00,872,887,15,17,FALSE,NA,"0.1.4"
"862","646",2022-09-09 23:15:00,871,887,16,17,FALSE,NA,"0.1.4"
"863","646",2022-09-09 23:30:00,870,887,17,17,FALSE,NA,"0.1.4"
"864","646",2022-09-09 23:45:00,871,887,16,17,FALSE,NA,"0.1.4"
"865","646",2022-09-10,869,887,18,17,FALSE,NA,"0.1.4"
"866","646",2022-09-10 00:15:00,868,887,19,17,FALSE,NA,"0.1.4"
"867","646",2022-09-10 00:30:00,868,887,19,17,FALSE,NA,"0.1.4"
"868","646",2022-09-10 00:45:00,868,887,19,17,FALSE,NA,"0.1.4"
"869","646",2022-09-10 01:00:00,868,887,19,17,FALSE,NA,"0.1.4"
"870","646",2022-09-10 01:15:00,868,887,19,17,FALSE,NA,"0.1.4"
"871","646",2022-09-10 01:30:00,867,887,20,17,FALSE,NA,"0.1.4"
"872","646",2022-09-10 01:45:00,867,887,20,17,FALSE,NA,"0.1.4"
"873","646",2022-09-10 02:00:00,867,887,20,17,FALSE,NA,"0.1.4"
"874","646",2022-09-10 02:15:00,867,887,20,17,FALSE,NA,"0.1.4"
"875","646",2022-09-10 02:30:00,867,887,20,17,FALSE,NA,"0.1.4"
"876","646",2022-09-10 02:45:00,867,887,20,17,FALSE,NA,"0.1.4"
"877","646",2022-09-10 03:00:00,866,887,21,17,FALSE,NA,"0.1.4"
"878","646",2022-09-10 03:15:00,866,887,21,17,FALSE,NA,"0.1.4"
"879","646",2022-09-10 03:30:00,866,887,21,17,FALSE,NA,"0.1.4"
"880","646",2022-09-10 03:45:00,867,887,20,17,FALSE,NA,"0.1.4"
"881","646",2022-09-10 04:00:00,867,887,20,17,FALSE,NA,"0.1.4"
"882","646",2022-09-10 04:15:00,866,887,21,17,FALSE,NA,"0.1.4"
"883","646",2022-09-10 04:30:00,868,887,19,17,FALSE,NA,"0.1.4"
"884","646",2022-09-10 04:45:00,868,887,19,17,FALSE,NA,"0.1.4"
"885","646",2022-09-10 05:00:00,869,887,18,17,FALSE,NA,"0.1.4"
"886","646",2022-09-10 05:15:00,869,887,18,17,FALSE,NA,"0.1.4"
"887","646",2022-09-10 05:30:00,870,887,17,17,FALSE,NA,"0.1.4"
"888","646",2022-09-10 05:45:00,870,887,17,17,FALSE,NA,"0.1.4"
"889","646",2022-09-10 06:00:00,872,887,15,17,FALSE,NA,"0.1.4"
"890","646",2022-09-10 06:15:00,873,887,14,17,FALSE,NA,"0.1.4"
"891","646",2022-09-10 06:30:00,873,887,14,17,FALSE,NA,"0.1.4"
"892","646",2022-09-10 06:45:00,873,887,14,17,FALSE,NA,"0.1.4"
"893","646",2022-09-10 07:00:00,873,887,14,17,FALSE,NA,"0.1.4"
"894","646",2022-09-10 07:15:00,874,887,13,17,FALSE,NA,"0.1.4"
"895","646",2022-09-10 07:30:00,875,887,12,17,FALSE,NA,"0.1.4"
"896","646",2022-09-10 07:45:00,875,887,12,17,FALSE,NA,"0.1.4"
"897","646",2022-09-10 08:00:00,876,887,11,17,FALSE,NA,"0.1.4"
"898","646",2022-09-10 08:15:00,878,887,9,17,FALSE,NA,"0.1.4"
"899","646",2022-09-10 08:30:00,878,887,9,17,FALSE,NA,"0.1.4"
"900","646",2022-09-10 08:45:00,878,887,9,17,FALSE,NA,"0.1.4"
"901","646",2022-09-10 09:00:00,879,887,8,17,FALSE,NA,"0.1.4"
"902","646",2022-09-10 09:15:00,878,887,9,17,FALSE,NA,"0.1.4"
"903","646",2022-09-10 09:30:00,879,887,8,17,FALSE,NA,"0.1.4"
"904","646",2022-09-10 09:45:00,879,887,8,17,FALSE,NA,"0.1.4"
"905","646",2022-09-10 10:00:00,879,887,8,17,FALSE,NA,"0.1.4"
"906","646",2022-09-10 10:15:00,879,887,8,17,FALSE,NA,"0.1.4"
"907","646",2022-09-10 10:30:00,880,887,7,17,FALSE,NA,"0.1.4"
"908","646",2022-09-10 10:45:00,881,887,6,17,FALSE,NA,"0.1.4"
"909","646",2022-09-10 11:00:00,881,887,6,17,FALSE,NA,"0.1.4"
"910","646",2022-09-10 11:15:00,882,887,5,17,FALSE,NA,"0.1.4"
"911","646",2022-09-10 11:30:00,881,887,6,17,FALSE,NA,"0.1.4"
"912","646",2022-09-10 11:45:00,882,887,5,17,FALSE,NA,"0.1.4"
"913","646",2022-09-10 12:00:00,883,887,4,17,FALSE,NA,"0.1.4"
"914","646",2022-09-10 12:15:00,883,887,4,17,FALSE,NA,"0.1.4"
"915","646",2022-09-10 12:30:00,883,887,4,17,FALSE,NA,"0.1.4"
"916","646",2022-09-10 12:45:00,882,887,5,17,FALSE,NA,"0.1.4"
"917","646",2022-09-10 13:00:00,883,887,4,17,FALSE,NA,"0.1.4"
"918","646",2022-09-10 13:15:00,883,887,4,17,FALSE,NA,"0.1.4"
"919","646",2022-09-10 13:30:00,882,887,5,17,FALSE,NA,"0.1.4"
"920","646",2022-09-10 13:45:00,883,887,4,17,FALSE,NA,"0.1.4"
"921","646",2022-09-10 14:00:00,882,887,5,17,FALSE,NA,"0.1.4"
"922","646",2022-09-10 14:15:00,883,887,4,17,FALSE,NA,"0.1.4"
"923","646",2022-09-10 14:30:00,883,887,4,17,FALSE,NA,"0.1.4"
"924","646",2022-09-10 14:45:00,883,887,4,17,FALSE,NA,"0.1.4"
"925","646",2022-09-10 15:00:00,884,887,3,17,FALSE,NA,"0.1.4"
"926","646",2022-09-10 15:15:00,884,887,3,17,FALSE,NA,"0.1.4"
"927","646",2022-09-10 15:30:00,883,887,4,17,FALSE,NA,"0.1.4"
"928","646",2022-09-10 15:45:00,883,887,4,17,FALSE,NA,"0.1.4"
"929","646",2022-09-10 16:00:00,883,887,4,17,FALSE,NA,"0.1.4"
"930","646",2022-09-10 16:15:00,884,887,3,17,FALSE,NA,"0.1.4"
"931","646",2022-09-10 16:30:00,884,887,3,17,FALSE,NA,"0.1.4"
"932","646",2022-09-10 16:45:00,884,887,3,17,FALSE,NA,"0.1.4"
"933","646",2022-09-10 17:00:00,884,887,3,17,FALSE,NA,"0.1.4"
"934","646",2022-09-10 17:15:00,884,887,3,17,FALSE,NA,"0.1.4"
"935","646",2022-09-10 17:30:00,884,887,3,17,FALSE,NA,"0.1.4"
"936","646",2022-09-10 17:45:00,884,887,3,17,FALSE,NA,"0.1.4"
"937","646",2022-09-10 18:00:00,884,887,3,17,FALSE,NA,"0.1.4"
"938","646",2022-09-10 18:15:00,884,887,3,17,FALSE,NA,"0.1.4"
"939","646",2022-09-10 18:30:00,884,887,3,17,FALSE,NA,"0.1.4"
"940","646",2022-09-10 18:45:00,884,887,3,17,FALSE,NA,"0.1.4"
"941","646",2022-09-10 19:00:00,884,887,3,17,FALSE,NA,"0.1.4"
"942","646",2022-09-10 19:15:00,884,887,3,17,FALSE,NA,"0.1.4"
"943","646",2022-09-10 19:30:00,884,887,3,17,FALSE,NA,"0.1.4"
"944","646",2022-09-10 19:45:00,884,887,3,17,FALSE,NA,"0.1.4"
"945","646",2022-09-10 20:00:00,883,887,4,17,FALSE,NA,"0.1.4"
"946","646",2022-09-10 20:15:00,883,887,4,17,FALSE,NA,"0.1.4"
"947","646",2022-09-10 20:30:00,883,887,4,17,FALSE,NA,"0.1.4"
"948","646",2022-09-10 20:45:00,883,887,4,17,FALSE,NA,"0.1.4"
"949","646",2022-09-10 21:00:00,883,887,4,17,FALSE,NA,"0.1.4"
"950","646",2022-09-10 21:15:00,883,887,4,17,FALSE,NA,"0.1.4"
"951","646",2022-09-10 21:30:00,883,887,4,17,FALSE,NA,"0.1.4"
"952","646",2022-09-10 21:45:00,883,887,4,17,FALSE,NA,"0.1.4"
"953","646",2022-09-10 22:00:00,883,887,4,17,FALSE,NA,"0.1.4"
"954","646",2022-09-10 22:15:00,883,887,4,17,FALSE,NA,"0.1.4"
"955","646",2022-09-10 22:30:00,882,887,5,17,FALSE,NA,"0.1.4"
"956","646",2022-09-10 22:45:00,882,887,5,17,FALSE,NA,"0.1.4"
"957","646",2022-09-10 23:00:00,882,887,5,17,FALSE,NA,"0.1.4"
"958","646",2022-09-10 23:15:00,882,887,5,17,FALSE,NA,"0.1.4"
"959","646",2022-09-10 23:30:00,882,887,5,17,FALSE,NA,"0.1.4"
"960","646",2022-09-10 23:45:00,882,887,5,17,FALSE,NA,"0.1.4"
"961","646",2022-09-11,882,887,5,17,FALSE,NA,"0.1.4"
"962","646",2022-09-11 00:15:00,882,887,5,17,FALSE,NA,"0.1.4"
"963","646",2022-09-11 00:30:00,882,887,5,17,FALSE,NA,"0.1.4"
"964","646",2022-09-11 00:45:00,882,887,5,17,FALSE,NA,"0.1.4"
"965","646",2022-09-11 01:00:00,882,887,5,17,FALSE,NA,"0.1.4"
"966","646",2022-09-11 01:15:00,882,887,5,17,FALSE,NA,"0.1.4"
"967","646",2022-09-11 01:30:00,882,887,5,17,FALSE,NA,"0.1.4"
"968","646",2022-09-11 01:45:00,882,887,5,17,FALSE,NA,"0.1.4"
"969","646",2022-09-11 02:00:00,882,887,5,17,FALSE,NA,"0.1.4"
"970","646",2022-09-11 02:15:00,882,887,5,17,FALSE,NA,"0.1.4"
"971","646",2022-09-11 02:30:00,882,887,5,17,FALSE,NA,"0.1.4"
"972","646",2022-09-11 02:45:00,882,887,5,17,FALSE,NA,"0.1.4"
"973","646",2022-09-11 03:00:00,882,887,5,17,FALSE,NA,"0.1.4"
"974","646",2022-09-11 03:15:00,882,887,5,17,FALSE,NA,"0.1.4"
"975","646",2022-09-11 03:30:00,882,887,5,17,FALSE,NA,"0.1.4"
"976","646",2022-09-11 03:45:00,882,887,5,17,FALSE,NA,"0.1.4"
"977","646",2022-09-11 04:00:00,882,887,5,17,FALSE,NA,"0.1.4"
"978","646",2022-09-11 04:15:00,882,887,5,17,FALSE,NA,"0.1.4"
"979","646",2022-09-11 04:30:00,882,887,5,17,FALSE,NA,"0.1.4"
"980","646",2022-09-11 04:45:00,882,887,5,17,FALSE,NA,"0.1.4"
"981","646",2022-09-11 05:00:00,882,887,5,17,FALSE,NA,"0.1.4"
"982","646",2022-09-11 05:15:00,882,887,5,17,FALSE,NA,"0.1.4"
"983","646",2022-09-11 05:30:00,882,887,5,17,FALSE,NA,"0.1.4"
"984","646",2022-09-11 05:45:00,882,887,5,17,FALSE,NA,"0.1.4"
"985","646",2022-09-11 06:00:00,882,887,5,17,FALSE,NA,"0.1.4"
"986","646",2022-09-11 06:15:00,882,887,5,17,FALSE,NA,"0.1.4"
"987","646",2022-09-11 06:30:00,882,887,5,17,FALSE,NA,"0.1.4"
"988","646",2022-09-11 06:45:00,882,887,5,17,FALSE,NA,"0.1.4"
"989","646",2022-09-11 07:00:00,882,887,5,17,FALSE,NA,"0.1.4"
"990","646",2022-09-11 07:15:00,882,887,5,17,FALSE,NA,"0.1.4"
"991","646",2022-09-11 07:30:00,882,887,5,17,FALSE,NA,"0.1.4"
"992","646",2022-09-11 07:45:00,882,887,5,17,FALSE,NA,"0.1.4"
"993","646",2022-09-11 08:00:00,883,887,4,17,FALSE,NA,"0.1.4"
"994","646",2022-09-11 08:15:00,883,887,4,17,FALSE,NA,"0.1.4"
"995","646",2022-09-11 08:30:00,884,887,3,17,FALSE,NA,"0.1.4"
"996","646",2022-09-11 08:45:00,885,887,2,17,FALSE,NA,"0.1.4"
"997","646",2022-09-11 09:00:00,885,887,2,17,FALSE,NA,"0.1.4"
"998","646",2022-09-11 09:15:00,885,887,2,17,FALSE,NA,"0.1.4"
"999","646",2022-09-11 09:30:00,885,887,2,17,FALSE,NA,"0.1.4"
"1000","646",2022-09-11 09:45:00,886,887,1,17,FALSE,NA,"0.1.4"
"1001","646",2022-09-11 10:00:00,886,887,1,17,FALSE,NA,"0.1.4"
"1002","646",2022-09-11 10:15:00,887,887,0,17,FALSE,NA,"0.1.4"
"1003","646",2022-09-11 10:30:00,886,887,1,17,FALSE,NA,"0.1.4"
"1004","646",2022-09-11 10:45:00,887,887,0,17,FALSE,NA,"0.1.4"
"1005","646",2022-09-11 11:00:00,887,887,0,17,FALSE,NA,"0.1.4"
"1006","646",2022-09-11 11:15:00,888,888,0,18,FALSE,NA,"0.1.4"
"1007","646",2022-09-11 11:30:00,887,888,1,18,FALSE,NA,"0.1.4"
"1008","646",2022-09-11 11:45:00,887,888,1,18,FALSE,NA,"0.1.4"
"1009","646",2022-09-11 12:00:00,888,888,0,18,FALSE,NA,"0.1.4"
"1010","646",2022-09-11 12:15:00,888,888,0,18,FALSE,NA,"0.1.4"
"1011","646",2022-09-11 12:30:00,888,888,0,18,FALSE,NA,"0.1.4"
"1012","646",2022-09-11 12:45:00,888,888,0,18,FALSE,NA,"0.1.4"
"1013","646",2022-09-11 13:00:00,888,888,0,18,FALSE,NA,"0.1.4"
"1014","646",2022-09-11 13:15:00,888,888,0,18,FALSE,NA,"0.1.4"
"1015","646",2022-09-11 13:30:00,889,889,0,19,FALSE,NA,"0.1.4"
"1016","646",2022-09-11 13:45:00,889,889,0,19,FALSE,NA,"0.1.4"
"1017","646",2022-09-11 14:00:00,888,889,1,19,FALSE,NA,"0.1.4"
"1018","646",2022-09-11 14:15:00,888,889,1,19,FALSE,NA,"0.1.4"
"1019","646",2022-09-11 14:30:00,888,889,1,19,FALSE,NA,"0.1.4"
"1020","646",2022-09-11 14:45:00,888,889,1,19,FALSE,NA,"0.1.4"
"1021","646",2022-09-11 15:00:00,888,889,1,19,FALSE,NA,"0.1.4"
"1022","646",2022-09-11 15:15:00,888,889,1,19,FALSE,NA,"0.1.4"
"1023","646",2022-09-11 15:30:00,888,889,1,19,FALSE,NA,"0.1.4"
"1024","646",2022-09-11 15:45:00,888,889,1,19,FALSE,NA,"0.1.4"
"1025","646",2022-09-11 16:00:00,888,889,1,19,FALSE,NA,"0.1.4"
"1026","646",2022-09-11 16:15:00,888,889,1,19,FALSE,NA,"0.1.4"
"1027","646",2022-09-11 16:30:00,888,889,1,19,FALSE,NA,"0.1.4"
"1028","646",2022-09-11 16:45:00,888,889,1,19,FALSE,NA,"0.1.4"
"1029","646",2022-09-11 17:00:00,888,889,1,19,FALSE,NA,"0.1.4"
"1030","646",2022-09-11 17:15:00,888,889,1,19,FALSE,NA,"0.1.4"
"1031","646",2022-09-11 17:30:00,888,889,1,19,FALSE,NA,"0.1.4"
"1032","646",2022-09-11 17:45:00,888,889,1,19,FALSE,NA,"0.1.4"
"1033","646",2022-09-11 18:00:00,888,889,1,19,FALSE,NA,"0.1.4"
"1034","646",2022-09-11 18:15:00,888,889,1,19,FALSE,NA,"0.1.4"
"1035","646",2022-09-11 18:30:00,888,889,1,19,FALSE,NA,"0.1.4"
"1036","646",2022-09-11 18:45:00,888,889,1,19,FALSE,NA,"0.1.4"
"1037","646",2022-09-11 19:00:00,888,889,1,19,FALSE,NA,"0.1.4"
"1038","646",2022-09-11 19:15:00,888,889,1,19,FALSE,NA,"0.1.4"
"1039","646",2022-09-11 19:30:00,888,889,1,19,FALSE,NA,"0.1.4"
"1040","646",2022-09-11 19:45:00,888,889,1,19,FALSE,NA,"0.1.4"
"1041","646",2022-09-11 20:00:00,887,889,2,19,FALSE,NA,"0.1.4"
"1042","646",2022-09-11 20:15:00,888,889,1,19,FALSE,NA,"0.1.4"
"1043","646",2022-09-11 20:30:00,888,889,1,19,FALSE,NA,"0.1.4"
"1044","646",2022-09-11 20:45:00,887,889,2,19,FALSE,NA,"0.1.4"
"1045","646",2022-09-11 21:00:00,887,889,2,19,FALSE,NA,"0.1.4"
"1046","646",2022-09-11 21:15:00,887,889,2,19,FALSE,NA,"0.1.4"
"1047","646",2022-09-11 21:30:00,886,889,3,19,FALSE,NA,"0.1.4"
"1048","646",2022-09-11 21:45:00,886,889,3,19,FALSE,NA,"0.1.4"
"1049","646",2022-09-11 22:00:00,885,889,4,19,FALSE,NA,"0.1.4"
"1050","646",2022-09-11 22:15:00,884,889,5,19,FALSE,NA,"0.1.4"
"1051","646",2022-09-11 22:30:00,884,889,5,19,FALSE,NA,"0.1.4"
"1052","646",2022-09-11 22:45:00,883,889,6,19,FALSE,NA,"0.1.4"
"1053","646",2022-09-11 23:00:00,883,889,6,19,FALSE,NA,"0.1.4"
"1054","646",2022-09-11 23:15:00,883,889,6,19,FALSE,NA,"0.1.4"
"1055","646",2022-09-11 23:30:00,883,889,6,19,FALSE,NA,"0.1.4"
"1056","646",2022-09-11 23:45:00,882,889,7,19,FALSE,NA,"0.1.4"
"1057","646",2022-09-12,882,889,7,19,FALSE,NA,"0.1.4"
"1058","646",2022-09-12 00:15:00,882,889,7,19,FALSE,NA,"0.1.4"
"1059","646",2022-09-12 00:30:00,882,889,7,19,FALSE,NA,"0.1.4"
"1060","646",2022-09-12 00:45:00,882,889,7,19,FALSE,NA,"0.1.4"
"1061","646",2022-09-12 01:00:00,882,889,7,19,FALSE,NA,"0.1.4"
"1062","646",2022-09-12 01:15:00,882,889,7,19,FALSE,NA,"0.1.4"
"1063","646",2022-09-12 01:30:00,882,889,7,19,FALSE,NA,"0.1.4"
"1064","646",2022-09-12 01:45:00,882,889,7,19,FALSE,NA,"0.1.4"
"1065","646",2022-09-12 02:00:00,882,889,7,19,FALSE,NA,"0.1.4"
"1066","646",2022-09-12 02:15:00,882,889,7,19,FALSE,NA,"0.1.4"
"1067","646",2022-09-12 02:30:00,882,889,7,19,FALSE,NA,"0.1.4"
"1068","646",2022-09-12 02:45:00,882,889,7,19,FALSE,NA,"0.1.4"
"1069","646",2022-09-12 03:00:00,882,889,7,19,FALSE,NA,"0.1.4"
"1070","646",2022-09-12 03:15:00,882,889,7,19,FALSE,NA,"0.1.4"
"1071","646",2022-09-12 03:30:00,882,889,7,19,FALSE,NA,"0.1.4"
"1072","646",2022-09-12 03:45:00,882,889,7,19,FALSE,NA,"0.1.4"
"1073","646",2022-09-12 04:00:00,882,889,7,19,FALSE,NA,"0.1.4"
"1074","646",2022-09-12 04:15:00,882,889,7,19,FALSE,NA,"0.1.4"
"1075","646",2022-09-12 04:30:00,882,889,7,19,FALSE,NA,"0.1.4"
"1076","646",2022-09-12 04:45:00,882,889,7,19,FALSE,NA,"0.1.4"
"1077","646",2022-09-12 05:00:00,882,889,7,19,FALSE,NA,"0.1.4"
"1078","646",2022-09-12 05:15:00,882,889,7,19,FALSE,NA,"0.1.4"
"1079","646",2022-09-12 05:30:00,882,889,7,19,FALSE,NA,"0.1.4"
"1080","646",2022-09-12 05:45:00,882,889,7,19,FALSE,NA,"0.1.4"
"1081","646",2022-09-12 06:00:00,882,889,7,19,FALSE,NA,"0.1.4"
"1082","646",2022-09-12 06:15:00,883,889,6,19,FALSE,NA,"0.1.4"
"1083","646",2022-09-12 06:30:00,883,889,6,19,FALSE,NA,"0.1.4"
"1084","646",2022-09-12 06:45:00,883,889,6,19,FALSE,NA,"0.1.4"
"1085","646",2022-09-12 07:00:00,884,889,5,19,FALSE,NA,"0.1.4"
"1086","646",2022-09-12 07:15:00,884,889,5,19,FALSE,NA,"0.1.4"
"1087","646",2022-09-12 07:30:00,884,889,5,19,FALSE,NA,"0.1.4"
"1088","646",2022-09-12 07:45:00,884,889,5,19,FALSE,NA,"0.1.4"
"1089","646",2022-09-12 08:00:00,885,889,4,19,FALSE,NA,"0.1.4"
"1090","646",2022-09-12 08:15:00,885,889,4,19,FALSE,NA,"0.1.4"
"1091","646",2022-09-12 08:30:00,885,889,4,19,FALSE,NA,"0.1.4"
"1092","646",2022-09-12 08:45:00,886,889,3,19,FALSE,NA,"0.1.4"
"1093","646",2022-09-12 09:00:00,886,889,3,19,FALSE,NA,"0.1.4"
"1094","646",2022-09-12 09:15:00,886,889,3,19,FALSE,NA,"0.1.4"
"1095","646",2022-09-12 09:30:00,887,889,2,19,FALSE,NA,"0.1.4"
"1096","646",2022-09-12 09:45:00,886,889,3,19,FALSE,NA,"0.1.4"
"1097","646",2022-09-12 10:00:00,887,889,2,19,FALSE,NA,"0.1.4"
"1098","646",2022-09-12 10:15:00,887,889,2,19,FALSE,NA,"0.1.4"
"1099","646",2022-09-12 10:30:00,887,889,2,19,FALSE,NA,"0.1.4"
"1100","646",2022-09-12 10:45:00,888,889,1,19,FALSE,NA,"0.1.4"
"1101","646",2022-09-12 11:00:00,888,889,1,19,FALSE,NA,"0.1.4"
"1102","646",2022-09-12 11:15:00,888,889,1,19,FALSE,NA,"0.1.4"
"1103","646",2022-09-12 11:30:00,888,889,1,19,FALSE,NA,"0.1.4"
"1104","646",2022-09-12 11:45:00,888,889,1,19,FALSE,NA,"0.1.4"
"1105","646",2022-09-12 12:00:00,888,889,1,19,FALSE,NA,"0.1.4"
"1106","646",2022-09-12 12:15:00,889,889,0,19,FALSE,NA,"0.1.4"
"1107","646",2022-09-12 12:30:00,890,890,0,20,FALSE,NA,"0.1.4"
"1108","646",2022-09-12 12:45:00,889,890,1,20,FALSE,NA,"0.1.4"
"1109","646",2022-09-12 13:00:00,889,890,1,20,FALSE,NA,"0.1.4"
"1110","646",2022-09-12 13:15:00,889,890,1,20,FALSE,NA,"0.1.4"
"1111","646",2022-09-12 13:30:00,890,890,0,20,FALSE,NA,"0.1.4"
"1112","646",2022-09-12 13:45:00,890,890,0,20,FALSE,NA,"0.1.4"
"1113","646",2022-09-12 14:00:00,890,890,0,20,FALSE,NA,"0.1.4"
"1114","646",2022-09-12 14:15:00,890,890,0,20,FALSE,NA,"0.1.4"
"1115","646",2022-09-12 14:30:00,890,890,0,20,FALSE,NA,"0.1.4"
"1116","646",2022-09-12 14:45:00,891,891,0,21,FALSE,NA,"0.1.4"
"1117","646",2022-09-12 15:00:00,891,891,0,21,FALSE,NA,"0.1.4"
"1118","646",2022-09-12 15:15:00,892,892,0,22,FALSE,NA,"0.1.4"
"1119","646",2022-09-12 15:30:00,894,894,0,24,FALSE,NA,"0.1.4"
"1120","646",2022-09-12 15:45:00,892,894,2,24,FALSE,NA,"0.1.4"
"1121","646",2022-09-12 16:00:00,894,894,0,24,FALSE,NA,"0.1.4"
"1122","646",2022-09-12 16:15:00,895,895,0,25,FALSE,NA,"0.1.4"
"1123","646",2022-09-12 16:30:00,895,895,0,25,FALSE,NA,"0.1.4"
"1124","646",2022-09-12 16:45:00,895,895,0,25,FALSE,NA,"0.1.4"
"1125","646",2022-09-12 17:00:00,895,895,0,25,FALSE,NA,"0.1.4"
"1126","646",2022-09-12 17:15:00,895,895,0,25,FALSE,NA,"0.1.4"
"1127","646",2022-09-12 17:30:00,896,896,0,26,FALSE,NA,"0.1.4"
"1128","646",2022-09-12 17:45:00,896,896,0,26,FALSE,NA,"0.1.4"
"1129","646",2022-09-12 18:00:00,896,896,0,26,FALSE,NA,"0.1.4"
"1130","646",2022-09-12 18:15:00,896,896,0,26,FALSE,NA,"0.1.4"
"1131","646",2022-09-12 18:30:00,896,896,0,26,FALSE,NA,"0.1.4"
"1132","646",2022-09-12 18:45:00,896,896,0,26,FALSE,NA,"0.1.4"
"1133","646",2022-09-12 19:00:00,896,896,0,26,FALSE,NA,"0.1.4"
"1134","646",2022-09-12 19:15:00,896,896,0,26,FALSE,NA,"0.1.4"
"1135","646",2022-09-12 19:30:00,896,896,0,26,FALSE,NA,"0.1.4"
"1136","646",2022-09-12 19:45:00,896,896,0,26,FALSE,NA,"0.1.4"
"1137","646",2022-09-12 20:00:00,896,896,0,26,FALSE,NA,"0.1.4"
"1138","646",2022-09-12 20:15:00,896,896,0,26,FALSE,NA,"0.1.4"
"1139","646",2022-09-12 20:30:00,896,896,0,26,FALSE,NA,"0.1.4"
"1140","646",2022-09-12 20:45:00,896,896,0,26,FALSE,NA,"0.1.4"
"1141","646",2022-09-12 21:00:00,896,896,0,26,FALSE,NA,"0.1.4"
"1142","646",2022-09-12 21:15:00,896,896,0,26,FALSE,NA,"0.1.4"
"1143","646",2022-09-12 21:30:00,896,896,0,26,FALSE,NA,"0.1.4"
"1144","646",2022-09-12 21:45:00,896,896,0,26,FALSE,NA,"0.1.4"
"1145","646",2022-09-12 22:00:00,896,896,0,26,FALSE,NA,"0.1.4"
"1146","646",2022-09-12 22:15:00,896,896,0,26,FALSE,NA,"0.1.4"
"1147","646",2022-09-12 22:30:00,896,896,0,26,FALSE,NA,"0.1.4"
"1148","646",2022-09-12 22:45:00,896,896,0,26,FALSE,NA,"0.1.4"
"1149","646",2022-09-12 23:00:00,896,896,0,26,FALSE,NA,"0.1.4"
"1150","646",2022-09-12 23:15:00,895,896,1,26,FALSE,NA,"0.1.4"
"1151","646",2022-09-12 23:30:00,895,896,1,26,FALSE,NA,"0.1.4"
"1152","646",2022-09-12 23:45:00,895,896,1,26,FALSE,NA,"0.1.4"
"1153","646",2022-09-13,895,896,1,26,FALSE,NA,"0.1.4"
"1154","646",2022-09-13 00:15:00,895,896,1,26,FALSE,NA,"0.1.4"
"1155","646",2022-09-13 00:30:00,895,896,1,26,FALSE,NA,"0.1.4"
"1156","646",2022-09-13 00:45:00,895,896,1,26,FALSE,NA,"0.1.4"
"1157","646",2022-09-13 01:00:00,895,896,1,26,FALSE,NA,"0.1.4"
"1158","646",2022-09-13 01:15:00,895,896,1,26,FALSE,NA,"0.1.4"
"1159","646",2022-09-13 01:30:00,895,896,1,26,FALSE,NA,"0.1.4"
"1160","646",2022-09-13 01:45:00,895,896,1,26,FALSE,NA,"0.1.4"
"1161","646",2022-09-13 02:00:00,895,896,1,26,FALSE,NA,"0.1.4"
"1162","646",2022-09-13 02:15:00,895,896,1,26,FALSE,NA,"0.1.4"
"1163","646",2022-09-13 02:30:00,895,896,1,26,FALSE,NA,"0.1.4"
"1164","646",2022-09-13 02:45:00,895,896,1,26,FALSE,NA,"0.1.4"
"1165","646",2022-09-13 03:00:00,895,896,1,26,FALSE,NA,"0.1.4"
"1166","646",2022-09-13 03:15:00,894,896,2,26,FALSE,NA,"0.1.4"
"1167","646",2022-09-13 03:30:00,894,896,2,26,FALSE,NA,"0.1.4"
"1168","646",2022-09-13 03:45:00,894,896,2,26,FALSE,NA,"0.1.4"
"1169","646",2022-09-13 04:00:00,894,896,2,26,FALSE,NA,"0.1.4"
"1170","646",2022-09-13 04:15:00,894,896,2,26,FALSE,NA,"0.1.4"
"1171","646",2022-09-13 04:30:00,894,896,2,26,FALSE,NA,"0.1.4"
"1172","646",2022-09-13 04:45:00,894,896,2,26,FALSE,NA,"0.1.4"
"1173","646",2022-09-13 05:00:00,894,896,2,26,FALSE,NA,"0.1.4"
"1174","646",2022-09-13 05:15:00,894,896,2,26,FALSE,NA,"0.1.4"
"1175","646",2022-09-13 05:30:00,894,896,2,26,FALSE,NA,"0.1.4"
"1176","646",2022-09-13 05:45:00,894,896,2,26,FALSE,NA,"0.1.4"
"1177","646",2022-09-13 06:00:00,894,896,2,26,FALSE,NA,"0.1.4"
"1178","646",2022-09-13 06:15:00,894,896,2,26,FALSE,NA,"0.1.4"
"1179","646",2022-09-13 06:30:00,894,896,2,26,FALSE,NA,"0.1.4"
"1180","646",2022-09-13 06:45:00,894,896,2,26,FALSE,NA,"0.1.4"
"1181","646",2022-09-13 07:00:00,894,896,2,26,FALSE,NA,"0.1.4"
"1182","646",2022-09-13 07:15:00,894,896,2,26,FALSE,NA,"0.1.4"
"1183","646",2022-09-13 07:30:00,894,896,2,26,FALSE,NA,"0.1.4"
"1184","646",2022-09-13 07:45:00,894,896,2,26,FALSE,NA,"0.1.4"
"1185","646",2022-09-13 08:00:00,895,896,1,26,FALSE,NA,"0.1.4"
"1186","646",2022-09-13 08:15:00,895,896,1,26,FALSE,NA,"0.1.4"
"1187","646",2022-09-13 08:30:00,895,896,1,26,FALSE,NA,"0.1.4"
"1188","646",2022-09-13 08:45:00,895,896,1,26,FALSE,NA,"0.1.4"
"1189","646",2022-09-13 09:00:00,895,896,1,26,FALSE,NA,"0.1.4"
"1190","646",2022-09-13 09:15:00,895,896,1,26,FALSE,NA,"0.1.4"
"1191","646",2022-09-13 09:30:00,895,896,1,26,FALSE,NA,"0.1.4"
"1192","646",2022-09-13 09:45:00,895,896,1,26,FALSE,NA,"0.1.4"
"1193","646",2022-09-13 10:00:00,895,896,1,26,FALSE,NA,"0.1.4"
"1194","646",2022-09-13 10:15:00,895,896,1,26,FALSE,NA,"0.1.4"
"1195","646",2022-09-13 10:30:00,895,896,1,26,FALSE,NA,"0.1.4"
"1196","646",2022-09-13 10:45:00,895,896,1,26,FALSE,NA,"0.1.4"
"1197","646",2022-09-13 11:00:00,895,896,1,26,FALSE,NA,"0.1.4"
"1198","646",2022-09-13 11:15:00,895,896,1,26,FALSE,NA,"0.1.4"
"1199","646",2022-09-13 11:30:00,895,896,1,26,FALSE,NA,"0.1.4"
"1200","646",2022-09-13 11:45:00,895,896,1,26,FALSE,NA,"0.1.4"
"1201","646",2022-09-13 12:00:00,895,896,1,26,FALSE,NA,"0.1.4"
"1202","646",2022-09-13 12:15:00,896,896,0,26,FALSE,NA,"0.1.4"
"1203","646",2022-09-13 12:30:00,896,896,0,26,FALSE,NA,"0.1.4"
"1204","646",2022-09-13 12:45:00,896,896,0,26,FALSE,NA,"0.1.4"
"1205","646",2022-09-13 13:00:00,896,896,0,26,FALSE,NA,"0.1.4"
"1206","646",2022-09-13 13:15:00,896,896,0,26,FALSE,NA,"0.1.4"
"1207","646",2022-09-13 13:30:00,896,896,0,26,FALSE,NA,"0.1.4"
"1208","646",2022-09-13 13:45:00,897,897,0,27,FALSE,NA,"0.1.4"
"1209","646",2022-09-13 14:00:00,897,897,0,27,FALSE,NA,"0.1.4"
"1210","646",2022-09-13 14:15:00,897,897,0,27,FALSE,NA,"0.1.4"
"1211","646",2022-09-13 14:30:00,896,897,1,27,FALSE,NA,"0.1.4"
"1212","646",2022-09-13 14:45:00,897,897,0,27,FALSE,NA,"0.1.4"
"1213","646",2022-09-13 15:00:00,897,897,0,27,FALSE,NA,"0.1.4"
"1214","646",2022-09-13 15:15:00,897,897,0,27,FALSE,NA,"0.1.4"
"1215","646",2022-09-13 15:30:00,897,897,0,27,FALSE,NA,"0.1.4"
"1216","646",2022-09-13 15:45:00,897,897,0,27,FALSE,NA,"0.1.4"
"1217","646",2022-09-13 16:00:00,897,897,0,27,FALSE,NA,"0.1.4"
"1218","646",2022-09-13 16:15:00,897,897,0,27,FALSE,NA,"0.1.4"
"1219","646",2022-09-13 16:30:00,897,897,0,27,FALSE,NA,"0.1.4"
"1220","646",2022-09-13 16:45:00,897,897,0,27,FALSE,NA,"0.1.4"
"1221","646",2022-09-13 17:00:00,897,897,0,27,FALSE,NA,"0.1.4"
"1222","646",2022-09-13 17:15:00,897,897,0,27,FALSE,NA,"0.1.4"
"1223","646",2022-09-13 17:30:00,897,897,0,27,FALSE,NA,"0.1.4"
"1224","646",2022-09-13 17:45:00,897,897,0,27,FALSE,NA,"0.1.4"
"1225","646",2022-09-13 18:00:00,897,897,0,27,FALSE,NA,"0.1.4"
"1226","646",2022-09-13 18:15:00,897,897,0,27,FALSE,NA,"0.1.4"
"1227","646",2022-09-13 18:30:00,897,897,0,27,FALSE,NA,"0.1.4"
"1228","646",2022-09-13 18:45:00,897,897,0,27,FALSE,NA,"0.1.4"
"1229","646",2022-09-13 19:00:00,897,897,0,27,FALSE,NA,"0.1.4"
"1230","646",2022-09-13 19:15:00,897,897,0,27,FALSE,NA,"0.1.4"
"1231","646",2022-09-13 19:30:00,897,897,0,27,FALSE,NA,"0.1.4"
"1232","646",2022-09-13 19:45:00,897,897,0,27,FALSE,NA,"0.1.4"
"1233","646",2022-09-13 20:00:00,897,897,0,27,FALSE,NA,"0.1.4"
"1234","646",2022-09-13 20:15:00,897,897,0,27,FALSE,NA,"0.1.4"
"1235","646",2022-09-13 20:30:00,897,897,0,27,FALSE,NA,"0.1.4"
"1236","646",2022-09-13 20:45:00,897,897,0,27,FALSE,NA,"0.1.4"
"1237","646",2022-09-13 21:00:00,897,897,0,27,FALSE,NA,"0.1.4"
"1238","646",2022-09-13 21:15:00,897,897,0,27,FALSE,NA,"0.1.4"
"1239","646",2022-09-13 21:30:00,896,897,1,27,FALSE,NA,"0.1.4"
"1240","646",2022-09-13 21:45:00,896,897,1,27,FALSE,NA,"0.1.4"
"1241","646",2022-09-13 22:00:00,895,897,2,27,FALSE,NA,"0.1.4"
"1242","646",2022-09-13 22:15:00,892,897,5,27,FALSE,NA,"0.1.4"
"1243","646",2022-09-13 22:30:00,891,897,6,27,FALSE,NA,"0.1.4"
"1244","646",2022-09-13 22:45:00,890,897,7,27,FALSE,NA,"0.1.4"
"1245","646",2022-09-13 23:00:00,889,897,8,27,FALSE,NA,"0.1.4"
"1246","646",2022-09-13 23:15:00,889,897,8,27,FALSE,NA,"0.1.4"
"1247","646",2022-09-13 23:30:00,888,897,9,27,FALSE,NA,"0.1.4"
"1248","646",2022-09-13 23:45:00,888,897,9,27,FALSE,NA,"0.1.4"
"1249","646",2022-09-14,888,897,9,27,FALSE,NA,"0.1.4"
"1250","646",2022-09-14 00:15:00,887,897,10,27,FALSE,NA,"0.1.4"
"1251","646",2022-09-14 00:30:00,887,897,10,27,FALSE,NA,"0.1.4"
"1252","646",2022-09-14 00:45:00,887,897,10,27,FALSE,NA,"0.1.4"
"1253","646",2022-09-14 01:00:00,887,897,10,27,FALSE,NA,"0.1.4"
"1254","646",2022-09-14 01:15:00,887,897,10,27,FALSE,NA,"0.1.4"
"1255","646",2022-09-14 01:30:00,887,897,10,27,FALSE,NA,"0.1.4"
"1256","646",2022-09-14 01:45:00,887,897,10,27,FALSE,NA,"0.1.4"
"1257","646",2022-09-14 02:00:00,887,897,10,27,FALSE,NA,"0.1.4"
"1258","646",2022-09-14 02:15:00,887,897,10,27,FALSE,NA,"0.1.4"
"1259","646",2022-09-14 02:30:00,887,897,10,27,FALSE,NA,"0.1.4"
"1260","646",2022-09-14 02:45:00,887,897,10,27,FALSE,NA,"0.1.4"
"1261","646",2022-09-14 03:00:00,887,897,10,27,FALSE,NA,"0.1.4"
"1262","646",2022-09-14 03:15:00,887,897,10,27,FALSE,NA,"0.1.4"
"1263","646",2022-09-14 03:30:00,887,897,10,27,FALSE,NA,"0.1.4"
"1264","646",2022-09-14 03:45:00,887,897,10,27,FALSE,NA,"0.1.4"
"1265","646",2022-09-14 04:00:00,887,897,10,27,FALSE,NA,"0.1.4"
"1266","646",2022-09-14 04:15:00,887,897,10,27,FALSE,NA,"0.1.4"
"1267","646",2022-09-14 04:30:00,887,897,10,27,FALSE,NA,"0.1.4"
"1268","646",2022-09-14 04:45:00,887,897,10,27,FALSE,NA,"0.1.4"
"1269","646",2022-09-14 05:00:00,887,897,10,27,FALSE,NA,"0.1.4"
"1270","646",2022-09-14 05:15:00,887,897,10,27,FALSE,NA,"0.1.4"
"1271","646",2022-09-14 05:30:00,887,897,10,27,FALSE,NA,"0.1.4"
"1272","646",2022-09-14 05:45:00,887,897,10,27,FALSE,NA,"0.1.4"
"1273","646",2022-09-14 06:00:00,887,897,10,27,FALSE,NA,"0.1.4"
"1274","646",2022-09-14 06:15:00,887,897,10,27,FALSE,NA,"0.1.4"
"1275","646",2022-09-14 06:30:00,887,897,10,27,FALSE,NA,"0.1.4"
"1276","646",2022-09-14 06:45:00,887,897,10,27,FALSE,NA,"0.1.4"
"1277","646",2022-09-14 07:00:00,887,897,10,27,FALSE,NA,"0.1.4"
"1278","646",2022-09-14 07:15:00,887,897,10,27,FALSE,NA,"0.1.4"
"1279","646",2022-09-14 07:30:00,887,897,10,27,FALSE,NA,"0.1.4"
"1280","646",2022-09-14 07:45:00,888,897,9,27,FALSE,NA,"0.1.4"
"1281","646",2022-09-14 08:00:00,888,897,9,27,FALSE,NA,"0.1.4"
"1282","646",2022-09-14 08:15:00,888,897,9,27,FALSE,NA,"0.1.4"
"1283","646",2022-09-14 08:30:00,888,897,9,27,FALSE,NA,"0.1.4"
"1284","646",2022-09-14 08:45:00,888,897,9,27,FALSE,NA,"0.1.4"
"1285","646",2022-09-14 09:00:00,889,897,8,27,FALSE,NA,"0.1.4"
"1286","646",2022-09-14 09:15:00,890,897,7,27,FALSE,NA,"0.1.4"
"1287","646",2022-09-14 09:30:00,890,897,7,27,FALSE,NA,"0.1.4"
"1288","646",2022-09-14 09:45:00,890,897,7,27,FALSE,NA,"0.1.4"
"1289","646",2022-09-14 10:00:00,890,897,7,27,FALSE,NA,"0.1.4"
"1290","646",2022-09-14 10:15:00,890,897,7,27,FALSE,NA,"0.1.4"
"1291","646",2022-09-14 10:30:00,890,897,7,27,FALSE,NA,"0.1.4"
"1292","646",2022-09-14 10:45:00,891,897,6,27,FALSE,NA,"0.1.4"
"1293","646",2022-09-14 11:00:00,891,897,6,27,FALSE,NA,"0.1.4"
"1294","646",2022-09-14 11:15:00,891,897,6,27,FALSE,NA,"0.1.4"
"1295","646",2022-09-14 11:30:00,891,897,6,27,FALSE,NA,"0.1.4"
"1296","646",2022-09-14 11:45:00,891,897,6,27,FALSE,NA,"0.1.4"
"1297","646",2022-09-14 12:00:00,891,897,6,27,FALSE,NA,"0.1.4"
"1298","646",2022-09-14 12:15:00,892,897,5,27,FALSE,NA,"0.1.4"
"1299","646",2022-09-14 12:30:00,893,897,4,27,FALSE,NA,"0.1.4"
"1300","646",2022-09-14 12:45:00,892,897,5,27,FALSE,NA,"0.1.4"
"1301","646",2022-09-14 13:00:00,893,897,4,27,FALSE,NA,"0.1.4"
"1302","646",2022-09-14 13:15:00,893,897,4,27,FALSE,NA,"0.1.4"
"1303","646",2022-09-14 13:30:00,894,897,3,27,FALSE,NA,"0.1.4"
"1304","646",2022-09-14 13:45:00,894,897,3,27,FALSE,NA,"0.1.4"
"1305","646",2022-09-14 14:00:00,894,897,3,27,FALSE,NA,"0.1.4"
"1306","646",2022-09-14 14:15:00,896,897,1,27,FALSE,NA,"0.1.4"
"1307","646",2022-09-14 14:30:00,896,897,1,27,FALSE,NA,"0.1.4"
"1308","646",2022-09-14 14:45:00,896,897,1,27,FALSE,NA,"0.1.4"
"1309","646",2022-09-14 15:00:00,896,897,1,27,FALSE,NA,"0.1.4"
"1310","646",2022-09-14 15:15:00,896,897,1,27,FALSE,NA,"0.1.4"
"1311","646",2022-09-14 15:30:00,896,897,1,27,FALSE,NA,"0.1.4"
"1312","646",2022-09-14 15:45:00,896,897,1,27,FALSE,NA,"0.1.4"
"1313","646",2022-09-14 16:00:00,896,897,1,27,FALSE,NA,"0.1.4"
"1314","646",2022-09-14 16:15:00,896,897,1,27,FALSE,NA,"0.1.4"
"1315","646",2022-09-14 16:30:00,896,897,1,27,FALSE,NA,"0.1.4"
"1316","646",2022-09-14 16:45:00,896,897,1,27,FALSE,NA,"0.1.4"
"1317","646",2022-09-14 17:00:00,896,897,1,27,FALSE,NA,"0.1.4"
"1318","646",2022-09-14 17:15:00,896,897,1,27,FALSE,NA,"0.1.4"
"1319","646",2022-09-14 17:30:00,896,897,1,27,FALSE,NA,"0.1.4"
"1320","646",2022-09-14 17:45:00,896,897,1,27,FALSE,NA,"0.1.4"
"1321","646",2022-09-14 18:00:00,896,897,1,27,FALSE,NA,"0.1.4"
"1322","646",2022-09-14 18:15:00,896,897,1,27,FALSE,NA,"0.1.4"
"1323","646",2022-09-14 18:30:00,896,897,1,27,FALSE,NA,"0.1.4"
"1324","646",2022-09-14 18:45:00,896,897,1,27,FALSE,NA,"0.1.4"
"1325","646",2022-09-14 19:00:00,896,897,1,27,FALSE,NA,"0.1.4"
"1326","646",2022-09-14 19:15:00,896,897,1,27,FALSE,NA,"0.1.4"
"1327","646",2022-09-14 19:30:00,896,897,1,27,FALSE,NA,"0.1.4"
"1328","646",2022-09-14 19:45:00,896,897,1,27,FALSE,NA,"0.1.4"
"1329","646",2022-09-14 20:00:00,896,897,1,27,FALSE,NA,"0.1.4"
"1330","646",2022-09-14 20:15:00,895,897,2,27,FALSE,NA,"0.1.4"
"1331","646",2022-09-14 20:30:00,895,897,2,27,FALSE,NA,"0.1.4"
"1332","646",2022-09-14 20:45:00,895,897,2,27,FALSE,NA,"0.1.4"
"1333","646",2022-09-14 21:00:00,895,897,2,27,FALSE,NA,"0.1.4"
"1334","646",2022-09-14 21:15:00,893,897,4,27,FALSE,NA,"0.1.4"
"1335","646",2022-09-14 21:30:00,893,897,4,27,FALSE,NA,"0.1.4"
"1336","646",2022-09-14 21:45:00,892,897,5,27,FALSE,NA,"0.1.4"
"1337","646",2022-09-14 22:00:00,890,897,7,27,FALSE,NA,"0.1.4"
"1338","646",2022-09-14 22:15:00,888,897,9,27,FALSE,NA,"0.1.4"
"1339","646",2022-09-14 22:30:00,888,897,9,27,FALSE,NA,"0.1.4"
"1340","646",2022-09-14 22:45:00,886,897,11,27,FALSE,NA,"0.1.4"
"1341","646",2022-09-14 23:00:00,886,897,11,27,FALSE,NA,"0.1.4"
"1342","646",2022-09-14 23:15:00,886,897,11,27,FALSE,NA,"0.1.4"
"1343","646",2022-09-14 23:30:00,885,897,12,27,FALSE,NA,"0.1.4"
"1344","646",2022-09-14 23:45:00,886,897,11,27,FALSE,NA,"0.1.4"
"1345","646",2022-09-15,885,897,12,27,FALSE,NA,"0.1.4"
"1346","646",2022-09-15 00:15:00,885,897,12,27,FALSE,NA,"0.1.4"
"1347","646",2022-09-15 00:30:00,885,897,12,27,FALSE,NA,"0.1.4"
"1348","646",2022-09-15 00:45:00,885,897,12,27,FALSE,NA,"0.1.4"
"1349","646",2022-09-15 01:00:00,885,897,12,27,FALSE,NA,"0.1.4"
"1350","646",2022-09-15 01:15:00,885,897,12,27,FALSE,NA,"0.1.4"
"1351","646",2022-09-15 01:30:00,885,897,12,27,FALSE,NA,"0.1.4"
"1352","646",2022-09-15 01:45:00,885,897,12,27,FALSE,NA,"0.1.4"
"1353","646",2022-09-15 02:00:00,885,897,12,27,FALSE,NA,"0.1.4"
"1354","646",2022-09-15 02:15:00,885,897,12,27,FALSE,NA,"0.1.4"
"1355","646",2022-09-15 02:30:00,885,897,12,27,FALSE,NA,"0.1.4"
"1356","646",2022-09-15 02:45:00,885,897,12,27,FALSE,NA,"0.1.4"
"1357","646",2022-09-15 03:00:00,885,897,12,27,FALSE,NA,"0.1.4"
"1358","646",2022-09-15 03:15:00,885,897,12,27,FALSE,NA,"0.1.4"
"1359","646",2022-09-15 03:30:00,885,897,12,27,FALSE,NA,"0.1.4"
"1360","646",2022-09-15 03:45:00,885,897,12,27,FALSE,NA,"0.1.4"
"1361","646",2022-09-15 04:00:00,885,897,12,27,FALSE,NA,"0.1.4"
"1362","646",2022-09-15 04:15:00,885,897,12,27,FALSE,NA,"0.1.4"
"1363","646",2022-09-15 04:30:00,885,897,12,27,FALSE,NA,"0.1.4"
"1364","646",2022-09-15 04:45:00,885,897,12,27,FALSE,NA,"0.1.4"
"1365","646",2022-09-15 05:00:00,885,897,12,27,FALSE,NA,"0.1.4"
"1366","646",2022-09-15 05:15:00,885,897,12,27,FALSE,NA,"0.1.4"
"1367","646",2022-09-15 05:30:00,885,897,12,27,FALSE,NA,"0.1.4"
"1368","646",2022-09-15 05:45:00,886,897,11,27,FALSE,NA,"0.1.4"
"1369","646",2022-09-15 06:00:00,886,897,11,27,FALSE,NA,"0.1.4"
"1370","646",2022-09-15 06:15:00,886,897,11,27,FALSE,NA,"0.1.4"
"1371","646",2022-09-15 06:30:00,885,897,12,27,FALSE,NA,"0.1.4"
"1372","646",2022-09-15 06:45:00,886,897,11,27,FALSE,NA,"0.1.4"
"1373","646",2022-09-15 07:00:00,886,897,11,27,FALSE,NA,"0.1.4"
"1374","646",2022-09-15 07:15:00,886,897,11,27,FALSE,NA,"0.1.4"
"1375","646",2022-09-15 07:30:00,887,897,10,27,FALSE,NA,"0.1.4"
"1376","646",2022-09-15 07:45:00,887,897,10,27,FALSE,NA,"0.1.4"
"1377","646",2022-09-15 08:00:00,887,897,10,27,FALSE,NA,"0.1.4"
"1378","646",2022-09-15 08:15:00,887,897,10,27,FALSE,NA,"0.1.4"
"1379","646",2022-09-15 08:30:00,887,897,10,27,FALSE,NA,"0.1.4"
"1380","646",2022-09-15 08:45:00,888,897,9,27,FALSE,NA,"0.1.4"
"1381","646",2022-09-15 09:00:00,888,897,9,27,FALSE,NA,"0.1.4"
"1382","646",2022-09-15 09:15:00,888,897,9,27,FALSE,NA,"0.1.4"
"1383","646",2022-09-15 09:30:00,888,897,9,27,FALSE,NA,"0.1.4"
"1384","646",2022-09-15 09:45:00,889,897,8,27,FALSE,NA,"0.1.4"
"1385","646",2022-09-15 10:00:00,889,897,8,27,FALSE,NA,"0.1.4"
"1386","646",2022-09-15 10:15:00,889,897,8,27,FALSE,NA,"0.1.4"
"1387","646",2022-09-15 10:30:00,890,897,7,27,FALSE,NA,"0.1.4"
"1388","646",2022-09-15 10:45:00,890,897,7,27,FALSE,NA,"0.1.4"
"1389","646",2022-09-15 11:00:00,891,897,6,27,FALSE,NA,"0.1.4"
"1390","646",2022-09-15 11:15:00,891,897,6,27,FALSE,NA,"0.1.4"
"1391","646",2022-09-15 11:30:00,892,897,5,27,FALSE,NA,"0.1.4"
"1392","646",2022-09-15 11:45:00,891,897,6,27,FALSE,NA,"0.1.4"
"1393","646",2022-09-15 12:00:00,892,897,5,27,FALSE,NA,"0.1.4"
"1394","646",2022-09-15 12:15:00,892,897,5,27,FALSE,NA,"0.1.4"
"1395","646",2022-09-15 12:30:00,894,897,3,27,FALSE,NA,"0.1.4"
"1396","646",2022-09-15 12:45:00,895,897,2,27,FALSE,NA,"0.1.4"
"1397","646",2022-09-15 13:00:00,895,897,2,27,FALSE,NA,"0.1.4"
"1398","646",2022-09-15 13:15:00,895,897,2,27,FALSE,NA,"0.1.4"
"1399","646",2022-09-15 13:30:00,895,897,2,27,FALSE,NA,"0.1.4"
"1400","646",2022-09-15 13:45:00,895,897,2,27,FALSE,NA,"0.1.4"
"1401","646",2022-09-15 14:00:00,896,897,1,27,FALSE,NA,"0.1.4"
"1402","646",2022-09-15 14:15:00,895,897,2,27,FALSE,NA,"0.1.4"
"1403","646",2022-09-15 14:30:00,896,897,1,27,FALSE,NA,"0.1.4"
"1404","646",2022-09-15 14:45:00,896,897,1,27,FALSE,NA,"0.1.4"
"1405","646",2022-09-15 15:00:00,896,897,1,27,FALSE,NA,"0.1.4"
"1406","646",2022-09-15 15:15:00,896,897,1,27,FALSE,NA,"0.1.4"
"1407","646",2022-09-15 15:30:00,896,897,1,27,FALSE,NA,"0.1.4"
"1408","646",2022-09-15 15:45:00,896,897,1,27,FALSE,NA,"0.1.4"
"1409","646",2022-09-15 16:00:00,896,897,1,27,FALSE,NA,"0.1.4"
"1410","646",2022-09-15 16:15:00,896,897,1,27,FALSE,NA,"0.1.4"
"1411","646",2022-09-15 16:30:00,895,897,2,27,FALSE,NA,"0.1.4"
"1412","646",2022-09-15 16:45:00,896,897,1,27,FALSE,NA,"0.1.4"
"1413","646",2022-09-15 17:00:00,896,897,1,27,FALSE,NA,"0.1.4"
"1414","646",2022-09-15 17:15:00,896,897,1,27,FALSE,NA,"0.1.4"
"1415","646",2022-09-15 17:30:00,896,897,1,27,FALSE,NA,"0.1.4"
"1416","646",2022-09-15 17:45:00,896,897,1,27,FALSE,NA,"0.1.4"
"1417","646",2022-09-15 18:00:00,896,897,1,27,FALSE,NA,"0.1.4"
"1418","646",2022-09-15 18:15:00,896,897,1,27,FALSE,NA,"0.1.4"
"1419","646",2022-09-15 18:30:00,896,897,1,27,FALSE,NA,"0.1.4"
"1420","646",2022-09-15 18:45:00,896,897,1,27,FALSE,NA,"0.1.4"
"1421","646",2022-09-15 19:00:00,896,897,1,27,FALSE,NA,"0.1.4"
"1422","646",2022-09-15 19:15:00,896,897,1,27,FALSE,NA,"0.1.4"
"1423","646",2022-09-15 19:30:00,896,897,1,27,FALSE,NA,"0.1.4"
"1424","646",2022-09-15 19:45:00,896,897,1,27,FALSE,NA,"0.1.4"
"1425","646",2022-09-15 20:00:00,896,897,1,27,FALSE,NA,"0.1.4"
"1426","646",2022-09-15 20:15:00,896,897,1,27,FALSE,NA,"0.1.4"
"1427","646",2022-09-15 20:30:00,896,897,1,27,FALSE,NA,"0.1.4"
"1428","646",2022-09-15 20:45:00,896,897,1,27,FALSE,NA,"0.1.4"
"1429","646",2022-09-15 21:00:00,896,897,1,27,FALSE,NA,"0.1.4"
"1430","646",2022-09-15 21:15:00,896,897,1,27,FALSE,NA,"0.1.4"
"1431","646",2022-09-15 21:30:00,896,897,1,27,FALSE,NA,"0.1.4"
"1432","646",2022-09-15 21:45:00,896,897,1,27,FALSE,NA,"0.1.4"
"1433","646",2022-09-15 22:00:00,896,897,1,27,FALSE,NA,"0.1.4"
"1434","646",2022-09-15 22:15:00,895,897,2,27,FALSE,NA,"0.1.4"
"1435","646",2022-09-15 22:30:00,895,897,2,27,FALSE,NA,"0.1.4"
"1436","646",2022-09-15 22:45:00,894,897,3,27,FALSE,NA,"0.1.4"
"1437","646",2022-09-15 23:00:00,894,897,3,27,FALSE,NA,"0.1.4"
"1438","646",2022-09-15 23:15:00,894,897,3,27,FALSE,NA,"0.1.4"
"1439","646",2022-09-15 23:30:00,893,897,4,27,FALSE,NA,"0.1.4"
"1440","646",2022-09-15 23:45:00,893,897,4,27,FALSE,NA,"0.1.4"
"1441","646",2022-09-16,893,897,4,27,FALSE,NA,"0.1.4"
"1442","646",2022-09-16 00:15:00,893,897,4,27,FALSE,NA,"0.1.4"
"1443","646",2022-09-16 00:30:00,893,897,4,27,FALSE,NA,"0.1.4"
"1444","646",2022-09-16 00:45:00,893,897,4,27,FALSE,NA,"0.1.4"
"1445","646",2022-09-16 01:00:00,893,897,4,27,FALSE,NA,"0.1.4"
"1446","646",2022-09-16 01:15:00,893,897,4,27,FALSE,NA,"0.1.4"
"1447","646",2022-09-16 01:30:00,893,897,4,27,FALSE,NA,"0.1.4"
"1448","646",2022-09-16 01:45:00,893,897,4,27,FALSE,NA,"0.1.4"
"1449","646",2022-09-16 02:00:00,893,897,4,27,FALSE,NA,"0.1.4"
"1450","646",2022-09-16 02:15:00,893,897,4,27,FALSE,NA,"0.1.4"
"1451","646",2022-09-16 02:30:00,893,897,4,27,FALSE,NA,"0.1.4"
"1452","646",2022-09-16 02:45:00,893,897,4,27,FALSE,NA,"0.1.4"
"1453","646",2022-09-16 03:00:00,893,897,4,27,FALSE,NA,"0.1.4"
"1454","646",2022-09-16 03:15:00,893,897,4,27,FALSE,NA,"0.1.4"
"1455","646",2022-09-16 03:30:00,893,897,4,27,FALSE,NA,"0.1.4"
"1456","646",2022-09-16 03:45:00,893,897,4,27,FALSE,NA,"0.1.4"
"1457","646",2022-09-16 04:00:00,893,897,4,27,FALSE,NA,"0.1.4"
"1458","646",2022-09-16 04:15:00,893,897,4,27,FALSE,NA,"0.1.4"
"1459","646",2022-09-16 04:30:00,893,897,4,27,FALSE,NA,"0.1.4"
"1460","646",2022-09-16 04:45:00,893,897,4,27,FALSE,NA,"0.1.4"
"1461","646",2022-09-16 05:00:00,893,897,4,27,FALSE,NA,"0.1.4"
"1462","646",2022-09-16 05:15:00,893,897,4,27,FALSE,NA,"0.1.4"
"1463","646",2022-09-16 05:30:00,893,897,4,27,FALSE,NA,"0.1.4"
"1464","646",2022-09-16 05:45:00,893,897,4,27,FALSE,NA,"0.1.4"
"1465","646",2022-09-16 06:00:00,893,897,4,27,FALSE,NA,"0.1.4"
"1466","646",2022-09-16 06:15:00,893,897,4,27,FALSE,NA,"0.1.4"
"1467","646",2022-09-16 06:30:00,893,897,4,27,FALSE,NA,"0.1.4"
"1468","646",2022-09-16 06:45:00,893,897,4,27,FALSE,NA,"0.1.4"
"1469","646",2022-09-16 07:00:00,893,897,4,27,FALSE,NA,"0.1.4"
"1470","646",2022-09-16 07:15:00,893,897,4,27,FALSE,NA,"0.1.4"
"1471","646",2022-09-16 07:30:00,893,897,4,27,FALSE,NA,"0.1.4"
"1472","646",2022-09-16 07:45:00,893,897,4,27,FALSE,NA,"0.1.4"
"1473","646",2022-09-16 08:00:00,893,897,4,27,FALSE,NA,"0.1.4"
"1474","646",2022-09-16 08:15:00,894,897,3,27,FALSE,NA,"0.1.4"
"1475","646",2022-09-16 08:30:00,894,897,3,27,FALSE,NA,"0.1.4"
"1476","646",2022-09-16 08:45:00,894,897,3,27,FALSE,NA,"0.1.4"
"1477","646",2022-09-16 09:00:00,894,897,3,27,FALSE,NA,"0.1.4"
"1478","646",2022-09-16 09:15:00,894,897,3,27,FALSE,NA,"0.1.4"
"1479","646",2022-09-16 09:30:00,894,897,3,27,FALSE,NA,"0.1.4"
"1480","646",2022-09-16 09:45:00,894,897,3,27,FALSE,NA,"0.1.4"
"1481","646",2022-09-16 10:00:00,894,897,3,27,FALSE,NA,"0.1.4"
"1482","646",2022-09-16 10:15:00,894,897,3,27,FALSE,NA,"0.1.4"
"1483","646",2022-09-16 10:30:00,894,897,3,27,FALSE,NA,"0.1.4"
"1484","646",2022-09-16 10:45:00,894,897,3,27,FALSE,NA,"0.1.4"
"1485","646",2022-09-16 11:00:00,894,897,3,27,FALSE,NA,"0.1.4"
"1486","646",2022-09-16 11:15:00,894,897,3,27,FALSE,NA,"0.1.4"
"1487","646",2022-09-16 11:30:00,894,897,3,27,FALSE,NA,"0.1.4"
"1488","646",2022-09-16 11:45:00,894,897,3,27,FALSE,NA,"0.1.4"
"1489","646",2022-09-16 12:00:00,894,897,3,27,FALSE,NA,"0.1.4"
"1490","646",2022-09-16 12:15:00,894,897,3,27,FALSE,NA,"0.1.4"
"1491","646",2022-09-16 12:30:00,895,897,2,27,FALSE,NA,"0.1.4"
"1492","646",2022-09-16 12:45:00,895,897,2,27,FALSE,NA,"0.1.4"
"1493","646",2022-09-16 13:00:00,895,897,2,27,FALSE,NA,"0.1.4"
"1494","646",2022-09-16 13:15:00,896,897,1,27,FALSE,NA,"0.1.4"
"1495","646",2022-09-16 13:30:00,897,897,0,27,FALSE,NA,"0.1.4"
"1496","646",2022-09-16 13:45:00,897,897,0,27,FALSE,NA,"0.1.4"
"1497","646",2022-09-16 14:00:00,897,897,0,27,FALSE,NA,"0.1.4"
"1498","646",2022-09-16 14:15:00,896,897,1,27,FALSE,NA,"0.1.4"
"1499","646",2022-09-16 14:30:00,897,897,0,27,FALSE,NA,"0.1.4"
"1500","646",2022-09-16 14:45:00,897,897,0,27,FALSE,NA,"0.1.4"
"1501","646",2022-09-16 15:00:00,897,897,0,27,FALSE,NA,"0.1.4"
"1502","646",2022-09-16 15:15:00,897,897,0,27,FALSE,NA,"0.1.4"
"1503","646",2022-09-16 15:30:00,897,897,0,27,FALSE,NA,"0.1.4"
"1504","646",2022-09-16 15:45:00,897,897,0,27,FALSE,NA,"0.1.4"
"1505","646",2022-09-16 16:00:00,897,897,0,27,FALSE,NA,"0.1.4"
"1506","646",2022-09-16 16:15:00,897,897,0,27,FALSE,NA,"0.1.4"
"1507","646",2022-09-16 16:30:00,897,897,0,27,FALSE,NA,"0.1.4"
"1508","646",2022-09-16 16:45:00,897,897,0,27,FALSE,NA,"0.1.4"
"1509","646",2022-09-16 17:00:00,897,897,0,27,FALSE,NA,"0.1.4"
"1510","646",2022-09-16 17:15:00,897,897,0,27,FALSE,NA,"0.1.4"
"1511","646",2022-09-16 17:30:00,897,897,0,27,FALSE,NA,"0.1.4"
"1512","646",2022-09-16 17:45:00,897,897,0,27,FALSE,NA,"0.1.4"
"1513","646",2022-09-16 18:00:00,897,897,0,27,FALSE,NA,"0.1.4"
"1514","646",2022-09-16 18:15:00,897,897,0,27,FALSE,NA,"0.1.4"
"1515","646",2022-09-16 18:30:00,897,897,0,27,FALSE,NA,"0.1.4"
"1516","646",2022-09-16 18:45:00,897,897,0,27,FALSE,NA,"0.1.4"
"1517","646",2022-09-16 19:00:00,897,897,0,27,FALSE,NA,"0.1.4"
"1518","646",2022-09-16 19:15:00,897,897,0,27,FALSE,NA,"0.1.4"
"1519","646",2022-09-16 19:30:00,897,897,0,27,FALSE,NA,"0.1.4"
"1520","646",2022-09-16 19:45:00,897,897,0,27,FALSE,NA,"0.1.4"
"1521","646",2022-09-16 20:00:00,897,897,0,27,FALSE,NA,"0.1.4"
"1522","646",2022-09-16 20:15:00,897,897,0,27,FALSE,NA,"0.1.4"
"1523","646",2022-09-16 20:30:00,897,897,0,27,FALSE,NA,"0.1.4"
"1524","646",2022-09-16 20:45:00,897,897,0,27,FALSE,NA,"0.1.4"
"1525","646",2022-09-16 21:00:00,897,897,0,27,FALSE,NA,"0.1.4"
"1526","646",2022-09-16 21:15:00,896,897,1,27,FALSE,NA,"0.1.4"
"1527","646",2022-09-16 21:30:00,896,897,1,27,FALSE,NA,"0.1.4"
"1528","646",2022-09-16 21:45:00,896,897,1,27,FALSE,NA,"0.1.4"
"1529","646",2022-09-16 22:00:00,896,897,1,27,FALSE,NA,"0.1.4"
"1530","646",2022-09-16 22:15:00,896,897,1,27,FALSE,NA,"0.1.4"
"1531","646",2022-09-16 22:30:00,896,897,1,27,FALSE,NA,"0.1.4"
"1532","646",2022-09-16 22:45:00,895,897,2,27,FALSE,NA,"0.1.4"
"1533","646",2022-09-16 23:00:00,894,897,3,27,FALSE,NA,"0.1.4"
"1534","646",2022-09-16 23:15:00,894,897,3,27,FALSE,NA,"0.1.4"
"1535","646",2022-09-16 23:30:00,893,897,4,27,FALSE,NA,"0.1.4"
"1536","646",2022-09-16 23:45:00,893,897,4,27,FALSE,NA,"0.1.4"
"1537","646",2022-09-17,893,897,4,27,FALSE,NA,"0.1.4"
"1538","646",2022-09-17 00:15:00,892,897,5,27,FALSE,NA,"0.1.4"
"1539","646",2022-09-17 00:30:00,892,897,5,27,FALSE,NA,"0.1.4"
"1540","646",2022-09-17 00:45:00,891,897,6,27,FALSE,NA,"0.1.4"
"1541","646",2022-09-17 01:00:00,891,897,6,27,FALSE,NA,"0.1.4"
"1542","646",2022-09-17 01:15:00,891,897,6,27,FALSE,NA,"0.1.4"
"1543","646",2022-09-17 01:30:00,891,897,6,27,FALSE,NA,"0.1.4"
"1544","646",2022-09-17 01:45:00,891,897,6,27,FALSE,NA,"0.1.4"
"1545","646",2022-09-17 02:00:00,891,897,6,27,FALSE,NA,"0.1.4"
"1546","646",2022-09-17 02:15:00,891,897,6,27,FALSE,NA,"0.1.4"
"1547","646",2022-09-17 02:30:00,891,897,6,27,FALSE,NA,"0.1.4"
"1548","646",2022-09-17 02:45:00,891,897,6,27,FALSE,NA,"0.1.4"
"1549","646",2022-09-17 03:00:00,891,897,6,27,FALSE,NA,"0.1.4"
"1550","646",2022-09-17 03:15:00,891,897,6,27,FALSE,NA,"0.1.4"
"1551","646",2022-09-17 03:30:00,891,897,6,27,FALSE,NA,"0.1.4"
"1552","646",2022-09-17 03:45:00,891,897,6,27,FALSE,NA,"0.1.4"
"1553","646",2022-09-17 04:00:00,891,897,6,27,FALSE,NA,"0.1.4"
"1554","646",2022-09-17 04:15:00,891,897,6,27,FALSE,NA,"0.1.4"
"1555","646",2022-09-17 04:30:00,891,897,6,27,FALSE,NA,"0.1.4"
"1556","646",2022-09-17 04:45:00,891,897,6,27,FALSE,NA,"0.1.4"
"1557","646",2022-09-17 05:00:00,891,897,6,27,FALSE,NA,"0.1.4"
"1558","646",2022-09-17 05:15:00,891,897,6,27,FALSE,NA,"0.1.4"
"1559","646",2022-09-17 05:30:00,891,897,6,27,FALSE,NA,"0.1.4"
"1560","646",2022-09-17 05:45:00,891,897,6,27,FALSE,NA,"0.1.4"
"1561","646",2022-09-17 06:00:00,891,897,6,27,FALSE,NA,"0.1.4"
"1562","646",2022-09-17 06:15:00,891,897,6,27,FALSE,NA,"0.1.4"
"1563","646",2022-09-17 06:30:00,891,897,6,27,FALSE,NA,"0.1.4"
"1564","646",2022-09-17 06:45:00,891,897,6,27,FALSE,NA,"0.1.4"
"1565","646",2022-09-17 07:00:00,891,897,6,27,FALSE,NA,"0.1.4"
"1566","646",2022-09-17 07:15:00,891,897,6,27,FALSE,NA,"0.1.4"
"1567","646",2022-09-17 07:30:00,891,897,6,27,FALSE,NA,"0.1.4"
"1568","646",2022-09-17 07:45:00,891,897,6,27,FALSE,NA,"0.1.4"
"1569","646",2022-09-17 08:00:00,892,897,5,27,FALSE,NA,"0.1.4"
"1570","646",2022-09-17 08:15:00,892,897,5,27,FALSE,NA,"0.1.4"
"1571","646",2022-09-17 08:30:00,892,897,5,27,FALSE,NA,"0.1.4"
"1572","646",2022-09-17 08:45:00,892,897,5,27,FALSE,NA,"0.1.4"
"1573","646",2022-09-17 09:00:00,892,897,5,27,FALSE,NA,"0.1.4"
"1574","646",2022-09-17 09:15:00,892,897,5,27,FALSE,NA,"0.1.4"
"1575","646",2022-09-17 09:30:00,892,897,5,27,FALSE,NA,"0.1.4"
"1576","646",2022-09-17 09:45:00,892,897,5,27,FALSE,NA,"0.1.4"
"1577","646",2022-09-17 10:00:00,892,897,5,27,FALSE,NA,"0.1.4"
"1578","646",2022-09-17 10:15:00,892,897,5,27,FALSE,NA,"0.1.4"
"1579","646",2022-09-17 10:30:00,892,897,5,27,FALSE,NA,"0.1.4"
"1580","646",2022-09-17 10:45:00,893,897,4,27,FALSE,NA,"0.1.4"
"1581","646",2022-09-17 11:00:00,893,897,4,27,FALSE,NA,"0.1.4"
"1582","646",2022-09-17 11:15:00,894,897,3,27,FALSE,NA,"0.1.4"
"1583","646",2022-09-17 11:30:00,895,897,2,27,FALSE,NA,"0.1.4"
"1584","646",2022-09-17 11:45:00,894,897,3,27,FALSE,NA,"0.1.4"
"1585","646",2022-09-17 12:00:00,893,897,4,27,FALSE,NA,"0.1.4"
"1586","646",2022-09-17 12:15:00,894,897,3,27,FALSE,NA,"0.1.4"
"1587","646",2022-09-17 12:30:00,895,897,2,27,FALSE,NA,"0.1.4"
"1588","646",2022-09-17 12:45:00,895,897,2,27,FALSE,NA,"0.1.4"
"1589","646",2022-09-17 13:00:00,896,897,1,27,FALSE,NA,"0.1.4"
"1590","646",2022-09-17 13:15:00,896,897,1,27,FALSE,NA,"0.1.4"
"1591","646",2022-09-17 13:30:00,896,897,1,27,FALSE,NA,"0.1.4"
"1592","646",2022-09-17 13:45:00,897,897,0,27,FALSE,NA,"0.1.4"
"1593","646",2022-09-17 14:00:00,897,897,0,27,FALSE,NA,"0.1.4"
"1594","646",2022-09-17 14:15:00,897,897,0,27,FALSE,NA,"0.1.4"
"1595","646",2022-09-17 14:30:00,897,897,0,27,FALSE,NA,"0.1.4"
"1596","646",2022-09-17 14:45:00,897,897,0,27,FALSE,NA,"0.1.4"
"1597","646",2022-09-17 15:00:00,897,897,0,27,FALSE,NA,"0.1.4"
"1598","646",2022-09-17 15:15:00,897,897,0,27,FALSE,NA,"0.1.4"
"1599","646",2022-09-17 15:30:00,897,897,0,27,FALSE,NA,"0.1.4"
"1600","646",2022-09-17 15:45:00,897,897,0,27,FALSE,NA,"0.1.4"
"1601","646",2022-09-17 16:00:00,897,897,0,27,FALSE,NA,"0.1.4"
"1602","646",2022-09-17 16:15:00,897,897,0,27,FALSE,NA,"0.1.4"
"1603","646",2022-09-17 16:30:00,897,897,0,27,FALSE,NA,"0.1.4"
"1604","646",2022-09-17 16:45:00,897,897,0,27,FALSE,NA,"0.1.4"
"1605","646",2022-09-17 17:00:00,897,897,0,27,FALSE,NA,"0.1.4"
"1606","646",2022-09-17 17:15:00,897,897,0,27,FALSE,NA,"0.1.4"
"1607","646",2022-09-17 17:30:00,897,897,0,27,FALSE,NA,"0.1.4"
"1608","646",2022-09-17 17:45:00,897,897,0,27,FALSE,NA,"0.1.4"
"1609","646",2022-09-17 18:00:00,897,897,0,27,FALSE,NA,"0.1.4"
"1610","646",2022-09-17 18:15:00,897,897,0,27,FALSE,NA,"0.1.4"
"1611","646",2022-09-17 18:30:00,897,897,0,27,FALSE,NA,"0.1.4"
"1612","646",2022-09-17 18:45:00,897,897,0,27,FALSE,NA,"0.1.4"
"1613","646",2022-09-17 19:00:00,897,897,0,27,FALSE,NA,"0.1.4"
"1614","646",2022-09-17 19:15:00,897,897,0,27,FALSE,NA,"0.1.4"
"1615","646",2022-09-17 19:30:00,897,897,0,27,FALSE,NA,"0.1.4"
"1616","646",2022-09-17 19:45:00,897,897,0,27,FALSE,NA,"0.1.4"
"1617","646",2022-09-17 20:00:00,897,897,0,27,FALSE,NA,"0.1.4"
"1618","646",2022-09-17 20:15:00,897,897,0,27,FALSE,NA,"0.1.4"
"1619","646",2022-09-17 20:30:00,897,897,0,27,FALSE,NA,"0.1.4"
"1620","646",2022-09-17 20:45:00,897,897,0,27,FALSE,NA,"0.1.4"
"1621","646",2022-09-17 21:00:00,897,897,0,27,FALSE,NA,"0.1.4"
"1622","646",2022-09-17 21:15:00,897,897,0,27,FALSE,NA,"0.1.4"
"1623","646",2022-09-17 21:30:00,897,897,0,27,FALSE,NA,"0.1.4"
"1624","646",2022-09-17 21:45:00,897,897,0,27,FALSE,NA,"0.1.4"
"1625","646",2022-09-17 22:00:00,898,898,0,28,FALSE,NA,"0.1.4"
"1626","646",2022-09-17 22:15:00,897,898,1,28,FALSE,NA,"0.1.4"
"1627","646",2022-09-17 22:30:00,897,898,1,28,FALSE,NA,"0.1.4"
"1628","646",2022-09-17 22:45:00,897,898,1,28,FALSE,NA,"0.1.4"
"1629","646",2022-09-17 23:00:00,897,898,1,28,FALSE,NA,"0.1.4"
"1630","646",2022-09-17 23:15:00,896,898,2,28,FALSE,NA,"0.1.4"
"1631","646",2022-09-17 23:30:00,896,898,2,28,FALSE,NA,"0.1.4"
"1632","646",2022-09-17 23:45:00,896,898,2,28,FALSE,NA,"0.1.4"
"1633","646",2022-09-18,896,898,2,28,FALSE,NA,"0.1.4"
"1634","646",2022-09-18 00:15:00,896,898,2,28,FALSE,NA,"0.1.4"
"1635","646",2022-09-18 00:30:00,896,898,2,28,FALSE,NA,"0.1.4"
"1636","646",2022-09-18 00:45:00,896,898,2,28,FALSE,NA,"0.1.4"
"1637","646",2022-09-18 01:00:00,896,898,2,28,FALSE,NA,"0.1.4"
"1638","646",2022-09-18 01:15:00,896,898,2,28,FALSE,NA,"0.1.4"
"1639","646",2022-09-18 01:30:00,896,898,2,28,FALSE,NA,"0.1.4"
"1640","646",2022-09-18 01:45:00,896,898,2,28,FALSE,NA,"0.1.4"
"1641","646",2022-09-18 02:00:00,896,898,2,28,FALSE,NA,"0.1.4"
"1642","646",2022-09-18 02:15:00,896,898,2,28,FALSE,NA,"0.1.4"
"1643","646",2022-09-18 02:30:00,895,898,3,28,FALSE,NA,"0.1.4"
"1644","646",2022-09-18 02:45:00,895,898,3,28,FALSE,NA,"0.1.4"
"1645","646",2022-09-18 03:00:00,895,898,3,28,FALSE,NA,"0.1.4"
"1646","646",2022-09-18 03:15:00,895,898,3,28,FALSE,NA,"0.1.4"
"1647","646",2022-09-18 03:30:00,895,898,3,28,FALSE,NA,"0.1.4"
"1648","646",2022-09-18 03:45:00,895,898,3,28,FALSE,NA,"0.1.4"
"1649","646",2022-09-18 04:00:00,895,898,3,28,FALSE,NA,"0.1.4"
"1650","646",2022-09-18 04:15:00,896,898,2,28,FALSE,NA,"0.1.4"
"1651","646",2022-09-18 04:30:00,896,898,2,28,FALSE,NA,"0.1.4"
"1652","646",2022-09-18 04:45:00,896,898,2,28,FALSE,NA,"0.1.4"
"1653","646",2022-09-18 05:00:00,896,898,2,28,FALSE,NA,"0.1.4"
"1654","646",2022-09-18 05:15:00,896,898,2,28,FALSE,NA,"0.1.4"
"1655","646",2022-09-18 05:30:00,896,898,2,28,FALSE,NA,"0.1.4"
"1656","646",2022-09-18 05:45:00,896,898,2,28,FALSE,NA,"0.1.4"
"1657","646",2022-09-18 06:00:00,896,898,2,28,FALSE,NA,"0.1.4"
"1658","646",2022-09-18 06:15:00,896,898,2,28,FALSE,NA,"0.1.4"
"1659","646",2022-09-18 06:30:00,896,898,2,28,FALSE,NA,"0.1.4"
"1660","646",2022-09-18 06:45:00,896,898,2,28,FALSE,NA,"0.1.4"
"1661","646",2022-09-18 07:00:00,896,898,2,28,FALSE,NA,"0.1.4"
"1662","646",2022-09-18 07:15:00,896,898,2,28,FALSE,NA,"0.1.4"
"1663","646",2022-09-18 07:30:00,897,898,1,28,FALSE,NA,"0.1.4"
"1664","646",2022-09-18 07:45:00,897,898,1,28,FALSE,NA,"0.1.4"
"1665","646",2022-09-18 08:00:00,897,898,1,28,FALSE,NA,"0.1.4"
"1666","646",2022-09-18 08:15:00,897,898,1,28,FALSE,NA,"0.1.4"
"1667","646",2022-09-18 08:30:00,897,898,1,28,FALSE,NA,"0.1.4"
"1668","646",2022-09-18 08:45:00,898,898,0,28,FALSE,NA,"0.1.4"
"1669","646",2022-09-18 09:00:00,898,898,0,28,FALSE,NA,"0.1.4"
"1670","646",2022-09-18 09:15:00,898,898,0,28,FALSE,NA,"0.1.4"
"1671","646",2022-09-18 09:30:00,898,898,0,28,FALSE,NA,"0.1.4"
"1672","646",2022-09-18 09:45:00,899,899,0,29,FALSE,NA,"0.1.4"
"1673","646",2022-09-18 10:00:00,899,899,0,29,FALSE,NA,"0.1.4"
"1674","646",2022-09-18 10:15:00,900,900,0,30,FALSE,NA,"0.1.4"
"1675","646",2022-09-18 10:30:00,900,900,0,30,FALSE,NA,"0.1.4"
"1676","646",2022-09-18 10:45:00,900,900,0,30,FALSE,NA,"0.1.4"
"1677","646",2022-09-18 11:00:00,900,900,0,30,FALSE,NA,"0.1.4"
"1678","646",2022-09-18 11:15:00,900,900,0,30,FALSE,NA,"0.1.4"
"1679","646",2022-09-18 11:30:00,900,900,0,30,FALSE,NA,"0.1.4"
"1680","646",2022-09-18 11:45:00,901,901,0,31,FALSE,NA,"0.1.4"
"1681","646",2022-09-18 12:00:00,901,901,0,31,FALSE,NA,"0.1.4"
"1682","646",2022-09-18 12:15:00,901,901,0,31,FALSE,NA,"0.1.4"
"1683","646",2022-09-18 12:30:00,901,901,0,31,FALSE,NA,"0.1.4"
"1684","646",2022-09-18 12:45:00,901,901,0,31,FALSE,NA,"0.1.4"
"1685","646",2022-09-18 13:00:00,902,902,0,32,FALSE,NA,"0.1.4"
"1686","646",2022-09-18 13:15:00,903,903,0,33,FALSE,NA,"0.1.4"
"1687","646",2022-09-18 13:30:00,904,904,0,34,FALSE,NA,"0.1.4"
"1688","646",2022-09-18 13:45:00,903,904,1,34,FALSE,NA,"0.1.4"
"1689","646",2022-09-18 14:00:00,904,904,0,34,FALSE,NA,"0.1.4"
"1690","646",2022-09-18 14:15:00,903,904,1,34,FALSE,NA,"0.1.4"
"1691","646",2022-09-18 14:30:00,904,904,0,34,FALSE,NA,"0.1.4"
"1692","646",2022-09-18 14:45:00,904,904,0,34,FALSE,NA,"0.1.4"
"1693","646",2022-09-18 15:00:00,905,905,0,35,FALSE,NA,"0.1.4"
"1694","646",2022-09-18 15:15:00,905,905,0,35,FALSE,NA,"0.1.4"
"1695","646",2022-09-18 15:30:00,905,905,0,35,FALSE,NA,"0.1.4"
"1696","646",2022-09-18 15:45:00,905,905,0,35,FALSE,NA,"0.1.4"
"1697","646",2022-09-18 16:00:00,905,905,0,35,FALSE,NA,"0.1.4"
"1698","646",2022-09-18 16:15:00,905,905,0,35,FALSE,NA,"0.1.4"
"1699","646",2022-09-18 16:30:00,905,905,0,35,FALSE,NA,"0.1.4"
"1700","646",2022-09-18 16:45:00,905,905,0,35,FALSE,NA,"0.1.4"
"1701","646",2022-09-18 17:00:00,906,906,0,36,FALSE,NA,"0.1.4"
"1702","646",2022-09-18 17:15:00,906,906,0,36,FALSE,NA,"0.1.4"
"1703","646",2022-09-18 17:30:00,906,906,0,36,FALSE,NA,"0.1.4"
"1704","646",2022-09-18 17:45:00,906,906,0,36,FALSE,NA,"0.1.4"
"1705","646",2022-09-18 18:00:00,906,906,0,36,FALSE,NA,"0.1.4"
"1706","646",2022-09-18 18:15:00,906,906,0,36,FALSE,NA,"0.1.4"
"1707","646",2022-09-18 18:30:00,907,907,0,37,FALSE,NA,"0.1.4"
"1708","646",2022-09-18 18:45:00,906,907,1,37,FALSE,NA,"0.1.4"
"1709","646",2022-09-18 19:00:00,906,907,1,37,FALSE,NA,"0.1.4"
"1710","646",2022-09-18 19:15:00,906,907,1,37,FALSE,NA,"0.1.4"
"1711","646",2022-09-18 19:30:00,906,907,1,37,FALSE,NA,"0.1.4"
"1712","646",2022-09-18 19:45:00,906,907,1,37,FALSE,NA,"0.1.4"
"1713","646",2022-09-18 20:00:00,906,907,1,37,FALSE,NA,"0.1.4"
"1714","646",2022-09-18 20:15:00,906,907,1,37,FALSE,NA,"0.1.4"
"1715","646",2022-09-18 20:30:00,907,907,0,37,FALSE,NA,"0.1.4"
"1716","646",2022-09-18 20:45:00,907,907,0,37,FALSE,NA,"0.1.4"
"1717","646",2022-09-18 21:00:00,907,907,0,37,FALSE,NA,"0.1.4"
"1718","646",2022-09-18 21:15:00,907,907,0,37,FALSE,NA,"0.1.4"
"1719","646",2022-09-18 21:30:00,907,907,0,37,FALSE,NA,"0.1.4"
"1720","646",2022-09-18 21:45:00,907,907,0,37,FALSE,NA,"0.1.4"
"1721","646",2022-09-18 22:00:00,907,907,0,37,FALSE,NA,"0.1.4"
"1722","646",2022-09-18 22:15:00,907,907,0,37,FALSE,NA,"0.1.4"
"1723","646",2022-09-18 22:30:00,907,907,0,37,FALSE,NA,"0.1.4"
"1724","646",2022-09-18 22:45:00,907,907,0,37,FALSE,NA,"0.1.4"
"1725","646",2022-09-18 23:00:00,907,907,0,37,FALSE,NA,"0.1.4"
"1726","646",2022-09-18 23:15:00,907,907,0,37,FALSE,NA,"0.1.4"
"1727","646",2022-09-18 23:30:00,907,907,0,37,FALSE,NA,"0.1.4"
"1728","646",2022-09-18 23:45:00,907,907,0,37,FALSE,NA,"0.1.4"
"1729","646",2022-09-19,907,907,0,37,FALSE,NA,"0.1.4"
"1730","646",2022-09-19 00:15:00,907,907,0,37,FALSE,NA,"0.1.4"
"1731","646",2022-09-19 00:30:00,907,907,0,37,FALSE,NA,"0.1.4"
"1732","646",2022-09-19 00:45:00,907,907,0,37,FALSE,NA,"0.1.4"
"1733","646",2022-09-19 01:00:00,907,907,0,37,FALSE,NA,"0.1.4"
"1734","646",2022-09-19 01:15:00,907,907,0,37,FALSE,NA,"0.1.4"
"1735","646",2022-09-19 01:30:00,907,907,0,37,FALSE,NA,"0.1.4"
"1736","646",2022-09-19 01:45:00,907,907,0,37,FALSE,NA,"0.1.4"
"1737","646",2022-09-19 02:00:00,907,907,0,37,FALSE,NA,"0.1.4"
"1738","646",2022-09-19 02:15:00,907,907,0,37,FALSE,NA,"0.1.4"
"1739","646",2022-09-19 02:30:00,907,907,0,37,FALSE,NA,"0.1.4"
"1740","646",2022-09-19 02:45:00,907,907,0,37,FALSE,NA,"0.1.4"
"1741","646",2022-09-19 03:00:00,908,908,0,38,FALSE,NA,"0.1.4"
"1742","646",2022-09-19 03:15:00,907,908,1,38,FALSE,NA,"0.1.4"
"1743","646",2022-09-19 03:30:00,908,908,0,38,FALSE,NA,"0.1.4"
"1744","646",2022-09-19 03:45:00,908,908,0,38,FALSE,NA,"0.1.4"
"1745","646",2022-09-19 04:00:00,908,908,0,38,FALSE,NA,"0.1.4"
"1746","646",2022-09-19 04:15:00,907,908,1,38,FALSE,NA,"0.1.4"
"1747","646",2022-09-19 04:30:00,908,908,0,38,FALSE,NA,"0.1.4"
"1748","646",2022-09-19 04:45:00,907,908,1,38,FALSE,NA,"0.1.4"
"1749","646",2022-09-19 05:00:00,907,908,1,38,FALSE,NA,"0.1.4"
"1750","646",2022-09-19 05:15:00,907,908,1,38,FALSE,NA,"0.1.4"
"1751","646",2022-09-19 05:30:00,908,908,0,38,FALSE,NA,"0.1.4"
"1752","646",2022-09-19 05:45:00,909,909,0,39,FALSE,NA,"0.1.4"
"1753","646",2022-09-19 06:00:00,909,909,0,39,FALSE,NA,"0.1.4"
"1754","646",2022-09-19 06:15:00,909,909,0,39,FALSE,NA,"0.1.4"
"1755","646",2022-09-19 06:30:00,909,909,0,39,FALSE,NA,"0.1.4"
"1756","646",2022-09-19 06:45:00,909,909,0,39,FALSE,NA,"0.1.4"
"1757","646",2022-09-19 07:00:00,909,909,0,39,FALSE,NA,"0.1.4"
"1758","646",2022-09-19 07:15:00,909,909,0,39,FALSE,NA,"0.1.4"
"1759","646",2022-09-19 07:30:00,910,910,0,40,FALSE,NA,"0.1.4"
"1760","646",2022-09-19 07:45:00,909,910,1,40,FALSE,NA,"0.1.4"
"1761","646",2022-09-19 08:00:00,910,910,0,40,FALSE,NA,"0.1.4"
"1762","646",2022-09-19 08:15:00,910,910,0,40,FALSE,NA,"0.1.4"
"1763","646",2022-09-19 08:30:00,910,910,0,40,FALSE,NA,"0.1.4"
"1764","646",2022-09-19 08:45:00,910,910,0,40,FALSE,NA,"0.1.4"
"1765","646",2022-09-19 09:00:00,910,910,0,40,FALSE,NA,"0.1.4"
"1766","646",2022-09-19 09:15:00,910,910,0,40,FALSE,NA,"0.1.4"
"1767","646",2022-09-19 09:30:00,910,910,0,40,FALSE,NA,"0.1.4"
"1768","646",2022-09-19 09:45:00,910,910,0,40,FALSE,NA,"0.1.4"
"1769","646",2022-09-19 10:00:00,911,911,0,41,FALSE,NA,"0.1.4"
"1770","646",2022-09-19 10:15:00,911,911,0,41,FALSE,NA,"0.1.4"
"1771","646",2022-09-19 10:30:00,911,911,0,41,FALSE,NA,"0.1.4"
"1772","646",2022-09-19 10:45:00,911,911,0,41,FALSE,NA,"0.1.4"
"1773","646",2022-09-19 11:00:00,912,912,0,42,FALSE,NA,"0.1.4"
"1774","646",2022-09-19 11:15:00,912,912,0,42,FALSE,NA,"0.1.4"
"1775","646",2022-09-19 11:30:00,912,912,0,42,FALSE,NA,"0.1.4"
"1776","646",2022-09-19 11:45:00,912,912,0,42,FALSE,NA,"0.1.4"
"1777","646",2022-09-19 12:00:00,912,912,0,42,FALSE,NA,"0.1.4"
"1778","646",2022-09-19 12:15:00,912,912,0,42,FALSE,NA,"0.1.4"
"1779","646",2022-09-19 12:30:00,912,912,0,42,FALSE,NA,"0.1.4"
"1780","646",2022-09-19 12:45:00,912,912,0,42,FALSE,NA,"0.1.4"
"1781","646",2022-09-19 13:00:00,912,912,0,42,FALSE,NA,"0.1.4"
"1782","646",2022-09-19 13:15:00,912,912,0,42,FALSE,NA,"0.1.4"
"1783","646",2022-09-19 13:30:00,912,912,0,42,FALSE,NA,"0.1.4"
"1784","646",2022-09-19 13:45:00,912,912,0,42,FALSE,NA,"0.1.4"
"1785","646",2022-09-19 14:00:00,912,912,0,42,FALSE,NA,"0.1.4"
"1786","646",2022-09-19 14:15:00,912,912,0,42,FALSE,NA,"0.1.4"
"1787","646",2022-09-19 14:30:00,912,912,0,42,FALSE,NA,"0.1.4"
"1788","646",2022-09-19 14:45:00,912,912,0,42,FALSE,NA,"0.1.4"
"1789","646",2022-09-19 15:00:00,912,912,0,42,FALSE,NA,"0.1.4"
"1790","646",2022-09-19 15:15:00,912,912,0,42,FALSE,NA,"0.1.4"
"1791","646",2022-09-19 15:30:00,912,912,0,42,FALSE,NA,"0.1.4"
"1792","646",2022-09-19 15:45:00,912,912,0,42,FALSE,NA,"0.1.4"
"1793","646",2022-09-19 16:00:00,912,912,0,42,FALSE,NA,"0.1.4"
"1794","646",2022-09-19 16:15:00,912,912,0,42,FALSE,NA,"0.1.4"
"1795","646",2022-09-19 16:30:00,912,912,0,42,FALSE,NA,"0.1.4"
"1796","646",2022-09-19 16:45:00,912,912,0,42,FALSE,NA,"0.1.4"
"1797","646",2022-09-19 17:00:00,912,912,0,42,FALSE,NA,"0.1.4"
"1798","646",2022-09-19 17:15:00,912,912,0,42,FALSE,NA,"0.1.4"
"1799","646",2022-09-19 17:30:00,912,912,0,42,FALSE,NA,"0.1.4"
"1800","646",2022-09-19 17:45:00,912,912,0,42,FALSE,NA,"0.1.4"
"1801","646",2022-09-19 18:00:00,912,912,0,42,FALSE,NA,"0.1.4"
"1802","646",2022-09-19 18:15:00,912,912,0,42,FALSE,NA,"0.1.4"
"1803","646",2022-09-19 18:30:00,912,912,0,42,FALSE,NA,"0.1.4"
"1804","646",2022-09-19 18:45:00,912,912,0,42,FALSE,NA,"0.1.4"
"1805","646",2022-09-19 19:00:00,912,912,0,42,FALSE,NA,"0.1.4"
"1806","646",2022-09-19 19:15:00,912,912,0,42,FALSE,NA,"0.1.4"
"1807","646",2022-09-19 19:30:00,912,912,0,42,FALSE,NA,"0.1.4"
"1808","646",2022-09-19 19:45:00,912,912,0,42,FALSE,NA,"0.1.4"
"1809","646",2022-09-19 20:00:00,912,912,0,42,FALSE,NA,"0.1.4"
"1810","646",2022-09-19 20:15:00,912,912,0,42,FALSE,NA,"0.1.4"
"1811","646",2022-09-19 20:30:00,912,912,0,42,FALSE,NA,"0.1.4"
"1812","646",2022-09-19 20:45:00,912,912,0,42,FALSE,NA,"0.1.4"
"1813","646",2022-09-19 21:00:00,912,912,0,42,FALSE,NA,"0.1.4"
"1814","646",2022-09-19 21:15:00,912,912,0,42,FALSE,NA,"0.1.4"
"1815","646",2022-09-19 21:30:00,912,912,0,42,FALSE,NA,"0.1.4"
"1816","646",2022-09-19 21:45:00,912,912,0,42,FALSE,NA,"0.1.4"
"1817","646",2022-09-19 22:00:00,912,912,0,42,FALSE,NA,"0.1.4"
"1818","646",2022-09-19 22:15:00,912,912,0,42,FALSE,NA,"0.1.4"
"1819","646",2022-09-19 22:30:00,912,912,0,42,FALSE,NA,"0.1.4"
"1820","646",2022-09-19 22:45:00,912,912,0,42,FALSE,NA,"0.1.4"
"1821","646",2022-09-19 23:00:00,912,912,0,42,FALSE,NA,"0.1.4"
"1822","646",2022-09-19 23:15:00,912,912,0,42,FALSE,NA,"0.1.4"
"1823","646",2022-09-19 23:30:00,912,912,0,42,FALSE,NA,"0.1.4"
"1824","646",2022-09-19 23:45:00,912,912,0,42,FALSE,NA,"0.1.4"
"1825","646",2022-09-20,912,912,0,42,FALSE,NA,"0.1.4"
"1826","646",2022-09-20 00:15:00,912,912,0,42,FALSE,NA,"0.1.4"
"1827","646",2022-09-20 00:30:00,912,912,0,42,FALSE,NA,"0.1.4"
"1828","646",2022-09-20 00:45:00,912,912,0,42,FALSE,NA,"0.1.4"
"1829","646",2022-09-20 01:00:00,912,912,0,42,FALSE,NA,"0.1.4"
"1830","646",2022-09-20 01:15:00,912,912,0,42,FALSE,NA,"0.1.4"
"1831","646",2022-09-20 01:30:00,912,912,0,42,FALSE,NA,"0.1.4"
"1832","646",2022-09-20 01:45:00,912,912,0,42,FALSE,NA,"0.1.4"
"1833","646",2022-09-20 02:00:00,912,912,0,42,FALSE,NA,"0.1.4"
"1834","646",2022-09-20 02:15:00,912,912,0,42,FALSE,NA,"0.1.4"
"1835","646",2022-09-20 02:30:00,912,912,0,42,FALSE,NA,"0.1.4"
"1836","646",2022-09-20 02:45:00,912,912,0,42,FALSE,NA,"0.1.4"
"1837","646",2022-09-20 03:00:00,912,912,0,42,FALSE,NA,"0.1.4"
"1838","646",2022-09-20 03:15:00,912,912,0,42,FALSE,NA,"0.1.4"
"1839","646",2022-09-20 03:30:00,912,912,0,42,FALSE,NA,"0.1.4"
"1840","646",2022-09-20 03:45:00,912,912,0,42,FALSE,NA,"0.1.4"
"1841","646",2022-09-20 04:00:00,912,912,0,42,FALSE,NA,"0.1.4"
"1842","646",2022-09-20 04:15:00,912,912,0,42,FALSE,NA,"0.1.4"
"1843","646",2022-09-20 04:30:00,912,912,0,42,FALSE,NA,"0.1.4"
"1844","646",2022-09-20 04:45:00,912,912,0,42,FALSE,NA,"0.1.4"
"1845","646",2022-09-20 05:00:00,912,912,0,42,FALSE,NA,"0.1.4"
"1846","646",2022-09-20 05:15:00,912,912,0,42,FALSE,NA,"0.1.4"
"1847","646",2022-09-20 05:30:00,912,912,0,42,FALSE,NA,"0.1.4"
"1848","646",2022-09-20 05:45:00,912,912,0,42,FALSE,NA,"0.1.4"
"1849","646",2022-09-20 06:00:00,912,912,0,42,FALSE,NA,"0.1.4"
"1850","646",2022-09-20 06:15:00,912,912,0,42,FALSE,NA,"0.1.4"
"1851","646",2022-09-20 06:30:00,912,912,0,42,FALSE,NA,"0.1.4"
"1852","646",2022-09-20 06:45:00,912,912,0,42,FALSE,NA,"0.1.4"
"1853","646",2022-09-20 07:00:00,912,912,0,42,FALSE,NA,"0.1.4"
"1854","646",2022-09-20 07:15:00,912,912,0,42,FALSE,NA,"0.1.4"
"1855","646",2022-09-20 07:30:00,912,912,0,42,FALSE,NA,"0.1.4"
"1856","646",2022-09-20 07:45:00,912,912,0,42,FALSE,NA,"0.1.4"
"1857","646",2022-09-20 08:00:00,912,912,0,42,FALSE,NA,"0.1.4"
"1858","646",2022-09-20 08:15:00,912,912,0,42,FALSE,NA,"0.1.4"
"1859","646",2022-09-20 08:30:00,912,912,0,42,FALSE,NA,"0.1.4"
"1860","646",2022-09-20 08:45:00,912,912,0,42,FALSE,NA,"0.1.4"
"1861","646",2022-09-20 09:00:00,912,912,0,42,FALSE,NA,"0.1.4"
"1862","646",2022-09-20 09:15:00,912,912,0,42,FALSE,NA,"0.1.4"
"1863","646",2022-09-20 09:30:00,912,912,0,42,FALSE,NA,"0.1.4"
"1864","646",2022-09-20 09:45:00,912,912,0,42,FALSE,NA,"0.1.4"
"1865","646",2022-09-20 10:00:00,912,912,0,42,FALSE,NA,"0.1.4"
"1866","646",2022-09-20 10:15:00,912,912,0,42,FALSE,NA,"0.1.4"
"1867","646",2022-09-20 10:30:00,913,913,0,43,FALSE,NA,"0.1.4"
"1868","646",2022-09-20 10:45:00,913,913,0,43,FALSE,NA,"0.1.4"
"1869","646",2022-09-20 11:00:00,913,913,0,43,FALSE,NA,"0.1.4"
"1870","646",2022-09-20 11:15:00,913,913,0,43,FALSE,NA,"0.1.4"
"1871","646",2022-09-20 11:30:00,913,913,0,43,FALSE,NA,"0.1.4"
"1872","646",2022-09-20 11:45:00,913,913,0,43,FALSE,NA,"0.1.4"
"1873","646",2022-09-20 12:00:00,913,913,0,43,FALSE,NA,"0.1.4"
"1874","646",2022-09-20 12:15:00,913,913,0,43,FALSE,NA,"0.1.4"
"1875","646",2022-09-20 12:30:00,913,913,0,43,FALSE,NA,"0.1.4"
"1876","646",2022-09-20 12:45:00,913,913,0,43,FALSE,NA,"0.1.4"
"1877","646",2022-09-20 13:00:00,913,913,0,43,FALSE,NA,"0.1.4"
"1878","646",2022-09-20 13:15:00,913,913,0,43,FALSE,NA,"0.1.4"
"1879","646",2022-09-20 13:30:00,913,913,0,43,FALSE,NA,"0.1.4"
"1880","646",2022-09-20 13:45:00,913,913,0,43,FALSE,NA,"0.1.4"
"1881","646",2022-09-20 14:00:00,913,913,0,43,FALSE,NA,"0.1.4"
"1882","646",2022-09-20 14:15:00,913,913,0,43,FALSE,NA,"0.1.4"
"1883","646",2022-09-20 14:30:00,913,913,0,43,FALSE,NA,"0.1.4"
"1884","646",2022-09-20 14:45:00,913,913,0,43,FALSE,NA,"0.1.4"
"1885","646",2022-09-20 15:00:00,913,913,0,43,FALSE,NA,"0.1.4"
"1886","646",2022-09-20 15:15:00,913,913,0,43,FALSE,NA,"0.1.4"
"1887","646",2022-09-20 15:30:00,913,913,0,43,FALSE,NA,"0.1.4"
"1888","646",2022-09-20 15:45:00,913,913,0,43,FALSE,NA,"0.1.4"
"1889","646",2022-09-20 16:00:00,913,913,0,43,FALSE,NA,"0.1.4"
"1890","646",2022-09-20 16:15:00,913,913,0,43,FALSE,NA,"0.1.4"
"1891","646",2022-09-20 16:30:00,913,913,0,43,FALSE,NA,"0.1.4"
"1892","646",2022-09-20 16:45:00,913,913,0,43,FALSE,NA,"0.1.4"
"1893","646",2022-09-20 17:00:00,913,913,0,43,FALSE,NA,"0.1.4"
"1894","646",2022-09-20 17:15:00,913,913,0,43,FALSE,NA,"0.1.4"
"1895","646",2022-09-20 17:30:00,913,913,0,43,FALSE,NA,"0.1.4"
"1896","646",2022-09-20 17:45:00,913,913,0,43,FALSE,NA,"0.1.4"
"1897","646",2022-09-20 18:00:00,913,913,0,43,FALSE,NA,"0.1.4"
"1898","646",2022-09-20 18:15:00,913,913,0,43,FALSE,NA,"0.1.4"
"1899","646",2022-09-20 18:30:00,913,913,0,43,FALSE,NA,"0.1.4"
"1900","646",2022-09-20 18:45:00,913,913,0,43,FALSE,NA,"0.1.4"
"1901","646",2022-09-20 19:00:00,913,913,0,43,FALSE,NA,"0.1.4"
"1902","646",2022-09-20 19:15:00,913,913,0,43,FALSE,NA,"0.1.4"
"1903","646",2022-09-20 19:30:00,913,913,0,43,FALSE,NA,"0.1.4"
"1904","646",2022-09-20 19:45:00,913,913,0,43,FALSE,NA,"0.1.4"
"1905","646",2022-09-20 20:00:00,913,913,0,43,FALSE,NA,"0.1.4"
"1906","646",2022-09-20 20:15:00,913,913,0,43,FALSE,NA,"0.1.4"
"1907","646",2022-09-20 20:30:00,913,913,0,43,FALSE,NA,"0.1.4"
"1908","646",2022-09-20 20:45:00,913,913,0,43,FALSE,NA,"0.1.4"
"1909","646",2022-09-20 21:00:00,913,913,0,43,FALSE,NA,"0.1.4"
"1910","646",2022-09-20 21:15:00,913,913,0,43,FALSE,NA,"0.1.4"
"1911","646",2022-09-20 21:30:00,913,913,0,43,FALSE,NA,"0.1.4"
"1912","646",2022-09-20 21:45:00,913,913,0,43,FALSE,NA,"0.1.4"
"1913","646",2022-09-20 22:00:00,913,913,0,43,FALSE,NA,"0.1.4"
"1914","646",2022-09-20 22:15:00,913,913,0,43,FALSE,NA,"0.1.4"
"1915","646",2022-09-20 22:30:00,913,913,0,43,FALSE,NA,"0.1.4"
"1916","646",2022-09-20 22:45:00,913,913,0,43,FALSE,NA,"0.1.4"
"1917","646",2022-09-20 23:00:00,913,913,0,43,FALSE,NA,"0.1.4"
"1918","646",2022-09-20 23:15:00,913,913,0,43,FALSE,NA,"0.1.4"
"1919","646",2022-09-20 23:30:00,913,913,0,43,FALSE,NA,"0.1.4"
"1920","646",2022-09-20 23:45:00,913,913,0,43,FALSE,NA,"0.1.4"
"1921","646",2022-09-21,913,913,0,43,FALSE,NA,"0.1.4"
"1922","646",2022-09-21 00:15:00,913,913,0,43,FALSE,NA,"0.1.4"
"1923","646",2022-09-21 00:30:00,913,913,0,43,FALSE,NA,"0.1.4"
"1924","646",2022-09-21 00:45:00,913,913,0,43,FALSE,NA,"0.1.4"
"1925","646",2022-09-21 01:00:00,913,913,0,43,FALSE,NA,"0.1.4"
"1926","646",2022-09-21 01:15:00,913,913,0,43,FALSE,NA,"0.1.4"
"1927","646",2022-09-21 01:30:00,913,913,0,43,FALSE,NA,"0.1.4"
"1928","646",2022-09-21 01:45:00,913,913,0,43,FALSE,NA,"0.1.4"
"1929","646",2022-09-21 02:00:00,913,913,0,43,FALSE,NA,"0.1.4"
"1930","646",2022-09-21 02:15:00,913,913,0,43,FALSE,NA,"0.1.4"
"1931","646",2022-09-21 02:30:00,913,913,0,43,FALSE,NA,"0.1.4"
"1932","646",2022-09-21 02:45:00,913,913,0,43,FALSE,NA,"0.1.4"
"1933","646",2022-09-21 03:00:00,913,913,0,43,FALSE,NA,"0.1.4"
"1934","646",2022-09-21 03:15:00,913,913,0,43,FALSE,NA,"0.1.4"
"1935","646",2022-09-21 03:30:00,914,914,0,44,FALSE,NA,"0.1.4"
"1936","646",2022-09-21 03:45:00,913,914,1,44,FALSE,NA,"0.1.4"
"1937","646",2022-09-21 04:00:00,913,914,1,44,FALSE,NA,"0.1.4"
"1938","646",2022-09-21 04:15:00,913,914,1,44,FALSE,NA,"0.1.4"
"1939","646",2022-09-21 04:30:00,913,914,1,44,FALSE,NA,"0.1.4"
"1940","646",2022-09-21 04:45:00,913,914,1,44,FALSE,NA,"0.1.4"
"1941","646",2022-09-21 05:00:00,913,914,1,44,FALSE,NA,"0.1.4"
"1942","646",2022-09-21 05:15:00,913,914,1,44,FALSE,NA,"0.1.4"
"1943","646",2022-09-21 05:30:00,913,914,1,44,FALSE,NA,"0.1.4"
"1944","646",2022-09-21 05:45:00,913,914,1,44,FALSE,NA,"0.1.4"
"1945","646",2022-09-21 06:00:00,913,914,1,44,FALSE,NA,"0.1.4"
"1946","646",2022-09-21 06:15:00,913,914,1,44,FALSE,NA,"0.1.4"
"1947","646",2022-09-21 06:30:00,913,914,1,44,FALSE,NA,"0.1.4"
"1948","646",2022-09-21 06:45:00,913,914,1,44,FALSE,NA,"0.1.4"
"1949","646",2022-09-21 07:00:00,913,914,1,44,FALSE,NA,"0.1.4"
"1950","646",2022-09-21 07:15:00,914,914,0,44,FALSE,NA,"0.1.4"
"1951","646",2022-09-21 07:30:00,914,914,0,44,FALSE,NA,"0.1.4"
"1952","646",2022-09-21 07:45:00,914,914,0,44,FALSE,NA,"0.1.4"
"1953","646",2022-09-21 08:00:00,914,914,0,44,FALSE,NA,"0.1.4"
"1954","646",2022-09-21 08:15:00,914,914,0,44,FALSE,NA,"0.1.4"
"1955","646",2022-09-21 08:30:00,914,914,0,44,FALSE,NA,"0.1.4"
"1956","646",2022-09-21 08:45:00,914,914,0,44,FALSE,NA,"0.1.4"
"1957","646",2022-09-21 09:00:00,914,914,0,44,FALSE,NA,"0.1.4"
"1958","646",2022-09-21 09:15:00,914,914,0,44,FALSE,NA,"0.1.4"
"1959","646",2022-09-21 09:30:00,914,914,0,44,FALSE,NA,"0.1.4"
"1960","646",2022-09-21 09:45:00,914,914,0,44,FALSE,NA,"0.1.4"
"1961","646",2022-09-21 10:00:00,914,914,0,44,FALSE,NA,"0.1.4"
"1962","646",2022-09-21 10:15:00,915,915,0,45,FALSE,NA,"0.1.4"
"1963","646",2022-09-21 10:30:00,915,915,0,45,FALSE,NA,"0.1.4"
"1964","646",2022-09-21 10:45:00,915,915,0,45,FALSE,NA,"0.1.4"
"1965","646",2022-09-21 11:00:00,915,915,0,45,FALSE,NA,"0.1.4"
"1966","646",2022-09-21 11:15:00,915,915,0,45,FALSE,NA,"0.1.4"
"1967","646",2022-09-21 11:30:00,915,915,0,45,FALSE,NA,"0.1.4"
"1968","646",2022-09-21 11:45:00,915,915,0,45,FALSE,NA,"0.1.4"
"1969","646",2022-09-21 12:00:00,915,915,0,45,FALSE,NA,"0.1.4"
"1970","646",2022-09-21 12:15:00,915,915,0,45,FALSE,NA,"0.1.4"
"1971","646",2022-09-21 12:30:00,915,915,0,45,FALSE,NA,"0.1.4"
"1972","646",2022-09-21 12:45:00,915,915,0,45,FALSE,NA,"0.1.4"
"1973","646",2022-09-21 13:00:00,915,915,0,45,FALSE,NA,"0.1.4"
"1974","646",2022-09-21 13:15:00,915,915,0,45,FALSE,NA,"0.1.4"
"1975","646",2022-09-21 13:30:00,915,915,0,45,FALSE,NA,"0.1.4"
"1976","646",2022-09-21 13:45:00,915,915,0,45,FALSE,NA,"0.1.4"
"1977","646",2022-09-21 14:00:00,915,915,0,45,FALSE,NA,"0.1.4"
"1978","646",2022-09-21 14:15:00,915,915,0,45,FALSE,NA,"0.1.4"
"1979","646",2022-09-21 14:30:00,915,915,0,45,FALSE,NA,"0.1.4"
"1980","646",2022-09-21 14:45:00,915,915,0,45,FALSE,NA,"0.1.4"
"1981","646",2022-09-21 15:00:00,915,915,0,45,FALSE,NA,"0.1.4"
"1982","646",2022-09-21 15:15:00,915,915,0,45,FALSE,NA,"0.1.4"
"1983","646",2022-09-21 15:30:00,915,915,0,45,FALSE,NA,"0.1.4"
"1984","646",2022-09-21 15:45:00,915,915,0,45,FALSE,NA,"0.1.4"
"1985","646",2022-09-21 16:00:00,915,915,0,45,FALSE,NA,"0.1.4"
"1986","646",2022-09-21 16:15:00,915,915,0,45,FALSE,NA,"0.1.4"
"1987","646",2022-09-21 16:30:00,915,915,0,45,FALSE,NA,"0.1.4"
"1988","646",2022-09-21 16:45:00,915,915,0,45,FALSE,NA,"0.1.4"
"1989","646",2022-09-21 17:00:00,915,915,0,45,FALSE,NA,"0.1.4"
"1990","646",2022-09-21 17:15:00,916,916,0,46,FALSE,NA,"0.1.4"
"1991","646",2022-09-21 17:30:00,916,916,0,46,FALSE,NA,"0.1.4"
"1992","646",2022-09-21 17:45:00,916,916,0,46,FALSE,NA,"0.1.4"
"1993","646",2022-09-21 18:00:00,916,916,0,46,FALSE,NA,"0.1.4"
"1994","646",2022-09-21 18:15:00,916,916,0,46,FALSE,NA,"0.1.4"
"1995","646",2022-09-21 18:30:00,916,916,0,46,FALSE,NA,"0.1.4"
"1996","646",2022-09-21 18:45:00,916,916,0,46,FALSE,NA,"0.1.4"
"1997","646",2022-09-21 19:00:00,916,916,0,46,FALSE,NA,"0.1.4"
"1998","646",2022-09-21 19:15:00,916,916,0,46,FALSE,NA,"0.1.4"
"1999","646",2022-09-21 19:30:00,916,916,0,46,FALSE,NA,"0.1.4"
"2000","646",2022-09-21 19:45:00,916,916,0,46,FALSE,NA,"0.1.4"
"2001","646",2022-09-21 20:00:00,916,916,0,46,FALSE,NA,"0.1.4"
"2002","646",2022-09-21 20:15:00,916,916,0,46,FALSE,NA,"0.1.4"
"2003","646",2022-09-21 20:30:00,916,916,0,46,FALSE,NA,"0.1.4"
"2004","646",2022-09-21 20:45:00,916,916,0,46,FALSE,NA,"0.1.4"
"2005","646",2022-09-21 21:00:00,916,916,0,46,FALSE,NA,"0.1.4"
"2006","646",2022-09-21 21:15:00,916,916,0,46,FALSE,NA,"0.1.4"
"2007","646",2022-09-21 21:30:00,916,916,0,46,FALSE,NA,"0.1.4"
"2008","646",2022-09-21 21:45:00,916,916,0,46,FALSE,NA,"0.1.4"
"2009","646",2022-09-21 22:00:00,916,916,0,46,FALSE,NA,"0.1.4"
"2010","646",2022-09-21 22:15:00,916,916,0,46,FALSE,NA,"0.1.4"
"2011","646",2022-09-21 22:30:00,916,916,0,46,FALSE,NA,"0.1.4"
"2012","646",2022-09-21 22:45:00,916,916,0,46,FALSE,NA,"0.1.4"
"2013","646",2022-09-21 23:00:00,916,916,0,46,FALSE,NA,"0.1.4"
"2014","646",2022-09-21 23:15:00,916,916,0,46,FALSE,NA,"0.1.4"
"2015","646",2022-09-21 23:30:00,916,916,0,46,FALSE,NA,"0.1.4"
"2016","646",2022-09-21 23:45:00,916,916,0,46,FALSE,NA,"0.1.4"
"2017","646",2022-09-22,916,916,0,46,FALSE,NA,"0.1.4"
"2018","646",2022-09-22 00:15:00,916,916,0,46,FALSE,NA,"0.1.4"
"2019","646",2022-09-22 00:30:00,916,916,0,46,FALSE,NA,"0.1.4"
"2020","646",2022-09-22 00:45:00,916,916,0,46,FALSE,NA,"0.1.4"
"2021","646",2022-09-22 01:00:00,916,916,0,46,FALSE,NA,"0.1.4"
"2022","646",2022-09-22 01:15:00,916,916,0,46,FALSE,NA,"0.1.4"
"2023","646",2022-09-22 01:30:00,916,916,0,46,FALSE,NA,"0.1.4"
"2024","646",2022-09-22 01:45:00,917,917,0,47,FALSE,NA,"0.1.4"
"2025","646",2022-09-22 02:00:00,917,917,0,47,FALSE,NA,"0.1.4"
"2026","646",2022-09-22 02:15:00,917,917,0,47,FALSE,NA,"0.1.4"
"2027","646",2022-09-22 02:30:00,917,917,0,47,FALSE,NA,"0.1.4"
"2028","646",2022-09-22 02:45:00,917,917,0,47,FALSE,NA,"0.1.4"
"2029","646",2022-09-22 03:00:00,918,918,0,48,FALSE,NA,"0.1.4"
"2030","646",2022-09-22 03:15:00,918,918,0,48,FALSE,NA,"0.1.4"
"2031","646",2022-09-22 03:30:00,919,919,0,49,FALSE,NA,"0.1.4"
"2032","646",2022-09-22 03:45:00,918,919,1,49,FALSE,NA,"0.1.4"
"2033","646",2022-09-22 04:00:00,919,919,0,49,FALSE,NA,"0.1.4"
"2034","646",2022-09-22 04:15:00,919,919,0,49,FALSE,NA,"0.1.4"
"2035","646",2022-09-22 04:30:00,919,919,0,49,FALSE,NA,"0.1.4"
"2036","646",2022-09-22 04:45:00,920,920,0,50,FALSE,NA,"0.1.4"
"2037","646",2022-09-22 05:00:00,920,920,0,50,FALSE,NA,"0.1.4"
"2038","646",2022-09-22 05:15:00,920,920,0,50,FALSE,NA,"0.1.4"
"2039","646",2022-09-22 05:30:00,920,920,0,50,FALSE,NA,"0.1.4"
"2040","646",2022-09-22 05:45:00,920,920,0,50,FALSE,NA,"0.1.4"
"2041","646",2022-09-22 06:00:00,920,920,0,50,FALSE,NA,"0.1.4"
"2042","646",2022-09-22 06:15:00,921,921,0,51,FALSE,NA,"0.1.4"
"2043","646",2022-09-22 06:30:00,922,922,0,52,FALSE,NA,"0.1.4"
"2044","646",2022-09-22 06:45:00,922,922,0,52,FALSE,NA,"0.1.4"
"2045","646",2022-09-22 07:00:00,922,922,0,52,FALSE,NA,"0.1.4"
"2046","646",2022-09-22 07:15:00,923,923,0,53,FALSE,NA,"0.1.4"
"2047","646",2022-09-22 07:30:00,923,923,0,53,FALSE,NA,"0.1.4"
"2048","646",2022-09-22 07:45:00,923,923,0,53,FALSE,NA,"0.1.4"
"2049","646",2022-09-22 08:00:00,923,923,0,53,FALSE,NA,"0.1.4"
"2050","646",2022-09-22 08:15:00,923,923,0,53,FALSE,NA,"0.1.4"
"2051","646",2022-09-22 08:30:00,925,925,0,55,FALSE,NA,"0.1.4"
"2052","646",2022-09-22 08:45:00,926,926,0,56,FALSE,NA,"0.1.4"
"2053","646",2022-09-22 09:00:00,925,926,1,56,FALSE,NA,"0.1.4"
"2054","646",2022-09-22 09:15:00,926,926,0,56,FALSE,NA,"0.1.4"
"2055","646",2022-09-22 09:30:00,926,926,0,56,FALSE,NA,"0.1.4"
"2056","646",2022-09-22 09:45:00,926,926,0,56,FALSE,NA,"0.1.4"
"2057","646",2022-09-22 10:00:00,926,926,0,56,FALSE,NA,"0.1.4"
"2058","646",2022-09-22 10:15:00,926,926,0,56,FALSE,NA,"0.1.4"
"2059","646",2022-09-22 10:30:00,927,927,0,57,FALSE,NA,"0.1.4"
"2060","646",2022-09-22 10:45:00,927,927,0,57,FALSE,NA,"0.1.4"
"2061","646",2022-09-22 11:00:00,927,927,0,57,FALSE,NA,"0.1.4"
"2062","646",2022-09-22 11:15:00,927,927,0,57,FALSE,NA,"0.1.4"
"2063","646",2022-09-22 11:30:00,927,927,0,57,FALSE,NA,"0.1.4"
"2064","646",2022-09-22 11:45:00,927,927,0,57,FALSE,NA,"0.1.4"
"2065","646",2022-09-22 12:00:00,927,927,0,57,FALSE,NA,"0.1.4"
"2066","646",2022-09-22 12:15:00,927,927,0,57,FALSE,NA,"0.1.4"
"2067","646",2022-09-22 12:30:00,927,927,0,57,FALSE,NA,"0.1.4"
"2068","646",2022-09-22 12:45:00,927,927,0,57,FALSE,NA,"0.1.4"
"2069","646",2022-09-22 13:00:00,927,927,0,57,FALSE,NA,"0.1.4"
"2070","646",2022-09-22 13:15:00,927,927,0,57,FALSE,NA,"0.1.4"
"2071","646",2022-09-22 13:30:00,927,927,0,57,FALSE,NA,"0.1.4"
"2072","646",2022-09-22 13:45:00,927,927,0,57,FALSE,NA,"0.1.4"
"2073","646",2022-09-22 14:00:00,927,927,0,57,FALSE,NA,"0.1.4"
"2074","646",2022-09-22 14:15:00,928,928,0,58,FALSE,NA,"0.1.4"
"2075","646",2022-09-22 14:30:00,928,928,0,58,FALSE,NA,"0.1.4"
"2076","646",2022-09-22 14:45:00,927,928,1,58,FALSE,NA,"0.1.4"
"2077","646",2022-09-22 15:00:00,927,928,1,58,FALSE,NA,"0.1.4"
"2078","646",2022-09-22 15:15:00,928,928,0,58,FALSE,NA,"0.1.4"
"2079","646",2022-09-22 15:30:00,928,928,0,58,FALSE,NA,"0.1.4"
"2080","646",2022-09-22 15:45:00,928,928,0,58,FALSE,NA,"0.1.4"
"2081","646",2022-09-22 16:00:00,928,928,0,58,FALSE,NA,"0.1.4"
"2082","646",2022-09-22 16:15:00,928,928,0,58,FALSE,NA,"0.1.4"
"2083","646",2022-09-22 16:30:00,928,928,0,58,FALSE,NA,"0.1.4"
"2084","646",2022-09-22 16:45:00,928,928,0,58,FALSE,NA,"0.1.4"
"2085","646",2022-09-22 17:00:00,929,929,0,59,FALSE,NA,"0.1.4"
"2086","646",2022-09-22 17:15:00,929,929,0,59,FALSE,NA,"0.1.4"
"2087","646",2022-09-22 17:30:00,929,929,0,59,FALSE,NA,"0.1.4"
"2088","646",2022-09-22 17:45:00,930,930,0,60,FALSE,NA,"0.1.4"
"2089","646",2022-09-22 18:00:00,930,930,0,60,FALSE,NA,"0.1.4"
"2090","646",2022-09-22 18:15:00,929,930,1,60,FALSE,NA,"0.1.4"
"2091","646",2022-09-22 18:30:00,929,930,1,60,FALSE,NA,"0.1.4"
"2092","646",2022-09-22 18:45:00,930,930,0,60,FALSE,NA,"0.1.4"
"2093","646",2022-09-22 19:00:00,930,930,0,60,FALSE,NA,"0.1.4"
"2094","646",2022-09-22 19:15:00,929,930,1,60,FALSE,NA,"0.1.4"
"2095","646",2022-09-22 19:30:00,929,930,1,60,FALSE,NA,"0.1.4"
"2096","646",2022-09-22 19:45:00,929,930,1,60,FALSE,NA,"0.1.4"
"2097","646",2022-09-22 20:00:00,929,930,1,60,FALSE,NA,"0.1.4"
"2098","646",2022-09-22 20:15:00,929,930,1,60,FALSE,NA,"0.1.4"
"2099","646",2022-09-22 20:30:00,929,930,1,60,FALSE,NA,"0.1.4"
"2100","646",2022-09-22 20:45:00,929,930,1,60,FALSE,NA,"0.1.4"
"2101","646",2022-09-22 21:00:00,929,930,1,60,FALSE,NA,"0.1.4"
"2102","646",2022-09-22 21:15:00,929,930,1,60,FALSE,NA,"0.1.4"
"2103","646",2022-09-22 21:30:00,929,930,1,60,FALSE,NA,"0.1.4"
"2104","646",2022-09-22 21:45:00,929,930,1,60,FALSE,NA,"0.1.4"
"2105","646",2022-09-22 22:00:00,929,930,1,60,FALSE,NA,"0.1.4"
"2106","646",2022-09-22 22:15:00,929,930,1,60,FALSE,NA,"0.1.4"
"2107","646",2022-09-22 22:30:00,929,930,1,60,FALSE,NA,"0.1.4"
"2108","646",2022-09-22 22:45:00,929,930,1,60,FALSE,NA,"0.1.4"
"2109","646",2022-09-22 23:00:00,929,930,1,60,FALSE,NA,"0.1.4"
"2110","646",2022-09-22 23:15:00,929,930,1,60,FALSE,NA,"0.1.4"
"2111","646",2022-09-22 23:30:00,929,930,1,60,FALSE,NA,"0.1.4"
"2112","646",2022-09-22 23:45:00,929,930,1,60,FALSE,NA,"0.1.4"
"2113","646",2022-09-23,929,930,1,60,FALSE,NA,"0.1.4"
"2114","646",2022-09-23 00:15:00,929,930,1,60,FALSE,NA,"0.1.4"
"2115","646",2022-09-23 00:30:00,929,930,1,60,FALSE,NA,"0.1.4"
"2116","646",2022-09-23 00:45:00,929,930,1,60,FALSE,NA,"0.1.4"
"2117","646",2022-09-23 01:00:00,929,930,1,60,FALSE,NA,"0.1.4"
"2118","646",2022-09-23 01:15:00,929,930,1,60,FALSE,NA,"0.1.4"
"2119","646",2022-09-23 01:30:00,929,930,1,60,FALSE,NA,"0.1.4"
"2120","646",2022-09-23 01:45:00,929,930,1,60,FALSE,NA,"0.1.4"
"2121","646",2022-09-23 02:00:00,929,930,1,60,FALSE,NA,"0.1.4"
"2122","646",2022-09-23 02:15:00,929,930,1,60,FALSE,NA,"0.1.4"
"2123","646",2022-09-23 02:30:00,929,930,1,60,FALSE,NA,"0.1.4"
"2124","646",2022-09-23 02:45:00,929,930,1,60,FALSE,NA,"0.1.4"
"2125","646",2022-09-23 03:00:00,929,930,1,60,FALSE,NA,"0.1.4"
"2126","646",2022-09-23 03:15:00,929,930,1,60,FALSE,NA,"0.1.4"
"2127","646",2022-09-23 03:30:00,929,930,1,60,FALSE,NA,"0.1.4"
"2128","646",2022-09-23 03:45:00,929,930,1,60,FALSE,NA,"0.1.4"
"2129","646",2022-09-23 04:00:00,929,930,1,60,FALSE,NA,"0.1.4"
"2130","646",2022-09-23 04:15:00,929,930,1,60,FALSE,NA,"0.1.4"
"2131","646",2022-09-23 04:30:00,929,930,1,60,FALSE,NA,"0.1.4"
"2132","646",2022-09-23 04:45:00,929,930,1,60,FALSE,NA,"0.1.4"
"2133","646",2022-09-23 05:00:00,929,930,1,60,FALSE,NA,"0.1.4"
"2134","646",2022-09-23 05:15:00,930,930,0,60,FALSE,NA,"0.1.4"
"2135","646",2022-09-23 05:30:00,929,930,1,60,FALSE,NA,"0.1.4"
"2136","646",2022-09-23 05:45:00,930,930,0,60,FALSE,NA,"0.1.4"
"2137","646",2022-09-23 06:00:00,930,930,0,60,FALSE,NA,"0.1.4"
"2138","646",2022-09-23 06:15:00,929,930,1,60,FALSE,NA,"0.1.4"
"2139","646",2022-09-23 06:30:00,930,930,0,60,FALSE,NA,"0.1.4"
"2140","646",2022-09-23 06:45:00,930,930,0,60,FALSE,NA,"0.1.4"
"2141","646",2022-09-23 07:00:00,930,930,0,60,FALSE,NA,"0.1.4"
"2142","646",2022-09-23 07:15:00,930,930,0,60,FALSE,NA,"0.1.4"
"2143","646",2022-09-23 07:30:00,930,930,0,60,FALSE,NA,"0.1.4"
"2144","646",2022-09-23 07:45:00,930,930,0,60,FALSE,NA,"0.1.4"
"2145","646",2022-09-23 08:00:00,930,930,0,60,FALSE,NA,"0.1.4"
"2146","646",2022-09-23 08:15:00,930,930,0,60,FALSE,NA,"0.1.4"
"2147","646",2022-09-23 08:30:00,930,930,0,60,FALSE,NA,"0.1.4"
"2148","646",2022-09-23 08:45:00,930,930,0,60,FALSE,NA,"0.1.4"
"2149","646",2022-09-23 09:00:00,930,930,0,60,FALSE,NA,"0.1.4"
"2150","646",2022-09-23 09:15:00,930,930,0,60,FALSE,NA,"0.1.4"
"2151","646",2022-09-23 09:30:00,930,930,0,60,FALSE,NA,"0.1.4"
"2152","646",2022-09-23 09:45:00,930,930,0,60,FALSE,NA,"0.1.4"
"2153","646",2022-09-23 10:00:00,930,930,0,60,FALSE,NA,"0.1.4"
"2154","646",2022-09-23 10:15:00,930,930,0,60,FALSE,NA,"0.1.4"
"2155","646",2022-09-23 10:30:00,930,930,0,60,FALSE,NA,"0.1.4"
"2156","646",2022-09-23 10:45:00,930,930,0,60,FALSE,NA,"0.1.4"
"2157","646",2022-09-23 11:00:00,931,931,0,61,FALSE,NA,"0.1.4"
"2158","646",2022-09-23 11:15:00,930,931,1,61,FALSE,NA,"0.1.4"
"2159","646",2022-09-23 11:30:00,930,931,1,61,FALSE,NA,"0.1.4"
"2160","646",2022-09-23 11:45:00,931,931,0,61,FALSE,NA,"0.1.4"
"2161","646",2022-09-23 12:00:00,930,931,1,61,FALSE,NA,"0.1.4"
"2162","646",2022-09-23 12:15:00,930,931,1,61,FALSE,NA,"0.1.4"
"2163","646",2022-09-23 12:30:00,930,931,1,61,FALSE,NA,"0.1.4"
"2164","646",2022-09-23 12:45:00,931,931,0,61,FALSE,NA,"0.1.4"
"2165","646",2022-09-23 13:00:00,930,931,1,61,FALSE,NA,"0.1.4"
"2166","646",2022-09-23 13:15:00,930,931,1,61,FALSE,NA,"0.1.4"
"2167","646",2022-09-23 13:30:00,931,931,0,61,FALSE,NA,"0.1.4"
"2168","646",2022-09-23 13:45:00,931,931,0,61,FALSE,NA,"0.1.4"
"2169","646",2022-09-23 14:00:00,931,931,0,61,FALSE,NA,"0.1.4"
"2170","646",2022-09-23 14:15:00,931,931,0,61,FALSE,NA,"0.1.4"
"2171","646",2022-09-23 14:30:00,931,931,0,61,FALSE,NA,"0.1.4"
"2172","646",2022-09-23 14:45:00,931,931,0,61,FALSE,NA,"0.1.4"
"2173","646",2022-09-23 15:00:00,931,931,0,61,FALSE,NA,"0.1.4"
"2174","646",2022-09-23 15:15:00,930,931,1,61,FALSE,NA,"0.1.4"
"2175","646",2022-09-23 15:30:00,930,931,1,61,FALSE,NA,"0.1.4"
"2176","646",2022-09-23 15:45:00,931,931,0,61,FALSE,NA,"0.1.4"
"2177","646",2022-09-23 16:00:00,930,931,1,61,FALSE,NA,"0.1.4"
"2178","646",2022-09-23 16:15:00,930,931,1,61,FALSE,NA,"0.1.4"
"2179","646",2022-09-23 16:30:00,930,931,1,61,FALSE,NA,"0.1.4"
"2180","646",2022-09-23 16:45:00,930,931,1,61,FALSE,NA,"0.1.4"
"2181","646",2022-09-23 17:00:00,931,931,0,61,FALSE,NA,"0.1.4"
"2182","646",2022-09-23 17:15:00,930,931,1,61,FALSE,NA,"0.1.4"
"2183","646",2022-09-23 17:30:00,931,931,0,61,FALSE,NA,"0.1.4"
"2184","646",2022-09-23 17:45:00,931,931,0,61,FALSE,NA,"0.1.4"
"2185","646",2022-09-23 18:00:00,931,931,0,61,FALSE,NA,"0.1.4"
"2186","646",2022-09-23 18:15:00,931,931,0,61,FALSE,NA,"0.1.4"
"2187","646",2022-09-23 18:30:00,931,931,0,61,FALSE,NA,"0.1.4"
"2188","646",2022-09-23 18:45:00,931,931,0,61,FALSE,NA,"0.1.4"
"2189","646",2022-09-23 19:00:00,931,931,0,61,FALSE,NA,"0.1.4"
"2190","646",2022-09-23 19:15:00,931,931,0,61,FALSE,NA,"0.1.4"
"2191","646",2022-09-23 19:30:00,931,931,0,61,FALSE,NA,"0.1.4"
"2192","646",2022-09-23 19:45:00,931,931,0,61,FALSE,NA,"0.1.4"
"2193","646",2022-09-23 20:00:00,931,931,0,61,FALSE,NA,"0.1.4"
"2194","646",2022-09-23 20:15:00,931,931,0,61,FALSE,NA,"0.1.4"
"2195","646",2022-09-23 20:30:00,931,931,0,61,FALSE,NA,"0.1.4"
"2196","646",2022-09-23 20:45:00,930,931,1,61,FALSE,NA,"0.1.4"
"2197","646",2022-09-23 21:00:00,930,931,1,61,FALSE,NA,"0.1.4"
"2198","646",2022-09-23 21:15:00,930,931,1,61,FALSE,NA,"0.1.4"
"2199","646",2022-09-23 21:30:00,930,931,1,61,FALSE,NA,"0.1.4"
"2200","646",2022-09-23 21:45:00,930,931,1,61,FALSE,NA,"0.1.4"
"2201","646",2022-09-23 22:00:00,931,931,0,61,FALSE,NA,"0.1.4"
"2202","646",2022-09-23 22:15:00,929,931,2,61,FALSE,NA,"0.1.4"
"2203","646",2022-09-23 22:30:00,929,931,2,61,FALSE,NA,"0.1.4"
"2204","646",2022-09-23 22:45:00,929,931,2,61,FALSE,NA,"0.1.4"
"2205","646",2022-09-23 23:00:00,929,931,2,61,FALSE,NA,"0.1.4"
"2206","646",2022-09-23 23:15:00,929,931,2,61,FALSE,NA,"0.1.4"
"2207","646",2022-09-23 23:30:00,929,931,2,61,FALSE,NA,"0.1.4"
"2208","646",2022-09-23 23:45:00,929,931,2,61,FALSE,NA,"0.1.4"
"2209","646",2022-09-24,929,931,2,61,FALSE,NA,"0.1.4"
"2210","646",2022-09-24 00:15:00,929,931,2,61,FALSE,NA,"0.1.4"
"2211","646",2022-09-24 00:30:00,929,931,2,61,FALSE,NA,"0.1.4"
"2212","646",2022-09-24 00:45:00,929,931,2,61,FALSE,NA,"0.1.4"
"2213","646",2022-09-24 01:00:00,929,931,2,61,FALSE,NA,"0.1.4"
"2214","646",2022-09-24 01:15:00,929,931,2,61,FALSE,NA,"0.1.4"
"2215","646",2022-09-24 01:30:00,929,931,2,61,FALSE,NA,"0.1.4"
"2216","646",2022-09-24 01:45:00,929,931,2,61,FALSE,NA,"0.1.4"
"2217","646",2022-09-24 02:00:00,929,931,2,61,FALSE,NA,"0.1.4"
"2218","646",2022-09-24 02:15:00,929,931,2,61,FALSE,NA,"0.1.4"
"2219","646",2022-09-24 02:30:00,929,931,2,61,FALSE,NA,"0.1.4"
"2220","646",2022-09-24 02:45:00,929,931,2,61,FALSE,NA,"0.1.4"
"2221","646",2022-09-24 03:00:00,929,931,2,61,FALSE,NA,"0.1.4"
"2222","646",2022-09-24 03:15:00,929,931,2,61,FALSE,NA,"0.1.4"
"2223","646",2022-09-24 03:30:00,929,931,2,61,FALSE,NA,"0.1.4"
"2224","646",2022-09-24 03:45:00,929,931,2,61,FALSE,NA,"0.1.4"
"2225","646",2022-09-24 04:00:00,929,931,2,61,FALSE,NA,"0.1.4"
"2226","646",2022-09-24 04:15:00,929,931,2,61,FALSE,NA,"0.1.4"
"2227","646",2022-09-24 04:30:00,929,931,2,61,FALSE,NA,"0.1.4"
"2228","646",2022-09-24 04:45:00,929,931,2,61,FALSE,NA,"0.1.4"
"2229","646",2022-09-24 05:00:00,929,931,2,61,FALSE,NA,"0.1.4"
"2230","646",2022-09-24 05:15:00,929,931,2,61,FALSE,NA,"0.1.4"
"2231","646",2022-09-24 05:30:00,929,931,2,61,FALSE,NA,"0.1.4"
"2232","646",2022-09-24 05:45:00,929,931,2,61,FALSE,NA,"0.1.4"
"2233","646",2022-09-24 06:00:00,929,931,2,61,FALSE,NA,"0.1.4"
"2234","646",2022-09-24 06:15:00,929,931,2,61,FALSE,NA,"0.1.4"
"2235","646",2022-09-24 06:30:00,929,931,2,61,FALSE,NA,"0.1.4"
"2236","646",2022-09-24 06:45:00,929,931,2,61,FALSE,NA,"0.1.4"
"2237","646",2022-09-24 07:00:00,929,931,2,61,FALSE,NA,"0.1.4"
"2238","646",2022-09-24 07:15:00,929,931,2,61,FALSE,NA,"0.1.4"
"2239","646",2022-09-24 07:30:00,929,931,2,61,FALSE,NA,"0.1.4"
"2240","646",2022-09-24 07:45:00,929,931,2,61,FALSE,NA,"0.1.4"
"2241","646",2022-09-24 08:00:00,929,931,2,61,FALSE,NA,"0.1.4"
"2242","646",2022-09-24 08:15:00,929,931,2,61,FALSE,NA,"0.1.4"
"2243","646",2022-09-24 08:30:00,929,931,2,61,FALSE,NA,"0.1.4"
"2244","646",2022-09-24 08:45:00,929,931,2,61,FALSE,NA,"0.1.4"
"2245","646",2022-09-24 09:00:00,929,931,2,61,FALSE,NA,"0.1.4"
"2246","646",2022-09-24 09:15:00,929,931,2,61,FALSE,NA,"0.1.4"
"2247","646",2022-09-24 09:30:00,929,931,2,61,FALSE,NA,"0.1.4"
"2248","646",2022-09-24 09:45:00,929,931,2,61,FALSE,NA,"0.1.4"
"2249","646",2022-09-24 10:00:00,929,931,2,61,FALSE,NA,"0.1.4"
"2250","646",2022-09-24 10:15:00,929,931,2,61,FALSE,NA,"0.1.4"
"2251","646",2022-09-24 10:30:00,929,931,2,61,FALSE,NA,"0.1.4"
"2252","646",2022-09-24 10:45:00,929,931,2,61,FALSE,NA,"0.1.4"
"2253","646",2022-09-24 11:00:00,929,931,2,61,FALSE,NA,"0.1.4"
"2254","646",2022-09-24 11:15:00,930,931,1,61,FALSE,NA,"0.1.4"
"2255","646",2022-09-24 11:30:00,930,931,1,61,FALSE,NA,"0.1.4"
"2256","646",2022-09-24 11:45:00,930,931,1,61,FALSE,NA,"0.1.4"
"2257","646",2022-09-24 12:00:00,930,931,1,61,FALSE,NA,"0.1.4"
"2258","646",2022-09-24 12:15:00,930,931,1,61,FALSE,NA,"0.1.4"
"2259","646",2022-09-24 12:30:00,930,931,1,61,FALSE,NA,"0.1.4"
"2260","646",2022-09-24 12:45:00,930,931,1,61,FALSE,NA,"0.1.4"
"2261","646",2022-09-24 13:00:00,930,931,1,61,FALSE,NA,"0.1.4"
"2262","646",2022-09-24 13:15:00,930,931,1,61,FALSE,NA,"0.1.4"
"2263","646",2022-09-24 13:30:00,930,931,1,61,FALSE,NA,"0.1.4"
"2264","646",2022-09-24 13:45:00,930,931,1,61,FALSE,NA,"0.1.4"
"2265","646",2022-09-24 14:00:00,930,931,1,61,FALSE,NA,"0.1.4"
"2266","646",2022-09-24 14:15:00,930,931,1,61,FALSE,NA,"0.1.4"
"2267","646",2022-09-24 14:30:00,930,931,1,61,FALSE,NA,"0.1.4"
"2268","646",2022-09-24 14:45:00,930,931,1,61,FALSE,NA,"0.1.4"
"2269","646",2022-09-24 15:00:00,930,931,1,61,FALSE,NA,"0.1.4"
"2270","646",2022-09-24 15:15:00,930,931,1,61,FALSE,NA,"0.1.4"
"2271","646",2022-09-24 15:30:00,930,931,1,61,FALSE,NA,"0.1.4"
"2272","646",2022-09-24 15:45:00,930,931,1,61,FALSE,NA,"0.1.4"
"2273","646",2022-09-24 16:00:00,930,931,1,61,FALSE,NA,"0.1.4"
"2274","646",2022-09-24 16:15:00,930,931,1,61,FALSE,NA,"0.1.4"
"2275","646",2022-09-24 16:30:00,930,931,1,61,FALSE,NA,"0.1.4"
"2276","646",2022-09-24 16:45:00,930,931,1,61,FALSE,NA,"0.1.4"
"2277","646",2022-09-24 17:00:00,930,931,1,61,FALSE,NA,"0.1.4"
"2278","646",2022-09-24 17:15:00,930,931,1,61,FALSE,NA,"0.1.4"
"2279","646",2022-09-24 17:30:00,930,931,1,61,FALSE,NA,"0.1.4"
"2280","646",2022-09-24 17:45:00,930,931,1,61,FALSE,NA,"0.1.4"
"2281","646",2022-09-24 18:00:00,930,931,1,61,FALSE,NA,"0.1.4"
"2282","646",2022-09-24 18:15:00,930,931,1,61,FALSE,NA,"0.1.4"
"2283","646",2022-09-24 18:30:00,930,931,1,61,FALSE,NA,"0.1.4"
"2284","646",2022-09-24 18:45:00,930,931,1,61,FALSE,NA,"0.1.4"
"2285","646",2022-09-24 19:00:00,930,931,1,61,FALSE,NA,"0.1.4"
"2286","646",2022-09-24 19:15:00,930,931,1,61,FALSE,NA,"0.1.4"
"2287","646",2022-09-24 19:30:00,930,931,1,61,FALSE,NA,"0.1.4"
"2288","646",2022-09-24 19:45:00,929,931,2,61,FALSE,NA,"0.1.4"
"2289","646",2022-09-24 20:00:00,929,931,2,61,FALSE,NA,"0.1.4"
"2290","646",2022-09-24 20:15:00,929,931,2,61,FALSE,NA,"0.1.4"
"2291","646",2022-09-24 20:30:00,929,931,2,61,FALSE,NA,"0.1.4"
"2292","646",2022-09-24 20:45:00,929,931,2,61,FALSE,NA,"0.1.4"
"2293","646",2022-09-24 21:00:00,930,931,1,61,FALSE,NA,"0.1.4"
"2294","646",2022-09-24 21:15:00,929,931,2,61,FALSE,NA,"0.1.4"
"2295","646",2022-09-24 21:30:00,929,931,2,61,FALSE,NA,"0.1.4"
"2296","646",2022-09-24 21:45:00,929,931,2,61,FALSE,NA,"0.1.4"
"2297","646",2022-09-24 22:00:00,928,931,3,61,FALSE,NA,"0.1.4"
"2298","646",2022-09-24 22:15:00,928,931,3,61,FALSE,NA,"0.1.4"
"2299","646",2022-09-24 22:30:00,928,931,3,61,FALSE,NA,"0.1.4"
"2300","646",2022-09-24 22:45:00,928,931,3,61,FALSE,NA,"0.1.4"
"2301","646",2022-09-24 23:00:00,927,931,4,61,FALSE,NA,"0.1.4"
"2302","646",2022-09-24 23:15:00,926,931,5,61,FALSE,NA,"0.1.4"
"2303","646",2022-09-24 23:30:00,926,931,5,61,FALSE,NA,"0.1.4"
"2304","646",2022-09-24 23:45:00,926,931,5,61,FALSE,NA,"0.1.4"
"2305","646",2022-09-25,926,931,5,61,FALSE,NA,"0.1.4"
"2306","646",2022-09-25 00:15:00,926,931,5,61,FALSE,NA,"0.1.4"
"2307","646",2022-09-25 00:30:00,926,931,5,61,FALSE,NA,"0.1.4"
"2308","646",2022-09-25 00:45:00,926,931,5,61,FALSE,NA,"0.1.4"
"2309","646",2022-09-25 01:00:00,926,931,5,61,FALSE,NA,"0.1.4"
"2310","646",2022-09-25 01:15:00,926,931,5,61,FALSE,NA,"0.1.4"
"2311","646",2022-09-25 01:30:00,926,931,5,61,FALSE,NA,"0.1.4"
"2312","646",2022-09-25 01:45:00,926,931,5,61,FALSE,NA,"0.1.4"
"2313","646",2022-09-25 02:00:00,926,931,5,61,FALSE,NA,"0.1.4"
"2314","646",2022-09-25 02:15:00,926,931,5,61,FALSE,NA,"0.1.4"
"2315","646",2022-09-25 02:30:00,926,931,5,61,FALSE,NA,"0.1.4"
"2316","646",2022-09-25 02:45:00,926,931,5,61,FALSE,NA,"0.1.4"
"2317","646",2022-09-25 03:00:00,926,931,5,61,FALSE,NA,"0.1.4"
"2318","646",2022-09-25 03:15:00,926,931,5,61,FALSE,NA,"0.1.4"
"2319","646",2022-09-25 03:30:00,926,931,5,61,FALSE,NA,"0.1.4"
"2320","646",2022-09-25 03:45:00,926,931,5,61,FALSE,NA,"0.1.4"
"2321","646",2022-09-25 04:00:00,926,931,5,61,FALSE,NA,"0.1.4"
"2322","646",2022-09-25 04:15:00,926,931,5,61,FALSE,NA,"0.1.4"
"2323","646",2022-09-25 04:30:00,926,931,5,61,FALSE,NA,"0.1.4"
"2324","646",2022-09-25 04:45:00,926,931,5,61,FALSE,NA,"0.1.4"
"2325","646",2022-09-25 05:00:00,926,931,5,61,FALSE,NA,"0.1.4"
"2326","646",2022-09-25 05:15:00,926,931,5,61,FALSE,NA,"0.1.4"
"2327","646",2022-09-25 05:30:00,926,931,5,61,FALSE,NA,"0.1.4"
"2328","646",2022-09-25 05:45:00,926,931,5,61,FALSE,NA,"0.1.4"
"2329","646",2022-09-25 06:00:00,926,931,5,61,FALSE,NA,"0.1.4"
"2330","646",2022-09-25 06:15:00,926,931,5,61,FALSE,NA,"0.1.4"
"2331","646",2022-09-25 06:30:00,926,931,5,61,FALSE,NA,"0.1.4"
"2332","646",2022-09-25 06:45:00,926,931,5,61,FALSE,NA,"0.1.4"
"2333","646",2022-09-25 07:00:00,926,931,5,61,FALSE,NA,"0.1.4"
"2334","646",2022-09-25 07:15:00,926,931,5,61,FALSE,NA,"0.1.4"
"2335","646",2022-09-25 07:30:00,926,931,5,61,FALSE,NA,"0.1.4"
"2336","646",2022-09-25 07:45:00,926,931,5,61,FALSE,NA,"0.1.4"
"2337","646",2022-09-25 08:00:00,926,931,5,61,FALSE,NA,"0.1.4"
"2338","646",2022-09-25 08:15:00,926,931,5,61,FALSE,NA,"0.1.4"
"2339","646",2022-09-25 08:30:00,926,931,5,61,FALSE,NA,"0.1.4"
"2340","646",2022-09-25 08:45:00,926,931,5,61,FALSE,NA,"0.1.4"
"2341","646",2022-09-25 09:00:00,926,931,5,61,FALSE,NA,"0.1.4"
"2342","646",2022-09-25 09:15:00,926,931,5,61,FALSE,NA,"0.1.4"
"2343","646",2022-09-25 09:30:00,926,931,5,61,FALSE,NA,"0.1.4"
"2344","646",2022-09-25 09:45:00,926,931,5,61,FALSE,NA,"0.1.4"
"2345","646",2022-09-25 10:00:00,927,931,4,61,FALSE,NA,"0.1.4"
"2346","646",2022-09-25 10:15:00,927,931,4,61,FALSE,NA,"0.1.4"
"2347","646",2022-09-25 10:30:00,927,931,4,61,FALSE,NA,"0.1.4"
"2348","646",2022-09-25 10:45:00,927,931,4,61,FALSE,NA,"0.1.4"
"2349","646",2022-09-25 11:00:00,927,931,4,61,FALSE,NA,"0.1.4"
"2350","646",2022-09-25 11:15:00,927,931,4,61,FALSE,NA,"0.1.4"
"2351","646",2022-09-25 11:30:00,927,931,4,61,FALSE,NA,"0.1.4"
"2352","646",2022-09-25 11:45:00,927,931,4,61,FALSE,NA,"0.1.4"
"2353","646",2022-09-25 12:00:00,928,931,3,61,FALSE,NA,"0.1.4"
"2354","646",2022-09-25 12:15:00,927,931,4,61,FALSE,NA,"0.1.4"
"2355","646",2022-09-25 12:30:00,928,931,3,61,FALSE,NA,"0.1.4"
"2356","646",2022-09-25 12:45:00,928,931,3,61,FALSE,NA,"0.1.4"
"2357","646",2022-09-25 13:00:00,928,931,3,61,FALSE,NA,"0.1.4"
"2358","646",2022-09-25 13:15:00,928,931,3,61,FALSE,NA,"0.1.4"
"2359","646",2022-09-25 13:30:00,928,931,3,61,FALSE,NA,"0.1.4"
"2360","646",2022-09-25 13:45:00,927,931,4,61,FALSE,NA,"0.1.4"
"2361","646",2022-09-25 14:00:00,927,931,4,61,FALSE,NA,"0.1.4"
"2362","646",2022-09-25 14:15:00,927,931,4,61,FALSE,NA,"0.1.4"
"2363","646",2022-09-25 14:30:00,927,931,4,61,FALSE,NA,"0.1.4"
"2364","646",2022-09-25 14:45:00,927,931,4,61,FALSE,NA,"0.1.4"
"2365","646",2022-09-25 15:00:00,927,931,4,61,FALSE,NA,"0.1.4"
"2366","646",2022-09-25 15:15:00,927,931,4,61,FALSE,NA,"0.1.4"
"2367","646",2022-09-25 15:30:00,927,931,4,61,FALSE,NA,"0.1.4"
"2368","646",2022-09-25 15:45:00,927,931,4,61,FALSE,NA,"0.1.4"
"2369","646",2022-09-25 16:00:00,927,931,4,61,FALSE,NA,"0.1.4"
"2370","646",2022-09-25 16:15:00,927,931,4,61,FALSE,NA,"0.1.4"
"2371","646",2022-09-25 16:30:00,927,931,4,61,FALSE,NA,"0.1.4"
"2372","646",2022-09-25 16:45:00,927,931,4,61,FALSE,NA,"0.1.4"
"2373","646",2022-09-25 17:00:00,927,931,4,61,FALSE,NA,"0.1.4"
"2374","646",2022-09-25 17:15:00,927,931,4,61,FALSE,NA,"0.1.4"
"2375","646",2022-09-25 17:30:00,927,931,4,61,FALSE,NA,"0.1.4"
"2376","646",2022-09-25 17:45:00,927,931,4,61,FALSE,NA,"0.1.4"
"2377","646",2022-09-25 18:00:00,927,931,4,61,FALSE,NA,"0.1.4"
"2378","646",2022-09-25 18:15:00,927,931,4,61,FALSE,NA,"0.1.4"
"2379","646",2022-09-25 18:30:00,927,931,4,61,FALSE,NA,"0.1.4"
"2380","646",2022-09-25 18:45:00,927,931,4,61,FALSE,NA,"0.1.4"
"2381","646",2022-09-25 19:00:00,927,931,4,61,FALSE,NA,"0.1.4"
"2382","646",2022-09-25 19:15:00,927,931,4,61,FALSE,NA,"0.1.4"
"2383","646",2022-09-25 19:30:00,927,931,4,61,FALSE,NA,"0.1.4"
"2384","646",2022-09-25 19:45:00,927,931,4,61,FALSE,NA,"0.1.4"
"2385","646",2022-09-25 20:00:00,927,931,4,61,FALSE,NA,"0.1.4"
"2386","646",2022-09-25 20:15:00,927,931,4,61,FALSE,NA,"0.1.4"
"2387","646",2022-09-25 20:30:00,926,931,5,61,FALSE,NA,"0.1.4"
"2388","646",2022-09-25 20:45:00,927,931,4,61,FALSE,NA,"0.1.4"
"2389","646",2022-09-25 21:00:00,926,931,5,61,FALSE,NA,"0.1.4"
"2390","646",2022-09-25 21:15:00,925,931,6,61,FALSE,NA,"0.1.4"
"2391","646",2022-09-25 21:30:00,923,931,8,61,FALSE,NA,"0.1.4"
"2392","646",2022-09-25 21:45:00,922,931,9,61,FALSE,NA,"0.1.4"
"2393","646",2022-09-25 22:00:00,921,931,10,61,FALSE,NA,"0.1.4"
"2394","646",2022-09-25 22:15:00,920,931,11,61,FALSE,NA,"0.1.4"
"2395","646",2022-09-25 22:30:00,920,931,11,61,FALSE,NA,"0.1.4"
"2396","646",2022-09-25 22:45:00,919,931,12,61,FALSE,NA,"0.1.4"
"2397","646",2022-09-25 23:00:00,919,931,12,61,FALSE,NA,"0.1.4"
"2398","646",2022-09-25 23:15:00,919,931,12,61,FALSE,NA,"0.1.4"
"2399","646",2022-09-25 23:30:00,919,931,12,61,FALSE,NA,"0.1.4"
"2400","646",2022-09-25 23:45:00,918,931,13,61,FALSE,NA,"0.1.4"
"2401","646",2022-09-26,918,931,13,61,FALSE,NA,"0.1.4"
"2402","646",2022-09-26 00:15:00,918,931,13,61,FALSE,NA,"0.1.4"
"2403","646",2022-09-26 00:30:00,918,931,13,61,FALSE,NA,"0.1.4"
"2404","646",2022-09-26 00:45:00,918,931,13,61,FALSE,NA,"0.1.4"
"2405","646",2022-09-26 01:00:00,918,931,13,61,FALSE,NA,"0.1.4"
"2406","646",2022-09-26 01:15:00,918,931,13,61,FALSE,NA,"0.1.4"
"2407","646",2022-09-26 01:30:00,918,931,13,61,FALSE,NA,"0.1.4"
"2408","646",2022-09-26 01:45:00,918,931,13,61,FALSE,NA,"0.1.4"
"2409","646",2022-09-26 02:00:00,918,931,13,61,FALSE,NA,"0.1.4"
"2410","646",2022-09-26 02:15:00,918,931,13,61,FALSE,NA,"0.1.4"
"2411","646",2022-09-26 02:30:00,918,931,13,61,FALSE,NA,"0.1.4"
"2412","646",2022-09-26 02:45:00,918,931,13,61,FALSE,NA,"0.1.4"
"2413","646",2022-09-26 03:00:00,918,931,13,61,FALSE,NA,"0.1.4"
"2414","646",2022-09-26 03:15:00,918,931,13,61,FALSE,NA,"0.1.4"
"2415","646",2022-09-26 03:30:00,918,931,13,61,FALSE,NA,"0.1.4"
"2416","646",2022-09-26 03:45:00,918,931,13,61,FALSE,NA,"0.1.4"
"2417","646",2022-09-26 04:00:00,918,931,13,61,FALSE,NA,"0.1.4"
"2418","646",2022-09-26 04:15:00,918,931,13,61,FALSE,NA,"0.1.4"
"2419","646",2022-09-26 04:30:00,918,931,13,61,FALSE,NA,"0.1.4"
"2420","646",2022-09-26 04:45:00,918,931,13,61,FALSE,NA,"0.1.4"
"2421","646",2022-09-26 05:00:00,918,931,13,61,FALSE,NA,"0.1.4"
"2422","646",2022-09-26 05:15:00,918,931,13,61,FALSE,NA,"0.1.4"
"2423","646",2022-09-26 05:30:00,918,931,13,61,FALSE,NA,"0.1.4"
"2424","646",2022-09-26 05:45:00,918,931,13,61,FALSE,NA,"0.1.4"
"2425","646",2022-09-26 06:00:00,918,931,13,61,FALSE,NA,"0.1.4"
"2426","646",2022-09-26 06:15:00,918,931,13,61,FALSE,NA,"0.1.4"
"2427","646",2022-09-26 06:30:00,918,931,13,61,FALSE,NA,"0.1.4"
"2428","646",2022-09-26 06:45:00,918,931,13,61,FALSE,NA,"0.1.4"
"2429","646",2022-09-26 07:00:00,918,931,13,61,FALSE,NA,"0.1.4"
"2430","646",2022-09-26 07:15:00,918,931,13,61,FALSE,NA,"0.1.4"
"2431","646",2022-09-26 07:30:00,918,931,13,61,FALSE,NA,"0.1.4"
"2432","646",2022-09-26 07:45:00,918,931,13,61,FALSE,NA,"0.1.4"
"2433","646",2022-09-26 08:00:00,918,931,13,61,FALSE,NA,"0.1.4"
"2434","646",2022-09-26 08:15:00,918,931,13,61,FALSE,NA,"0.1.4"
"2435","646",2022-09-26 08:30:00,918,931,13,61,FALSE,NA,"0.1.4"
"2436","646",2022-09-26 08:45:00,918,931,13,61,FALSE,NA,"0.1.4"
"2437","646",2022-09-26 09:00:00,918,931,13,61,FALSE,NA,"0.1.4"
"2438","646",2022-09-26 09:15:00,918,931,13,61,FALSE,NA,"0.1.4"
"2439","646",2022-09-26 09:30:00,918,931,13,61,FALSE,NA,"0.1.4"
"2440","646",2022-09-26 09:45:00,918,931,13,61,FALSE,NA,"0.1.4"
"2441","646",2022-09-26 10:00:00,918,931,13,61,FALSE,NA,"0.1.4"
"2442","646",2022-09-26 10:15:00,919,931,12,61,FALSE,NA,"0.1.4"
"2443","646",2022-09-26 10:30:00,918,931,13,61,FALSE,NA,"0.1.4"
"2444","646",2022-09-26 10:45:00,918,931,13,61,FALSE,NA,"0.1.4"
"2445","646",2022-09-26 11:00:00,919,931,12,61,FALSE,NA,"0.1.4"
"2446","646",2022-09-26 11:15:00,919,931,12,61,FALSE,NA,"0.1.4"
"2447","646",2022-09-26 11:30:00,919,931,12,61,FALSE,NA,"0.1.4"
"2448","646",2022-09-26 11:45:00,919,931,12,61,FALSE,NA,"0.1.4"
"2449","646",2022-09-26 12:00:00,919,931,12,61,FALSE,NA,"0.1.4"
"2450","646",2022-09-26 12:15:00,919,931,12,61,FALSE,NA,"0.1.4"
"2451","646",2022-09-26 12:30:00,919,931,12,61,FALSE,NA,"0.1.4"
"2452","646",2022-09-26 12:45:00,919,931,12,61,FALSE,NA,"0.1.4"
"2453","646",2022-09-26 13:00:00,919,931,12,61,FALSE,NA,"0.1.4"
"2454","646",2022-09-26 13:15:00,919,931,12,61,FALSE,NA,"0.1.4"
"2455","646",2022-09-26 13:30:00,919,931,12,61,FALSE,NA,"0.1.4"
"2456","646",2022-09-26 13:45:00,919,931,12,61,FALSE,NA,"0.1.4"
"2457","646",2022-09-26 14:00:00,919,931,12,61,FALSE,NA,"0.1.4"
"2458","646",2022-09-26 14:15:00,919,931,12,61,FALSE,NA,"0.1.4"
"2459","646",2022-09-26 14:30:00,919,931,12,61,FALSE,NA,"0.1.4"
"2460","646",2022-09-26 14:45:00,919,931,12,61,FALSE,NA,"0.1.4"
"2461","646",2022-09-26 15:00:00,919,931,12,61,FALSE,NA,"0.1.4"
"2462","646",2022-09-26 15:15:00,919,931,12,61,FALSE,NA,"0.1.4"
"2463","646",2022-09-26 15:30:00,919,931,12,61,FALSE,NA,"0.1.4"
"2464","646",2022-09-26 15:45:00,919,931,12,61,FALSE,NA,"0.1.4"
"2465","646",2022-09-26 16:00:00,919,931,12,61,FALSE,NA,"0.1.4"
"2466","646",2022-09-26 16:15:00,919,931,12,61,FALSE,NA,"0.1.4"
"2467","646",2022-09-26 16:30:00,919,931,12,61,FALSE,NA,"0.1.4"
"2468","646",2022-09-26 16:45:00,919,931,12,61,FALSE,NA,"0.1.4"
"2469","646",2022-09-26 17:00:00,919,931,12,61,FALSE,NA,"0.1.4"
"2470","646",2022-09-26 17:15:00,919,931,12,61,FALSE,NA,"0.1.4"
"2471","646",2022-09-26 17:30:00,919,931,12,61,FALSE,NA,"0.1.4"
"2472","646",2022-09-26 17:45:00,919,931,12,61,FALSE,NA,"0.1.4"
"2473","646",2022-09-26 18:00:00,919,931,12,61,FALSE,NA,"0.1.4"
"2474","646",2022-09-26 18:15:00,919,931,12,61,FALSE,NA,"0.1.4"
"2475","646",2022-09-26 18:30:00,919,931,12,61,FALSE,NA,"0.1.4"
"2476","646",2022-09-26 18:45:00,919,931,12,61,FALSE,NA,"0.1.4"
"2477","646",2022-09-26 19:00:00,919,931,12,61,FALSE,NA,"0.1.4"
"2478","646",2022-09-26 19:15:00,919,931,12,61,FALSE,NA,"0.1.4"
"2479","646",2022-09-26 19:30:00,919,931,12,61,FALSE,NA,"0.1.4"
"2480","646",2022-09-26 19:45:00,919,931,12,61,FALSE,NA,"0.1.4"
"2481","646",2022-09-26 20:00:00,919,931,12,61,FALSE,NA,"0.1.4"
"2482","646",2022-09-26 20:15:00,919,931,12,61,FALSE,NA,"0.1.4"
"2483","646",2022-09-26 20:30:00,919,931,12,61,FALSE,NA,"0.1.4"
"2484","646",2022-09-26 20:45:00,919,931,12,61,FALSE,NA,"0.1.4"
"2485","646",2022-09-26 21:00:00,918,931,13,61,FALSE,NA,"0.1.4"
"2486","646",2022-09-26 21:15:00,917,931,14,61,FALSE,NA,"0.1.4"
"2487","646",2022-09-26 21:30:00,916,931,15,61,FALSE,NA,"0.1.4"
"2488","646",2022-09-26 21:45:00,914,931,17,61,FALSE,NA,"0.1.4"
"2489","646",2022-09-26 22:00:00,913,931,18,61,FALSE,NA,"0.1.4"
"2490","646",2022-09-26 22:15:00,913,931,18,61,FALSE,NA,"0.1.4"
"2491","646",2022-09-26 22:30:00,912,931,19,61,FALSE,NA,"0.1.4"
"2492","646",2022-09-26 22:45:00,912,931,19,61,FALSE,NA,"0.1.4"
"2493","646",2022-09-26 23:00:00,912,931,19,61,FALSE,NA,"0.1.4"
"2494","646",2022-09-26 23:15:00,912,931,19,61,FALSE,NA,"0.1.4"
"2495","646",2022-09-26 23:30:00,911,931,20,61,FALSE,NA,"0.1.4"
"2496","646",2022-09-26 23:45:00,911,931,20,61,FALSE,NA,"0.1.4"
"2497","646",2022-09-27,911,931,20,61,FALSE,NA,"0.1.4"
"2498","646",2022-09-27 00:15:00,912,931,19,61,FALSE,NA,"0.1.4"
"2499","646",2022-09-27 00:30:00,912,931,19,61,FALSE,NA,"0.1.4"
"2500","646",2022-09-27 00:45:00,911,931,20,61,FALSE,NA,"0.1.4"
"2501","646",2022-09-27 01:00:00,911,931,20,61,FALSE,NA,"0.1.4"
"2502","646",2022-09-27 01:15:00,911,931,20,61,FALSE,NA,"0.1.4"
"2503","646",2022-09-27 01:30:00,911,931,20,61,FALSE,NA,"0.1.4"
"2504","646",2022-09-27 01:45:00,911,931,20,61,FALSE,NA,"0.1.4"
"2505","646",2022-09-27 02:00:00,911,931,20,61,FALSE,NA,"0.1.4"
"2506","646",2022-09-27 02:15:00,911,931,20,61,FALSE,NA,"0.1.4"
"2507","646",2022-09-27 02:30:00,911,931,20,61,FALSE,NA,"0.1.4"
"2508","646",2022-09-27 02:45:00,911,931,20,61,FALSE,NA,"0.1.4"
"2509","646",2022-09-27 03:00:00,911,931,20,61,FALSE,NA,"0.1.4"
"2510","646",2022-09-27 03:15:00,911,931,20,61,FALSE,NA,"0.1.4"
"2511","646",2022-09-27 03:30:00,911,931,20,61,FALSE,NA,"0.1.4"
"2512","646",2022-09-27 03:45:00,911,931,20,61,FALSE,NA,"0.1.4"
"2513","646",2022-09-27 04:00:00,911,931,20,61,FALSE,NA,"0.1.4"
"2514","646",2022-09-27 04:15:00,912,931,19,61,FALSE,NA,"0.1.4"
"2515","646",2022-09-27 04:30:00,912,931,19,61,FALSE,NA,"0.1.4"
"2516","646",2022-09-27 04:45:00,912,931,19,61,FALSE,NA,"0.1.4"
"2517","646",2022-09-27 05:00:00,912,931,19,61,FALSE,NA,"0.1.4"
"2518","646",2022-09-27 05:15:00,912,931,19,61,FALSE,NA,"0.1.4"
"2519","646",2022-09-27 05:30:00,912,931,19,61,FALSE,NA,"0.1.4"
"2520","646",2022-09-27 05:45:00,912,931,19,61,FALSE,NA,"0.1.4"
"2521","646",2022-09-27 06:00:00,912,931,19,61,FALSE,NA,"0.1.4"
"2522","646",2022-09-27 06:15:00,912,931,19,61,FALSE,NA,"0.1.4"
"2523","646",2022-09-27 06:30:00,912,931,19,61,FALSE,NA,"0.1.4"
"2524","646",2022-09-27 06:45:00,912,931,19,61,FALSE,NA,"0.1.4"
"2525","646",2022-09-27 07:00:00,912,931,19,61,FALSE,NA,"0.1.4"
"2526","646",2022-09-27 07:15:00,912,931,19,61,FALSE,NA,"0.1.4"
"2527","646",2022-09-27 07:30:00,912,931,19,61,FALSE,NA,"0.1.4"
"2528","646",2022-09-27 07:45:00,912,931,19,61,FALSE,NA,"0.1.4"
"2529","646",2022-09-27 08:00:00,912,931,19,61,FALSE,NA,"0.1.4"
"2530","646",2022-09-27 08:15:00,912,931,19,61,FALSE,NA,"0.1.4"
"2531","646",2022-09-27 08:30:00,912,931,19,61,FALSE,NA,"0.1.4"
"2532","646",2022-09-27 08:45:00,912,931,19,61,FALSE,NA,"0.1.4"
"2533","646",2022-09-27 09:00:00,912,931,19,61,FALSE,NA,"0.1.4"
"2534","646",2022-09-27 09:15:00,912,931,19,61,FALSE,NA,"0.1.4"
"2535","646",2022-09-27 09:30:00,912,931,19,61,FALSE,NA,"0.1.4"
"2536","646",2022-09-27 09:45:00,912,931,19,61,FALSE,NA,"0.1.4"
"2537","646",2022-09-27 10:00:00,912,931,19,61,FALSE,NA,"0.1.4"
"2538","646",2022-09-27 10:15:00,912,931,19,61,FALSE,NA,"0.1.4"
"2539","646",2022-09-27 10:30:00,913,931,18,61,FALSE,NA,"0.1.4"
"2540","646",2022-09-27 10:45:00,912,931,19,61,FALSE,NA,"0.1.4"
"2541","646",2022-09-27 11:00:00,913,931,18,61,FALSE,NA,"0.1.4"
"2542","646",2022-09-27 11:15:00,912,931,19,61,FALSE,NA,"0.1.4"
"2543","646",2022-09-27 11:30:00,912,931,19,61,FALSE,NA,"0.1.4"
"2544","646",2022-09-27 11:45:00,913,931,18,61,FALSE,NA,"0.1.4"
"2545","646",2022-09-27 12:00:00,913,931,18,61,FALSE,NA,"0.1.4"
"2546","646",2022-09-27 12:15:00,912,931,19,61,FALSE,NA,"0.1.4"
"2547","646",2022-09-27 12:30:00,912,931,19,61,FALSE,NA,"0.1.4"
"2548","646",2022-09-27 12:45:00,912,931,19,61,FALSE,NA,"0.1.4"
"2549","646",2022-09-27 13:00:00,912,931,19,61,FALSE,NA,"0.1.4"
"2550","646",2022-09-27 13:15:00,913,931,18,61,FALSE,NA,"0.1.4"
"2551","646",2022-09-27 13:30:00,913,931,18,61,FALSE,NA,"0.1.4"
"2552","646",2022-09-27 13:45:00,913,931,18,61,FALSE,NA,"0.1.4"
"2553","646",2022-09-27 14:00:00,913,931,18,61,FALSE,NA,"0.1.4"
"2554","646",2022-09-27 14:15:00,913,931,18,61,FALSE,NA,"0.1.4"
"2555","646",2022-09-27 14:30:00,913,931,18,61,FALSE,NA,"0.1.4"
"2556","646",2022-09-27 14:45:00,913,931,18,61,FALSE,NA,"0.1.4"
"2557","646",2022-09-27 15:00:00,913,931,18,61,FALSE,NA,"0.1.4"
"2558","646",2022-09-27 15:15:00,913,931,18,61,FALSE,NA,"0.1.4"
"2559","646",2022-09-27 15:30:00,913,931,18,61,FALSE,NA,"0.1.4"
"2560","646",2022-09-27 15:45:00,913,931,18,61,FALSE,NA,"0.1.4"
"2561","646",2022-09-27 16:00:00,913,931,18,61,FALSE,NA,"0.1.4"
"2562","646",2022-09-27 16:15:00,913,931,18,61,FALSE,NA,"0.1.4"
"2563","646",2022-09-27 16:30:00,913,931,18,61,FALSE,NA,"0.1.4"
"2564","646",2022-09-27 16:45:00,913,931,18,61,FALSE,NA,"0.1.4"
"2565","646",2022-09-27 17:00:00,913,931,18,61,FALSE,NA,"0.1.4"
"2566","646",2022-09-27 17:15:00,913,931,18,61,FALSE,NA,"0.1.4"
"2567","646",2022-09-27 17:30:00,913,931,18,61,FALSE,NA,"0.1.4"
"2568","646",2022-09-27 17:45:00,913,931,18,61,FALSE,NA,"0.1.4"
"2569","646",2022-09-27 18:00:00,913,931,18,61,FALSE,NA,"0.1.4"
"2570","646",2022-09-27 18:15:00,913,931,18,61,FALSE,NA,"0.1.4"
"2571","646",2022-09-27 18:30:00,913,931,18,61,FALSE,NA,"0.1.4"
"2572","646",2022-09-27 18:45:00,913,931,18,61,FALSE,NA,"0.1.4"
"2573","646",2022-09-27 19:00:00,913,931,18,61,FALSE,NA,"0.1.4"
"2574","646",2022-09-27 19:15:00,913,931,18,61,FALSE,NA,"0.1.4"
"2575","646",2022-09-27 19:30:00,913,931,18,61,FALSE,NA,"0.1.4"
"2576","646",2022-09-27 19:45:00,913,931,18,61,FALSE,NA,"0.1.4"
"2577","646",2022-09-27 20:00:00,913,931,18,61,FALSE,NA,"0.1.4"
"2578","646",2022-09-27 20:15:00,914,931,17,61,FALSE,NA,"0.1.4"
"2579","646",2022-09-27 20:30:00,914,931,17,61,FALSE,NA,"0.1.4"
"2580","646",2022-09-27 20:45:00,914,931,17,61,FALSE,NA,"0.1.4"
"2581","646",2022-09-27 21:00:00,913,931,18,61,FALSE,NA,"0.1.4"
"2582","646",2022-09-27 21:15:00,913,931,18,61,FALSE,NA,"0.1.4"
"2583","646",2022-09-27 21:30:00,914,931,17,61,FALSE,NA,"0.1.4"
"2584","646",2022-09-27 21:45:00,913,931,18,61,FALSE,NA,"0.1.4"
"2585","646",2022-09-27 22:00:00,913,931,18,61,FALSE,NA,"0.1.4"
"2586","646",2022-09-27 22:15:00,911,931,20,61,FALSE,NA,"0.1.4"
"2587","646",2022-09-27 22:30:00,912,931,19,61,FALSE,NA,"0.1.4"
"2588","646",2022-09-27 22:45:00,911,931,20,61,FALSE,NA,"0.1.4"
"2589","646",2022-09-27 23:00:00,910,931,21,61,FALSE,NA,"0.1.4"
"2590","646",2022-09-27 23:15:00,909,931,22,61,FALSE,NA,"0.1.4"
"2591","646",2022-09-27 23:30:00,909,931,22,61,FALSE,NA,"0.1.4"
"2592","646",2022-09-27 23:45:00,908,931,23,61,FALSE,NA,"0.1.4"
"2593","646",2022-09-28,908,931,23,61,FALSE,NA,"0.1.4"
"2594","646",2022-09-28 00:15:00,908,931,23,61,FALSE,NA,"0.1.4"
"2595","646",2022-09-28 00:30:00,908,931,23,61,FALSE,NA,"0.1.4"
"2596","646",2022-09-28 00:45:00,908,931,23,61,FALSE,NA,"0.1.4"
"2597","646",2022-09-28 01:00:00,908,931,23,61,FALSE,NA,"0.1.4"
"2598","646",2022-09-28 01:15:00,908,931,23,61,FALSE,NA,"0.1.4"
"2599","646",2022-09-28 01:30:00,908,931,23,61,FALSE,NA,"0.1.4"
"2600","646",2022-09-28 01:45:00,908,931,23,61,FALSE,NA,"0.1.4"
"2601","646",2022-09-28 02:00:00,908,931,23,61,FALSE,NA,"0.1.4"
"2602","646",2022-09-28 02:15:00,907,931,24,61,FALSE,NA,"0.1.4"
"2603","646",2022-09-28 02:30:00,908,931,23,61,FALSE,NA,"0.1.4"
"2604","646",2022-09-28 02:45:00,908,931,23,61,FALSE,NA,"0.1.4"
"2605","646",2022-09-28 03:00:00,908,931,23,61,FALSE,NA,"0.1.4"
"2606","646",2022-09-28 03:15:00,908,931,23,61,FALSE,NA,"0.1.4"
"2607","646",2022-09-28 03:30:00,908,931,23,61,FALSE,NA,"0.1.4"
"2608","646",2022-09-28 03:45:00,908,931,23,61,FALSE,NA,"0.1.4"
"2609","646",2022-09-28 04:00:00,908,931,23,61,FALSE,NA,"0.1.4"
"2610","646",2022-09-28 04:15:00,908,931,23,61,FALSE,NA,"0.1.4"
"2611","646",2022-09-28 04:30:00,908,931,23,61,FALSE,NA,"0.1.4"
"2612","646",2022-09-28 04:45:00,908,931,23,61,FALSE,NA,"0.1.4"
"2613","646",2022-09-28 05:00:00,908,931,23,61,FALSE,NA,"0.1.4"
"2614","646",2022-09-28 05:15:00,908,931,23,61,FALSE,NA,"0.1.4"
"2615","646",2022-09-28 05:30:00,908,931,23,61,FALSE,NA,"0.1.4"
"2616","646",2022-09-28 05:45:00,909,931,22,61,FALSE,NA,"0.1.4"
"2617","646",2022-09-28 06:00:00,909,931,22,61,FALSE,NA,"0.1.4"
"2618","646",2022-09-28 06:15:00,909,931,22,61,FALSE,NA,"0.1.4"
"2619","646",2022-09-28 06:30:00,909,931,22,61,FALSE,NA,"0.1.4"
"2620","646",2022-09-28 06:45:00,909,931,22,61,FALSE,NA,"0.1.4"
"2621","646",2022-09-28 07:00:00,909,931,22,61,FALSE,NA,"0.1.4"
"2622","646",2022-09-28 07:15:00,909,931,22,61,FALSE,NA,"0.1.4"
"2623","646",2022-09-28 07:30:00,909,931,22,61,FALSE,NA,"0.1.4"
"2624","646",2022-09-28 07:45:00,909,931,22,61,FALSE,NA,"0.1.4"
"2625","646",2022-09-28 08:00:00,909,931,22,61,FALSE,NA,"0.1.4"
"2626","646",2022-09-28 08:15:00,909,931,22,61,FALSE,NA,"0.1.4"
"2627","646",2022-09-28 08:30:00,909,931,22,61,FALSE,NA,"0.1.4"
"2628","646",2022-09-28 08:45:00,909,931,22,61,FALSE,NA,"0.1.4"
"2629","646",2022-09-28 09:00:00,909,931,22,61,FALSE,NA,"0.1.4"
"2630","646",2022-09-28 09:15:00,909,931,22,61,FALSE,NA,"0.1.4"
"2631","646",2022-09-28 09:30:00,909,931,22,61,FALSE,NA,"0.1.4"
"2632","646",2022-09-28 09:45:00,909,931,22,61,FALSE,NA,"0.1.4"
"2633","646",2022-09-28 10:00:00,909,931,22,61,FALSE,NA,"0.1.4"
"2634","646",2022-09-28 10:15:00,909,931,22,61,FALSE,NA,"0.1.4"
"2635","646",2022-09-28 10:30:00,909,931,22,61,FALSE,NA,"0.1.4"
"2636","646",2022-09-28 10:45:00,909,931,22,61,FALSE,NA,"0.1.4"
"2637","646",2022-09-28 11:00:00,909,931,22,61,FALSE,NA,"0.1.4"
"2638","646",2022-09-28 11:15:00,909,931,22,61,FALSE,NA,"0.1.4"
"2639","646",2022-09-28 11:30:00,910,931,21,61,FALSE,NA,"0.1.4"
"2640","646",2022-09-28 11:45:00,910,931,21,61,FALSE,NA,"0.1.4"
"2641","646",2022-09-28 12:00:00,910,931,21,61,FALSE,NA,"0.1.4"
"2642","646",2022-09-28 12:15:00,910,931,21,61,FALSE,NA,"0.1.4"
"2643","646",2022-09-28 12:30:00,910,931,21,61,FALSE,NA,"0.1.4"
"2644","646",2022-09-28 12:45:00,910,931,21,61,FALSE,NA,"0.1.4"
"2645","646",2022-09-28 13:00:00,910,931,21,61,FALSE,NA,"0.1.4"
"2646","646",2022-09-28 13:15:00,910,931,21,61,FALSE,NA,"0.1.4"
"2647","646",2022-09-28 13:30:00,911,931,20,61,FALSE,NA,"0.1.4"
"2648","646",2022-09-28 13:45:00,911,931,20,61,FALSE,NA,"0.1.4"
"2649","646",2022-09-28 14:00:00,911,931,20,61,FALSE,NA,"0.1.4"
"2650","646",2022-09-28 14:15:00,910,931,21,61,FALSE,NA,"0.1.4"
"2651","646",2022-09-28 14:30:00,911,931,20,61,FALSE,NA,"0.1.4"
"2652","646",2022-09-28 14:45:00,911,931,20,61,FALSE,NA,"0.1.4"
"2653","646",2022-09-28 15:00:00,911,931,20,61,FALSE,NA,"0.1.4"
"2654","646",2022-09-28 15:15:00,910,931,21,61,FALSE,NA,"0.1.4"
"2655","646",2022-09-28 15:30:00,910,931,21,61,FALSE,NA,"0.1.4"
"2656","646",2022-09-28 15:45:00,911,931,20,61,FALSE,NA,"0.1.4"
"2657","646",2022-09-28 16:00:00,911,931,20,61,FALSE,NA,"0.1.4"
"2658","646",2022-09-28 16:15:00,910,931,21,61,FALSE,NA,"0.1.4"
"2659","646",2022-09-28 16:30:00,910,931,21,61,FALSE,NA,"0.1.4"
"2660","646",2022-09-28 16:45:00,910,931,21,61,FALSE,NA,"0.1.4"
"2661","646",2022-09-28 17:00:00,911,931,20,61,FALSE,NA,"0.1.4"
"2662","646",2022-09-28 17:15:00,911,931,20,61,FALSE,NA,"0.1.4"
"2663","646",2022-09-28 17:30:00,911,931,20,61,FALSE,NA,"0.1.4"
"2664","646",2022-09-28 17:45:00,911,931,20,61,FALSE,NA,"0.1.4"
"2665","646",2022-09-28 18:00:00,911,931,20,61,FALSE,NA,"0.1.4"
"2666","646",2022-09-28 18:15:00,911,931,20,61,FALSE,NA,"0.1.4"
"2667","646",2022-09-28 18:30:00,911,931,20,61,FALSE,NA,"0.1.4"
"2668","646",2022-09-28 18:45:00,911,931,20,61,FALSE,NA,"0.1.4"
"2669","646",2022-09-28 19:00:00,911,931,20,61,FALSE,NA,"0.1.4"
"2670","646",2022-09-28 19:15:00,911,931,20,61,FALSE,NA,"0.1.4"
"2671","646",2022-09-28 19:30:00,911,931,20,61,FALSE,NA,"0.1.4"
"2672","646",2022-09-28 19:45:00,911,931,20,61,FALSE,NA,"0.1.4"
"2673","646",2022-09-28 20:00:00,911,931,20,61,FALSE,NA,"0.1.4"
"2674","646",2022-09-28 20:15:00,911,931,20,61,FALSE,NA,"0.1.4"
"2675","646",2022-09-28 20:30:00,911,931,20,61,FALSE,NA,"0.1.4"
"2676","646",2022-09-28 20:45:00,911,931,20,61,FALSE,NA,"0.1.4"
"2677","646",2022-09-28 21:00:00,910,931,21,61,FALSE,NA,"0.1.4"
"2678","646",2022-09-28 21:15:00,910,931,21,61,FALSE,NA,"0.1.4"
"2679","646",2022-09-28 21:30:00,910,931,21,61,FALSE,NA,"0.1.4"
"2680","646",2022-09-28 21:45:00,910,931,21,61,FALSE,NA,"0.1.4"
"2681","646",2022-09-28 22:00:00,911,931,20,61,FALSE,NA,"0.1.4"
"2682","646",2022-09-28 22:15:00,910,931,21,61,FALSE,NA,"0.1.4"
"2683","646",2022-09-28 22:30:00,910,931,21,61,FALSE,NA,"0.1.4"
"2684","646",2022-09-28 22:45:00,910,931,21,61,FALSE,NA,"0.1.4"
"2685","646",2022-09-28 23:00:00,910,931,21,61,FALSE,NA,"0.1.4"
"2686","646",2022-09-28 23:15:00,910,931,21,61,FALSE,NA,"0.1.4"
"2687","646",2022-09-28 23:30:00,910,931,21,61,FALSE,NA,"0.1.4"
"2688","646",2022-09-28 23:45:00,910,931,21,61,FALSE,NA,"0.1.4"
"2689","646",2022-09-29,910,931,21,61,FALSE,NA,"0.1.4"
"2690","646",2022-09-29 00:15:00,910,931,21,61,FALSE,NA,"0.1.4"
"2691","646",2022-09-29 00:30:00,910,931,21,61,FALSE,NA,"0.1.4"
"2692","646",2022-09-29 00:45:00,910,931,21,61,FALSE,NA,"0.1.4"
"2693","646",2022-09-29 01:00:00,910,931,21,61,FALSE,NA,"0.1.4"
"2694","646",2022-09-29 01:15:00,910,931,21,61,FALSE,NA,"0.1.4"
"2695","646",2022-09-29 01:30:00,910,931,21,61,FALSE,NA,"0.1.4"
"2696","646",2022-09-29 01:45:00,910,931,21,61,FALSE,NA,"0.1.4"
"2697","646",2022-09-29 02:00:00,910,931,21,61,FALSE,NA,"0.1.4"
"2698","646",2022-09-29 02:15:00,910,931,21,61,FALSE,NA,"0.1.4"
"2699","646",2022-09-29 02:30:00,910,931,21,61,FALSE,NA,"0.1.4"
"2700","646",2022-09-29 02:45:00,910,931,21,61,FALSE,NA,"0.1.4"
"2701","646",2022-09-29 03:00:00,910,931,21,61,FALSE,NA,"0.1.4"
"2702","646",2022-09-29 03:15:00,910,931,21,61,FALSE,NA,"0.1.4"
"2703","646",2022-09-29 03:30:00,910,931,21,61,FALSE,NA,"0.1.4"
"2704","646",2022-09-29 03:45:00,910,931,21,61,FALSE,NA,"0.1.4"
"2705","646",2022-09-29 04:00:00,910,931,21,61,FALSE,NA,"0.1.4"
"2706","646",2022-09-29 04:15:00,910,931,21,61,FALSE,NA,"0.1.4"
"2707","646",2022-09-29 04:30:00,910,931,21,61,FALSE,NA,"0.1.4"
"2708","646",2022-09-29 04:45:00,910,931,21,61,FALSE,NA,"0.1.4"
"2709","646",2022-09-29 05:00:00,910,931,21,61,FALSE,NA,"0.1.4"
"2710","646",2022-09-29 05:15:00,910,931,21,61,FALSE,NA,"0.1.4"
"2711","646",2022-09-29 05:30:00,910,931,21,61,FALSE,NA,"0.1.4"
"2712","646",2022-09-29 05:45:00,910,931,21,61,FALSE,NA,"0.1.4"
"2713","646",2022-09-29 06:00:00,910,931,21,61,FALSE,NA,"0.1.4"
"2714","646",2022-09-29 06:15:00,910,931,21,61,FALSE,NA,"0.1.4"
"2715","646",2022-09-29 06:30:00,910,931,21,61,FALSE,NA,"0.1.4"
"2716","646",2022-09-29 06:45:00,910,931,21,61,FALSE,NA,"0.1.4"
"2717","646",2022-09-29 07:00:00,910,931,21,61,FALSE,NA,"0.1.4"
"2718","646",2022-09-29 07:15:00,910,931,21,61,FALSE,NA,"0.1.4"
"2719","646",2022-09-29 07:30:00,910,931,21,61,FALSE,NA,"0.1.4"
"2720","646",2022-09-29 07:45:00,910,931,21,61,FALSE,NA,"0.1.4"
"2721","646",2022-09-29 08:00:00,910,931,21,61,FALSE,NA,"0.1.4"
"2722","646",2022-09-29 08:15:00,910,931,21,61,FALSE,NA,"0.1.4"
"2723","646",2022-09-29 08:30:00,910,931,21,61,FALSE,NA,"0.1.4"
"2724","646",2022-09-29 08:45:00,910,931,21,61,FALSE,NA,"0.1.4"
"2725","646",2022-09-29 09:00:00,910,931,21,61,FALSE,NA,"0.1.4"
"2726","646",2022-09-29 09:15:00,910,931,21,61,FALSE,NA,"0.1.4"
"2727","646",2022-09-29 09:30:00,910,931,21,61,FALSE,NA,"0.1.4"
"2728","646",2022-09-29 09:45:00,910,931,21,61,FALSE,NA,"0.1.4"
"2729","646",2022-09-29 10:00:00,911,931,20,61,FALSE,NA,"0.1.4"
"2730","646",2022-09-29 10:15:00,911,931,20,61,FALSE,NA,"0.1.4"
"2731","646",2022-09-29 10:30:00,911,931,20,61,FALSE,NA,"0.1.4"
"2732","646",2022-09-29 10:45:00,911,931,20,61,FALSE,NA,"0.1.4"
"2733","646",2022-09-29 11:00:00,911,931,20,61,FALSE,NA,"0.1.4"
"2734","646",2022-09-29 11:15:00,911,931,20,61,FALSE,NA,"0.1.4"
"2735","646",2022-09-29 11:30:00,911,931,20,61,FALSE,NA,"0.1.4"
"2736","646",2022-09-29 11:45:00,911,931,20,61,FALSE,NA,"0.1.4"
"2737","646",2022-09-29 12:00:00,911,931,20,61,FALSE,NA,"0.1.4"
"2738","646",2022-09-29 12:15:00,911,931,20,61,FALSE,NA,"0.1.4"
"2739","646",2022-09-29 12:30:00,911,931,20,61,FALSE,NA,"0.1.4"
"2740","646",2022-09-29 12:45:00,911,931,20,61,FALSE,NA,"0.1.4"
"2741","646",2022-09-29 13:00:00,912,931,19,61,FALSE,NA,"0.1.4"
"2742","646",2022-09-29 13:15:00,912,931,19,61,FALSE,NA,"0.1.4"
"2743","646",2022-09-29 13:30:00,912,931,19,61,FALSE,NA,"0.1.4"
"2744","646",2022-09-29 13:45:00,913,931,18,61,FALSE,NA,"0.1.4"
"2745","646",2022-09-29 14:00:00,912,931,19,61,FALSE,NA,"0.1.4"
"2746","646",2022-09-29 14:15:00,913,931,18,61,FALSE,NA,"0.1.4"
"2747","646",2022-09-29 14:30:00,913,931,18,61,FALSE,NA,"0.1.4"
"2748","646",2022-09-29 14:45:00,913,931,18,61,FALSE,NA,"0.1.4"
"2749","646",2022-09-29 15:00:00,914,931,17,61,FALSE,NA,"0.1.4"
"2750","646",2022-09-29 15:15:00,916,931,15,61,FALSE,NA,"0.1.4"
"2751","646",2022-09-29 15:30:00,917,931,14,61,FALSE,NA,"0.1.4"
"2752","646",2022-09-29 15:45:00,916,931,15,61,FALSE,NA,"0.1.4"
"2753","646",2022-09-29 16:00:00,916,931,15,61,FALSE,NA,"0.1.4"
"2754","646",2022-09-29 16:15:00,916,931,15,61,FALSE,NA,"0.1.4"
"2755","646",2022-09-29 16:30:00,917,931,14,61,FALSE,NA,"0.1.4"
"2756","646",2022-09-29 16:45:00,918,931,13,61,FALSE,NA,"0.1.4"
"2757","646",2022-09-29 17:00:00,918,931,13,61,FALSE,NA,"0.1.4"
"2758","646",2022-09-29 17:15:00,918,931,13,61,FALSE,NA,"0.1.4"
"2759","646",2022-09-29 17:30:00,918,931,13,61,FALSE,NA,"0.1.4"
"2760","646",2022-09-29 17:45:00,918,931,13,61,FALSE,NA,"0.1.4"
"2761","646",2022-09-29 18:00:00,918,931,13,61,FALSE,NA,"0.1.4"
"2762","646",2022-09-29 18:15:00,918,931,13,61,FALSE,NA,"0.1.4"
"2763","646",2022-09-29 18:30:00,918,931,13,61,FALSE,NA,"0.1.4"
"2764","646",2022-09-29 18:45:00,918,931,13,61,FALSE,NA,"0.1.4"
"2765","646",2022-09-29 19:00:00,919,931,12,61,FALSE,NA,"0.1.4"
"2766","646",2022-09-29 19:15:00,919,931,12,61,FALSE,NA,"0.1.4"
"2767","646",2022-09-29 19:30:00,919,931,12,61,FALSE,NA,"0.1.4"
"2768","646",2022-09-29 19:45:00,919,931,12,61,FALSE,NA,"0.1.4"
"2769","646",2022-09-29 20:00:00,920,931,11,61,FALSE,NA,"0.1.4"
"2770","646",2022-09-29 20:15:00,919,931,12,61,FALSE,NA,"0.1.4"
"2771","646",2022-09-29 20:30:00,920,931,11,61,FALSE,NA,"0.1.4"
"2772","646",2022-09-29 20:45:00,920,931,11,61,FALSE,NA,"0.1.4"
"2773","646",2022-09-29 21:00:00,921,931,10,61,FALSE,NA,"0.1.4"
"2774","646",2022-09-29 21:15:00,920,931,11,61,FALSE,NA,"0.1.4"
"2775","646",2022-09-29 21:30:00,920,931,11,61,FALSE,NA,"0.1.4"
"2776","646",2022-09-29 21:45:00,920,931,11,61,FALSE,NA,"0.1.4"
"2777","646",2022-09-29 22:00:00,920,931,11,61,FALSE,NA,"0.1.4"
"2778","646",2022-09-29 22:15:00,920,931,11,61,FALSE,NA,"0.1.4"
"2779","646",2022-09-29 22:30:00,920,931,11,61,FALSE,NA,"0.1.4"
"2780","646",2022-09-29 22:45:00,920,931,11,61,FALSE,NA,"0.1.4"
"2781","646",2022-09-29 23:00:00,920,931,11,61,FALSE,NA,"0.1.4"
"2782","646",2022-09-29 23:15:00,920,931,11,61,FALSE,NA,"0.1.4"
"2783","646",2022-09-29 23:30:00,920,931,11,61,FALSE,NA,"0.1.4"
"2784","646",2022-09-29 23:45:00,920,931,11,61,FALSE,NA,"0.1.4"
"2785","646",2022-09-30,920,931,11,61,FALSE,NA,"0.1.4"
"2786","646",2022-09-30 00:15:00,920,931,11,61,FALSE,NA,"0.1.4"
"2787","646",2022-09-30 00:30:00,920,931,11,61,FALSE,NA,"0.1.4"
"2788","646",2022-09-30 00:45:00,920,931,11,61,FALSE,NA,"0.1.4"
"2789","646",2022-09-30 01:00:00,921,931,10,61,FALSE,NA,"0.1.4"
"2790","646",2022-09-30 01:15:00,921,931,10,61,FALSE,NA,"0.1.4"
"2791","646",2022-09-30 01:30:00,921,931,10,61,FALSE,NA,"0.1.4"
"2792","646",2022-09-30 01:45:00,921,931,10,61,FALSE,NA,"0.1.4"
"2793","646",2022-09-30 02:00:00,921,931,10,61,FALSE,NA,"0.1.4"
"2794","646",2022-09-30 02:15:00,922,931,9,61,FALSE,NA,"0.1.4"
"2795","646",2022-09-30 02:30:00,922,931,9,61,FALSE,NA,"0.1.4"
"2796","646",2022-09-30 02:45:00,922,931,9,61,FALSE,NA,"0.1.4"
"2797","646",2022-09-30 03:00:00,923,931,8,61,FALSE,NA,"0.1.4"
"2798","646",2022-09-30 03:15:00,923,931,8,61,FALSE,NA,"0.1.4"
"2799","646",2022-09-30 03:30:00,924,931,7,61,FALSE,NA,"0.1.4"
"2800","646",2022-09-30 03:45:00,923,931,8,61,FALSE,NA,"0.1.4"
"2801","646",2022-09-30 04:00:00,923,931,8,61,FALSE,NA,"0.1.4"
"2802","646",2022-09-30 04:15:00,923,931,8,61,FALSE,NA,"0.1.4"
"2803","646",2022-09-30 04:30:00,924,931,7,61,FALSE,NA,"0.1.4"
"2804","646",2022-09-30 04:45:00,925,931,6,61,FALSE,NA,"0.1.4"
"2805","646",2022-09-30 05:00:00,924,931,7,61,FALSE,NA,"0.1.4"
"2806","646",2022-09-30 05:15:00,924,931,7,61,FALSE,NA,"0.1.4"
"2807","646",2022-09-30 05:30:00,925,931,6,61,FALSE,NA,"0.1.4"
"2808","646",2022-09-30 05:45:00,925,931,6,61,FALSE,NA,"0.1.4"
"2809","646",2022-09-30 06:00:00,925,931,6,61,FALSE,NA,"0.1.4"
"2810","646",2022-09-30 06:15:00,926,931,5,61,FALSE,NA,"0.1.4"
"2811","646",2022-09-30 06:30:00,925,931,6,61,FALSE,NA,"0.1.4"
"2812","646",2022-09-30 06:45:00,925,931,6,61,FALSE,NA,"0.1.4"
"2813","646",2022-09-30 07:00:00,925,931,6,61,FALSE,NA,"0.1.4"
"2814","646",2022-09-30 07:15:00,926,931,5,61,FALSE,NA,"0.1.4"
"2815","646",2022-09-30 07:30:00,926,931,5,61,FALSE,NA,"0.1.4"
"2816","646",2022-09-30 07:45:00,926,931,5,61,FALSE,NA,"0.1.4"
"2817","646",2022-09-30 08:00:00,927,931,4,61,FALSE,NA,"0.1.4"
"2818","646",2022-09-30 08:15:00,926,931,5,61,FALSE,NA,"0.1.4"
"2819","646",2022-09-30 08:30:00,927,931,4,61,FALSE,NA,"0.1.4"
"2820","646",2022-09-30 08:45:00,927,931,4,61,FALSE,NA,"0.1.4"
"2821","646",2022-09-30 09:00:00,926,931,5,61,FALSE,NA,"0.1.4"
"2822","646",2022-09-30 09:15:00,926,931,5,61,FALSE,NA,"0.1.4"
"2823","646",2022-09-30 09:30:00,927,931,4,61,FALSE,NA,"0.1.4"
"2824","646",2022-09-30 09:45:00,927,931,4,61,FALSE,NA,"0.1.4"
"2825","646",2022-09-30 10:00:00,927,931,4,61,FALSE,NA,"0.1.4"
"2826","646",2022-09-30 10:15:00,927,931,4,61,FALSE,NA,"0.1.4"
"2827","646",2022-09-30 10:30:00,927,931,4,61,FALSE,NA,"0.1.4"
"2828","646",2022-09-30 10:45:00,927,931,4,61,FALSE,NA,"0.1.4"
"2829","646",2022-09-30 11:00:00,928,931,3,61,FALSE,NA,"0.1.4"
"2830","646",2022-09-30 11:15:00,928,931,3,61,FALSE,NA,"0.1.4"
"2831","646",2022-09-30 11:30:00,928,931,3,61,FALSE,NA,"0.1.4"
"2832","646",2022-09-30 11:45:00,928,931,3,61,FALSE,NA,"0.1.4"
"2833","646",2022-09-30 12:00:00,929,931,2,61,FALSE,NA,"0.1.4"
"2834","646",2022-09-30 12:15:00,928,931,3,61,FALSE,NA,"0.1.4"
"2835","646",2022-09-30 12:30:00,928,931,3,61,FALSE,NA,"0.1.4"
"2836","646",2022-09-30 12:45:00,928,931,3,61,FALSE,NA,"0.1.4"
"2837","646",2022-09-30 13:00:00,929,931,2,61,FALSE,NA,"0.1.4"
"2838","646",2022-09-30 13:15:00,929,931,2,61,FALSE,NA,"0.1.4"
"2839","646",2022-09-30 13:30:00,929,931,2,61,FALSE,NA,"0.1.4"
"2840","646",2022-09-30 13:45:00,930,931,1,61,FALSE,NA,"0.1.4"
"2841","646",2022-09-30 14:00:00,930,931,1,61,FALSE,NA,"0.1.4"
"2842","646",2022-09-30 14:15:00,929,931,2,61,FALSE,NA,"0.1.4"
"2843","646",2022-09-30 14:30:00,929,931,2,61,FALSE,NA,"0.1.4"
"2844","646",2022-09-30 14:45:00,930,931,1,61,FALSE,NA,"0.1.4"
"2845","646",2022-09-30 15:00:00,930,931,1,61,FALSE,NA,"0.1.4"
"2846","646",2022-09-30 15:15:00,930,931,1,61,FALSE,NA,"0.1.4"
"2847","646",2022-09-30 15:30:00,930,931,1,61,FALSE,NA,"0.1.4"
"2848","646",2022-09-30 15:45:00,931,931,0,61,FALSE,NA,"0.1.4"
"2849","646",2022-09-30 16:00:00,931,931,0,61,FALSE,NA,"0.1.4"
"2850","646",2022-09-30 16:15:00,931,931,0,61,FALSE,NA,"0.1.4"
"2851","646",2022-09-30 16:30:00,931,931,0,61,FALSE,NA,"0.1.4"
"2852","646",2022-09-30 16:45:00,930,931,1,61,FALSE,NA,"0.1.4"
"2853","646",2022-09-30 17:00:00,930,931,1,61,FALSE,NA,"0.1.4"
"2854","646",2022-09-30 17:15:00,930,931,1,61,FALSE,NA,"0.1.4"
"2855","646",2022-09-30 17:30:00,931,931,0,61,FALSE,NA,"0.1.4"
"2856","646",2022-09-30 17:45:00,931,931,0,61,FALSE,NA,"0.1.4"
"2857","646",2022-09-30 18:00:00,931,931,0,61,FALSE,NA,"0.1.4"
"2858","646",2022-09-30 18:15:00,931,931,0,61,FALSE,NA,"0.1.4"
"2859","646",2022-09-30 18:30:00,931,931,0,61,FALSE,NA,"0.1.4"
"2860","646",2022-09-30 18:45:00,931,931,0,61,FALSE,NA,"0.1.4"
"2861","646",2022-09-30 19:00:00,931,931,0,61,FALSE,NA,"0.1.4"
"2862","646",2022-09-30 19:15:00,931,931,0,61,FALSE,NA,"0.1.4"
"2863","646",2022-09-30 19:30:00,931,931,0,61,FALSE,NA,"0.1.4"
"2864","646",2022-09-30 19:45:00,931,931,0,61,FALSE,NA,"0.1.4"
"2865","646",2022-09-30 20:00:00,931,931,0,61,FALSE,NA,"0.1.4"
"2866","646",2022-09-30 20:15:00,931,931,0,61,FALSE,NA,"0.1.4"
"2867","646",2022-09-30 20:30:00,931,931,0,61,FALSE,NA,"0.1.4"
"2868","646",2022-09-30 20:45:00,931,931,0,61,FALSE,NA,"0.1.4"
"2869","646",2022-09-30 21:00:00,931,931,0,61,FALSE,NA,"0.1.4"
"2870","646",2022-09-30 21:15:00,931,931,0,61,FALSE,NA,"0.1.4"
"2871","646",2022-09-30 21:30:00,931,931,0,61,FALSE,NA,"0.1.4"
"2872","646",2022-09-30 21:45:00,931,931,0,61,FALSE,NA,"0.1.4"
"2873","646",2022-09-30 22:00:00,931,931,0,61,FALSE,NA,"0.1.4"
"2874","646",2022-09-30 22:15:00,930,931,1,61,FALSE,NA,"0.1.4"
"2875","646",2022-09-30 22:30:00,930,931,1,61,FALSE,NA,"0.1.4"
"2876","646",2022-09-30 22:45:00,930,931,1,61,FALSE,NA,"0.1.4"
"2877","646",2022-09-30 23:00:00,930,931,1,61,FALSE,NA,"0.1.4"
"2878","646",2022-09-30 23:15:00,930,931,1,61,FALSE,NA,"0.1.4"
"2879","646",2022-09-30 23:30:00,930,931,1,61,FALSE,NA,"0.1.4"
"2880","646",2022-09-30 23:45:00,930,931,1,61,FALSE,NA,"0.1.4"
"2881","646",2022-10-01,930,931,1,61,FALSE,NA,"0.1.4"
"2882","646",2022-10-01 00:15:00,930,931,1,61,FALSE,NA,"0.1.4"
"2883","646",2022-10-01 00:30:00,930,931,1,61,FALSE,NA,"0.1.4"
"2884","646",2022-10-01 00:45:00,930,931,1,61,FALSE,NA,"0.1.4"
"2885","646",2022-10-01 01:00:00,930,931,1,61,FALSE,NA,"0.1.4"
"2886","646",2022-10-01 01:15:00,929,931,2,61,FALSE,NA,"0.1.4"
"2887","646",2022-10-01 01:30:00,930,931,1,61,FALSE,NA,"0.1.4"
"2888","646",2022-10-01 01:45:00,929,931,2,61,FALSE,NA,"0.1.4"
"2889","646",2022-10-01 02:00:00,930,931,1,61,FALSE,NA,"0.1.4"
"2890","646",2022-10-01 02:15:00,930,931,1,61,FALSE,NA,"0.1.4"
"2891","646",2022-10-01 02:30:00,930,931,1,61,FALSE,NA,"0.1.4"
"2892","646",2022-10-01 02:45:00,930,931,1,61,FALSE,NA,"0.1.4"
"2893","646",2022-10-01 03:00:00,930,931,1,61,FALSE,NA,"0.1.4"
"2894","646",2022-10-01 03:15:00,930,931,1,61,FALSE,NA,"0.1.4"
"2895","646",2022-10-01 03:30:00,930,931,1,61,FALSE,NA,"0.1.4"
"2896","646",2022-10-01 03:45:00,930,931,1,61,FALSE,NA,"0.1.4"
"2897","646",2022-10-01 04:00:00,930,931,1,61,FALSE,NA,"0.1.4"
"2898","646",2022-10-01 04:15:00,930,931,1,61,FALSE,NA,"0.1.4"
"2899","646",2022-10-01 04:30:00,930,931,1,61,FALSE,NA,"0.1.4"
"2900","646",2022-10-01 04:45:00,930,931,1,61,FALSE,NA,"0.1.4"
"2901","646",2022-10-01 05:00:00,930,931,1,61,FALSE,NA,"0.1.4"
"2902","646",2022-10-01 05:15:00,930,931,1,61,FALSE,NA,"0.1.4"
"2903","646",2022-10-01 05:30:00,930,931,1,61,FALSE,NA,"0.1.4"
"2904","646",2022-10-01 05:45:00,930,931,1,61,FALSE,NA,"0.1.4"
"2905","646",2022-10-01 06:00:00,930,931,1,61,FALSE,NA,"0.1.4"
"2906","646",2022-10-01 06:15:00,930,931,1,61,FALSE,NA,"0.1.4"
"2907","646",2022-10-01 06:30:00,930,931,1,61,FALSE,NA,"0.1.4"
"2908","646",2022-10-01 06:45:00,930,931,1,61,FALSE,NA,"0.1.4"
"2909","646",2022-10-01 07:00:00,930,931,1,61,FALSE,NA,"0.1.4"
"2910","646",2022-10-01 07:15:00,930,931,1,61,FALSE,NA,"0.1.4"
"2911","646",2022-10-01 07:30:00,930,931,1,61,FALSE,NA,"0.1.4"
"2912","646",2022-10-01 07:45:00,930,931,1,61,FALSE,NA,"0.1.4"
"2913","646",2022-10-01 08:00:00,930,931,1,61,FALSE,NA,"0.1.4"
"2914","646",2022-10-01 08:15:00,930,931,1,61,FALSE,NA,"0.1.4"
"2915","646",2022-10-01 08:30:00,930,931,1,61,FALSE,NA,"0.1.4"
"2916","646",2022-10-01 08:45:00,930,931,1,61,FALSE,NA,"0.1.4"
"2917","646",2022-10-01 09:00:00,930,931,1,61,FALSE,NA,"0.1.4"
"2918","646",2022-10-01 09:15:00,930,931,1,61,FALSE,NA,"0.1.4"
"2919","646",2022-10-01 09:30:00,930,931,1,61,FALSE,NA,"0.1.4"
"2920","646",2022-10-01 09:45:00,930,931,1,61,FALSE,NA,"0.1.4"
"2921","646",2022-10-01 10:00:00,930,931,1,61,FALSE,NA,"0.1.4"
"2922","646",2022-10-01 10:15:00,930,931,1,61,FALSE,NA,"0.1.4"
"2923","646",2022-10-01 10:30:00,930,931,1,61,FALSE,NA,"0.1.4"
"2924","646",2022-10-01 10:45:00,930,931,1,61,FALSE,NA,"0.1.4"
"2925","646",2022-10-01 11:00:00,930,931,1,61,FALSE,NA,"0.1.4"
"2926","646",2022-10-01 11:15:00,931,931,0,61,FALSE,NA,"0.1.4"
"2927","646",2022-10-01 11:30:00,930,931,1,61,FALSE,NA,"0.1.4"
"2928","646",2022-10-01 11:45:00,931,931,0,61,FALSE,NA,"0.1.4"
"2929","646",2022-10-01 12:00:00,931,931,0,61,FALSE,NA,"0.1.4"
"2930","646",2022-10-01 12:15:00,931,931,0,61,FALSE,NA,"0.1.4"
"2931","646",2022-10-01 12:30:00,931,931,0,61,FALSE,NA,"0.1.4"
"2932","646",2022-10-01 12:45:00,931,931,0,61,FALSE,NA,"0.1.4"
"2933","646",2022-10-01 13:00:00,931,931,0,61,FALSE,NA,"0.1.4"
"2934","646",2022-10-01 13:15:00,931,931,0,61,FALSE,NA,"0.1.4"
"2935","646",2022-10-01 13:30:00,931,931,0,61,FALSE,NA,"0.1.4"
"2936","646",2022-10-01 13:45:00,931,931,0,61,FALSE,NA,"0.1.4"
"2937","646",2022-10-01 14:00:00,931,931,0,61,FALSE,NA,"0.1.4"
"2938","646",2022-10-01 14:15:00,930,931,1,61,FALSE,NA,"0.1.4"
"2939","646",2022-10-01 14:30:00,930,931,1,61,FALSE,NA,"0.1.4"
"2940","646",2022-10-01 14:45:00,930,931,1,61,FALSE,NA,"0.1.4"
"2941","646",2022-10-01 15:00:00,930,931,1,61,FALSE,NA,"0.1.4"
"2942","646",2022-10-01 15:15:00,930,931,1,61,FALSE,NA,"0.1.4"
"2943","646",2022-10-01 15:30:00,931,931,0,61,FALSE,NA,"0.1.4"
"2944","646",2022-10-01 15:45:00,931,931,0,61,FALSE,NA,"0.1.4"
"2945","646",2022-10-01 16:00:00,931,931,0,61,FALSE,NA,"0.1.4"
"2946","646",2022-10-01 16:15:00,931,931,0,61,FALSE,NA,"0.1.4"
"2947","646",2022-10-01 16:30:00,931,931,0,61,FALSE,NA,"0.1.4"
"2948","646",2022-10-01 16:45:00,931,931,0,61,FALSE,NA,"0.1.4"
"2949","646",2022-10-01 17:00:00,931,931,0,61,FALSE,NA,"0.1.4"
"2950","646",2022-10-01 17:15:00,931,931,0,61,FALSE,NA,"0.1.4"
"2951","646",2022-10-01 17:30:00,931,931,0,61,FALSE,NA,"0.1.4"
"2952","646",2022-10-01 17:45:00,931,931,0,61,FALSE,NA,"0.1.4"
"2953","646",2022-10-01 18:00:00,931,931,0,61,FALSE,NA,"0.1.4"
"2954","646",2022-10-01 18:15:00,931,931,0,61,FALSE,NA,"0.1.4"
"2955","646",2022-10-01 18:30:00,931,931,0,61,FALSE,NA,"0.1.4"
"2956","646",2022-10-01 18:45:00,931,931,0,61,FALSE,NA,"0.1.4"
"2957","646",2022-10-01 19:00:00,931,931,0,61,FALSE,NA,"0.1.4"
"2958","646",2022-10-01 19:15:00,931,931,0,61,FALSE,NA,"0.1.4"
"2959","646",2022-10-01 19:30:00,931,931,0,61,FALSE,NA,"0.1.4"
"2960","646",2022-10-01 19:45:00,930,931,1,61,FALSE,NA,"0.1.4"
"2961","646",2022-10-01 20:00:00,930,931,1,61,FALSE,NA,"0.1.4"
"2962","646",2022-10-01 20:15:00,930,931,1,61,FALSE,NA,"0.1.4"
"2963","646",2022-10-01 20:30:00,930,931,1,61,FALSE,NA,"0.1.4"
"2964","646",2022-10-01 20:45:00,930,931,1,61,FALSE,NA,"0.1.4"
"2965","646",2022-10-01 21:00:00,930,931,1,61,FALSE,NA,"0.1.4"
"2966","646",2022-10-01 21:15:00,930,931,1,61,FALSE,NA,"0.1.4"
"2967","646",2022-10-01 21:30:00,930,931,1,61,FALSE,NA,"0.1.4"
"2968","646",2022-10-01 21:45:00,930,931,1,61,FALSE,NA,"0.1.4"
"2969","646",2022-10-01 22:00:00,930,931,1,61,FALSE,NA,"0.1.4"
"2970","646",2022-10-01 22:15:00,930,931,1,61,FALSE,NA,"0.1.4"
"2971","646",2022-10-01 22:30:00,930,931,1,61,FALSE,NA,"0.1.4"
"2972","646",2022-10-01 22:45:00,929,931,2,61,FALSE,NA,"0.1.4"
"2973","646",2022-10-01 23:00:00,930,931,1,61,FALSE,NA,"0.1.4"
"2974","646",2022-10-01 23:15:00,930,931,1,61,FALSE,NA,"0.1.4"
"2975","646",2022-10-01 23:30:00,929,931,2,61,FALSE,NA,"0.1.4"
"2976","646",2022-10-01 23:45:00,929,931,2,61,FALSE,NA,"0.1.4"
"2977","646",2022-10-02,929,931,2,61,FALSE,NA,"0.1.4"
"2978","646",2022-10-02 00:15:00,929,931,2,61,FALSE,NA,"0.1.4"
"2979","646",2022-10-02 00:30:00,929,931,2,61,FALSE,NA,"0.1.4"
"2980","646",2022-10-02 00:45:00,929,931,2,61,FALSE,NA,"0.1.4"
"2981","646",2022-10-02 01:00:00,929,931,2,61,FALSE,NA,"0.1.4"
"2982","646",2022-10-02 01:15:00,929,931,2,61,FALSE,NA,"0.1.4"
"2983","646",2022-10-02 01:30:00,928,931,3,61,FALSE,NA,"0.1.4"
"2984","646",2022-10-02 01:45:00,928,931,3,61,FALSE,NA,"0.1.4"
"2985","646",2022-10-02 02:00:00,929,931,2,61,FALSE,NA,"0.1.4"
"2986","646",2022-10-02 02:15:00,929,931,2,61,FALSE,NA,"0.1.4"
"2987","646",2022-10-02 02:30:00,929,931,2,61,FALSE,NA,"0.1.4"
"2988","646",2022-10-02 02:45:00,929,931,2,61,FALSE,NA,"0.1.4"
"2989","646",2022-10-02 03:00:00,928,931,3,61,FALSE,NA,"0.1.4"
"2990","646",2022-10-02 03:15:00,929,931,2,61,FALSE,NA,"0.1.4"
"2991","646",2022-10-02 03:30:00,929,931,2,61,FALSE,NA,"0.1.4"
"2992","646",2022-10-02 03:45:00,929,931,2,61,FALSE,NA,"0.1.4"
"2993","646",2022-10-02 04:00:00,929,931,2,61,FALSE,NA,"0.1.4"
"2994","646",2022-10-02 04:15:00,929,931,2,61,FALSE,NA,"0.1.4"
"2995","646",2022-10-02 04:30:00,929,931,2,61,FALSE,NA,"0.1.4"
"2996","646",2022-10-02 04:45:00,928,931,3,61,FALSE,NA,"0.1.4"
"2997","646",2022-10-02 05:00:00,929,931,2,61,FALSE,NA,"0.1.4"
"2998","646",2022-10-02 05:15:00,929,931,2,61,FALSE,NA,"0.1.4"
"2999","646",2022-10-02 05:30:00,929,931,2,61,FALSE,NA,"0.1.4"
"3000","646",2022-10-02 05:45:00,929,931,2,61,FALSE,NA,"0.1.4"
"3001","646",2022-10-02 06:00:00,928,931,3,61,FALSE,NA,"0.1.4"
"3002","646",2022-10-02 06:15:00,929,931,2,61,FALSE,NA,"0.1.4"
"3003","646",2022-10-02 06:30:00,929,931,2,61,FALSE,NA,"0.1.4"
"3004","646",2022-10-02 06:45:00,929,931,2,61,FALSE,NA,"0.1.4"
"3005","646",2022-10-02 07:00:00,929,931,2,61,FALSE,NA,"0.1.4"
"3006","646",2022-10-02 07:15:00,929,931,2,61,FALSE,NA,"0.1.4"
"3007","646",2022-10-02 07:30:00,929,931,2,61,FALSE,NA,"0.1.4"
"3008","646",2022-10-02 07:45:00,929,931,2,61,FALSE,NA,"0.1.4"
"3009","646",2022-10-02 08:00:00,929,931,2,61,FALSE,NA,"0.1.4"
"3010","646",2022-10-02 08:15:00,929,931,2,61,FALSE,NA,"0.1.4"
"3011","646",2022-10-02 08:30:00,929,931,2,61,FALSE,NA,"0.1.4"
"3012","646",2022-10-02 08:45:00,929,931,2,61,FALSE,NA,"0.1.4"
"3013","646",2022-10-02 09:00:00,929,931,2,61,FALSE,NA,"0.1.4"
"3014","646",2022-10-02 09:15:00,929,931,2,61,FALSE,NA,"0.1.4"
"3015","646",2022-10-02 09:30:00,929,931,2,61,FALSE,NA,"0.1.4"
"3016","646",2022-10-02 09:45:00,929,931,2,61,FALSE,NA,"0.1.4"
"3017","646",2022-10-02 10:00:00,929,931,2,61,FALSE,NA,"0.1.4"
"3018","646",2022-10-02 10:15:00,928,931,3,61,FALSE,NA,"0.1.4"
"3019","646",2022-10-02 10:30:00,929,931,2,61,FALSE,NA,"0.1.4"
"3020","646",2022-10-02 10:45:00,929,931,2,61,FALSE,NA,"0.1.4"
"3021","646",2022-10-02 11:00:00,929,931,2,61,FALSE,NA,"0.1.4"
"3022","646",2022-10-02 11:15:00,929,931,2,61,FALSE,NA,"0.1.4"
"3023","646",2022-10-02 11:30:00,929,931,2,61,FALSE,NA,"0.1.4"
"3024","646",2022-10-02 11:45:00,929,931,2,61,FALSE,NA,"0.1.4"
"3025","646",2022-10-02 12:00:00,929,931,2,61,FALSE,NA,"0.1.4"
"3026","646",2022-10-02 12:15:00,929,931,2,61,FALSE,NA,"0.1.4"
"3027","646",2022-10-02 12:30:00,929,931,2,61,FALSE,NA,"0.1.4"
"3028","646",2022-10-02 12:45:00,929,931,2,61,FALSE,NA,"0.1.4"
"3029","646",2022-10-02 13:00:00,929,931,2,61,FALSE,NA,"0.1.4"
"3030","646",2022-10-02 13:15:00,929,931,2,61,FALSE,NA,"0.1.4"
"3031","646",2022-10-02 13:30:00,929,931,2,61,FALSE,NA,"0.1.4"
"3032","646",2022-10-02 13:45:00,929,931,2,61,FALSE,NA,"0.1.4"
"3033","646",2022-10-02 14:00:00,929,931,2,61,FALSE,NA,"0.1.4"
"3034","646",2022-10-02 14:15:00,929,931,2,61,FALSE,NA,"0.1.4"
"3035","646",2022-10-02 14:30:00,929,931,2,61,FALSE,NA,"0.1.4"
"3036","646",2022-10-02 14:45:00,929,931,2,61,FALSE,NA,"0.1.4"
"3037","646",2022-10-02 15:00:00,929,931,2,61,FALSE,NA,"0.1.4"
"3038","646",2022-10-02 15:15:00,929,931,2,61,FALSE,NA,"0.1.4"
"3039","646",2022-10-02 15:30:00,929,931,2,61,FALSE,NA,"0.1.4"
"3040","646",2022-10-02 15:45:00,929,931,2,61,FALSE,NA,"0.1.4"
"3041","646",2022-10-02 16:00:00,929,931,2,61,FALSE,NA,"0.1.4"
"3042","646",2022-10-02 16:15:00,929,931,2,61,FALSE,NA,"0.1.4"
"3043","646",2022-10-02 16:30:00,929,931,2,61,FALSE,NA,"0.1.4"
"3044","646",2022-10-02 16:45:00,929,931,2,61,FALSE,NA,"0.1.4"
"3045","646",2022-10-02 17:00:00,929,931,2,61,FALSE,NA,"0.1.4"
"3046","646",2022-10-02 17:15:00,929,931,2,61,FALSE,NA,"0.1.4"
"3047","646",2022-10-02 17:30:00,929,931,2,61,FALSE,NA,"0.1.4"
"3048","646",2022-10-02 17:45:00,929,931,2,61,FALSE,NA,"0.1.4"
"3049","646",2022-10-02 18:00:00,929,931,2,61,FALSE,NA,"0.1.4"
"3050","646",2022-10-02 18:15:00,929,931,2,61,FALSE,NA,"0.1.4"
"3051","646",2022-10-02 18:30:00,929,931,2,61,FALSE,NA,"0.1.4"
"3052","646",2022-10-02 18:45:00,929,931,2,61,FALSE,NA,"0.1.4"
"3053","646",2022-10-02 19:00:00,929,931,2,61,FALSE,NA,"0.1.4"
"3054","646",2022-10-02 19:15:00,929,931,2,61,FALSE,NA,"0.1.4"
"3055","646",2022-10-02 19:30:00,929,931,2,61,FALSE,NA,"0.1.4"
"3056","646",2022-10-02 19:45:00,929,931,2,61,FALSE,NA,"0.1.4"
"3057","646",2022-10-02 20:00:00,929,931,2,61,FALSE,NA,"0.1.4"
"3058","646",2022-10-02 20:15:00,929,931,2,61,FALSE,NA,"0.1.4"
"3059","646",2022-10-02 20:30:00,928,931,3,61,FALSE,NA,"0.1.4"
"3060","646",2022-10-02 20:45:00,928,931,3,61,FALSE,NA,"0.1.4"
"3061","646",2022-10-02 21:00:00,929,931,2,61,FALSE,NA,"0.1.4"
"3062","646",2022-10-02 21:15:00,928,931,3,61,FALSE,NA,"0.1.4"
"3063","646",2022-10-02 21:30:00,927,931,4,61,FALSE,NA,"0.1.4"
"3064","646",2022-10-02 21:45:00,927,931,4,61,FALSE,NA,"0.1.4"
"3065","646",2022-10-02 22:00:00,926,931,5,61,FALSE,NA,"0.1.4"
"3066","646",2022-10-02 22:15:00,925,931,6,61,FALSE,NA,"0.1.4"
"3067","646",2022-10-02 22:30:00,925,931,6,61,FALSE,NA,"0.1.4"
"3068","646",2022-10-02 22:45:00,924,931,7,61,FALSE,NA,"0.1.4"
"3069","646",2022-10-02 23:00:00,923,931,8,61,FALSE,NA,"0.1.4"
"3070","646",2022-10-02 23:15:00,923,931,8,61,FALSE,NA,"0.1.4"
"3071","646",2022-10-02 23:30:00,923,931,8,61,FALSE,NA,"0.1.4"
"3072","646",2022-10-02 23:45:00,923,931,8,61,FALSE,NA,"0.1.4"
"3073","646",2022-10-03,923,931,8,61,FALSE,NA,"0.1.4"
"3074","646",2022-10-03 00:15:00,923,931,8,61,FALSE,NA,"0.1.4"
"3075","646",2022-10-03 00:30:00,923,931,8,61,FALSE,NA,"0.1.4"
"3076","646",2022-10-03 00:45:00,923,931,8,61,FALSE,NA,"0.1.4"
"3077","646",2022-10-03 01:00:00,923,931,8,61,FALSE,NA,"0.1.4"
"3078","646",2022-10-03 01:15:00,923,931,8,61,FALSE,NA,"0.1.4"
"3079","646",2022-10-03 01:30:00,923,931,8,61,FALSE,NA,"0.1.4"
"3080","646",2022-10-03 01:45:00,923,931,8,61,FALSE,NA,"0.1.4"
"3081","646",2022-10-03 02:00:00,923,931,8,61,FALSE,NA,"0.1.4"
"3082","646",2022-10-03 02:15:00,923,931,8,61,FALSE,NA,"0.1.4"
"3083","646",2022-10-03 02:30:00,923,931,8,61,FALSE,NA,"0.1.4"
"3084","646",2022-10-03 02:45:00,923,931,8,61,FALSE,NA,"0.1.4"
"3085","646",2022-10-03 03:00:00,923,931,8,61,FALSE,NA,"0.1.4"
"3086","646",2022-10-03 03:15:00,923,931,8,61,FALSE,NA,"0.1.4"
"3087","646",2022-10-03 03:30:00,923,931,8,61,FALSE,NA,"0.1.4"
"3088","646",2022-10-03 03:45:00,923,931,8,61,FALSE,NA,"0.1.4"
"3089","646",2022-10-03 04:00:00,923,931,8,61,FALSE,NA,"0.1.4"
"3090","646",2022-10-03 04:15:00,923,931,8,61,FALSE,NA,"0.1.4"
"3091","646",2022-10-03 04:30:00,923,931,8,61,FALSE,NA,"0.1.4"
"3092","646",2022-10-03 04:45:00,923,931,8,61,FALSE,NA,"0.1.4"
"3093","646",2022-10-03 05:00:00,923,931,8,61,FALSE,NA,"0.1.4"
"3094","646",2022-10-03 05:15:00,923,931,8,61,FALSE,NA,"0.1.4"
"3095","646",2022-10-03 05:30:00,923,931,8,61,FALSE,NA,"0.1.4"
"3096","646",2022-10-03 05:45:00,923,931,8,61,FALSE,NA,"0.1.4"
"3097","646",2022-10-03 06:00:00,923,931,8,61,FALSE,NA,"0.1.4"
"3098","646",2022-10-03 06:15:00,923,931,8,61,FALSE,NA,"0.1.4"
"3099","646",2022-10-03 06:30:00,923,931,8,61,FALSE,NA,"0.1.4"
"3100","646",2022-10-03 06:45:00,923,931,8,61,FALSE,NA,"0.1.4"
"3101","646",2022-10-03 07:00:00,923,931,8,61,FALSE,NA,"0.1.4"
"3102","646",2022-10-03 07:15:00,923,931,8,61,FALSE,NA,"0.1.4"
"3103","646",2022-10-03 07:30:00,923,931,8,61,FALSE,NA,"0.1.4"
"3104","646",2022-10-03 07:45:00,923,931,8,61,FALSE,NA,"0.1.4"
"3105","646",2022-10-03 08:00:00,923,931,8,61,FALSE,NA,"0.1.4"
"3106","646",2022-10-03 08:15:00,923,931,8,61,FALSE,NA,"0.1.4"
"3107","646",2022-10-03 08:30:00,923,931,8,61,FALSE,NA,"0.1.4"
"3108","646",2022-10-03 08:45:00,923,931,8,61,FALSE,NA,"0.1.4"
"3109","646",2022-10-03 09:00:00,923,931,8,61,FALSE,NA,"0.1.4"
"3110","646",2022-10-03 09:15:00,923,931,8,61,FALSE,NA,"0.1.4"
"3111","646",2022-10-03 09:30:00,923,931,8,61,FALSE,NA,"0.1.4"
"3112","646",2022-10-03 09:45:00,923,931,8,61,FALSE,NA,"0.1.4"
"3113","646",2022-10-03 10:00:00,923,931,8,61,FALSE,NA,"0.1.4"
"3114","646",2022-10-03 10:15:00,923,931,8,61,FALSE,NA,"0.1.4"
"3115","646",2022-10-03 10:30:00,923,931,8,61,FALSE,NA,"0.1.4"
"3116","646",2022-10-03 10:45:00,923,931,8,61,FALSE,NA,"0.1.4"
"3117","646",2022-10-03 11:00:00,923,931,8,61,FALSE,NA,"0.1.4"
"3118","646",2022-10-03 11:15:00,923,931,8,61,FALSE,NA,"0.1.4"
"3119","646",2022-10-03 11:30:00,923,931,8,61,FALSE,NA,"0.1.4"
"3120","646",2022-10-03 11:45:00,923,931,8,61,FALSE,NA,"0.1.4"
"3121","646",2022-10-03 12:00:00,923,931,8,61,FALSE,NA,"0.1.4"
"3122","646",2022-10-03 12:15:00,923,931,8,61,FALSE,NA,"0.1.4"
"3123","646",2022-10-03 12:30:00,923,931,8,61,FALSE,NA,"0.1.4"
"3124","646",2022-10-03 12:45:00,923,931,8,61,FALSE,NA,"0.1.4"
"3125","646",2022-10-03 13:00:00,923,931,8,61,FALSE,NA,"0.1.4"
"3126","646",2022-10-03 13:15:00,923,931,8,61,FALSE,NA,"0.1.4"
"3127","646",2022-10-03 13:30:00,923,931,8,61,FALSE,NA,"0.1.4"
"3128","646",2022-10-03 13:45:00,923,931,8,61,FALSE,NA,"0.1.4"
"3129","646",2022-10-03 14:00:00,923,931,8,61,FALSE,NA,"0.1.4"
"3130","646",2022-10-03 14:15:00,923,931,8,61,FALSE,NA,"0.1.4"
"3131","646",2022-10-03 14:30:00,923,931,8,61,FALSE,NA,"0.1.4"
"3132","646",2022-10-03 14:45:00,923,931,8,61,FALSE,NA,"0.1.4"
"3133","646",2022-10-03 15:00:00,923,931,8,61,FALSE,NA,"0.1.4"
"3134","646",2022-10-03 15:15:00,923,931,8,61,FALSE,NA,"0.1.4"
"3135","646",2022-10-03 15:30:00,923,931,8,61,FALSE,NA,"0.1.4"
"3136","646",2022-10-03 15:45:00,923,931,8,61,FALSE,NA,"0.1.4"
"3137","646",2022-10-03 16:00:00,923,931,8,61,FALSE,NA,"0.1.4"
"3138","646",2022-10-03 16:15:00,923,931,8,61,FALSE,NA,"0.1.4"
"3139","646",2022-10-03 16:30:00,923,931,8,61,FALSE,NA,"0.1.4"
"3140","646",2022-10-03 16:45:00,923,931,8,61,FALSE,NA,"0.1.4"
"3141","646",2022-10-03 17:00:00,923,931,8,61,FALSE,NA,"0.1.4"
"3142","646",2022-10-03 17:15:00,923,931,8,61,FALSE,NA,"0.1.4"
"3143","646",2022-10-03 17:30:00,923,931,8,61,FALSE,NA,"0.1.4"
"3144","646",2022-10-03 17:45:00,923,931,8,61,FALSE,NA,"0.1.4"
"3145","646",2022-10-03 18:00:00,923,931,8,61,FALSE,NA,"0.1.4"
"3146","646",2022-10-03 18:15:00,923,931,8,61,FALSE,NA,"0.1.4"
"3147","646",2022-10-03 18:30:00,923,931,8,61,FALSE,NA,"0.1.4"
"3148","646",2022-10-03 18:45:00,923,931,8,61,FALSE,NA,"0.1.4"
"3149","646",2022-10-03 19:00:00,923,931,8,61,FALSE,NA,"0.1.4"
"3150","646",2022-10-03 19:15:00,923,931,8,61,FALSE,NA,"0.1.4"
"3151","646",2022-10-03 19:30:00,923,931,8,61,FALSE,NA,"0.1.4"
"3152","646",2022-10-03 19:45:00,923,931,8,61,FALSE,NA,"0.1.4"
"3153","646",2022-10-03 20:00:00,923,931,8,61,FALSE,NA,"0.1.4"
"3154","646",2022-10-03 20:15:00,923,931,8,61,FALSE,NA,"0.1.4"
"3155","646",2022-10-03 20:30:00,923,931,8,61,FALSE,NA,"0.1.4"
"3156","646",2022-10-03 20:45:00,923,931,8,61,FALSE,NA,"0.1.4"
"3157","646",2022-10-03 21:00:00,923,931,8,61,FALSE,NA,"0.1.4"
"3158","646",2022-10-03 21:15:00,922,931,9,61,FALSE,NA,"0.1.4"
"3159","646",2022-10-03 21:30:00,921,931,10,61,FALSE,NA,"0.1.4"
"3160","646",2022-10-03 21:45:00,921,931,10,61,FALSE,NA,"0.1.4"
"3161","646",2022-10-03 22:00:00,920,931,11,61,FALSE,NA,"0.1.4"
"3162","646",2022-10-03 22:15:00,920,931,11,61,FALSE,NA,"0.1.4"
"3163","646",2022-10-03 22:30:00,918,931,13,61,FALSE,NA,"0.1.4"
"3164","646",2022-10-03 22:45:00,918,931,13,61,FALSE,NA,"0.1.4"
"3165","646",2022-10-03 23:00:00,918,931,13,61,FALSE,NA,"0.1.4"
"3166","646",2022-10-03 23:15:00,918,931,13,61,FALSE,NA,"0.1.4"
"3167","646",2022-10-03 23:30:00,918,931,13,61,FALSE,NA,"0.1.4"
"3168","646",2022-10-03 23:45:00,919,931,12,61,FALSE,NA,"0.1.4"
"3169","646",2022-10-04,918,931,13,61,FALSE,NA,"0.1.4"
"3170","646",2022-10-04 00:15:00,918,931,13,61,FALSE,NA,"0.1.4"
"3171","646",2022-10-04 00:30:00,918,931,13,61,FALSE,NA,"0.1.4"
"3172","646",2022-10-04 00:45:00,919,931,12,61,FALSE,NA,"0.1.4"
"3173","646",2022-10-04 01:00:00,919,931,12,61,FALSE,NA,"0.1.4"
"3174","646",2022-10-04 01:15:00,919,931,12,61,FALSE,NA,"0.1.4"
"3175","646",2022-10-04 01:30:00,919,931,12,61,FALSE,NA,"0.1.4"
"3176","646",2022-10-04 01:45:00,918,931,13,61,FALSE,NA,"0.1.4"
"3177","646",2022-10-04 02:00:00,918,931,13,61,FALSE,NA,"0.1.4"
"3178","646",2022-10-04 02:15:00,919,931,12,61,FALSE,NA,"0.1.4"
"3179","646",2022-10-04 02:30:00,919,931,12,61,FALSE,NA,"0.1.4"
"3180","646",2022-10-04 02:45:00,919,931,12,61,FALSE,NA,"0.1.4"
"3181","646",2022-10-04 03:00:00,919,931,12,61,FALSE,NA,"0.1.4"
"3182","646",2022-10-04 03:15:00,919,931,12,61,FALSE,NA,"0.1.4"
"3183","646",2022-10-04 03:30:00,919,931,12,61,FALSE,NA,"0.1.4"
"3184","646",2022-10-04 03:45:00,919,931,12,61,FALSE,NA,"0.1.4"
"3185","646",2022-10-04 04:00:00,918,931,13,61,FALSE,NA,"0.1.4"
"3186","646",2022-10-04 04:15:00,919,931,12,61,FALSE,NA,"0.1.4"
"3187","646",2022-10-04 04:30:00,919,931,12,61,FALSE,NA,"0.1.4"
"3188","646",2022-10-04 04:45:00,919,931,12,61,FALSE,NA,"0.1.4"
"3189","646",2022-10-04 05:00:00,919,931,12,61,FALSE,NA,"0.1.4"
"3190","646",2022-10-04 05:15:00,919,931,12,61,FALSE,NA,"0.1.4"
"3191","646",2022-10-04 05:30:00,919,931,12,61,FALSE,NA,"0.1.4"
"3192","646",2022-10-04 05:45:00,919,931,12,61,FALSE,NA,"0.1.4"
"3193","646",2022-10-04 06:00:00,919,931,12,61,FALSE,NA,"0.1.4"
"3194","646",2022-10-04 06:15:00,919,931,12,61,FALSE,NA,"0.1.4"
"3195","646",2022-10-04 06:30:00,919,931,12,61,FALSE,NA,"0.1.4"
"3196","646",2022-10-04 06:45:00,919,931,12,61,FALSE,NA,"0.1.4"
"3197","646",2022-10-04 07:00:00,919,931,12,61,FALSE,NA,"0.1.4"
"3198","646",2022-10-04 07:15:00,919,931,12,61,FALSE,NA,"0.1.4"
"3199","646",2022-10-04 07:30:00,919,931,12,61,FALSE,NA,"0.1.4"
"3200","646",2022-10-04 07:45:00,919,931,12,61,FALSE,NA,"0.1.4"
"3201","646",2022-10-04 08:00:00,919,931,12,61,FALSE,NA,"0.1.4"
"3202","646",2022-10-04 08:15:00,919,931,12,61,FALSE,NA,"0.1.4"
"3203","646",2022-10-04 08:30:00,919,931,12,61,FALSE,NA,"0.1.4"
"3204","646",2022-10-04 08:45:00,919,931,12,61,FALSE,NA,"0.1.4"
"3205","646",2022-10-04 09:00:00,919,931,12,61,FALSE,NA,"0.1.4"
"3206","646",2022-10-04 09:15:00,919,931,12,61,FALSE,NA,"0.1.4"
"3207","646",2022-10-04 09:30:00,919,931,12,61,FALSE,NA,"0.1.4"
"3208","646",2022-10-04 09:45:00,919,931,12,61,FALSE,NA,"0.1.4"
"3209","646",2022-10-04 10:00:00,919,931,12,61,FALSE,NA,"0.1.4"
"3210","646",2022-10-04 10:15:00,919,931,12,61,FALSE,NA,"0.1.4"
"3211","646",2022-10-04 10:30:00,919,931,12,61,FALSE,NA,"0.1.4"
"3212","646",2022-10-04 10:45:00,919,931,12,61,FALSE,NA,"0.1.4"
"3213","646",2022-10-04 11:00:00,919,931,12,61,FALSE,NA,"0.1.4"
"3214","646",2022-10-04 11:15:00,918,931,13,61,FALSE,NA,"0.1.4"
"3215","646",2022-10-04 11:30:00,918,931,13,61,FALSE,NA,"0.1.4"
"3216","646",2022-10-04 11:45:00,918,931,13,61,FALSE,NA,"0.1.4"
"3217","646",2022-10-04 12:00:00,918,931,13,61,FALSE,NA,"0.1.4"
"3218","646",2022-10-04 12:15:00,918,931,13,61,FALSE,NA,"0.1.4"
"3219","646",2022-10-04 12:30:00,918,931,13,61,FALSE,NA,"0.1.4"
"3220","646",2022-10-04 12:45:00,919,931,12,61,FALSE,NA,"0.1.4"
"3221","646",2022-10-04 13:00:00,919,931,12,61,FALSE,NA,"0.1.4"
"3222","646",2022-10-04 13:15:00,919,931,12,61,FALSE,NA,"0.1.4"
"3223","646",2022-10-04 13:30:00,919,931,12,61,FALSE,NA,"0.1.4"
"3224","646",2022-10-04 13:45:00,919,931,12,61,FALSE,NA,"0.1.4"
"3225","646",2022-10-04 14:00:00,919,931,12,61,FALSE,NA,"0.1.4"
"3226","646",2022-10-04 14:15:00,919,931,12,61,FALSE,NA,"0.1.4"
"3227","646",2022-10-04 14:30:00,919,931,12,61,FALSE,NA,"0.1.4"
"3228","646",2022-10-04 14:45:00,919,931,12,61,FALSE,NA,"0.1.4"
"3229","646",2022-10-04 15:00:00,919,931,12,61,FALSE,NA,"0.1.4"
"3230","646",2022-10-04 15:15:00,919,931,12,61,FALSE,NA,"0.1.4"
"3231","646",2022-10-04 15:30:00,919,931,12,61,FALSE,NA,"0.1.4"
"3232","646",2022-10-04 15:45:00,919,931,12,61,FALSE,NA,"0.1.4"
"3233","646",2022-10-04 16:00:00,919,931,12,61,FALSE,NA,"0.1.4"
"3234","646",2022-10-04 16:15:00,919,931,12,61,FALSE,NA,"0.1.4"
"3235","646",2022-10-04 16:30:00,919,931,12,61,FALSE,NA,"0.1.4"
"3236","646",2022-10-04 16:45:00,919,931,12,61,FALSE,NA,"0.1.4"
"3237","646",2022-10-04 17:00:00,919,931,12,61,FALSE,NA,"0.1.4"
"3238","646",2022-10-04 17:15:00,919,931,12,61,FALSE,NA,"0.1.4"
"3239","646",2022-10-04 17:30:00,919,931,12,61,FALSE,NA,"0.1.4"
"3240","646",2022-10-04 17:45:00,919,931,12,61,FALSE,NA,"0.1.4"
"3241","646",2022-10-04 18:00:00,919,931,12,61,FALSE,NA,"0.1.4"
"3242","646",2022-10-04 18:15:00,919,931,12,61,FALSE,NA,"0.1.4"
"3243","646",2022-10-04 18:30:00,919,931,12,61,FALSE,NA,"0.1.4"
"3244","646",2022-10-04 18:45:00,919,931,12,61,FALSE,NA,"0.1.4"
"3245","646",2022-10-04 19:00:00,919,931,12,61,FALSE,NA,"0.1.4"
"3246","646",2022-10-04 19:15:00,919,931,12,61,FALSE,NA,"0.1.4"
"3247","646",2022-10-04 19:30:00,919,931,12,61,FALSE,NA,"0.1.4"
"3248","646",2022-10-04 19:45:00,919,931,12,61,FALSE,NA,"0.1.4"
"3249","646",2022-10-04 20:00:00,919,931,12,61,FALSE,NA,"0.1.4"
"3250","646",2022-10-04 20:15:00,919,931,12,61,FALSE,NA,"0.1.4"
"3251","646",2022-10-04 20:30:00,919,931,12,61,FALSE,NA,"0.1.4"
"3252","646",2022-10-04 20:45:00,919,931,12,61,FALSE,NA,"0.1.4"
"3253","646",2022-10-04 21:00:00,919,931,12,61,FALSE,NA,"0.1.4"
"3254","646",2022-10-04 21:15:00,919,931,12,61,FALSE,NA,"0.1.4"
"3255","646",2022-10-04 21:30:00,919,931,12,61,FALSE,NA,"0.1.4"
"3256","646",2022-10-04 21:45:00,919,931,12,61,FALSE,NA,"0.1.4"
"3257","646",2022-10-04 22:00:00,919,931,12,61,FALSE,NA,"0.1.4"
"3258","646",2022-10-04 22:15:00,919,931,12,61,FALSE,NA,"0.1.4"
"3259","646",2022-10-04 22:30:00,918,931,13,61,FALSE,NA,"0.1.4"
"3260","646",2022-10-04 22:45:00,918,931,13,61,FALSE,NA,"0.1.4"
"3261","646",2022-10-04 23:00:00,918,931,13,61,FALSE,NA,"0.1.4"
"3262","646",2022-10-04 23:15:00,918,931,13,61,FALSE,NA,"0.1.4"
"3263","646",2022-10-04 23:30:00,918,931,13,61,FALSE,NA,"0.1.4"
"3264","646",2022-10-04 23:45:00,917,931,14,61,FALSE,NA,"0.1.4"
"3265","646",2022-10-05,918,931,13,61,FALSE,NA,"0.1.4"
"3266","646",2022-10-05 00:15:00,917,931,14,61,FALSE,NA,"0.1.4"
"3267","646",2022-10-05 00:30:00,917,931,14,61,FALSE,NA,"0.1.4"
"3268","646",2022-10-05 00:45:00,917,931,14,61,FALSE,NA,"0.1.4"
"3269","646",2022-10-05 01:00:00,917,931,14,61,FALSE,NA,"0.1.4"
"3270","646",2022-10-05 01:15:00,917,931,14,61,FALSE,NA,"0.1.4"
"3271","646",2022-10-05 01:30:00,917,931,14,61,FALSE,NA,"0.1.4"
"3272","646",2022-10-05 01:45:00,917,931,14,61,FALSE,NA,"0.1.4"
"3273","646",2022-10-05 02:00:00,917,931,14,61,FALSE,NA,"0.1.4"
"3274","646",2022-10-05 02:15:00,917,931,14,61,FALSE,NA,"0.1.4"
"3275","646",2022-10-05 02:30:00,917,931,14,61,FALSE,NA,"0.1.4"
"3276","646",2022-10-05 02:45:00,917,931,14,61,FALSE,NA,"0.1.4"
"3277","646",2022-10-05 03:00:00,917,931,14,61,FALSE,NA,"0.1.4"
"3278","646",2022-10-05 03:15:00,917,931,14,61,FALSE,NA,"0.1.4"
"3279","646",2022-10-05 03:30:00,917,931,14,61,FALSE,NA,"0.1.4"
"3280","646",2022-10-05 03:45:00,917,931,14,61,FALSE,NA,"0.1.4"
"3281","646",2022-10-05 04:00:00,917,931,14,61,FALSE,NA,"0.1.4"
"3282","646",2022-10-05 04:15:00,917,931,14,61,FALSE,NA,"0.1.4"
"3283","646",2022-10-05 04:30:00,917,931,14,61,FALSE,NA,"0.1.4"
"3284","646",2022-10-05 04:45:00,917,931,14,61,FALSE,NA,"0.1.4"
"3285","646",2022-10-05 05:00:00,917,931,14,61,FALSE,NA,"0.1.4"
"3286","646",2022-10-05 05:15:00,917,931,14,61,FALSE,NA,"0.1.4"
"3287","646",2022-10-05 05:30:00,917,931,14,61,FALSE,NA,"0.1.4"
"3288","646",2022-10-05 05:45:00,917,931,14,61,FALSE,NA,"0.1.4"
"3289","646",2022-10-05 06:00:00,917,931,14,61,FALSE,NA,"0.1.4"
"3290","646",2022-10-05 06:15:00,917,931,14,61,FALSE,NA,"0.1.4"
"3291","646",2022-10-05 06:30:00,917,931,14,61,FALSE,NA,"0.1.4"
"3292","646",2022-10-05 06:45:00,918,931,13,61,FALSE,NA,"0.1.4"
"3293","646",2022-10-05 07:00:00,918,931,13,61,FALSE,NA,"0.1.4"
"3294","646",2022-10-05 07:15:00,918,931,13,61,FALSE,NA,"0.1.4"
"3295","646",2022-10-05 07:30:00,918,931,13,61,FALSE,NA,"0.1.4"
"3296","646",2022-10-05 07:45:00,918,931,13,61,FALSE,NA,"0.1.4"
"3297","646",2022-10-05 08:00:00,917,931,14,61,FALSE,NA,"0.1.4"
"3298","646",2022-10-05 08:15:00,917,931,14,61,FALSE,NA,"0.1.4"
"3299","646",2022-10-05 08:30:00,917,931,14,61,FALSE,NA,"0.1.4"
"3300","646",2022-10-05 08:45:00,917,931,14,61,FALSE,NA,"0.1.4"
"3301","646",2022-10-05 09:00:00,917,931,14,61,FALSE,NA,"0.1.4"
"3302","646",2022-10-05 09:15:00,917,931,14,61,FALSE,NA,"0.1.4"
"3303","646",2022-10-05 09:30:00,917,931,14,61,FALSE,NA,"0.1.4"
"3304","646",2022-10-05 09:45:00,917,931,14,61,FALSE,NA,"0.1.4"
"3305","646",2022-10-05 10:00:00,918,931,13,61,FALSE,NA,"0.1.4"
"3306","646",2022-10-05 10:15:00,918,931,13,61,FALSE,NA,"0.1.4"
"3307","646",2022-10-05 10:30:00,918,931,13,61,FALSE,NA,"0.1.4"
"3308","646",2022-10-05 10:45:00,918,931,13,61,FALSE,NA,"0.1.4"
"3309","646",2022-10-05 11:00:00,918,931,13,61,FALSE,NA,"0.1.4"
"3310","646",2022-10-05 11:15:00,917,931,14,61,FALSE,NA,"0.1.4"
"3311","646",2022-10-05 11:30:00,917,931,14,61,FALSE,NA,"0.1.4"
"3312","646",2022-10-05 11:45:00,917,931,14,61,FALSE,NA,"0.1.4"
"3313","646",2022-10-05 12:00:00,917,931,14,61,FALSE,NA,"0.1.4"
"3314","646",2022-10-05 12:15:00,917,931,14,61,FALSE,NA,"0.1.4"
"3315","646",2022-10-05 12:30:00,917,931,14,61,FALSE,NA,"0.1.4"
"3316","646",2022-10-05 12:45:00,917,931,14,61,FALSE,NA,"0.1.4"
"3317","646",2022-10-05 13:00:00,917,931,14,61,FALSE,NA,"0.1.4"
"3318","646",2022-10-05 13:15:00,917,931,14,61,FALSE,NA,"0.1.4"
"3319","646",2022-10-05 13:30:00,917,931,14,61,FALSE,NA,"0.1.4"
"3320","646",2022-10-05 13:45:00,917,931,14,61,FALSE,NA,"0.1.4"
"3321","646",2022-10-05 14:00:00,917,931,14,61,FALSE,NA,"0.1.4"
"3322","646",2022-10-05 14:15:00,918,931,13,61,FALSE,NA,"0.1.4"
"3323","646",2022-10-05 14:30:00,917,931,14,61,FALSE,NA,"0.1.4"
"3324","646",2022-10-05 14:45:00,918,931,13,61,FALSE,NA,"0.1.4"
"3325","646",2022-10-05 15:00:00,918,931,13,61,FALSE,NA,"0.1.4"
"3326","646",2022-10-05 15:15:00,918,931,13,61,FALSE,NA,"0.1.4"
"3327","646",2022-10-05 15:30:00,918,931,13,61,FALSE,NA,"0.1.4"
"3328","646",2022-10-05 15:45:00,918,931,13,61,FALSE,NA,"0.1.4"
"3329","646",2022-10-05 16:00:00,918,931,13,61,FALSE,NA,"0.1.4"
"3330","646",2022-10-05 16:15:00,918,931,13,61,FALSE,NA,"0.1.4"
"3331","646",2022-10-05 16:30:00,918,931,13,61,FALSE,NA,"0.1.4"
"3332","646",2022-10-05 16:45:00,918,931,13,61,FALSE,NA,"0.1.4"
"3333","646",2022-10-05 17:00:00,918,931,13,61,FALSE,NA,"0.1.4"
"3334","646",2022-10-05 17:15:00,918,931,13,61,FALSE,NA,"0.1.4"
"3335","646",2022-10-05 17:30:00,918,931,13,61,FALSE,NA,"0.1.4"
"3336","646",2022-10-05 17:45:00,918,931,13,61,FALSE,NA,"0.1.4"
"3337","646",2022-10-05 18:00:00,918,931,13,61,FALSE,NA,"0.1.4"
"3338","646",2022-10-05 18:15:00,918,931,13,61,FALSE,NA,"0.1.4"
"3339","646",2022-10-05 18:30:00,918,931,13,61,FALSE,NA,"0.1.4"
"3340","646",2022-10-05 18:45:00,918,931,13,61,FALSE,NA,"0.1.4"
"3341","646",2022-10-05 19:00:00,918,931,13,61,FALSE,NA,"0.1.4"
"3342","646",2022-10-05 19:15:00,918,931,13,61,FALSE,NA,"0.1.4"
"3343","646",2022-10-05 19:30:00,918,931,13,61,FALSE,NA,"0.1.4"
"3344","646",2022-10-05 19:45:00,918,931,13,61,FALSE,NA,"0.1.4"
"3345","646",2022-10-05 20:00:00,918,931,13,61,FALSE,NA,"0.1.4"
"3346","646",2022-10-05 20:15:00,918,931,13,61,FALSE,NA,"0.1.4"
"3347","646",2022-10-05 20:30:00,918,931,13,61,FALSE,NA,"0.1.4"
"3348","646",2022-10-05 20:45:00,918,931,13,61,FALSE,NA,"0.1.4"
"3349","646",2022-10-05 21:00:00,918,931,13,61,FALSE,NA,"0.1.4"
"3350","646",2022-10-05 21:15:00,918,931,13,61,FALSE,NA,"0.1.4"
"3351","646",2022-10-05 21:30:00,918,931,13,61,FALSE,NA,"0.1.4"
"3352","646",2022-10-05 21:45:00,918,931,13,61,FALSE,NA,"0.1.4"
"3353","646",2022-10-05 22:00:00,918,931,13,61,FALSE,NA,"0.1.4"
"3354","646",2022-10-05 22:15:00,918,931,13,61,FALSE,NA,"0.1.4"
"3355","646",2022-10-05 22:30:00,918,931,13,61,FALSE,NA,"0.1.4"
"3356","646",2022-10-05 22:45:00,918,931,13,61,FALSE,NA,"0.1.4"
"3357","646",2022-10-05 23:00:00,918,931,13,61,FALSE,NA,"0.1.4"
"3358","646",2022-10-05 23:15:00,918,931,13,61,FALSE,NA,"0.1.4"
"3359","646",2022-10-05 23:30:00,918,931,13,61,FALSE,NA,"0.1.4"
"3360","646",2022-10-05 23:45:00,918,931,13,61,FALSE,NA,"0.1.4"
"3361","646",2022-10-06,918,931,13,61,FALSE,NA,"0.1.4"
"3362","646",2022-10-06 00:15:00,918,931,13,61,FALSE,NA,"0.1.4"
"3363","646",2022-10-06 00:30:00,918,931,13,61,FALSE,NA,"0.1.4"
"3364","646",2022-10-06 00:45:00,918,931,13,61,FALSE,NA,"0.1.4"
"3365","646",2022-10-06 01:00:00,918,931,13,61,FALSE,NA,"0.1.4"
"3366","646",2022-10-06 01:15:00,918,931,13,61,FALSE,NA,"0.1.4"
"3367","646",2022-10-06 01:30:00,917,931,14,61,FALSE,NA,"0.1.4"
"3368","646",2022-10-06 01:45:00,917,931,14,61,FALSE,NA,"0.1.4"
"3369","646",2022-10-06 02:00:00,917,931,14,61,FALSE,NA,"0.1.4"
"3370","646",2022-10-06 02:15:00,918,931,13,61,FALSE,NA,"0.1.4"
"3371","646",2022-10-06 02:30:00,918,931,13,61,FALSE,NA,"0.1.4"
"3372","646",2022-10-06 02:45:00,918,931,13,61,FALSE,NA,"0.1.4"
"3373","646",2022-10-06 03:00:00,918,931,13,61,FALSE,NA,"0.1.4"
"3374","646",2022-10-06 03:15:00,917,931,14,61,FALSE,NA,"0.1.4"
"3375","646",2022-10-06 03:30:00,918,931,13,61,FALSE,NA,"0.1.4"
"3376","646",2022-10-06 03:45:00,918,931,13,61,FALSE,NA,"0.1.4"
"3377","646",2022-10-06 04:00:00,918,931,13,61,FALSE,NA,"0.1.4"
"3378","646",2022-10-06 04:15:00,918,931,13,61,FALSE,NA,"0.1.4"
"3379","646",2022-10-06 04:30:00,918,931,13,61,FALSE,NA,"0.1.4"
"3380","646",2022-10-06 04:45:00,918,931,13,61,FALSE,NA,"0.1.4"
"3381","646",2022-10-06 05:00:00,918,931,13,61,FALSE,NA,"0.1.4"
"3382","646",2022-10-06 05:15:00,918,931,13,61,FALSE,NA,"0.1.4"
"3383","646",2022-10-06 05:30:00,918,931,13,61,FALSE,NA,"0.1.4"
"3384","646",2022-10-06 05:45:00,918,931,13,61,FALSE,NA,"0.1.4"
"3385","646",2022-10-06 06:00:00,918,931,13,61,FALSE,NA,"0.1.4"
"3386","646",2022-10-06 06:15:00,918,931,13,61,FALSE,NA,"0.1.4"
"3387","646",2022-10-06 06:30:00,918,931,13,61,FALSE,NA,"0.1.4"
"3388","646",2022-10-06 06:45:00,918,931,13,61,FALSE,NA,"0.1.4"
"3389","646",2022-10-06 07:00:00,918,931,13,61,FALSE,NA,"0.1.4"
"3390","646",2022-10-06 07:15:00,918,931,13,61,FALSE,NA,"0.1.4"
"3391","646",2022-10-06 07:30:00,918,931,13,61,FALSE,NA,"0.1.4"
"3392","646",2022-10-06 07:45:00,918,931,13,61,FALSE,NA,"0.1.4"
"3393","646",2022-10-06 08:00:00,918,931,13,61,FALSE,NA,"0.1.4"
"3394","646",2022-10-06 08:15:00,918,931,13,61,FALSE,NA,"0.1.4"
"3395","646",2022-10-06 08:30:00,918,931,13,61,FALSE,NA,"0.1.4"
"3396","646",2022-10-06 08:45:00,918,931,13,61,FALSE,NA,"0.1.4"
"3397","646",2022-10-06 09:00:00,918,931,13,61,FALSE,NA,"0.1.4"
"3398","646",2022-10-06 09:15:00,918,931,13,61,FALSE,NA,"0.1.4"
"3399","646",2022-10-06 09:30:00,918,931,13,61,FALSE,NA,"0.1.4"
"3400","646",2022-10-06 09:45:00,918,931,13,61,FALSE,NA,"0.1.4"
"3401","646",2022-10-06 10:00:00,918,931,13,61,FALSE,NA,"0.1.4"
"3402","646",2022-10-06 10:15:00,918,931,13,61,FALSE,NA,"0.1.4"
"3403","646",2022-10-06 10:30:00,918,931,13,61,FALSE,NA,"0.1.4"
"3404","646",2022-10-06 10:45:00,918,931,13,61,FALSE,NA,"0.1.4"
"3405","646",2022-10-06 11:00:00,918,931,13,61,FALSE,NA,"0.1.4"
"3406","646",2022-10-06 11:15:00,918,931,13,61,FALSE,NA,"0.1.4"
"3407","646",2022-10-06 11:30:00,918,931,13,61,FALSE,NA,"0.1.4"
"3408","646",2022-10-06 11:45:00,918,931,13,61,FALSE,NA,"0.1.4"
"3409","646",2022-10-06 12:00:00,918,931,13,61,FALSE,NA,"0.1.4"
"3410","646",2022-10-06 12:15:00,918,931,13,61,FALSE,NA,"0.1.4"
"3411","646",2022-10-06 12:30:00,918,931,13,61,FALSE,NA,"0.1.4"
"3412","646",2022-10-06 12:45:00,918,931,13,61,FALSE,NA,"0.1.4"
"3413","646",2022-10-06 13:00:00,918,931,13,61,FALSE,NA,"0.1.4"
"3414","646",2022-10-06 13:15:00,918,931,13,61,FALSE,NA,"0.1.4"
"3415","646",2022-10-06 13:30:00,918,931,13,61,FALSE,NA,"0.1.4"
"3416","646",2022-10-06 13:45:00,918,931,13,61,FALSE,NA,"0.1.4"
"3417","646",2022-10-06 14:00:00,918,931,13,61,FALSE,NA,"0.1.4"
"3418","646",2022-10-06 14:15:00,918,931,13,61,FALSE,NA,"0.1.4"
"3419","646",2022-10-06 14:30:00,918,931,13,61,FALSE,NA,"0.1.4"
"3420","646",2022-10-06 14:45:00,918,931,13,61,FALSE,NA,"0.1.4"
"3421","646",2022-10-06 15:00:00,918,931,13,61,FALSE,NA,"0.1.4"
"3422","646",2022-10-06 15:15:00,918,931,13,61,FALSE,NA,"0.1.4"
"3423","646",2022-10-06 15:30:00,918,931,13,61,FALSE,NA,"0.1.4"
"3424","646",2022-10-06 15:45:00,918,931,13,61,FALSE,NA,"0.1.4"
"3425","646",2022-10-06 16:00:00,918,931,13,61,FALSE,NA,"0.1.4"
"3426","646",2022-10-06 16:15:00,918,931,13,61,FALSE,NA,"0.1.4"
"3427","646",2022-10-06 16:30:00,918,931,13,61,FALSE,NA,"0.1.4"
"3428","646",2022-10-06 16:45:00,918,931,13,61,FALSE,NA,"0.1.4"
"3429","646",2022-10-06 17:00:00,918,931,13,61,FALSE,NA,"0.1.4"
"3430","646",2022-10-06 17:15:00,919,931,12,61,FALSE,NA,"0.1.4"
"3431","646",2022-10-06 17:30:00,919,931,12,61,FALSE,NA,"0.1.4"
"3432","646",2022-10-06 17:45:00,919,931,12,61,FALSE,NA,"0.1.4"
"3433","646",2022-10-06 18:00:00,919,931,12,61,FALSE,NA,"0.1.4"
"3434","646",2022-10-06 18:15:00,919,931,12,61,FALSE,NA,"0.1.4"
"3435","646",2022-10-06 18:30:00,919,931,12,61,FALSE,NA,"0.1.4"
"3436","646",2022-10-06 18:45:00,919,931,12,61,FALSE,NA,"0.1.4"
"3437","646",2022-10-06 19:00:00,919,931,12,61,FALSE,NA,"0.1.4"
"3438","646",2022-10-06 19:15:00,919,931,12,61,FALSE,NA,"0.1.4"
"3439","646",2022-10-06 19:30:00,919,931,12,61,FALSE,NA,"0.1.4"
"3440","646",2022-10-06 19:45:00,919,931,12,61,FALSE,NA,"0.1.4"
"3441","646",2022-10-06 20:00:00,918,931,13,61,FALSE,NA,"0.1.4"
"3442","646",2022-10-06 20:15:00,918,931,13,61,FALSE,NA,"0.1.4"
"3443","646",2022-10-06 20:30:00,919,931,12,61,FALSE,NA,"0.1.4"
"3444","646",2022-10-06 20:45:00,918,931,13,61,FALSE,NA,"0.1.4"
"3445","646",2022-10-06 21:00:00,918,931,13,61,FALSE,NA,"0.1.4"
"3446","646",2022-10-06 21:15:00,918,931,13,61,FALSE,NA,"0.1.4"
"3447","646",2022-10-06 21:30:00,918,931,13,61,FALSE,NA,"0.1.4"
"3448","646",2022-10-06 21:45:00,918,931,13,61,FALSE,NA,"0.1.4"
"3449","646",2022-10-06 22:00:00,918,931,13,61,FALSE,NA,"0.1.4"
"3450","646",2022-10-06 22:15:00,918,931,13,61,FALSE,NA,"0.1.4"
"3451","646",2022-10-06 22:30:00,918,931,13,61,FALSE,NA,"0.1.4"
"3452","646",2022-10-06 22:45:00,918,931,13,61,FALSE,NA,"0.1.4"
"3453","646",2022-10-06 23:00:00,918,931,13,61,FALSE,NA,"0.1.4"
"3454","646",2022-10-06 23:15:00,918,931,13,61,FALSE,NA,"0.1.4"
"3455","646",2022-10-06 23:30:00,917,931,14,61,FALSE,NA,"0.1.4"
"3456","646",2022-10-06 23:45:00,917,931,14,61,FALSE,NA,"0.1.4"
"3457","646",2022-10-07,917,931,14,61,FALSE,NA,"0.1.4"
"3458","646",2022-10-07 00:15:00,917,931,14,61,FALSE,NA,"0.1.4"
"3459","646",2022-10-07 00:30:00,916,931,15,61,FALSE,NA,"0.1.4"
"3460","646",2022-10-07 00:45:00,916,931,15,61,FALSE,NA,"0.1.4"
"3461","646",2022-10-07 01:00:00,916,931,15,61,FALSE,NA,"0.1.4"
"3462","646",2022-10-07 01:15:00,916,931,15,61,FALSE,NA,"0.1.4"
"3463","646",2022-10-07 01:30:00,916,931,15,61,FALSE,NA,"0.1.4"
"3464","646",2022-10-07 01:45:00,916,931,15,61,FALSE,NA,"0.1.4"
"3465","646",2022-10-07 02:00:00,916,931,15,61,FALSE,NA,"0.1.4"
"3466","646",2022-10-07 02:15:00,916,931,15,61,FALSE,NA,"0.1.4"
"3467","646",2022-10-07 02:30:00,916,931,15,61,FALSE,NA,"0.1.4"
"3468","646",2022-10-07 02:45:00,916,931,15,61,FALSE,NA,"0.1.4"
"3469","646",2022-10-07 03:00:00,916,931,15,61,FALSE,NA,"0.1.4"
"3470","646",2022-10-07 03:15:00,916,931,15,61,FALSE,NA,"0.1.4"
"3471","646",2022-10-07 03:30:00,916,931,15,61,FALSE,NA,"0.1.4"
"3472","646",2022-10-07 03:45:00,916,931,15,61,FALSE,NA,"0.1.4"
"3473","646",2022-10-07 04:00:00,916,931,15,61,FALSE,NA,"0.1.4"
"3474","646",2022-10-07 04:15:00,916,931,15,61,FALSE,NA,"0.1.4"
"3475","646",2022-10-07 04:30:00,916,931,15,61,FALSE,NA,"0.1.4"
"3476","646",2022-10-07 04:45:00,916,931,15,61,FALSE,NA,"0.1.4"
"3477","646",2022-10-07 05:00:00,916,931,15,61,FALSE,NA,"0.1.4"
"3478","646",2022-10-07 05:15:00,916,931,15,61,FALSE,NA,"0.1.4"
"3479","646",2022-10-07 05:30:00,916,931,15,61,FALSE,NA,"0.1.4"
"3480","646",2022-10-07 05:45:00,916,931,15,61,FALSE,NA,"0.1.4"
"3481","646",2022-10-07 06:00:00,916,931,15,61,FALSE,NA,"0.1.4"
"3482","646",2022-10-07 06:15:00,916,931,15,61,FALSE,NA,"0.1.4"
"3483","646",2022-10-07 06:30:00,916,931,15,61,FALSE,NA,"0.1.4"
"3484","646",2022-10-07 06:45:00,916,931,15,61,FALSE,NA,"0.1.4"
"3485","646",2022-10-07 07:00:00,916,931,15,61,FALSE,NA,"0.1.4"
"3486","646",2022-10-07 07:15:00,916,931,15,61,FALSE,NA,"0.1.4"
"3487","646",2022-10-07 07:30:00,916,931,15,61,FALSE,NA,"0.1.4"
"3488","646",2022-10-07 07:45:00,916,931,15,61,FALSE,NA,"0.1.4"
"3489","646",2022-10-07 08:00:00,916,931,15,61,FALSE,NA,"0.1.4"
"3490","646",2022-10-07 08:15:00,916,931,15,61,FALSE,NA,"0.1.4"
"3491","646",2022-10-07 08:30:00,916,931,15,61,FALSE,NA,"0.1.4"
"3492","646",2022-10-07 08:45:00,916,931,15,61,FALSE,NA,"0.1.4"
"3493","646",2022-10-07 09:00:00,916,931,15,61,FALSE,NA,"0.1.4"
"3494","646",2022-10-07 09:15:00,916,931,15,61,FALSE,NA,"0.1.4"
"3495","646",2022-10-07 09:30:00,917,931,14,61,FALSE,NA,"0.1.4"
"3496","646",2022-10-07 09:45:00,916,931,15,61,FALSE,NA,"0.1.4"
"3497","646",2022-10-07 10:00:00,916,931,15,61,FALSE,NA,"0.1.4"
"3498","646",2022-10-07 10:15:00,916,931,15,61,FALSE,NA,"0.1.4"
"3499","646",2022-10-07 10:30:00,917,931,14,61,FALSE,NA,"0.1.4"
"3500","646",2022-10-07 10:45:00,917,931,14,61,FALSE,NA,"0.1.4"
"3501","646",2022-10-07 11:00:00,917,931,14,61,FALSE,NA,"0.1.4"
"3502","646",2022-10-07 11:15:00,917,931,14,61,FALSE,NA,"0.1.4"
"3503","646",2022-10-07 11:30:00,917,931,14,61,FALSE,NA,"0.1.4"
"3504","646",2022-10-07 11:45:00,916,931,15,61,FALSE,NA,"0.1.4"
"3505","646",2022-10-07 12:00:00,916,931,15,61,FALSE,NA,"0.1.4"
"3506","646",2022-10-07 12:15:00,916,931,15,61,FALSE,NA,"0.1.4"
"3507","646",2022-10-07 12:30:00,917,931,14,61,FALSE,NA,"0.1.4"
"3508","646",2022-10-07 12:45:00,917,931,14,61,FALSE,NA,"0.1.4"
"3509","646",2022-10-07 13:00:00,916,931,15,61,FALSE,NA,"0.1.4"
"3510","646",2022-10-07 13:15:00,917,931,14,61,FALSE,NA,"0.1.4"
"3511","646",2022-10-07 13:30:00,916,931,15,61,FALSE,NA,"0.1.4"
"3512","646",2022-10-07 13:45:00,916,931,15,61,FALSE,NA,"0.1.4"
"3513","646",2022-10-07 14:00:00,916,931,15,61,FALSE,NA,"0.1.4"
"3514","646",2022-10-07 14:15:00,916,931,15,61,FALSE,NA,"0.1.4"
"3515","646",2022-10-07 14:30:00,916,931,15,61,FALSE,NA,"0.1.4"
"3516","646",2022-10-07 14:45:00,916,931,15,61,FALSE,NA,"0.1.4"
"3517","646",2022-10-07 15:00:00,916,931,15,61,FALSE,NA,"0.1.4"
"3518","646",2022-10-07 15:15:00,917,931,14,61,FALSE,NA,"0.1.4"
"3519","646",2022-10-07 15:30:00,917,931,14,61,FALSE,NA,"0.1.4"
"3520","646",2022-10-07 15:45:00,917,931,14,61,FALSE,NA,"0.1.4"
"3521","646",2022-10-07 16:00:00,917,931,14,61,FALSE,NA,"0.1.4"
"3522","646",2022-10-07 16:15:00,917,931,14,61,FALSE,NA,"0.1.4"
"3523","646",2022-10-07 16:30:00,917,931,14,61,FALSE,NA,"0.1.4"
"3524","646",2022-10-07 16:45:00,917,931,14,61,FALSE,NA,"0.1.4"
"3525","646",2022-10-07 17:00:00,917,931,14,61,FALSE,NA,"0.1.4"
"3526","646",2022-10-07 17:15:00,917,931,14,61,FALSE,NA,"0.1.4"
"3527","646",2022-10-07 17:30:00,917,931,14,61,FALSE,NA,"0.1.4"
"3528","646",2022-10-07 17:45:00,917,931,14,61,FALSE,NA,"0.1.4"
"3529","646",2022-10-07 18:00:00,917,931,14,61,FALSE,NA,"0.1.4"
"3530","646",2022-10-07 18:15:00,917,931,14,61,FALSE,NA,"0.1.4"
"3531","646",2022-10-07 18:30:00,917,931,14,61,FALSE,NA,"0.1.4"
"3532","646",2022-10-07 18:45:00,917,931,14,61,FALSE,NA,"0.1.4"
"3533","646",2022-10-07 19:00:00,917,931,14,61,FALSE,NA,"0.1.4"
"3534","646",2022-10-07 19:15:00,917,931,14,61,FALSE,NA,"0.1.4"
"3535","646",2022-10-07 19:30:00,917,931,14,61,FALSE,NA,"0.1.4"
"3536","646",2022-10-07 19:45:00,917,931,14,61,FALSE,NA,"0.1.4"
"3537","646",2022-10-07 20:00:00,917,931,14,61,FALSE,NA,"0.1.4"
"3538","646",2022-10-07 20:15:00,917,931,14,61,FALSE,NA,"0.1.4"
"3539","646",2022-10-07 20:30:00,917,931,14,61,FALSE,NA,"0.1.4"
"3540","646",2022-10-07 20:45:00,916,931,15,61,FALSE,NA,"0.1.4"
"3541","646",2022-10-07 21:00:00,916,931,15,61,FALSE,NA,"0.1.4"
"3542","646",2022-10-07 21:15:00,916,931,15,61,FALSE,NA,"0.1.4"
"3543","646",2022-10-07 21:30:00,916,931,15,61,FALSE,NA,"0.1.4"
"3544","646",2022-10-07 21:45:00,916,931,15,61,FALSE,NA,"0.1.4"
"3545","646",2022-10-07 22:00:00,914,931,17,61,FALSE,NA,"0.1.4"
"3546","646",2022-10-07 22:15:00,913,931,18,61,FALSE,NA,"0.1.4"
"3547","646",2022-10-07 22:30:00,913,931,18,61,FALSE,NA,"0.1.4"
"3548","646",2022-10-07 22:45:00,914,931,17,61,FALSE,NA,"0.1.4"
"3549","646",2022-10-07 23:00:00,914,931,17,61,FALSE,NA,"0.1.4"
"3550","646",2022-10-07 23:15:00,914,931,17,61,FALSE,NA,"0.1.4"
"3551","646",2022-10-07 23:30:00,913,931,18,61,FALSE,NA,"0.1.4"
"3552","646",2022-10-07 23:45:00,913,931,18,61,FALSE,NA,"0.1.4"
"3553","646",2022-10-08,913,931,18,61,FALSE,NA,"0.1.4"
"3554","646",2022-10-08 00:15:00,913,931,18,61,FALSE,NA,"0.1.4"
"3555","646",2022-10-08 00:30:00,913,931,18,61,FALSE,NA,"0.1.4"
"3556","646",2022-10-08 00:45:00,913,931,18,61,FALSE,NA,"0.1.4"
"3557","646",2022-10-08 01:00:00,913,931,18,61,FALSE,NA,"0.1.4"
"3558","646",2022-10-08 01:15:00,913,931,18,61,FALSE,NA,"0.1.4"
"3559","646",2022-10-08 01:30:00,913,931,18,61,FALSE,NA,"0.1.4"
"3560","646",2022-10-08 01:45:00,913,931,18,61,FALSE,NA,"0.1.4"
"3561","646",2022-10-08 02:00:00,913,931,18,61,FALSE,NA,"0.1.4"
"3562","646",2022-10-08 02:15:00,913,931,18,61,FALSE,NA,"0.1.4"
"3563","646",2022-10-08 02:30:00,913,931,18,61,FALSE,NA,"0.1.4"
"3564","646",2022-10-08 02:45:00,913,931,18,61,FALSE,NA,"0.1.4"
"3565","646",2022-10-08 03:00:00,913,931,18,61,FALSE,NA,"0.1.4"
"3566","646",2022-10-08 03:15:00,913,931,18,61,FALSE,NA,"0.1.4"
"3567","646",2022-10-08 03:30:00,913,931,18,61,FALSE,NA,"0.1.4"
"3568","646",2022-10-08 03:45:00,913,931,18,61,FALSE,NA,"0.1.4"
"3569","646",2022-10-08 04:00:00,913,931,18,61,FALSE,NA,"0.1.4"
"3570","646",2022-10-08 04:15:00,913,931,18,61,FALSE,NA,"0.1.4"
"3571","646",2022-10-08 04:30:00,913,931,18,61,FALSE,NA,"0.1.4"
"3572","646",2022-10-08 04:45:00,913,931,18,61,FALSE,NA,"0.1.4"
"3573","646",2022-10-08 05:00:00,913,931,18,61,FALSE,NA,"0.1.4"
"3574","646",2022-10-08 05:15:00,913,931,18,61,FALSE,NA,"0.1.4"
"3575","646",2022-10-08 05:30:00,914,931,17,61,FALSE,NA,"0.1.4"
"3576","646",2022-10-08 05:45:00,914,931,17,61,FALSE,NA,"0.1.4"
"3577","646",2022-10-08 06:00:00,914,931,17,61,FALSE,NA,"0.1.4"
"3578","646",2022-10-08 06:15:00,913,931,18,61,FALSE,NA,"0.1.4"
"3579","646",2022-10-08 06:30:00,913,931,18,61,FALSE,NA,"0.1.4"
"3580","646",2022-10-08 06:45:00,914,931,17,61,FALSE,NA,"0.1.4"
"3581","646",2022-10-08 07:00:00,914,931,17,61,FALSE,NA,"0.1.4"
"3582","646",2022-10-08 07:15:00,914,931,17,61,FALSE,NA,"0.1.4"
"3583","646",2022-10-08 07:30:00,914,931,17,61,FALSE,NA,"0.1.4"
"3584","646",2022-10-08 07:45:00,914,931,17,61,FALSE,NA,"0.1.4"
"3585","646",2022-10-08 08:00:00,914,931,17,61,FALSE,NA,"0.1.4"
"3586","646",2022-10-08 08:15:00,914,931,17,61,FALSE,NA,"0.1.4"
"3587","646",2022-10-08 08:30:00,914,931,17,61,FALSE,NA,"0.1.4"
"3588","646",2022-10-08 08:45:00,914,931,17,61,FALSE,NA,"0.1.4"
"3589","646",2022-10-08 09:00:00,914,931,17,61,FALSE,NA,"0.1.4"
"3590","646",2022-10-08 09:15:00,914,931,17,61,FALSE,NA,"0.1.4"
"3591","646",2022-10-08 09:30:00,914,931,17,61,FALSE,NA,"0.1.4"
"3592","646",2022-10-08 09:45:00,914,931,17,61,FALSE,NA,"0.1.4"
"3593","646",2022-10-08 10:00:00,914,931,17,61,FALSE,NA,"0.1.4"
"3594","646",2022-10-08 10:15:00,914,931,17,61,FALSE,NA,"0.1.4"
"3595","646",2022-10-08 10:30:00,914,931,17,61,FALSE,NA,"0.1.4"
"3596","646",2022-10-08 10:45:00,914,931,17,61,FALSE,NA,"0.1.4"
"3597","646",2022-10-08 11:00:00,914,931,17,61,FALSE,NA,"0.1.4"
"3598","646",2022-10-08 11:15:00,914,931,17,61,FALSE,NA,"0.1.4"
"3599","646",2022-10-08 11:30:00,914,931,17,61,FALSE,NA,"0.1.4"
"3600","646",2022-10-08 11:45:00,914,931,17,61,FALSE,NA,"0.1.4"
"3601","646",2022-10-08 12:00:00,914,931,17,61,FALSE,NA,"0.1.4"
"3602","646",2022-10-08 12:15:00,914,931,17,61,FALSE,NA,"0.1.4"
"3603","646",2022-10-08 12:30:00,914,931,17,61,FALSE,NA,"0.1.4"
"3604","646",2022-10-08 12:45:00,914,931,17,61,FALSE,NA,"0.1.4"
"3605","646",2022-10-08 13:00:00,914,931,17,61,FALSE,NA,"0.1.4"
"3606","646",2022-10-08 13:15:00,914,931,17,61,FALSE,NA,"0.1.4"
"3607","646",2022-10-08 13:30:00,914,931,17,61,FALSE,NA,"0.1.4"
"3608","646",2022-10-08 13:45:00,914,931,17,61,FALSE,NA,"0.1.4"
"3609","646",2022-10-08 14:00:00,914,931,17,61,FALSE,NA,"0.1.4"
"3610","646",2022-10-08 14:15:00,914,931,17,61,FALSE,NA,"0.1.4"
"3611","646",2022-10-08 14:30:00,914,931,17,61,FALSE,NA,"0.1.4"
"3612","646",2022-10-08 14:45:00,914,931,17,61,FALSE,NA,"0.1.4"
"3613","646",2022-10-08 15:00:00,914,931,17,61,FALSE,NA,"0.1.4"
"3614","646",2022-10-08 15:15:00,915,931,16,61,FALSE,NA,"0.1.4"
"3615","646",2022-10-08 15:30:00,915,931,16,61,FALSE,NA,"0.1.4"
"3616","646",2022-10-08 15:45:00,915,931,16,61,FALSE,NA,"0.1.4"
"3617","646",2022-10-08 16:00:00,915,931,16,61,FALSE,NA,"0.1.4"
"3618","646",2022-10-08 16:15:00,915,931,16,61,FALSE,NA,"0.1.4"
"3619","646",2022-10-08 16:30:00,915,931,16,61,FALSE,NA,"0.1.4"
"3620","646",2022-10-08 16:45:00,915,931,16,61,FALSE,NA,"0.1.4"
"3621","646",2022-10-08 17:00:00,915,931,16,61,FALSE,NA,"0.1.4"
"3622","646",2022-10-08 17:15:00,915,931,16,61,FALSE,NA,"0.1.4"
"3623","646",2022-10-08 17:30:00,915,931,16,61,FALSE,NA,"0.1.4"
"3624","646",2022-10-08 17:45:00,915,931,16,61,FALSE,NA,"0.1.4"
"3625","646",2022-10-08 18:00:00,915,931,16,61,FALSE,NA,"0.1.4"
"3626","646",2022-10-08 18:15:00,915,931,16,61,FALSE,NA,"0.1.4"
"3627","646",2022-10-08 18:30:00,915,931,16,61,FALSE,NA,"0.1.4"
"3628","646",2022-10-08 18:45:00,916,931,15,61,FALSE,NA,"0.1.4"
"3629","646",2022-10-08 19:00:00,916,931,15,61,FALSE,NA,"0.1.4"
"3630","646",2022-10-08 19:15:00,916,931,15,61,FALSE,NA,"0.1.4"
"3631","646",2022-10-08 19:30:00,916,931,15,61,FALSE,NA,"0.1.4"
"3632","646",2022-10-08 19:45:00,916,931,15,61,FALSE,NA,"0.1.4"
"3633","646",2022-10-08 20:00:00,916,931,15,61,FALSE,NA,"0.1.4"
"3634","646",2022-10-08 20:15:00,916,931,15,61,FALSE,NA,"0.1.4"
"3635","646",2022-10-08 20:30:00,916,931,15,61,FALSE,NA,"0.1.4"
"3636","646",2022-10-08 20:45:00,916,931,15,61,FALSE,NA,"0.1.4"
"3637","646",2022-10-08 21:00:00,916,931,15,61,FALSE,NA,"0.1.4"
"3638","646",2022-10-08 21:15:00,916,931,15,61,FALSE,NA,"0.1.4"
"3639","646",2022-10-08 21:30:00,915,931,16,61,FALSE,NA,"0.1.4"
"3640","646",2022-10-08 21:45:00,915,931,16,61,FALSE,NA,"0.1.4"
"3641","646",2022-10-08 22:00:00,915,931,16,61,FALSE,NA,"0.1.4"
"3642","646",2022-10-08 22:15:00,915,931,16,61,FALSE,NA,"0.1.4"
"3643","646",2022-10-08 22:30:00,915,931,16,61,FALSE,NA,"0.1.4"
"3644","646",2022-10-08 22:45:00,915,931,16,61,FALSE,NA,"0.1.4"
"3645","646",2022-10-08 23:00:00,915,931,16,61,FALSE,NA,"0.1.4"
"3646","646",2022-10-08 23:15:00,915,931,16,61,FALSE,NA,"0.1.4"
"3647","646",2022-10-08 23:30:00,914,931,17,61,FALSE,NA,"0.1.4"
"3648","646",2022-10-08 23:45:00,914,931,17,61,FALSE,NA,"0.1.4"
"3649","646",2022-10-09,914,931,17,61,FALSE,NA,"0.1.4"
"3650","646",2022-10-09 00:15:00,914,931,17,61,FALSE,NA,"0.1.4"
"3651","646",2022-10-09 00:30:00,914,931,17,61,FALSE,NA,"0.1.4"
"3652","646",2022-10-09 00:45:00,914,931,17,61,FALSE,NA,"0.1.4"
"3653","646",2022-10-09 01:00:00,914,931,17,61,FALSE,NA,"0.1.4"
"3654","646",2022-10-09 01:15:00,914,931,17,61,FALSE,NA,"0.1.4"
"3655","646",2022-10-09 01:30:00,914,931,17,61,FALSE,NA,"0.1.4"
"3656","646",2022-10-09 01:45:00,914,931,17,61,FALSE,NA,"0.1.4"
"3657","646",2022-10-09 02:00:00,914,931,17,61,FALSE,NA,"0.1.4"
"3658","646",2022-10-09 02:15:00,914,931,17,61,FALSE,NA,"0.1.4"
"3659","646",2022-10-09 02:30:00,914,931,17,61,FALSE,NA,"0.1.4"
"3660","646",2022-10-09 02:45:00,914,931,17,61,FALSE,NA,"0.1.4"
"3661","646",2022-10-09 03:00:00,914,931,17,61,FALSE,NA,"0.1.4"
"3662","646",2022-10-09 03:15:00,914,931,17,61,FALSE,NA,"0.1.4"
"3663","646",2022-10-09 03:30:00,914,931,17,61,FALSE,NA,"0.1.4"
"3664","646",2022-10-09 03:45:00,914,931,17,61,FALSE,NA,"0.1.4"
"3665","646",2022-10-09 04:00:00,914,931,17,61,FALSE,NA,"0.1.4"
"3666","646",2022-10-09 04:15:00,914,931,17,61,FALSE,NA,"0.1.4"
"3667","646",2022-10-09 04:30:00,914,931,17,61,FALSE,NA,"0.1.4"
"3668","646",2022-10-09 04:45:00,914,931,17,61,FALSE,NA,"0.1.4"
"3669","646",2022-10-09 05:00:00,914,931,17,61,FALSE,NA,"0.1.4"
"3670","646",2022-10-09 05:15:00,914,931,17,61,FALSE,NA,"0.1.4"
"3671","646",2022-10-09 05:30:00,914,931,17,61,FALSE,NA,"0.1.4"
"3672","646",2022-10-09 05:45:00,914,931,17,61,FALSE,NA,"0.1.4"
"3673","646",2022-10-09 06:00:00,914,931,17,61,FALSE,NA,"0.1.4"
"3674","646",2022-10-09 06:15:00,914,931,17,61,FALSE,NA,"0.1.4"
"3675","646",2022-10-09 06:30:00,914,931,17,61,FALSE,NA,"0.1.4"
"3676","646",2022-10-09 06:45:00,914,931,17,61,FALSE,NA,"0.1.4"
"3677","646",2022-10-09 07:00:00,914,931,17,61,FALSE,NA,"0.1.4"
"3678","646",2022-10-09 07:15:00,914,931,17,61,FALSE,NA,"0.1.4"
"3679","646",2022-10-09 07:30:00,914,931,17,61,FALSE,NA,"0.1.4"
"3680","646",2022-10-09 07:45:00,914,931,17,61,FALSE,NA,"0.1.4"
"3681","646",2022-10-09 08:00:00,914,931,17,61,FALSE,NA,"0.1.4"
"3682","646",2022-10-09 08:15:00,914,931,17,61,FALSE,NA,"0.1.4"
"3683","646",2022-10-09 08:30:00,914,931,17,61,FALSE,NA,"0.1.4"
"3684","646",2022-10-09 08:45:00,914,931,17,61,FALSE,NA,"0.1.4"
"3685","646",2022-10-09 09:00:00,914,931,17,61,FALSE,NA,"0.1.4"
"3686","646",2022-10-09 09:15:00,914,931,17,61,FALSE,NA,"0.1.4"
"3687","646",2022-10-09 09:30:00,914,931,17,61,FALSE,NA,"0.1.4"
"3688","646",2022-10-09 09:45:00,914,931,17,61,FALSE,NA,"0.1.4"
"3689","646",2022-10-09 10:00:00,914,931,17,61,FALSE,NA,"0.1.4"
"3690","646",2022-10-09 10:15:00,914,931,17,61,FALSE,NA,"0.1.4"
"3691","646",2022-10-09 10:30:00,914,931,17,61,FALSE,NA,"0.1.4"
"3692","646",2022-10-09 10:45:00,914,931,17,61,FALSE,NA,"0.1.4"
"3693","646",2022-10-09 11:00:00,914,931,17,61,FALSE,NA,"0.1.4"
"3694","646",2022-10-09 11:15:00,914,931,17,61,FALSE,NA,"0.1.4"
"3695","646",2022-10-09 11:30:00,914,931,17,61,FALSE,NA,"0.1.4"
"3696","646",2022-10-09 11:45:00,914,931,17,61,FALSE,NA,"0.1.4"
"3697","646",2022-10-09 12:00:00,914,931,17,61,FALSE,NA,"0.1.4"
"3698","646",2022-10-09 12:15:00,914,931,17,61,FALSE,NA,"0.1.4"
"3699","646",2022-10-09 12:30:00,914,931,17,61,FALSE,NA,"0.1.4"
"3700","646",2022-10-09 12:45:00,914,931,17,61,FALSE,NA,"0.1.4"
"3701","646",2022-10-09 13:00:00,914,931,17,61,FALSE,NA,"0.1.4"
"3702","646",2022-10-09 13:15:00,914,931,17,61,FALSE,NA,"0.1.4"
"3703","646",2022-10-09 13:30:00,914,931,17,61,FALSE,NA,"0.1.4"
"3704","646",2022-10-09 13:45:00,914,931,17,61,FALSE,NA,"0.1.4"
"3705","646",2022-10-09 14:00:00,914,931,17,61,FALSE,NA,"0.1.4"
"3706","646",2022-10-09 14:15:00,914,931,17,61,FALSE,NA,"0.1.4"
"3707","646",2022-10-09 14:30:00,914,931,17,61,FALSE,NA,"0.1.4"
"3708","646",2022-10-09 14:45:00,914,931,17,61,FALSE,NA,"0.1.4"
"3709","646",2022-10-09 15:00:00,914,931,17,61,FALSE,NA,"0.1.4"
"3710","646",2022-10-09 15:15:00,914,931,17,61,FALSE,NA,"0.1.4"
"3711","646",2022-10-09 15:30:00,914,931,17,61,FALSE,NA,"0.1.4"
"3712","646",2022-10-09 15:45:00,914,931,17,61,FALSE,NA,"0.1.4"
"3713","646",2022-10-09 16:00:00,915,931,16,61,FALSE,NA,"0.1.4"
"3714","646",2022-10-09 16:15:00,914,931,17,61,FALSE,NA,"0.1.4"
"3715","646",2022-10-09 16:30:00,915,931,16,61,FALSE,NA,"0.1.4"
"3716","646",2022-10-09 16:45:00,915,931,16,61,FALSE,NA,"0.1.4"
"3717","646",2022-10-09 17:00:00,915,931,16,61,FALSE,NA,"0.1.4"
"3718","646",2022-10-09 17:15:00,915,931,16,61,FALSE,NA,"0.1.4"
"3719","646",2022-10-09 17:30:00,915,931,16,61,FALSE,NA,"0.1.4"
"3720","646",2022-10-09 17:45:00,915,931,16,61,FALSE,NA,"0.1.4"
"3721","646",2022-10-09 18:00:00,915,931,16,61,FALSE,NA,"0.1.4"
"3722","646",2022-10-09 18:15:00,915,931,16,61,FALSE,NA,"0.1.4"
"3723","646",2022-10-09 18:30:00,915,931,16,61,FALSE,NA,"0.1.4"
"3724","646",2022-10-09 18:45:00,915,931,16,61,FALSE,NA,"0.1.4"
"3725","646",2022-10-09 19:00:00,915,931,16,61,FALSE,NA,"0.1.4"
"3726","646",2022-10-09 19:15:00,915,931,16,61,FALSE,NA,"0.1.4"
"3727","646",2022-10-09 19:30:00,915,931,16,61,FALSE,NA,"0.1.4"
"3728","646",2022-10-09 19:45:00,915,931,16,61,FALSE,NA,"0.1.4"
"3729","646",2022-10-09 20:00:00,915,931,16,61,FALSE,NA,"0.1.4"
"3730","646",2022-10-09 20:15:00,915,931,16,61,FALSE,NA,"0.1.4"
"3731","646",2022-10-09 20:30:00,915,931,16,61,FALSE,NA,"0.1.4"
"3732","646",2022-10-09 20:45:00,915,931,16,61,FALSE,NA,"0.1.4"
"3733","646",2022-10-09 21:00:00,915,931,16,61,FALSE,NA,"0.1.4"
"3734","646",2022-10-09 21:15:00,914,931,17,61,FALSE,NA,"0.1.4"
"3735","646",2022-10-09 21:30:00,914,931,17,61,FALSE,NA,"0.1.4"
"3736","646",2022-10-09 21:45:00,914,931,17,61,FALSE,NA,"0.1.4"
"3737","646",2022-10-09 22:00:00,914,931,17,61,FALSE,NA,"0.1.4"
"3738","646",2022-10-09 22:15:00,914,931,17,61,FALSE,NA,"0.1.4"
"3739","646",2022-10-09 22:30:00,913,931,18,61,FALSE,NA,"0.1.4"
"3740","646",2022-10-09 22:45:00,912,931,19,61,FALSE,NA,"0.1.4"
"3741","646",2022-10-09 23:00:00,912,931,19,61,FALSE,NA,"0.1.4"
"3742","646",2022-10-09 23:15:00,912,931,19,61,FALSE,NA,"0.1.4"
"3743","646",2022-10-09 23:30:00,912,931,19,61,FALSE,NA,"0.1.4"
"3744","646",2022-10-09 23:45:00,912,931,19,61,FALSE,NA,"0.1.4"
"3745","646",2022-10-10,911,931,20,61,FALSE,NA,"0.1.4"
"3746","646",2022-10-10 00:15:00,912,931,19,61,FALSE,NA,"0.1.4"
"3747","646",2022-10-10 00:30:00,911,931,20,61,FALSE,NA,"0.1.4"
"3748","646",2022-10-10 00:45:00,911,931,20,61,FALSE,NA,"0.1.4"
"3749","646",2022-10-10 01:00:00,911,931,20,61,FALSE,NA,"0.1.4"
"3750","646",2022-10-10 01:15:00,911,931,20,61,FALSE,NA,"0.1.4"
"3751","646",2022-10-10 01:30:00,911,931,20,61,FALSE,NA,"0.1.4"
"3752","646",2022-10-10 01:45:00,911,931,20,61,FALSE,NA,"0.1.4"
"3753","646",2022-10-10 02:00:00,911,931,20,61,FALSE,NA,"0.1.4"
"3754","646",2022-10-10 02:15:00,911,931,20,61,FALSE,NA,"0.1.4"
"3755","646",2022-10-10 02:30:00,911,931,20,61,FALSE,NA,"0.1.4"
"3756","646",2022-10-10 02:45:00,911,931,20,61,FALSE,NA,"0.1.4"
"3757","646",2022-10-10 03:00:00,911,931,20,61,FALSE,NA,"0.1.4"
"3758","646",2022-10-10 03:15:00,911,931,20,61,FALSE,NA,"0.1.4"
"3759","646",2022-10-10 03:30:00,911,931,20,61,FALSE,NA,"0.1.4"
"3760","646",2022-10-10 03:45:00,911,931,20,61,FALSE,NA,"0.1.4"
"3761","646",2022-10-10 04:00:00,911,931,20,61,FALSE,NA,"0.1.4"
"3762","646",2022-10-10 04:15:00,911,931,20,61,FALSE,NA,"0.1.4"
"3763","646",2022-10-10 04:30:00,911,931,20,61,FALSE,NA,"0.1.4"
"3764","646",2022-10-10 04:45:00,911,931,20,61,FALSE,NA,"0.1.4"
"3765","646",2022-10-10 05:00:00,911,931,20,61,FALSE,NA,"0.1.4"
"3766","646",2022-10-10 05:15:00,911,931,20,61,FALSE,NA,"0.1.4"
"3767","646",2022-10-10 05:30:00,911,931,20,61,FALSE,NA,"0.1.4"
"3768","646",2022-10-10 05:45:00,911,931,20,61,FALSE,NA,"0.1.4"
"3769","646",2022-10-10 06:00:00,911,931,20,61,FALSE,NA,"0.1.4"
"3770","646",2022-10-10 06:15:00,911,931,20,61,FALSE,NA,"0.1.4"
"3771","646",2022-10-10 06:30:00,911,931,20,61,FALSE,NA,"0.1.4"
"3772","646",2022-10-10 06:45:00,911,931,20,61,FALSE,NA,"0.1.4"
"3773","646",2022-10-10 07:00:00,911,931,20,61,FALSE,NA,"0.1.4"
"3774","646",2022-10-10 07:15:00,911,931,20,61,FALSE,NA,"0.1.4"
"3775","646",2022-10-10 07:30:00,911,931,20,61,FALSE,NA,"0.1.4"
"3776","646",2022-10-10 07:45:00,912,931,19,61,FALSE,NA,"0.1.4"
"3777","646",2022-10-10 08:00:00,912,931,19,61,FALSE,NA,"0.1.4"
"3778","646",2022-10-10 08:15:00,912,931,19,61,FALSE,NA,"0.1.4"
"3779","646",2022-10-10 08:30:00,912,931,19,61,FALSE,NA,"0.1.4"
"3780","646",2022-10-10 08:45:00,912,931,19,61,FALSE,NA,"0.1.4"
"3781","646",2022-10-10 09:00:00,912,931,19,61,FALSE,NA,"0.1.4"
"3782","646",2022-10-10 09:15:00,912,931,19,61,FALSE,NA,"0.1.4"
"3783","646",2022-10-10 09:30:00,912,931,19,61,FALSE,NA,"0.1.4"
"3784","646",2022-10-10 09:45:00,912,931,19,61,FALSE,NA,"0.1.4"
"3785","646",2022-10-10 10:00:00,912,931,19,61,FALSE,NA,"0.1.4"
"3786","646",2022-10-10 10:15:00,912,931,19,61,FALSE,NA,"0.1.4"
"3787","646",2022-10-10 10:30:00,912,931,19,61,FALSE,NA,"0.1.4"
"3788","646",2022-10-10 10:45:00,912,931,19,61,FALSE,NA,"0.1.4"
"3789","646",2022-10-10 11:00:00,912,931,19,61,FALSE,NA,"0.1.4"
"3790","646",2022-10-10 11:15:00,912,931,19,61,FALSE,NA,"0.1.4"
"3791","646",2022-10-10 11:30:00,912,931,19,61,FALSE,NA,"0.1.4"
"3792","646",2022-10-10 11:45:00,912,931,19,61,FALSE,NA,"0.1.4"
"3793","646",2022-10-10 12:00:00,912,931,19,61,FALSE,NA,"0.1.4"
"3794","646",2022-10-10 12:15:00,912,931,19,61,FALSE,NA,"0.1.4"
"3795","646",2022-10-10 12:30:00,912,931,19,61,FALSE,NA,"0.1.4"
"3796","646",2022-10-10 12:45:00,912,931,19,61,FALSE,NA,"0.1.4"
"3797","646",2022-10-10 13:00:00,912,931,19,61,FALSE,NA,"0.1.4"
"3798","646",2022-10-10 13:15:00,912,931,19,61,FALSE,NA,"0.1.4"
"3799","646",2022-10-10 13:30:00,912,931,19,61,FALSE,NA,"0.1.4"
"3800","646",2022-10-10 13:45:00,912,931,19,61,FALSE,NA,"0.1.4"
"3801","646",2022-10-10 14:00:00,912,931,19,61,FALSE,NA,"0.1.4"
"3802","646",2022-10-10 14:15:00,912,931,19,61,FALSE,NA,"0.1.4"
"3803","646",2022-10-10 14:30:00,912,931,19,61,FALSE,NA,"0.1.4"
"3804","646",2022-10-10 14:45:00,912,931,19,61,FALSE,NA,"0.1.4"
"3805","646",2022-10-10 15:00:00,912,931,19,61,FALSE,NA,"0.1.4"
"3806","646",2022-10-10 15:15:00,912,931,19,61,FALSE,NA,"0.1.4"
"3807","646",2022-10-10 15:30:00,912,931,19,61,FALSE,NA,"0.1.4"
"3808","646",2022-10-10 15:45:00,912,931,19,61,FALSE,NA,"0.1.4"
"3809","646",2022-10-10 16:00:00,912,931,19,61,FALSE,NA,"0.1.4"
"3810","646",2022-10-10 16:15:00,912,931,19,61,FALSE,NA,"0.1.4"
"3811","646",2022-10-10 16:30:00,912,931,19,61,FALSE,NA,"0.1.4"
"3812","646",2022-10-10 16:45:00,912,931,19,61,FALSE,NA,"0.1.4"
"3813","646",2022-10-10 17:00:00,912,931,19,61,FALSE,NA,"0.1.4"
"3814","646",2022-10-10 17:15:00,912,931,19,61,FALSE,NA,"0.1.4"
"3815","646",2022-10-10 17:30:00,912,931,19,61,FALSE,NA,"0.1.4"
"3816","646",2022-10-10 17:45:00,912,931,19,61,FALSE,NA,"0.1.4"
"3817","646",2022-10-10 18:00:00,912,931,19,61,FALSE,NA,"0.1.4"
"3818","646",2022-10-10 18:15:00,912,931,19,61,FALSE,NA,"0.1.4"
"3819","646",2022-10-10 18:30:00,912,931,19,61,FALSE,NA,"0.1.4"
"3820","646",2022-10-10 18:45:00,912,931,19,61,FALSE,NA,"0.1.4"
"3821","646",2022-10-10 19:00:00,912,931,19,61,FALSE,NA,"0.1.4"
"3822","646",2022-10-10 19:15:00,912,931,19,61,FALSE,NA,"0.1.4"
"3823","646",2022-10-10 19:30:00,912,931,19,61,FALSE,NA,"0.1.4"
"3824","646",2022-10-10 19:45:00,912,931,19,61,FALSE,NA,"0.1.4"
"3825","646",2022-10-10 20:00:00,912,931,19,61,FALSE,NA,"0.1.4"
"3826","646",2022-10-10 20:15:00,912,931,19,61,FALSE,NA,"0.1.4"
"3827","646",2022-10-10 20:30:00,912,931,19,61,FALSE,NA,"0.1.4"
"3828","646",2022-10-10 20:45:00,912,931,19,61,FALSE,NA,"0.1.4"
"3829","646",2022-10-10 21:00:00,912,931,19,61,FALSE,NA,"0.1.4"
"3830","646",2022-10-10 21:15:00,912,931,19,61,FALSE,NA,"0.1.4"
"3831","646",2022-10-10 21:30:00,912,931,19,61,FALSE,NA,"0.1.4"
"3832","646",2022-10-10 21:45:00,912,931,19,61,FALSE,NA,"0.1.4"
"3833","646",2022-10-10 22:00:00,912,931,19,61,FALSE,NA,"0.1.4"
"3834","646",2022-10-10 22:15:00,912,931,19,61,FALSE,NA,"0.1.4"
"3835","646",2022-10-10 22:30:00,912,931,19,61,FALSE,NA,"0.1.4"
"3836","646",2022-10-10 22:45:00,912,931,19,61,FALSE,NA,"0.1.4"
"3837","646",2022-10-10 23:00:00,912,931,19,61,FALSE,NA,"0.1.4"
"3838","646",2022-10-10 23:15:00,911,931,20,61,FALSE,NA,"0.1.4"
"3839","646",2022-10-10 23:30:00,911,931,20,61,FALSE,NA,"0.1.4"
"3840","646",2022-10-10 23:45:00,912,931,19,61,FALSE,NA,"0.1.4"
"3841","646",2022-10-11,912,931,19,61,FALSE,NA,"0.1.4"
"3842","646",2022-10-11 00:15:00,912,931,19,61,FALSE,NA,"0.1.4"
"3843","646",2022-10-11 00:30:00,912,931,19,61,FALSE,NA,"0.1.4"
"3844","646",2022-10-11 00:45:00,912,931,19,61,FALSE,NA,"0.1.4"
"3845","646",2022-10-11 01:00:00,912,931,19,61,FALSE,NA,"0.1.4"
"3846","646",2022-10-11 01:15:00,912,931,19,61,FALSE,NA,"0.1.4"
"3847","646",2022-10-11 01:30:00,912,931,19,61,FALSE,NA,"0.1.4"
"3848","646",2022-10-11 01:45:00,912,931,19,61,FALSE,NA,"0.1.4"
"3849","646",2022-10-11 02:00:00,912,931,19,61,FALSE,NA,"0.1.4"
"3850","646",2022-10-11 02:15:00,912,931,19,61,FALSE,NA,"0.1.4"
"3851","646",2022-10-11 02:30:00,912,931,19,61,FALSE,NA,"0.1.4"
"3852","646",2022-10-11 02:45:00,912,931,19,61,FALSE,NA,"0.1.4"
"3853","646",2022-10-11 03:00:00,912,931,19,61,FALSE,NA,"0.1.4"
"3854","646",2022-10-11 03:15:00,912,931,19,61,FALSE,NA,"0.1.4"
"3855","646",2022-10-11 03:30:00,912,931,19,61,FALSE,NA,"0.1.4"
"3856","646",2022-10-11 03:45:00,912,931,19,61,FALSE,NA,"0.1.4"
"3857","646",2022-10-11 04:00:00,912,931,19,61,FALSE,NA,"0.1.4"
"3858","646",2022-10-11 04:15:00,912,931,19,61,FALSE,NA,"0.1.4"
"3859","646",2022-10-11 04:30:00,912,931,19,61,FALSE,NA,"0.1.4"
"3860","646",2022-10-11 04:45:00,912,931,19,61,FALSE,NA,"0.1.4"
"3861","646",2022-10-11 05:00:00,912,931,19,61,FALSE,NA,"0.1.4"
"3862","646",2022-10-11 05:15:00,912,931,19,61,FALSE,NA,"0.1.4"
"3863","646",2022-10-11 05:30:00,912,931,19,61,FALSE,NA,"0.1.4"
"3864","646",2022-10-11 05:45:00,912,931,19,61,FALSE,NA,"0.1.4"
"3865","646",2022-10-11 06:00:00,912,931,19,61,FALSE,NA,"0.1.4"
"3866","646",2022-10-11 06:15:00,912,931,19,61,FALSE,NA,"0.1.4"
"3867","646",2022-10-11 06:30:00,912,931,19,61,FALSE,NA,"0.1.4"
"3868","646",2022-10-11 06:45:00,912,931,19,61,FALSE,NA,"0.1.4"
"3869","646",2022-10-11 07:00:00,912,931,19,61,FALSE,NA,"0.1.4"
"3870","646",2022-10-11 07:15:00,912,931,19,61,FALSE,NA,"0.1.4"
"3871","646",2022-10-11 07:30:00,912,931,19,61,FALSE,NA,"0.1.4"
"3872","646",2022-10-11 07:45:00,912,931,19,61,FALSE,NA,"0.1.4"
"3873","646",2022-10-11 08:00:00,912,931,19,61,FALSE,NA,"0.1.4"
"3874","646",2022-10-11 08:15:00,912,931,19,61,FALSE,NA,"0.1.4"
"3875","646",2022-10-11 08:30:00,912,931,19,61,FALSE,NA,"0.1.4"
"3876","646",2022-10-11 08:45:00,912,931,19,61,FALSE,NA,"0.1.4"
"3877","646",2022-10-11 09:00:00,912,931,19,61,FALSE,NA,"0.1.4"
"3878","646",2022-10-11 09:15:00,912,931,19,61,FALSE,NA,"0.1.4"
"3879","646",2022-10-11 09:30:00,912,931,19,61,FALSE,NA,"0.1.4"
"3880","646",2022-10-11 09:45:00,912,931,19,61,FALSE,NA,"0.1.4"
"3881","646",2022-10-11 10:00:00,912,931,19,61,FALSE,NA,"0.1.4"
"3882","646",2022-10-11 10:15:00,912,931,19,61,FALSE,NA,"0.1.4"
"3883","646",2022-10-11 10:30:00,912,931,19,61,FALSE,NA,"0.1.4"
"3884","646",2022-10-11 10:45:00,912,931,19,61,FALSE,NA,"0.1.4"
"3885","646",2022-10-11 11:00:00,912,931,19,61,FALSE,NA,"0.1.4"
"3886","646",2022-10-11 11:15:00,912,931,19,61,FALSE,NA,"0.1.4"
"3887","646",2022-10-11 11:30:00,912,931,19,61,FALSE,NA,"0.1.4"
"3888","646",2022-10-11 11:45:00,912,931,19,61,FALSE,NA,"0.1.4"
"3889","646",2022-10-11 12:00:00,912,931,19,61,FALSE,NA,"0.1.4"
"3890","646",2022-10-11 12:15:00,912,931,19,61,FALSE,NA,"0.1.4"
"3891","646",2022-10-11 12:30:00,912,931,19,61,FALSE,NA,"0.1.4"
"3892","646",2022-10-11 12:45:00,912,931,19,61,FALSE,NA,"0.1.4"
"3893","646",2022-10-11 13:00:00,912,931,19,61,FALSE,NA,"0.1.4"
"3894","646",2022-10-11 13:15:00,912,931,19,61,FALSE,NA,"0.1.4"
"3895","646",2022-10-11 13:30:00,912,931,19,61,FALSE,NA,"0.1.4"
"3896","646",2022-10-11 13:45:00,912,931,19,61,FALSE,NA,"0.1.4"
"3897","646",2022-10-11 14:00:00,912,931,19,61,FALSE,NA,"0.1.4"
"3898","646",2022-10-11 14:15:00,912,931,19,61,FALSE,NA,"0.1.4"
"3899","646",2022-10-11 14:30:00,912,931,19,61,FALSE,NA,"0.1.4"
"3900","646",2022-10-11 14:45:00,912,931,19,61,FALSE,NA,"0.1.4"
"3901","646",2022-10-11 15:00:00,912,931,19,61,FALSE,NA,"0.1.4"
"3902","646",2022-10-11 15:15:00,912,931,19,61,FALSE,NA,"0.1.4"
"3903","646",2022-10-11 15:30:00,912,931,19,61,FALSE,NA,"0.1.4"
"3904","646",2022-10-11 15:45:00,912,931,19,61,FALSE,NA,"0.1.4"
"3905","646",2022-10-11 16:00:00,912,931,19,61,FALSE,NA,"0.1.4"
"3906","646",2022-10-11 16:15:00,912,931,19,61,FALSE,NA,"0.1.4"
"3907","646",2022-10-11 16:30:00,912,931,19,61,FALSE,NA,"0.1.4"
"3908","646",2022-10-11 16:45:00,912,931,19,61,FALSE,NA,"0.1.4"
"3909","646",2022-10-11 17:00:00,912,931,19,61,FALSE,NA,"0.1.4"
"3910","646",2022-10-11 17:15:00,912,931,19,61,FALSE,NA,"0.1.4"
"3911","646",2022-10-11 17:30:00,912,931,19,61,FALSE,NA,"0.1.4"
"3912","646",2022-10-11 17:45:00,912,931,19,61,FALSE,NA,"0.1.4"
"3913","646",2022-10-11 18:00:00,912,931,19,61,FALSE,NA,"0.1.4"
"3914","646",2022-10-11 18:15:00,912,931,19,61,FALSE,NA,"0.1.4"
"3915","646",2022-10-11 18:30:00,912,931,19,61,FALSE,NA,"0.1.4"
"3916","646",2022-10-11 18:45:00,912,931,19,61,FALSE,NA,"0.1.4"
"3917","646",2022-10-11 19:00:00,912,931,19,61,FALSE,NA,"0.1.4"
"3918","646",2022-10-11 19:15:00,912,931,19,61,FALSE,NA,"0.1.4"
"3919","646",2022-10-11 19:30:00,912,931,19,61,FALSE,NA,"0.1.4"
"3920","646",2022-10-11 19:45:00,912,931,19,61,FALSE,NA,"0.1.4"
"3921","646",2022-10-11 20:00:00,912,931,19,61,FALSE,NA,"0.1.4"
"3922","646",2022-10-11 20:15:00,912,931,19,61,FALSE,NA,"0.1.4"
"3923","646",2022-10-11 20:30:00,912,931,19,61,FALSE,NA,"0.1.4"
"3924","646",2022-10-11 20:45:00,912,931,19,61,FALSE,NA,"0.1.4"
"3925","646",2022-10-11 21:00:00,912,931,19,61,FALSE,NA,"0.1.4"
"3926","646",2022-10-11 21:15:00,912,931,19,61,FALSE,NA,"0.1.4"
"3927","646",2022-10-11 21:30:00,912,931,19,61,FALSE,NA,"0.1.4"
"3928","646",2022-10-11 21:45:00,912,931,19,61,FALSE,NA,"0.1.4"
"3929","646",2022-10-11 22:00:00,912,931,19,61,FALSE,NA,"0.1.4"
"3930","646",2022-10-11 22:15:00,912,931,19,61,FALSE,NA,"0.1.4"
"3931","646",2022-10-11 22:30:00,912,931,19,61,FALSE,NA,"0.1.4"
"3932","646",2022-10-11 22:45:00,912,931,19,61,FALSE,NA,"0.1.4"
"3933","646",2022-10-11 23:00:00,912,931,19,61,FALSE,NA,"0.1.4"
"3934","646",2022-10-11 23:15:00,912,931,19,61,FALSE,NA,"0.1.4"
"3935","646",2022-10-11 23:30:00,912,931,19,61,FALSE,NA,"0.1.4"
"3936","646",2022-10-11 23:45:00,912,931,19,61,FALSE,NA,"0.1.4"
"3937","646",2022-10-12,912,931,19,61,FALSE,NA,"0.1.4"
"3938","646",2022-10-12 00:15:00,912,931,19,61,FALSE,NA,"0.1.4"
"3939","646",2022-10-12 00:30:00,912,931,19,61,FALSE,NA,"0.1.4"
"3940","646",2022-10-12 00:45:00,912,931,19,61,FALSE,NA,"0.1.4"
"3941","646",2022-10-12 01:00:00,912,931,19,61,FALSE,NA,"0.1.4"
"3942","646",2022-10-12 01:15:00,912,931,19,61,FALSE,NA,"0.1.4"
"3943","646",2022-10-12 01:30:00,912,931,19,61,FALSE,NA,"0.1.4"
"3944","646",2022-10-12 01:45:00,912,931,19,61,FALSE,NA,"0.1.4"
"3945","646",2022-10-12 02:00:00,912,931,19,61,FALSE,NA,"0.1.4"
"3946","646",2022-10-12 02:15:00,912,931,19,61,FALSE,NA,"0.1.4"
"3947","646",2022-10-12 02:30:00,912,931,19,61,FALSE,NA,"0.1.4"
"3948","646",2022-10-12 02:45:00,912,931,19,61,FALSE,NA,"0.1.4"
"3949","646",2022-10-12 03:00:00,912,931,19,61,FALSE,NA,"0.1.4"
"3950","646",2022-10-12 03:15:00,912,931,19,61,FALSE,NA,"0.1.4"
"3951","646",2022-10-12 03:30:00,912,931,19,61,FALSE,NA,"0.1.4"
"3952","646",2022-10-12 03:45:00,912,931,19,61,FALSE,NA,"0.1.4"
"3953","646",2022-10-12 04:00:00,912,931,19,61,FALSE,NA,"0.1.4"
"3954","646",2022-10-12 04:15:00,912,931,19,61,FALSE,NA,"0.1.4"
"3955","646",2022-10-12 04:30:00,912,931,19,61,FALSE,NA,"0.1.4"
"3956","646",2022-10-12 04:45:00,912,931,19,61,FALSE,NA,"0.1.4"
"3957","646",2022-10-12 05:00:00,912,931,19,61,FALSE,NA,"0.1.4"
"3958","646",2022-10-12 05:15:00,912,931,19,61,FALSE,NA,"0.1.4"
"3959","646",2022-10-12 05:30:00,912,931,19,61,FALSE,NA,"0.1.4"
"3960","646",2022-10-12 05:45:00,912,931,19,61,FALSE,NA,"0.1.4"
"3961","646",2022-10-12 06:00:00,912,931,19,61,FALSE,NA,"0.1.4"
"3962","646",2022-10-12 06:15:00,912,931,19,61,FALSE,NA,"0.1.4"
"3963","646",2022-10-12 06:30:00,912,931,19,61,FALSE,NA,"0.1.4"
"3964","646",2022-10-12 06:45:00,912,931,19,61,FALSE,NA,"0.1.4"
"3965","646",2022-10-12 07:00:00,912,931,19,61,FALSE,NA,"0.1.4"
"3966","646",2022-10-12 07:15:00,912,931,19,61,FALSE,NA,"0.1.4"
"3967","646",2022-10-12 07:30:00,912,931,19,61,FALSE,NA,"0.1.4"
"3968","646",2022-10-12 07:45:00,912,931,19,61,FALSE,NA,"0.1.4"
"3969","646",2022-10-12 08:00:00,912,931,19,61,FALSE,NA,"0.1.4"
"3970","646",2022-10-12 08:15:00,912,931,19,61,FALSE,NA,"0.1.4"
"3971","646",2022-10-12 08:30:00,912,931,19,61,FALSE,NA,"0.1.4"
"3972","646",2022-10-12 08:45:00,912,931,19,61,FALSE,NA,"0.1.4"
"3973","646",2022-10-12 09:00:00,912,931,19,61,FALSE,NA,"0.1.4"
"3974","646",2022-10-12 09:15:00,912,931,19,61,FALSE,NA,"0.1.4"
"3975","646",2022-10-12 09:30:00,912,931,19,61,FALSE,NA,"0.1.4"
"3976","646",2022-10-12 09:45:00,912,931,19,61,FALSE,NA,"0.1.4"
"3977","646",2022-10-12 10:00:00,912,931,19,61,FALSE,NA,"0.1.4"
"3978","646",2022-10-12 10:15:00,912,931,19,61,FALSE,NA,"0.1.4"
"3979","646",2022-10-12 10:30:00,912,931,19,61,FALSE,NA,"0.1.4"
"3980","646",2022-10-12 10:45:00,912,931,19,61,FALSE,NA,"0.1.4"
"3981","646",2022-10-12 11:00:00,912,931,19,61,FALSE,NA,"0.1.4"
"3982","646",2022-10-12 11:15:00,911,931,20,61,FALSE,NA,"0.1.4"
"3983","646",2022-10-12 11:30:00,912,931,19,61,FALSE,NA,"0.1.4"
"3984","646",2022-10-12 11:45:00,912,931,19,61,FALSE,NA,"0.1.4"
"3985","646",2022-10-12 12:00:00,912,931,19,61,FALSE,NA,"0.1.4"
"3986","646",2022-10-12 12:15:00,912,931,19,61,FALSE,NA,"0.1.4"
"3987","646",2022-10-12 12:30:00,912,931,19,61,FALSE,NA,"0.1.4"
"3988","646",2022-10-12 12:45:00,912,931,19,61,FALSE,NA,"0.1.4"
"3989","646",2022-10-12 13:00:00,913,931,18,61,FALSE,NA,"0.1.4"
"3990","646",2022-10-12 13:15:00,913,931,18,61,FALSE,NA,"0.1.4"
"3991","646",2022-10-12 13:30:00,913,931,18,61,FALSE,NA,"0.1.4"
"3992","646",2022-10-12 13:45:00,913,931,18,61,FALSE,NA,"0.1.4"
"3993","646",2022-10-12 14:00:00,913,931,18,61,FALSE,NA,"0.1.4"
"3994","646",2022-10-12 14:15:00,913,931,18,61,FALSE,NA,"0.1.4"
"3995","646",2022-10-12 14:30:00,913,931,18,61,FALSE,NA,"0.1.4"
"3996","646",2022-10-12 14:45:00,913,931,18,61,FALSE,NA,"0.1.4"
"3997","646",2022-10-12 15:00:00,913,931,18,61,FALSE,NA,"0.1.4"
"3998","646",2022-10-12 15:15:00,913,931,18,61,FALSE,NA,"0.1.4"
"3999","646",2022-10-12 15:30:00,913,931,18,61,FALSE,NA,"0.1.4"
"4000","646",2022-10-12 15:45:00,913,931,18,61,FALSE,NA,"0.1.4"
"4001","646",2022-10-12 16:00:00,913,931,18,61,FALSE,NA,"0.1.4"
"4002","646",2022-10-12 16:15:00,913,931,18,61,FALSE,NA,"0.1.4"
"4003","646",2022-10-12 16:30:00,913,931,18,61,FALSE,NA,"0.1.4"
"4004","646",2022-10-12 16:45:00,913,931,18,61,FALSE,NA,"0.1.4"
"4005","646",2022-10-12 17:00:00,913,931,18,61,FALSE,NA,"0.1.4"
"4006","646",2022-10-12 17:15:00,913,931,18,61,FALSE,NA,"0.1.4"
"4007","646",2022-10-12 17:30:00,913,931,18,61,FALSE,NA,"0.1.4"
"4008","646",2022-10-12 17:45:00,913,931,18,61,FALSE,NA,"0.1.4"
"4009","646",2022-10-12 18:00:00,913,931,18,61,FALSE,NA,"0.1.4"
"4010","646",2022-10-12 18:15:00,913,931,18,61,FALSE,NA,"0.1.4"
"4011","646",2022-10-12 18:30:00,913,931,18,61,FALSE,NA,"0.1.4"
"4012","646",2022-10-12 18:45:00,913,931,18,61,FALSE,NA,"0.1.4"
"4013","646",2022-10-12 19:00:00,913,931,18,61,FALSE,NA,"0.1.4"
"4014","646",2022-10-12 19:15:00,913,931,18,61,FALSE,NA,"0.1.4"
"4015","646",2022-10-12 19:30:00,913,931,18,61,FALSE,NA,"0.1.4"
"4016","646",2022-10-12 19:45:00,913,931,18,61,FALSE,NA,"0.1.4"
"4017","646",2022-10-12 20:00:00,913,931,18,61,FALSE,NA,"0.1.4"
"4018","646",2022-10-12 20:15:00,913,931,18,61,FALSE,NA,"0.1.4"
"4019","646",2022-10-12 20:30:00,913,931,18,61,FALSE,NA,"0.1.4"
"4020","646",2022-10-12 20:45:00,913,931,18,61,FALSE,NA,"0.1.4"
"4021","646",2022-10-12 21:00:00,913,931,18,61,FALSE,NA,"0.1.4"
"4022","646",2022-10-12 21:15:00,913,931,18,61,FALSE,NA,"0.1.4"
"4023","646",2022-10-12 21:30:00,913,931,18,61,FALSE,NA,"0.1.4"
"4024","646",2022-10-12 21:45:00,913,931,18,61,FALSE,NA,"0.1.4"
"4025","646",2022-10-12 22:00:00,913,931,18,61,FALSE,NA,"0.1.4"
"4026","646",2022-10-12 22:15:00,913,931,18,61,FALSE,NA,"0.1.4"
"4027","646",2022-10-12 22:30:00,913,931,18,61,FALSE,NA,"0.1.4"
"4028","646",2022-10-12 22:45:00,913,931,18,61,FALSE,NA,"0.1.4"
"4029","646",2022-10-12 23:00:00,913,931,18,61,FALSE,NA,"0.1.4"
"4030","646",2022-10-12 23:15:00,913,931,18,61,FALSE,NA,"0.1.4"
"4031","646",2022-10-12 23:30:00,913,931,18,61,FALSE,NA,"0.1.4"
"4032","646",2022-10-12 23:45:00,913,931,18,61,FALSE,NA,"0.1.4"
"4033","646",2022-10-13,913,931,18,61,FALSE,NA,"0.1.4"
"4034","646",2022-10-13 00:15:00,913,931,18,61,FALSE,NA,"0.1.4"
"4035","646",2022-10-13 00:30:00,913,931,18,61,FALSE,NA,"0.1.4"
"4036","646",2022-10-13 00:45:00,913,931,18,61,FALSE,NA,"0.1.4"
"4037","646",2022-10-13 01:00:00,913,931,18,61,FALSE,NA,"0.1.4"
"4038","646",2022-10-13 01:15:00,913,931,18,61,FALSE,NA,"0.1.4"
"4039","646",2022-10-13 01:30:00,913,931,18,61,FALSE,NA,"0.1.4"
"4040","646",2022-10-13 01:45:00,913,931,18,61,FALSE,NA,"0.1.4"
"4041","646",2022-10-13 02:00:00,913,931,18,61,FALSE,NA,"0.1.4"
"4042","646",2022-10-13 02:15:00,913,931,18,61,FALSE,NA,"0.1.4"
"4043","646",2022-10-13 02:30:00,913,931,18,61,FALSE,NA,"0.1.4"
"4044","646",2022-10-13 02:45:00,913,931,18,61,FALSE,NA,"0.1.4"
"4045","646",2022-10-13 03:00:00,913,931,18,61,FALSE,NA,"0.1.4"
"4046","646",2022-10-13 03:15:00,913,931,18,61,FALSE,NA,"0.1.4"
"4047","646",2022-10-13 03:30:00,913,931,18,61,FALSE,NA,"0.1.4"
"4048","646",2022-10-13 03:45:00,913,931,18,61,FALSE,NA,"0.1.4"
"4049","646",2022-10-13 04:00:00,913,931,18,61,FALSE,NA,"0.1.4"
"4050","646",2022-10-13 04:15:00,913,931,18,61,FALSE,NA,"0.1.4"
"4051","646",2022-10-13 04:30:00,913,931,18,61,FALSE,NA,"0.1.4"
"4052","646",2022-10-13 04:45:00,913,931,18,61,FALSE,NA,"0.1.4"
"4053","646",2022-10-13 05:00:00,913,931,18,61,FALSE,NA,"0.1.4"
"4054","646",2022-10-13 05:15:00,913,931,18,61,FALSE,NA,"0.1.4"
"4055","646",2022-10-13 05:30:00,913,931,18,61,FALSE,NA,"0.1.4"
"4056","646",2022-10-13 05:45:00,913,931,18,61,FALSE,NA,"0.1.4"
"4057","646",2022-10-13 06:00:00,913,931,18,61,FALSE,NA,"0.1.4"
"4058","646",2022-10-13 06:15:00,913,931,18,61,FALSE,NA,"0.1.4"
"4059","646",2022-10-13 06:30:00,913,931,18,61,FALSE,NA,"0.1.4"
"4060","646",2022-10-13 06:45:00,913,931,18,61,FALSE,NA,"0.1.4"
"4061","646",2022-10-13 07:00:00,913,931,18,61,FALSE,NA,"0.1.4"
"4062","646",2022-10-13 07:15:00,913,931,18,61,FALSE,NA,"0.1.4"
"4063","646",2022-10-13 07:30:00,913,931,18,61,FALSE,NA,"0.1.4"
"4064","646",2022-10-13 07:45:00,913,931,18,61,FALSE,NA,"0.1.4"
"4065","646",2022-10-13 08:00:00,913,931,18,61,FALSE,NA,"0.1.4"
"4066","646",2022-10-13 08:15:00,913,931,18,61,FALSE,NA,"0.1.4"
"4067","646",2022-10-13 08:30:00,913,931,18,61,FALSE,NA,"0.1.4"
"4068","646",2022-10-13 08:45:00,913,931,18,61,FALSE,NA,"0.1.4"
"4069","646",2022-10-13 09:00:00,913,931,18,61,FALSE,NA,"0.1.4"
"4070","646",2022-10-13 09:15:00,913,931,18,61,FALSE,NA,"0.1.4"
"4071","646",2022-10-13 09:30:00,913,931,18,61,FALSE,NA,"0.1.4"
"4072","646",2022-10-13 09:45:00,913,931,18,61,FALSE,NA,"0.1.4"
"4073","646",2022-10-13 10:00:00,913,931,18,61,FALSE,NA,"0.1.4"
"4074","646",2022-10-13 10:15:00,913,931,18,61,FALSE,NA,"0.1.4"
"4075","646",2022-10-13 10:30:00,913,931,18,61,FALSE,NA,"0.1.4"
"4076","646",2022-10-13 10:45:00,913,931,18,61,FALSE,NA,"0.1.4"
"4077","646",2022-10-13 11:00:00,913,931,18,61,FALSE,NA,"0.1.4"
"4078","646",2022-10-13 11:15:00,913,931,18,61,FALSE,NA,"0.1.4"
"4079","646",2022-10-13 11:30:00,913,931,18,61,FALSE,NA,"0.1.4"
"4080","646",2022-10-13 11:45:00,913,931,18,61,FALSE,NA,"0.1.4"
"4081","646",2022-10-13 12:00:00,913,931,18,61,FALSE,NA,"0.1.4"
"4082","646",2022-10-13 12:15:00,913,931,18,61,FALSE,NA,"0.1.4"
"4083","646",2022-10-13 12:30:00,913,931,18,61,FALSE,NA,"0.1.4"
"4084","646",2022-10-13 12:45:00,913,931,18,61,FALSE,NA,"0.1.4"
"4085","646",2022-10-13 13:00:00,913,931,18,61,FALSE,NA,"0.1.4"
"4086","646",2022-10-13 13:15:00,913,931,18,61,FALSE,NA,"0.1.4"
"4087","646",2022-10-13 13:30:00,913,931,18,61,FALSE,NA,"0.1.4"
"4088","646",2022-10-13 13:45:00,913,931,18,61,FALSE,NA,"0.1.4"
"4089","646",2022-10-13 14:00:00,913,931,18,61,FALSE,NA,"0.1.4"
"4090","646",2022-10-13 14:15:00,913,931,18,61,FALSE,NA,"0.1.4"
"4091","646",2022-10-13 14:30:00,913,931,18,61,FALSE,NA,"0.1.4"
"4092","646",2022-10-13 14:45:00,913,931,18,61,FALSE,NA,"0.1.4"
"4093","646",2022-10-13 15:00:00,913,931,18,61,FALSE,NA,"0.1.4"
"4094","646",2022-10-13 15:15:00,913,931,18,61,FALSE,NA,"0.1.4"
"4095","646",2022-10-13 15:30:00,913,931,18,61,FALSE,NA,"0.1.4"
"4096","646",2022-10-13 15:45:00,913,931,18,61,FALSE,NA,"0.1.4"
"4097","646",2022-10-13 16:00:00,913,931,18,61,FALSE,NA,"0.1.4"
"4098","646",2022-10-13 16:15:00,913,931,18,61,FALSE,NA,"0.1.4"
"4099","646",2022-10-13 16:30:00,913,931,18,61,FALSE,NA,"0.1.4"
"4100","646",2022-10-13 16:45:00,913,931,18,61,FALSE,NA,"0.1.4"
"4101","646",2022-10-13 17:00:00,913,931,18,61,FALSE,NA,"0.1.4"
"4102","646",2022-10-13 17:15:00,913,931,18,61,FALSE,NA,"0.1.4"
"4103","646",2022-10-13 17:30:00,913,931,18,61,FALSE,NA,"0.1.4"
"4104","646",2022-10-13 17:45:00,913,931,18,61,FALSE,NA,"0.1.4"
"4105","646",2022-10-13 18:00:00,913,931,18,61,FALSE,NA,"0.1.4"
"4106","646",2022-10-13 18:15:00,913,931,18,61,FALSE,NA,"0.1.4"
"4107","646",2022-10-13 18:30:00,913,931,18,61,FALSE,NA,"0.1.4"
"4108","646",2022-10-13 18:45:00,913,931,18,61,FALSE,NA,"0.1.4"
"4109","646",2022-10-13 19:00:00,913,931,18,61,FALSE,NA,"0.1.4"
"4110","646",2022-10-13 19:15:00,913,931,18,61,FALSE,NA,"0.1.4"
"4111","646",2022-10-13 19:30:00,913,931,18,61,FALSE,NA,"0.1.4"
"4112","646",2022-10-13 19:45:00,913,931,18,61,FALSE,NA,"0.1.4"
"4113","646",2022-10-13 20:00:00,913,931,18,61,FALSE,NA,"0.1.4"
"4114","646",2022-10-13 20:15:00,913,931,18,61,FALSE,NA,"0.1.4"
"4115","646",2022-10-13 20:30:00,913,931,18,61,FALSE,NA,"0.1.4"
"4116","646",2022-10-13 20:45:00,913,931,18,61,FALSE,NA,"0.1.4"
"4117","646",2022-10-13 21:00:00,913,931,18,61,FALSE,NA,"0.1.4"
"4118","646",2022-10-13 21:15:00,913,931,18,61,FALSE,NA,"0.1.4"
"4119","646",2022-10-13 21:30:00,913,931,18,61,FALSE,NA,"0.1.4"
"4120","646",2022-10-13 21:45:00,913,931,18,61,FALSE,NA,"0.1.4"
"4121","646",2022-10-13 22:00:00,913,931,18,61,FALSE,NA,"0.1.4"
"4122","646",2022-10-13 22:15:00,912,931,19,61,FALSE,NA,"0.1.4"
"4123","646",2022-10-13 22:30:00,912,931,19,61,FALSE,NA,"0.1.4"
"4124","646",2022-10-13 22:45:00,911,931,20,61,FALSE,NA,"0.1.4"
"4125","646",2022-10-13 23:00:00,910,931,21,61,FALSE,NA,"0.1.4"
"4126","646",2022-10-13 23:15:00,911,931,20,61,FALSE,NA,"0.1.4"
"4127","646",2022-10-13 23:30:00,910,931,21,61,FALSE,NA,"0.1.4"
"4128","646",2022-10-13 23:45:00,910,931,21,61,FALSE,NA,"0.1.4"
"4129","646",2022-10-14,910,931,21,61,FALSE,NA,"0.1.4"
"4130","646",2022-10-14 00:15:00,910,931,21,61,FALSE,NA,"0.1.4"
"4131","646",2022-10-14 00:30:00,910,931,21,61,FALSE,NA,"0.1.4"
"4132","646",2022-10-14 00:45:00,910,931,21,61,FALSE,NA,"0.1.4"
"4133","646",2022-10-14 01:00:00,910,931,21,61,FALSE,NA,"0.1.4"
"4134","646",2022-10-14 01:15:00,910,931,21,61,FALSE,NA,"0.1.4"
"4135","646",2022-10-14 01:30:00,910,931,21,61,FALSE,NA,"0.1.4"
"4136","646",2022-10-14 01:45:00,910,931,21,61,FALSE,NA,"0.1.4"
"4137","646",2022-10-14 02:00:00,910,931,21,61,FALSE,NA,"0.1.4"
"4138","646",2022-10-14 02:15:00,910,931,21,61,FALSE,NA,"0.1.4"
"4139","646",2022-10-14 02:30:00,910,931,21,61,FALSE,NA,"0.1.4"
"4140","646",2022-10-14 02:45:00,910,931,21,61,FALSE,NA,"0.1.4"
"4141","646",2022-10-14 03:00:00,910,931,21,61,FALSE,NA,"0.1.4"
"4142","646",2022-10-14 03:15:00,910,931,21,61,FALSE,NA,"0.1.4"
"4143","646",2022-10-14 03:30:00,910,931,21,61,FALSE,NA,"0.1.4"
"4144","646",2022-10-14 03:45:00,910,931,21,61,FALSE,NA,"0.1.4"
"4145","646",2022-10-14 04:00:00,910,931,21,61,FALSE,NA,"0.1.4"
"4146","646",2022-10-14 04:15:00,910,931,21,61,FALSE,NA,"0.1.4"
"4147","646",2022-10-14 04:30:00,910,931,21,61,FALSE,NA,"0.1.4"
"4148","646",2022-10-14 04:45:00,910,931,21,61,FALSE,NA,"0.1.4"
"4149","646",2022-10-14 05:00:00,910,931,21,61,FALSE,NA,"0.1.4"
"4150","646",2022-10-14 05:15:00,910,931,21,61,FALSE,NA,"0.1.4"
"4151","646",2022-10-14 05:30:00,910,931,21,61,FALSE,NA,"0.1.4"
"4152","646",2022-10-14 05:45:00,910,931,21,61,FALSE,NA,"0.1.4"
"4153","646",2022-10-14 06:00:00,910,931,21,61,FALSE,NA,"0.1.4"
"4154","646",2022-10-14 06:15:00,910,931,21,61,FALSE,NA,"0.1.4"
"4155","646",2022-10-14 06:30:00,910,931,21,61,FALSE,NA,"0.1.4"
"4156","646",2022-10-14 06:45:00,910,931,21,61,FALSE,NA,"0.1.4"
"4157","646",2022-10-14 07:00:00,910,931,21,61,FALSE,NA,"0.1.4"
"4158","646",2022-10-14 07:15:00,910,931,21,61,FALSE,NA,"0.1.4"
"4159","646",2022-10-14 07:30:00,910,931,21,61,FALSE,NA,"0.1.4"
"4160","646",2022-10-14 07:45:00,910,931,21,61,FALSE,NA,"0.1.4"
"4161","646",2022-10-14 08:00:00,910,931,21,61,FALSE,NA,"0.1.4"
"4162","646",2022-10-14 08:15:00,910,931,21,61,FALSE,NA,"0.1.4"
"4163","646",2022-10-14 08:30:00,910,931,21,61,FALSE,NA,"0.1.4"
"4164","646",2022-10-14 08:45:00,910,931,21,61,FALSE,NA,"0.1.4"
"4165","646",2022-10-14 09:00:00,910,931,21,61,FALSE,NA,"0.1.4"
"4166","646",2022-10-14 09:15:00,910,931,21,61,FALSE,NA,"0.1.4"
"4167","646",2022-10-14 09:30:00,910,931,21,61,FALSE,NA,"0.1.4"
"4168","646",2022-10-14 09:45:00,910,931,21,61,FALSE,NA,"0.1.4"
"4169","646",2022-10-14 10:00:00,910,931,21,61,FALSE,NA,"0.1.4"
"4170","646",2022-10-14 10:15:00,910,931,21,61,FALSE,NA,"0.1.4"
"4171","646",2022-10-14 10:30:00,910,931,21,61,FALSE,NA,"0.1.4"
"4172","646",2022-10-14 10:45:00,910,931,21,61,FALSE,NA,"0.1.4"
"4173","646",2022-10-14 11:00:00,910,931,21,61,FALSE,NA,"0.1.4"
"4174","646",2022-10-14 11:15:00,910,931,21,61,FALSE,NA,"0.1.4"
"4175","646",2022-10-14 11:30:00,910,931,21,61,FALSE,NA,"0.1.4"
"4176","646",2022-10-14 11:45:00,910,931,21,61,FALSE,NA,"0.1.4"
"4177","646",2022-10-14 12:00:00,910,931,21,61,FALSE,NA,"0.1.4"
"4178","646",2022-10-14 12:15:00,910,931,21,61,FALSE,NA,"0.1.4"
"4179","646",2022-10-14 12:30:00,910,931,21,61,FALSE,NA,"0.1.4"
"4180","646",2022-10-14 12:45:00,910,931,21,61,FALSE,NA,"0.1.4"
"4181","646",2022-10-14 13:00:00,910,931,21,61,FALSE,NA,"0.1.4"
"4182","646",2022-10-14 13:15:00,910,931,21,61,FALSE,NA,"0.1.4"
"4183","646",2022-10-14 13:30:00,910,931,21,61,FALSE,NA,"0.1.4"
"4184","646",2022-10-14 13:45:00,910,931,21,61,FALSE,NA,"0.1.4"
"4185","646",2022-10-14 14:00:00,910,931,21,61,FALSE,NA,"0.1.4"
"4186","646",2022-10-14 14:15:00,910,931,21,61,FALSE,NA,"0.1.4"
"4187","646",2022-10-14 14:30:00,910,931,21,61,FALSE,NA,"0.1.4"
"4188","646",2022-10-14 14:45:00,910,931,21,61,FALSE,NA,"0.1.4"
"4189","646",2022-10-14 15:00:00,910,931,21,61,FALSE,NA,"0.1.4"
"4190","646",2022-10-14 15:15:00,910,931,21,61,FALSE,NA,"0.1.4"
"4191","646",2022-10-14 15:30:00,910,931,21,61,FALSE,NA,"0.1.4"
"4192","646",2022-10-14 15:45:00,910,931,21,61,FALSE,NA,"0.1.4"
"4193","646",2022-10-14 16:00:00,910,931,21,61,FALSE,NA,"0.1.4"
"4194","646",2022-10-14 16:15:00,910,931,21,61,FALSE,NA,"0.1.4"
"4195","646",2022-10-14 16:30:00,910,931,21,61,FALSE,NA,"0.1.4"
"4196","646",2022-10-14 16:45:00,910,931,21,61,FALSE,NA,"0.1.4"
"4197","646",2022-10-14 17:00:00,910,931,21,61,FALSE,NA,"0.1.4"
"4198","646",2022-10-14 17:15:00,910,931,21,61,FALSE,NA,"0.1.4"
"4199","646",2022-10-14 17:30:00,910,931,21,61,FALSE,NA,"0.1.4"
"4200","646",2022-10-14 17:45:00,910,931,21,61,FALSE,NA,"0.1.4"
"4201","646",2022-10-14 18:00:00,910,931,21,61,FALSE,NA,"0.1.4"
"4202","646",2022-10-14 18:15:00,910,931,21,61,FALSE,NA,"0.1.4"
"4203","646",2022-10-14 18:30:00,910,931,21,61,FALSE,NA,"0.1.4"
"4204","646",2022-10-14 18:45:00,910,931,21,61,FALSE,NA,"0.1.4"
"4205","646",2022-10-14 19:00:00,911,931,20,61,FALSE,NA,"0.1.4"
"4206","646",2022-10-14 19:15:00,911,931,20,61,FALSE,NA,"0.1.4"
"4207","646",2022-10-14 19:30:00,911,931,20,61,FALSE,NA,"0.1.4"
"4208","646",2022-10-14 19:45:00,910,931,21,61,FALSE,NA,"0.1.4"
"4209","646",2022-10-14 20:00:00,910,931,21,61,FALSE,NA,"0.1.4"
"4210","646",2022-10-14 20:15:00,910,931,21,61,FALSE,NA,"0.1.4"
"4211","646",2022-10-14 20:30:00,910,931,21,61,FALSE,NA,"0.1.4"
"4212","646",2022-10-14 20:45:00,911,931,20,61,FALSE,NA,"0.1.4"
"4213","646",2022-10-14 21:00:00,911,931,20,61,FALSE,NA,"0.1.4"
"4214","646",2022-10-14 21:15:00,911,931,20,61,FALSE,NA,"0.1.4"
"4215","646",2022-10-14 21:30:00,911,931,20,61,FALSE,NA,"0.1.4"
"4216","646",2022-10-14 21:45:00,911,931,20,61,FALSE,NA,"0.1.4"
"4217","646",2022-10-14 22:00:00,911,931,20,61,FALSE,NA,"0.1.4"
"4218","646",2022-10-14 22:15:00,911,931,20,61,FALSE,NA,"0.1.4"
"4219","646",2022-10-14 22:30:00,911,931,20,61,FALSE,NA,"0.1.4"
"4220","646",2022-10-14 22:45:00,911,931,20,61,FALSE,NA,"0.1.4"
"4221","646",2022-10-14 23:00:00,911,931,20,61,FALSE,NA,"0.1.4"
"4222","646",2022-10-14 23:15:00,911,931,20,61,FALSE,NA,"0.1.4"
"4223","646",2022-10-14 23:30:00,911,931,20,61,FALSE,NA,"0.1.4"
"4224","646",2022-10-14 23:45:00,911,931,20,61,FALSE,NA,"0.1.4"
"4225","646",2022-10-15,910,931,21,61,FALSE,NA,"0.1.4"
"4226","646",2022-10-15 00:15:00,910,931,21,61,FALSE,NA,"0.1.4"
"4227","646",2022-10-15 00:30:00,910,931,21,61,FALSE,NA,"0.1.4"
"4228","646",2022-10-15 00:45:00,910,931,21,61,FALSE,NA,"0.1.4"
"4229","646",2022-10-15 01:00:00,910,931,21,61,FALSE,NA,"0.1.4"
"4230","646",2022-10-15 01:15:00,910,931,21,61,FALSE,NA,"0.1.4"
"4231","646",2022-10-15 01:30:00,910,931,21,61,FALSE,NA,"0.1.4"
"4232","646",2022-10-15 01:45:00,910,931,21,61,FALSE,NA,"0.1.4"
"4233","646",2022-10-15 02:00:00,910,931,21,61,FALSE,NA,"0.1.4"
"4234","646",2022-10-15 02:15:00,910,931,21,61,FALSE,NA,"0.1.4"
"4235","646",2022-10-15 02:30:00,910,931,21,61,FALSE,NA,"0.1.4"
"4236","646",2022-10-15 02:45:00,910,931,21,61,FALSE,NA,"0.1.4"
"4237","646",2022-10-15 03:00:00,910,931,21,61,FALSE,NA,"0.1.4"
"4238","646",2022-10-15 03:15:00,910,931,21,61,FALSE,NA,"0.1.4"
"4239","646",2022-10-15 03:30:00,910,931,21,61,FALSE,NA,"0.1.4"
"4240","646",2022-10-15 03:45:00,910,931,21,61,FALSE,NA,"0.1.4"
"4241","646",2022-10-15 04:00:00,910,931,21,61,FALSE,NA,"0.1.4"
"4242","646",2022-10-15 04:15:00,910,931,21,61,FALSE,NA,"0.1.4"
"4243","646",2022-10-15 04:30:00,910,931,21,61,FALSE,NA,"0.1.4"
"4244","646",2022-10-15 04:45:00,910,931,21,61,FALSE,NA,"0.1.4"
"4245","646",2022-10-15 05:00:00,910,931,21,61,FALSE,NA,"0.1.4"
"4246","646",2022-10-15 05:15:00,910,931,21,61,FALSE,NA,"0.1.4"
"4247","646",2022-10-15 05:30:00,910,931,21,61,FALSE,NA,"0.1.4"
"4248","646",2022-10-15 05:45:00,910,931,21,61,FALSE,NA,"0.1.4"
"4249","646",2022-10-15 06:00:00,910,931,21,61,FALSE,NA,"0.1.4"
"4250","646",2022-10-15 06:15:00,910,931,21,61,FALSE,NA,"0.1.4"
"4251","646",2022-10-15 06:30:00,910,931,21,61,FALSE,NA,"0.1.4"
"4252","646",2022-10-15 06:45:00,910,931,21,61,FALSE,NA,"0.1.4"
"4253","646",2022-10-15 07:00:00,910,931,21,61,FALSE,NA,"0.1.4"
"4254","646",2022-10-15 07:15:00,910,931,21,61,FALSE,NA,"0.1.4"
"4255","646",2022-10-15 07:30:00,910,931,21,61,FALSE,NA,"0.1.4"
"4256","646",2022-10-15 07:45:00,910,931,21,61,FALSE,NA,"0.1.4"
"4257","646",2022-10-15 08:00:00,911,931,20,61,FALSE,NA,"0.1.4"
"4258","646",2022-10-15 08:15:00,911,931,20,61,FALSE,NA,"0.1.4"
"4259","646",2022-10-15 08:30:00,910,931,21,61,FALSE,NA,"0.1.4"
"4260","646",2022-10-15 08:45:00,911,931,20,61,FALSE,NA,"0.1.4"
"4261","646",2022-10-15 09:00:00,911,931,20,61,FALSE,NA,"0.1.4"
"4262","646",2022-10-15 09:15:00,911,931,20,61,FALSE,NA,"0.1.4"
"4263","646",2022-10-15 09:30:00,911,931,20,61,FALSE,NA,"0.1.4"
"4264","646",2022-10-15 09:45:00,911,931,20,61,FALSE,NA,"0.1.4"
"4265","646",2022-10-15 10:00:00,911,931,20,61,FALSE,NA,"0.1.4"
"4266","646",2022-10-15 10:15:00,911,931,20,61,FALSE,NA,"0.1.4"
"4267","646",2022-10-15 10:30:00,911,931,20,61,FALSE,NA,"0.1.4"
"4268","646",2022-10-15 10:45:00,911,931,20,61,FALSE,NA,"0.1.4"
"4269","646",2022-10-15 11:00:00,911,931,20,61,FALSE,NA,"0.1.4"
"4270","646",2022-10-15 11:15:00,911,931,20,61,FALSE,NA,"0.1.4"
"4271","646",2022-10-15 11:30:00,911,931,20,61,FALSE,NA,"0.1.4"
"4272","646",2022-10-15 11:45:00,911,931,20,61,FALSE,NA,"0.1.4"
"4273","646",2022-10-15 12:00:00,911,931,20,61,FALSE,NA,"0.1.4"
"4274","646",2022-10-15 12:15:00,911,931,20,61,FALSE,NA,"0.1.4"
"4275","646",2022-10-15 12:30:00,911,931,20,61,FALSE,NA,"0.1.4"
"4276","646",2022-10-15 12:45:00,911,931,20,61,FALSE,NA,"0.1.4"
"4277","646",2022-10-15 13:00:00,911,931,20,61,FALSE,NA,"0.1.4"
"4278","646",2022-10-15 13:15:00,911,931,20,61,FALSE,NA,"0.1.4"
"4279","646",2022-10-15 13:30:00,911,931,20,61,FALSE,NA,"0.1.4"
"4280","646",2022-10-15 13:45:00,911,931,20,61,FALSE,NA,"0.1.4"
"4281","646",2022-10-15 14:00:00,911,931,20,61,FALSE,NA,"0.1.4"
"4282","646",2022-10-15 14:15:00,911,931,20,61,FALSE,NA,"0.1.4"
"4283","646",2022-10-15 14:30:00,911,931,20,61,FALSE,NA,"0.1.4"
"4284","646",2022-10-15 14:45:00,911,931,20,61,FALSE,NA,"0.1.4"
"4285","646",2022-10-15 15:00:00,911,931,20,61,FALSE,NA,"0.1.4"
"4286","646",2022-10-15 15:15:00,911,931,20,61,FALSE,NA,"0.1.4"
"4287","646",2022-10-15 15:30:00,911,931,20,61,FALSE,NA,"0.1.4"
"4288","646",2022-10-15 15:45:00,911,931,20,61,FALSE,NA,"0.1.4"
"4289","646",2022-10-15 16:00:00,911,931,20,61,FALSE,NA,"0.1.4"
"4290","646",2022-10-15 16:15:00,911,931,20,61,FALSE,NA,"0.1.4"
"4291","646",2022-10-15 16:30:00,911,931,20,61,FALSE,NA,"0.1.4"
"4292","646",2022-10-15 16:45:00,911,931,20,61,FALSE,NA,"0.1.4"
"4293","646",2022-10-15 17:00:00,911,931,20,61,FALSE,NA,"0.1.4"
"4294","646",2022-10-15 17:15:00,911,931,20,61,FALSE,NA,"0.1.4"
"4295","646",2022-10-15 17:30:00,911,931,20,61,FALSE,NA,"0.1.4"
"4296","646",2022-10-15 17:45:00,911,931,20,61,FALSE,NA,"0.1.4"
"4297","646",2022-10-15 18:00:00,911,931,20,61,FALSE,NA,"0.1.4"
"4298","646",2022-10-15 18:15:00,911,931,20,61,FALSE,NA,"0.1.4"
"4299","646",2022-10-15 18:30:00,911,931,20,61,FALSE,NA,"0.1.4"
"4300","646",2022-10-15 18:45:00,911,931,20,61,FALSE,NA,"0.1.4"
"4301","646",2022-10-15 19:00:00,911,931,20,61,FALSE,NA,"0.1.4"
"4302","646",2022-10-15 19:15:00,911,931,20,61,FALSE,NA,"0.1.4"
"4303","646",2022-10-15 19:30:00,911,931,20,61,FALSE,NA,"0.1.4"
"4304","646",2022-10-15 19:45:00,911,931,20,61,FALSE,NA,"0.1.4"
"4305","646",2022-10-15 20:00:00,911,931,20,61,FALSE,NA,"0.1.4"
"4306","646",2022-10-15 20:15:00,911,931,20,61,FALSE,NA,"0.1.4"
"4307","646",2022-10-15 20:30:00,911,931,20,61,FALSE,NA,"0.1.4"
"4308","646",2022-10-15 20:45:00,911,931,20,61,FALSE,NA,"0.1.4"
"4309","646",2022-10-15 21:00:00,911,931,20,61,FALSE,NA,"0.1.4"
"4310","646",2022-10-15 21:15:00,911,931,20,61,FALSE,NA,"0.1.4"
"4311","646",2022-10-15 21:30:00,911,931,20,61,FALSE,NA,"0.1.4"
"4312","646",2022-10-15 21:45:00,911,931,20,61,FALSE,NA,"0.1.4"
"4313","646",2022-10-15 22:00:00,911,931,20,61,FALSE,NA,"0.1.4"
"4314","646",2022-10-15 22:15:00,910,931,21,61,FALSE,NA,"0.1.4"
"4315","646",2022-10-15 22:30:00,907,931,24,61,FALSE,NA,"0.1.4"
"4316","646",2022-10-15 22:45:00,906,931,25,61,FALSE,NA,"0.1.4"
"4317","646",2022-10-15 23:00:00,906,931,25,61,FALSE,NA,"0.1.4"
"4318","646",2022-10-15 23:15:00,905,931,26,61,FALSE,NA,"0.1.4"
"4319","646",2022-10-15 23:30:00,904,931,27,61,FALSE,NA,"0.1.4"
"4320","646",2022-10-15 23:45:00,905,931,26,61,FALSE,NA,"0.1.4"
"4321","646",2022-10-16,905,931,26,61,FALSE,NA,"0.1.4"
"4322","646",2022-10-16 00:15:00,905,931,26,61,FALSE,NA,"0.1.4"
"4323","646",2022-10-16 00:30:00,905,931,26,61,FALSE,NA,"0.1.4"
"4324","646",2022-10-16 00:45:00,905,931,26,61,FALSE,NA,"0.1.4"
"4325","646",2022-10-16 01:00:00,905,931,26,61,FALSE,NA,"0.1.4"
"4326","646",2022-10-16 01:15:00,905,931,26,61,FALSE,NA,"0.1.4"
"4327","646",2022-10-16 01:30:00,905,931,26,61,FALSE,NA,"0.1.4"
"4328","646",2022-10-16 01:45:00,905,931,26,61,FALSE,NA,"0.1.4"
"4329","646",2022-10-16 02:00:00,905,931,26,61,FALSE,NA,"0.1.4"
"4330","646",2022-10-16 02:15:00,905,931,26,61,FALSE,NA,"0.1.4"
"4331","646",2022-10-16 02:30:00,905,931,26,61,FALSE,NA,"0.1.4"
"4332","646",2022-10-16 02:45:00,905,931,26,61,FALSE,NA,"0.1.4"
"4333","646",2022-10-16 03:00:00,905,931,26,61,FALSE,NA,"0.1.4"
"4334","646",2022-10-16 03:15:00,905,931,26,61,FALSE,NA,"0.1.4"
"4335","646",2022-10-16 03:30:00,905,931,26,61,FALSE,NA,"0.1.4"
"4336","646",2022-10-16 03:45:00,905,931,26,61,FALSE,NA,"0.1.4"
"4337","646",2022-10-16 04:00:00,905,931,26,61,FALSE,NA,"0.1.4"
"4338","646",2022-10-16 04:15:00,905,931,26,61,FALSE,NA,"0.1.4"
"4339","646",2022-10-16 04:30:00,905,931,26,61,FALSE,NA,"0.1.4"
"4340","646",2022-10-16 04:45:00,905,931,26,61,FALSE,NA,"0.1.4"
"4341","646",2022-10-16 05:00:00,905,931,26,61,FALSE,NA,"0.1.4"
"4342","646",2022-10-16 05:15:00,905,931,26,61,FALSE,NA,"0.1.4"
"4343","646",2022-10-16 05:30:00,905,931,26,61,FALSE,NA,"0.1.4"
"4344","646",2022-10-16 05:45:00,905,931,26,61,FALSE,NA,"0.1.4"
"4345","646",2022-10-16 06:00:00,905,931,26,61,FALSE,NA,"0.1.4"
"4346","646",2022-10-16 06:15:00,905,931,26,61,FALSE,NA,"0.1.4"
"4347","646",2022-10-16 06:30:00,905,931,26,61,FALSE,NA,"0.1.4"
"4348","646",2022-10-16 06:45:00,905,931,26,61,FALSE,NA,"0.1.4"
"4349","646",2022-10-16 07:00:00,905,931,26,61,FALSE,NA,"0.1.4"
"4350","646",2022-10-16 07:15:00,905,931,26,61,FALSE,NA,"0.1.4"
"4351","646",2022-10-16 07:30:00,905,931,26,61,FALSE,NA,"0.1.4"
"4352","646",2022-10-16 07:45:00,905,931,26,61,FALSE,NA,"0.1.4"
"4353","646",2022-10-16 08:00:00,906,931,25,61,FALSE,NA,"0.1.4"
"4354","646",2022-10-16 08:15:00,906,931,25,61,FALSE,NA,"0.1.4"
"4355","646",2022-10-16 08:30:00,906,931,25,61,FALSE,NA,"0.1.4"
"4356","646",2022-10-16 08:45:00,906,931,25,61,FALSE,NA,"0.1.4"
"4357","646",2022-10-16 09:00:00,906,931,25,61,FALSE,NA,"0.1.4"
"4358","646",2022-10-16 09:15:00,905,931,26,61,FALSE,NA,"0.1.4"
"4359","646",2022-10-16 09:30:00,906,931,25,61,FALSE,NA,"0.1.4"
"4360","646",2022-10-16 09:45:00,906,931,25,61,FALSE,NA,"0.1.4"
"4361","646",2022-10-16 10:00:00,906,931,25,61,FALSE,NA,"0.1.4"
"4362","646",2022-10-16 10:15:00,906,931,25,61,FALSE,NA,"0.1.4"
"4363","646",2022-10-16 10:30:00,906,931,25,61,FALSE,NA,"0.1.4"
"4364","646",2022-10-16 10:45:00,906,931,25,61,FALSE,NA,"0.1.4"
"4365","646",2022-10-16 11:00:00,906,931,25,61,FALSE,NA,"0.1.4"
"4366","646",2022-10-16 11:15:00,905,931,26,61,FALSE,NA,"0.1.4"
"4367","646",2022-10-16 11:30:00,906,931,25,61,FALSE,NA,"0.1.4"
"4368","646",2022-10-16 11:45:00,906,931,25,61,FALSE,NA,"0.1.4"
"4369","646",2022-10-16 12:00:00,906,931,25,61,FALSE,NA,"0.1.4"
"4370","646",2022-10-16 12:15:00,906,931,25,61,FALSE,NA,"0.1.4"
"4371","646",2022-10-16 12:30:00,907,931,24,61,FALSE,NA,"0.1.4"
"4372","646",2022-10-16 12:45:00,906,931,25,61,FALSE,NA,"0.1.4"
"4373","646",2022-10-16 13:00:00,906,931,25,61,FALSE,NA,"0.1.4"
"4374","646",2022-10-16 13:15:00,907,931,24,61,FALSE,NA,"0.1.4"
"4375","646",2022-10-16 13:30:00,907,931,24,61,FALSE,NA,"0.1.4"
"4376","646",2022-10-16 13:45:00,907,931,24,61,FALSE,NA,"0.1.4"
"4377","646",2022-10-16 14:00:00,907,931,24,61,FALSE,NA,"0.1.4"
"4378","646",2022-10-16 14:15:00,907,931,24,61,FALSE,NA,"0.1.4"
"4379","646",2022-10-16 14:30:00,907,931,24,61,FALSE,NA,"0.1.4"
"4380","646",2022-10-16 14:45:00,907,931,24,61,FALSE,NA,"0.1.4"
"4381","646",2022-10-16 15:00:00,907,931,24,61,FALSE,NA,"0.1.4"
"4382","646",2022-10-16 15:15:00,907,931,24,61,FALSE,NA,"0.1.4"
"4383","646",2022-10-16 15:30:00,907,931,24,61,FALSE,NA,"0.1.4"
"4384","646",2022-10-16 15:45:00,907,931,24,61,FALSE,NA,"0.1.4"
"4385","646",2022-10-16 16:00:00,907,931,24,61,FALSE,NA,"0.1.4"
"4386","646",2022-10-16 16:15:00,907,931,24,61,FALSE,NA,"0.1.4"
"4387","646",2022-10-16 16:30:00,907,931,24,61,FALSE,NA,"0.1.4"
"4388","646",2022-10-16 16:45:00,907,931,24,61,FALSE,NA,"0.1.4"
"4389","646",2022-10-16 17:00:00,907,931,24,61,FALSE,NA,"0.1.4"
"4390","646",2022-10-16 17:15:00,907,931,24,61,FALSE,NA,"0.1.4"
"4391","646",2022-10-16 17:30:00,907,931,24,61,FALSE,NA,"0.1.4"
"4392","646",2022-10-16 17:45:00,907,931,24,61,FALSE,NA,"0.1.4"
"4393","646",2022-10-16 18:00:00,907,931,24,61,FALSE,NA,"0.1.4"
"4394","646",2022-10-16 18:15:00,907,931,24,61,FALSE,NA,"0.1.4"
"4395","646",2022-10-16 18:30:00,907,931,24,61,FALSE,NA,"0.1.4"
"4396","646",2022-10-16 18:45:00,907,931,24,61,FALSE,NA,"0.1.4"
"4397","646",2022-10-16 19:00:00,907,931,24,61,FALSE,NA,"0.1.4"
"4398","646",2022-10-16 19:15:00,907,931,24,61,FALSE,NA,"0.1.4"
"4399","646",2022-10-16 19:30:00,907,931,24,61,FALSE,NA,"0.1.4"
"4400","646",2022-10-16 19:45:00,907,931,24,61,FALSE,NA,"0.1.4"
"4401","646",2022-10-16 20:00:00,907,931,24,61,FALSE,NA,"0.1.4"
"4402","646",2022-10-16 20:15:00,907,931,24,61,FALSE,NA,"0.1.4"
"4403","646",2022-10-16 20:30:00,907,931,24,61,FALSE,NA,"0.1.4"
"4404","646",2022-10-16 20:45:00,907,931,24,61,FALSE,NA,"0.1.4"
"4405","646",2022-10-16 21:00:00,907,931,24,61,FALSE,NA,"0.1.4"
"4406","646",2022-10-16 21:15:00,907,931,24,61,FALSE,NA,"0.1.4"
"4407","646",2022-10-16 21:30:00,907,931,24,61,FALSE,NA,"0.1.4"
"4408","646",2022-10-16 21:45:00,907,931,24,61,FALSE,NA,"0.1.4"
"4409","646",2022-10-16 22:00:00,907,931,24,61,FALSE,NA,"0.1.4"
"4410","646",2022-10-16 22:15:00,906,931,25,61,FALSE,NA,"0.1.4"
"4411","646",2022-10-16 22:30:00,904,931,27,61,FALSE,NA,"0.1.4"
"4412","646",2022-10-16 22:45:00,904,931,27,61,FALSE,NA,"0.1.4"
"4413","646",2022-10-16 23:00:00,903,931,28,61,FALSE,NA,"0.1.4"
"4414","646",2022-10-16 23:15:00,903,931,28,61,FALSE,NA,"0.1.4"
"4415","646",2022-10-16 23:30:00,902,931,29,61,FALSE,NA,"0.1.4"
"4416","646",2022-10-16 23:45:00,901,931,30,61,FALSE,NA,"0.1.4"
"4417","646",2022-10-17,901,931,30,61,FALSE,NA,"0.1.4"
"4418","646",2022-10-17 00:15:00,901,931,30,61,FALSE,NA,"0.1.4"
"4419","646",2022-10-17 00:30:00,901,931,30,61,FALSE,NA,"0.1.4"
"4420","646",2022-10-17 00:45:00,901,931,30,61,FALSE,NA,"0.1.4"
"4421","646",2022-10-17 01:00:00,901,931,30,61,FALSE,NA,"0.1.4"
"4422","646",2022-10-17 01:15:00,901,931,30,61,FALSE,NA,"0.1.4"
"4423","646",2022-10-17 01:30:00,901,931,30,61,FALSE,NA,"0.1.4"
"4424","646",2022-10-17 01:45:00,901,931,30,61,FALSE,NA,"0.1.4"
"4425","646",2022-10-17 02:00:00,901,931,30,61,FALSE,NA,"0.1.4"
"4426","646",2022-10-17 02:15:00,901,931,30,61,FALSE,NA,"0.1.4"
"4427","646",2022-10-17 02:30:00,901,931,30,61,FALSE,NA,"0.1.4"
"4428","646",2022-10-17 02:45:00,901,931,30,61,FALSE,NA,"0.1.4"
"4429","646",2022-10-17 03:00:00,901,931,30,61,FALSE,NA,"0.1.4"
"4430","646",2022-10-17 03:15:00,901,931,30,61,FALSE,NA,"0.1.4"
"4431","646",2022-10-17 03:30:00,901,931,30,61,FALSE,NA,"0.1.4"
"4432","646",2022-10-17 03:45:00,901,931,30,61,FALSE,NA,"0.1.4"
"4433","646",2022-10-17 04:00:00,901,931,30,61,FALSE,NA,"0.1.4"
"4434","646",2022-10-17 04:15:00,901,931,30,61,FALSE,NA,"0.1.4"
"4435","646",2022-10-17 04:30:00,901,931,30,61,FALSE,NA,"0.1.4"
"4436","646",2022-10-17 04:45:00,901,931,30,61,FALSE,NA,"0.1.4"
"4437","646",2022-10-17 05:00:00,901,931,30,61,FALSE,NA,"0.1.4"
"4438","646",2022-10-17 05:15:00,901,931,30,61,FALSE,NA,"0.1.4"
"4439","646",2022-10-17 05:30:00,901,931,30,61,FALSE,NA,"0.1.4"
"4440","646",2022-10-17 05:45:00,901,931,30,61,FALSE,NA,"0.1.4"
"4441","646",2022-10-17 06:00:00,901,931,30,61,FALSE,NA,"0.1.4"
"4442","646",2022-10-17 06:15:00,901,931,30,61,FALSE,NA,"0.1.4"
"4443","646",2022-10-17 06:30:00,901,931,30,61,FALSE,NA,"0.1.4"
"4444","646",2022-10-17 06:45:00,901,931,30,61,FALSE,NA,"0.1.4"
"4445","646",2022-10-17 07:00:00,901,931,30,61,FALSE,NA,"0.1.4"
"4446","646",2022-10-17 07:15:00,901,931,30,61,FALSE,NA,"0.1.4"
"4447","646",2022-10-17 07:30:00,901,931,30,61,FALSE,NA,"0.1.4"
"4448","646",2022-10-17 07:45:00,901,931,30,61,FALSE,NA,"0.1.4"
"4449","646",2022-10-17 08:00:00,901,931,30,61,FALSE,NA,"0.1.4"
"4450","646",2022-10-17 08:15:00,901,931,30,61,FALSE,NA,"0.1.4"
"4451","646",2022-10-17 08:30:00,901,931,30,61,FALSE,NA,"0.1.4"
"4452","646",2022-10-17 08:45:00,901,931,30,61,FALSE,NA,"0.1.4"
"4453","646",2022-10-17 09:00:00,901,931,30,61,FALSE,NA,"0.1.4"
"4454","646",2022-10-17 09:15:00,901,931,30,61,FALSE,NA,"0.1.4"
"4455","646",2022-10-17 09:30:00,901,931,30,61,FALSE,NA,"0.1.4"
"4456","646",2022-10-17 09:45:00,901,931,30,61,FALSE,NA,"0.1.4"
"4457","646",2022-10-17 10:00:00,901,931,30,61,FALSE,NA,"0.1.4"
"4458","646",2022-10-17 10:15:00,902,931,29,61,FALSE,NA,"0.1.4"
"4459","646",2022-10-17 10:30:00,902,931,29,61,FALSE,NA,"0.1.4"
"4460","646",2022-10-17 10:45:00,902,931,29,61,FALSE,NA,"0.1.4"
"4461","646",2022-10-17 11:00:00,902,931,29,61,FALSE,NA,"0.1.4"
"4462","646",2022-10-17 11:15:00,902,931,29,61,FALSE,NA,"0.1.4"
"4463","646",2022-10-17 11:30:00,902,931,29,61,FALSE,NA,"0.1.4"
"4464","646",2022-10-17 11:45:00,902,931,29,61,FALSE,NA,"0.1.4"
"4465","646",2022-10-17 12:00:00,902,931,29,61,FALSE,NA,"0.1.4"
"4466","646",2022-10-17 12:15:00,902,931,29,61,FALSE,NA,"0.1.4"
"4467","646",2022-10-17 12:30:00,902,931,29,61,FALSE,NA,"0.1.4"
"4468","646",2022-10-17 12:45:00,902,931,29,61,FALSE,NA,"0.1.4"
"4469","646",2022-10-17 13:00:00,903,931,28,61,FALSE,NA,"0.1.4"
"4470","646",2022-10-17 13:15:00,902,931,29,61,FALSE,NA,"0.1.4"
"4471","646",2022-10-17 13:30:00,903,931,28,61,FALSE,NA,"0.1.4"
"4472","646",2022-10-17 13:45:00,903,931,28,61,FALSE,NA,"0.1.4"
"4473","646",2022-10-17 14:00:00,903,931,28,61,FALSE,NA,"0.1.4"
"4474","646",2022-10-17 14:15:00,903,931,28,61,FALSE,NA,"0.1.4"
"4475","646",2022-10-17 14:30:00,903,931,28,61,FALSE,NA,"0.1.4"
"4476","646",2022-10-17 14:45:00,903,931,28,61,FALSE,NA,"0.1.4"
"4477","646",2022-10-17 15:00:00,904,931,27,61,FALSE,NA,"0.1.4"
"4478","646",2022-10-17 15:15:00,904,931,27,61,FALSE,NA,"0.1.4"
"4479","646",2022-10-17 15:30:00,905,931,26,61,FALSE,NA,"0.1.4"
"4480","646",2022-10-17 15:45:00,904,931,27,61,FALSE,NA,"0.1.4"
"4481","646",2022-10-17 16:00:00,905,931,26,61,FALSE,NA,"0.1.4"
"4482","646",2022-10-17 16:15:00,904,931,27,61,FALSE,NA,"0.1.4"
"4483","646",2022-10-17 16:30:00,904,931,27,61,FALSE,NA,"0.1.4"
"4484","646",2022-10-17 16:45:00,904,931,27,61,FALSE,NA,"0.1.4"
"4485","646",2022-10-17 17:00:00,904,931,27,61,FALSE,NA,"0.1.4"
"4486","646",2022-10-17 17:15:00,904,931,27,61,FALSE,NA,"0.1.4"
"4487","646",2022-10-17 17:30:00,904,931,27,61,FALSE,NA,"0.1.4"
"4488","646",2022-10-17 17:45:00,904,931,27,61,FALSE,NA,"0.1.4"
"4489","646",2022-10-17 18:00:00,904,931,27,61,FALSE,NA,"0.1.4"
"4490","646",2022-10-17 18:15:00,904,931,27,61,FALSE,NA,"0.1.4"
"4491","646",2022-10-17 18:30:00,905,931,26,61,FALSE,NA,"0.1.4"
"4492","646",2022-10-17 18:45:00,905,931,26,61,FALSE,NA,"0.1.4"
"4493","646",2022-10-17 19:00:00,904,931,27,61,FALSE,NA,"0.1.4"
"4494","646",2022-10-17 19:15:00,905,931,26,61,FALSE,NA,"0.1.4"
"4495","646",2022-10-17 19:30:00,905,931,26,61,FALSE,NA,"0.1.4"
"4496","646",2022-10-17 19:45:00,905,931,26,61,FALSE,NA,"0.1.4"
"4497","646",2022-10-17 20:00:00,905,931,26,61,FALSE,NA,"0.1.4"
"4498","646",2022-10-17 20:15:00,905,931,26,61,FALSE,NA,"0.1.4"
"4499","646",2022-10-17 20:30:00,905,931,26,61,FALSE,NA,"0.1.4"
"4500","646",2022-10-17 20:45:00,904,931,27,61,FALSE,NA,"0.1.4"
"4501","646",2022-10-17 21:00:00,905,931,26,61,FALSE,NA,"0.1.4"
"4502","646",2022-10-17 21:15:00,904,931,27,61,FALSE,NA,"0.1.4"
"4503","646",2022-10-17 21:30:00,904,931,27,61,FALSE,NA,"0.1.4"
"4504","646",2022-10-17 21:45:00,904,931,27,61,FALSE,NA,"0.1.4"
"4505","646",2022-10-17 22:00:00,904,931,27,61,FALSE,NA,"0.1.4"
"4506","646",2022-10-17 22:15:00,904,931,27,61,FALSE,NA,"0.1.4"
"4507","646",2022-10-17 22:30:00,904,931,27,61,FALSE,NA,"0.1.4"
"4508","646",2022-10-17 22:45:00,904,931,27,61,FALSE,NA,"0.1.4"
"4509","646",2022-10-17 23:00:00,904,931,27,61,FALSE,NA,"0.1.4"
"4510","646",2022-10-17 23:15:00,904,931,27,61,FALSE,NA,"0.1.4"
"4511","646",2022-10-17 23:30:00,904,931,27,61,FALSE,NA,"0.1.4"
"4512","646",2022-10-17 23:45:00,904,931,27,61,FALSE,NA,"0.1.4"
"4513","646",2022-10-18,904,931,27,61,FALSE,NA,"0.1.4"
"4514","646",2022-10-18 00:15:00,904,931,27,61,FALSE,NA,"0.1.4"
"4515","646",2022-10-18 00:30:00,904,931,27,61,FALSE,NA,"0.1.4"
"4516","646",2022-10-18 00:45:00,904,931,27,61,FALSE,NA,"0.1.4"
"4517","646",2022-10-18 01:00:00,904,931,27,61,FALSE,NA,"0.1.4"
"4518","646",2022-10-18 01:15:00,904,931,27,61,FALSE,NA,"0.1.4"
"4519","646",2022-10-18 01:30:00,904,931,27,61,FALSE,NA,"0.1.4"
"4520","646",2022-10-18 01:45:00,904,931,27,61,FALSE,NA,"0.1.4"
"4521","646",2022-10-18 02:00:00,904,931,27,61,FALSE,NA,"0.1.4"
"4522","646",2022-10-18 02:15:00,904,931,27,61,FALSE,NA,"0.1.4"
"4523","646",2022-10-18 02:30:00,904,931,27,61,FALSE,NA,"0.1.4"
"4524","646",2022-10-18 02:45:00,904,931,27,61,FALSE,NA,"0.1.4"
"4525","646",2022-10-18 03:00:00,904,931,27,61,FALSE,NA,"0.1.4"
"4526","646",2022-10-18 03:15:00,904,931,27,61,FALSE,NA,"0.1.4"
"4527","646",2022-10-18 03:30:00,904,931,27,61,FALSE,NA,"0.1.4"
"4528","646",2022-10-18 03:45:00,904,931,27,61,FALSE,NA,"0.1.4"
"4529","646",2022-10-18 04:00:00,904,931,27,61,FALSE,NA,"0.1.4"
"4530","646",2022-10-18 04:15:00,904,931,27,61,FALSE,NA,"0.1.4"
"4531","646",2022-10-18 04:30:00,904,931,27,61,FALSE,NA,"0.1.4"
"4532","646",2022-10-18 04:45:00,904,931,27,61,FALSE,NA,"0.1.4"
"4533","646",2022-10-18 05:00:00,904,931,27,61,FALSE,NA,"0.1.4"
"4534","646",2022-10-18 05:15:00,904,931,27,61,FALSE,NA,"0.1.4"
"4535","646",2022-10-18 05:30:00,904,931,27,61,FALSE,NA,"0.1.4"
"4536","646",2022-10-18 05:45:00,905,931,26,61,FALSE,NA,"0.1.4"
"4537","646",2022-10-18 06:00:00,905,931,26,61,FALSE,NA,"0.1.4"
"4538","646",2022-10-18 06:15:00,904,931,27,61,FALSE,NA,"0.1.4"
"4539","646",2022-10-18 06:30:00,904,931,27,61,FALSE,NA,"0.1.4"
"4540","646",2022-10-18 06:45:00,904,931,27,61,FALSE,NA,"0.1.4"
"4541","646",2022-10-18 07:00:00,904,931,27,61,FALSE,NA,"0.1.4"
"4542","646",2022-10-18 07:15:00,904,931,27,61,FALSE,NA,"0.1.4"
"4543","646",2022-10-18 07:30:00,905,931,26,61,FALSE,NA,"0.1.4"
"4544","646",2022-10-18 07:45:00,905,931,26,61,FALSE,NA,"0.1.4"
"4545","646",2022-10-18 08:00:00,905,931,26,61,FALSE,NA,"0.1.4"
"4546","646",2022-10-18 08:15:00,905,931,26,61,FALSE,NA,"0.1.4"
"4547","646",2022-10-18 08:30:00,904,931,27,61,FALSE,NA,"0.1.4"
"4548","646",2022-10-18 08:45:00,904,931,27,61,FALSE,NA,"0.1.4"
"4549","646",2022-10-18 09:00:00,905,931,26,61,FALSE,NA,"0.1.4"
"4550","646",2022-10-18 09:15:00,905,931,26,61,FALSE,NA,"0.1.4"
"4551","646",2022-10-18 09:30:00,905,931,26,61,FALSE,NA,"0.1.4"
"4552","646",2022-10-18 09:45:00,906,931,25,61,FALSE,NA,"0.1.4"
"4553","646",2022-10-18 10:00:00,906,931,25,61,FALSE,NA,"0.1.4"
"4554","646",2022-10-18 10:15:00,906,931,25,61,FALSE,NA,"0.1.4"
"4555","646",2022-10-18 10:30:00,907,931,24,61,FALSE,NA,"0.1.4"
"4556","646",2022-10-18 10:45:00,906,931,25,61,FALSE,NA,"0.1.4"
"4557","646",2022-10-18 11:00:00,906,931,25,61,FALSE,NA,"0.1.4"
"4558","646",2022-10-18 11:15:00,906,931,25,61,FALSE,NA,"0.1.4"
"4559","646",2022-10-18 11:30:00,906,931,25,61,FALSE,NA,"0.1.4"
"4560","646",2022-10-18 11:45:00,907,931,24,61,FALSE,NA,"0.1.4"
"4561","646",2022-10-18 12:00:00,907,931,24,61,FALSE,NA,"0.1.4"
"4562","646",2022-10-18 12:15:00,907,931,24,61,FALSE,NA,"0.1.4"
"4563","646",2022-10-18 12:30:00,907,931,24,61,FALSE,NA,"0.1.4"
"4564","646",2022-10-18 12:45:00,907,931,24,61,FALSE,NA,"0.1.4"
"4565","646",2022-10-18 13:00:00,906,931,25,61,FALSE,NA,"0.1.4"
"4566","646",2022-10-18 13:15:00,907,931,24,61,FALSE,NA,"0.1.4"
"4567","646",2022-10-18 13:30:00,908,931,23,61,FALSE,NA,"0.1.4"
"4568","646",2022-10-18 13:45:00,908,931,23,61,FALSE,NA,"0.1.4"
"4569","646",2022-10-18 14:00:00,907,931,24,61,FALSE,NA,"0.1.4"
"4570","646",2022-10-18 14:15:00,908,931,23,61,FALSE,NA,"0.1.4"
"4571","646",2022-10-18 14:30:00,908,931,23,61,FALSE,NA,"0.1.4"
"4572","646",2022-10-18 14:45:00,908,931,23,61,FALSE,NA,"0.1.4"
"4573","646",2022-10-18 15:00:00,907,931,24,61,FALSE,NA,"0.1.4"
"4574","646",2022-10-18 15:15:00,908,931,23,61,FALSE,NA,"0.1.4"
"4575","646",2022-10-18 15:30:00,907,931,24,61,FALSE,NA,"0.1.4"
"4576","646",2022-10-18 15:45:00,907,931,24,61,FALSE,NA,"0.1.4"
"4577","646",2022-10-18 16:00:00,907,931,24,61,FALSE,NA,"0.1.4"
"4578","646",2022-10-18 16:15:00,908,931,23,61,FALSE,NA,"0.1.4"
"4579","646",2022-10-18 16:30:00,908,931,23,61,FALSE,NA,"0.1.4"
"4580","646",2022-10-18 16:45:00,908,931,23,61,FALSE,NA,"0.1.4"
"4581","646",2022-10-18 17:00:00,908,931,23,61,FALSE,NA,"0.1.4"
"4582","646",2022-10-18 17:15:00,908,931,23,61,FALSE,NA,"0.1.4"
"4583","646",2022-10-18 17:30:00,908,931,23,61,FALSE,NA,"0.1.4"
"4584","646",2022-10-18 17:45:00,908,931,23,61,FALSE,NA,"0.1.4"
"4585","646",2022-10-18 18:00:00,908,931,23,61,FALSE,NA,"0.1.4"
"4586","646",2022-10-18 18:15:00,908,931,23,61,FALSE,NA,"0.1.4"
"4587","646",2022-10-18 18:30:00,908,931,23,61,FALSE,NA,"0.1.4"
"4588","646",2022-10-18 18:45:00,908,931,23,61,FALSE,NA,"0.1.4"
"4589","646",2022-10-18 19:00:00,909,931,22,61,FALSE,NA,"0.1.4"
"4590","646",2022-10-18 19:15:00,909,931,22,61,FALSE,NA,"0.1.4"
"4591","646",2022-10-18 19:30:00,909,931,22,61,FALSE,NA,"0.1.4"
"4592","646",2022-10-18 19:45:00,909,931,22,61,FALSE,NA,"0.1.4"
"4593","646",2022-10-18 20:00:00,909,931,22,61,FALSE,NA,"0.1.4"
"4594","646",2022-10-18 20:15:00,909,931,22,61,FALSE,NA,"0.1.4"
"4595","646",2022-10-18 20:30:00,909,931,22,61,FALSE,NA,"0.1.4"
"4596","646",2022-10-18 20:45:00,909,931,22,61,FALSE,NA,"0.1.4"
"4597","646",2022-10-18 21:00:00,909,931,22,61,FALSE,NA,"0.1.4"
"4598","646",2022-10-18 21:15:00,909,931,22,61,FALSE,NA,"0.1.4"
"4599","646",2022-10-18 21:30:00,909,931,22,61,FALSE,NA,"0.1.4"
"4600","646",2022-10-18 21:45:00,908,931,23,61,FALSE,NA,"0.1.4"
"4601","646",2022-10-18 22:00:00,909,931,22,61,FALSE,NA,"0.1.4"
"4602","646",2022-10-18 22:15:00,909,931,22,61,FALSE,NA,"0.1.4"
"4603","646",2022-10-18 22:30:00,909,931,22,61,FALSE,NA,"0.1.4"
"4604","646",2022-10-18 22:45:00,908,931,23,61,FALSE,NA,"0.1.4"
"4605","646",2022-10-18 23:00:00,908,931,23,61,FALSE,NA,"0.1.4"
"4606","646",2022-10-18 23:15:00,908,931,23,61,FALSE,NA,"0.1.4"
"4607","646",2022-10-18 23:30:00,908,931,23,61,FALSE,NA,"0.1.4"
"4608","646",2022-10-18 23:45:00,908,931,23,61,FALSE,NA,"0.1.4"
"4609","646",2022-10-19,908,931,23,61,FALSE,NA,"0.1.4"
"4610","646",2022-10-19 00:15:00,908,931,23,61,FALSE,NA,"0.1.4"
"4611","646",2022-10-19 00:30:00,908,931,23,61,FALSE,NA,"0.1.4"
"4612","646",2022-10-19 00:45:00,908,931,23,61,FALSE,NA,"0.1.4"
"4613","646",2022-10-19 01:00:00,908,931,23,61,FALSE,NA,"0.1.4"
"4614","646",2022-10-19 01:15:00,908,931,23,61,FALSE,NA,"0.1.4"
"4615","646",2022-10-19 01:30:00,908,931,23,61,FALSE,NA,"0.1.4"
"4616","646",2022-10-19 01:45:00,908,931,23,61,FALSE,NA,"0.1.4"
"4617","646",2022-10-19 02:00:00,908,931,23,61,FALSE,NA,"0.1.4"
"4618","646",2022-10-19 02:15:00,908,931,23,61,FALSE,NA,"0.1.4"
"4619","646",2022-10-19 02:30:00,908,931,23,61,FALSE,NA,"0.1.4"
"4620","646",2022-10-19 02:45:00,908,931,23,61,FALSE,NA,"0.1.4"
"4621","646",2022-10-19 03:00:00,908,931,23,61,FALSE,NA,"0.1.4"
"4622","646",2022-10-19 03:15:00,908,931,23,61,FALSE,NA,"0.1.4"
"4623","646",2022-10-19 03:30:00,908,931,23,61,FALSE,NA,"0.1.4"
"4624","646",2022-10-19 03:45:00,908,931,23,61,FALSE,NA,"0.1.4"
"4625","646",2022-10-19 04:00:00,908,931,23,61,FALSE,NA,"0.1.4"
"4626","646",2022-10-19 04:15:00,908,931,23,61,FALSE,NA,"0.1.4"
"4627","646",2022-10-19 04:30:00,908,931,23,61,FALSE,NA,"0.1.4"
"4628","646",2022-10-19 04:45:00,908,931,23,61,FALSE,NA,"0.1.4"
"4629","646",2022-10-19 05:00:00,908,931,23,61,FALSE,NA,"0.1.4"
"4630","646",2022-10-19 05:15:00,908,931,23,61,FALSE,NA,"0.1.4"
"4631","646",2022-10-19 05:30:00,908,931,23,61,FALSE,NA,"0.1.4"
"4632","646",2022-10-19 05:45:00,908,931,23,61,FALSE,NA,"0.1.4"
"4633","646",2022-10-19 06:00:00,909,931,22,61,FALSE,NA,"0.1.4"
"4634","646",2022-10-19 06:15:00,908,931,23,61,FALSE,NA,"0.1.4"
"4635","646",2022-10-19 06:30:00,908,931,23,61,FALSE,NA,"0.1.4"
"4636","646",2022-10-19 06:45:00,908,931,23,61,FALSE,NA,"0.1.4"
"4637","646",2022-10-19 07:00:00,909,931,22,61,FALSE,NA,"0.1.4"
"4638","646",2022-10-19 07:15:00,908,931,23,61,FALSE,NA,"0.1.4"
"4639","646",2022-10-19 07:30:00,908,931,23,61,FALSE,NA,"0.1.4"
"4640","646",2022-10-19 07:45:00,908,931,23,61,FALSE,NA,"0.1.4"
"4641","646",2022-10-19 08:00:00,909,931,22,61,FALSE,NA,"0.1.4"
"4642","646",2022-10-19 08:15:00,908,931,23,61,FALSE,NA,"0.1.4"
"4643","646",2022-10-19 08:30:00,909,931,22,61,FALSE,NA,"0.1.4"
"4644","646",2022-10-19 08:45:00,909,931,22,61,FALSE,NA,"0.1.4"
"4645","646",2022-10-19 09:00:00,909,931,22,61,FALSE,NA,"0.1.4"
"4646","646",2022-10-19 09:15:00,909,931,22,61,FALSE,NA,"0.1.4"
"4647","646",2022-10-19 09:30:00,909,931,22,61,FALSE,NA,"0.1.4"
"4648","646",2022-10-19 09:45:00,909,931,22,61,FALSE,NA,"0.1.4"
"4649","646",2022-10-19 10:00:00,909,931,22,61,FALSE,NA,"0.1.4"
"4650","646",2022-10-19 10:15:00,908,931,23,61,FALSE,NA,"0.1.4"
"4651","646",2022-10-19 10:30:00,909,931,22,61,FALSE,NA,"0.1.4"
"4652","646",2022-10-19 10:45:00,909,931,22,61,FALSE,NA,"0.1.4"
"4653","646",2022-10-19 11:00:00,909,931,22,61,FALSE,NA,"0.1.4"
"4654","646",2022-10-19 11:15:00,909,931,22,61,FALSE,NA,"0.1.4"
"4655","646",2022-10-19 11:30:00,909,931,22,61,FALSE,NA,"0.1.4"
"4656","646",2022-10-19 11:45:00,908,931,23,61,FALSE,NA,"0.1.4"
"4657","646",2022-10-19 12:00:00,909,931,22,61,FALSE,NA,"0.1.4"
"4658","646",2022-10-19 12:15:00,909,931,22,61,FALSE,NA,"0.1.4"
"4659","646",2022-10-19 12:30:00,909,931,22,61,FALSE,NA,"0.1.4"
"4660","646",2022-10-19 12:45:00,909,931,22,61,FALSE,NA,"0.1.4"
"4661","646",2022-10-19 13:00:00,909,931,22,61,FALSE,NA,"0.1.4"
"4662","646",2022-10-19 13:15:00,909,931,22,61,FALSE,NA,"0.1.4"
"4663","646",2022-10-19 13:30:00,909,931,22,61,FALSE,NA,"0.1.4"
"4664","646",2022-10-19 13:45:00,909,931,22,61,FALSE,NA,"0.1.4"
"4665","646",2022-10-19 14:00:00,909,931,22,61,FALSE,NA,"0.1.4"
"4666","646",2022-10-19 14:15:00,909,931,22,61,FALSE,NA,"0.1.4"
"4667","646",2022-10-19 14:30:00,909,931,22,61,FALSE,NA,"0.1.4"
"4668","646",2022-10-19 14:45:00,909,931,22,61,FALSE,NA,"0.1.4"
"4669","646",2022-10-19 15:00:00,909,931,22,61,FALSE,NA,"0.1.4"
"4670","646",2022-10-19 15:15:00,909,931,22,61,FALSE,NA,"0.1.4"
"4671","646",2022-10-19 15:30:00,909,931,22,61,FALSE,NA,"0.1.4"
"4672","646",2022-10-19 15:45:00,909,931,22,61,FALSE,NA,"0.1.4"
"4673","646",2022-10-19 16:00:00,910,931,21,61,FALSE,NA,"0.1.4"
"4674","646",2022-10-19 16:15:00,910,931,21,61,FALSE,NA,"0.1.4"
"4675","646",2022-10-19 16:30:00,910,931,21,61,FALSE,NA,"0.1.4"
"4676","646",2022-10-19 16:45:00,910,931,21,61,FALSE,NA,"0.1.4"
"4677","646",2022-10-19 17:00:00,910,931,21,61,FALSE,NA,"0.1.4"
"4678","646",2022-10-19 17:15:00,910,931,21,61,FALSE,NA,"0.1.4"
"4679","646",2022-10-19 17:30:00,910,931,21,61,FALSE,NA,"0.1.4"
"4680","646",2022-10-19 17:45:00,910,931,21,61,FALSE,NA,"0.1.4"
"4681","646",2022-10-19 18:00:00,910,931,21,61,FALSE,NA,"0.1.4"
"4682","646",2022-10-19 18:15:00,910,931,21,61,FALSE,NA,"0.1.4"
"4683","646",2022-10-19 18:30:00,910,931,21,61,FALSE,NA,"0.1.4"
"4684","646",2022-10-19 18:45:00,910,931,21,61,FALSE,NA,"0.1.4"
"4685","646",2022-10-19 19:00:00,910,931,21,61,FALSE,NA,"0.1.4"
"4686","646",2022-10-19 19:15:00,910,931,21,61,FALSE,NA,"0.1.4"
"4687","646",2022-10-19 19:30:00,910,931,21,61,FALSE,NA,"0.1.4"
"4688","646",2022-10-19 19:45:00,910,931,21,61,FALSE,NA,"0.1.4"
"4689","646",2022-10-19 20:00:00,910,931,21,61,FALSE,NA,"0.1.4"
"4690","646",2022-10-19 20:15:00,910,931,21,61,FALSE,NA,"0.1.4"
"4691","646",2022-10-19 20:30:00,910,931,21,61,FALSE,NA,"0.1.4"
"4692","646",2022-10-19 20:45:00,910,931,21,61,FALSE,NA,"0.1.4"
"4693","646",2022-10-19 21:00:00,910,931,21,61,FALSE,NA,"0.1.4"
"4694","646",2022-10-19 21:15:00,910,931,21,61,FALSE,NA,"0.1.4"
"4695","646",2022-10-19 21:30:00,910,931,21,61,FALSE,NA,"0.1.4"
"4696","646",2022-10-19 21:45:00,910,931,21,61,FALSE,NA,"0.1.4"
"4697","646",2022-10-19 22:00:00,910,931,21,61,FALSE,NA,"0.1.4"
"4698","646",2022-10-19 22:15:00,910,931,21,61,FALSE,NA,"0.1.4"
"4699","646",2022-10-19 22:30:00,910,931,21,61,FALSE,NA,"0.1.4"
"4700","646",2022-10-19 22:45:00,910,931,21,61,FALSE,NA,"0.1.4"
"4701","646",2022-10-19 23:00:00,910,931,21,61,FALSE,NA,"0.1.4"
"4702","646",2022-10-19 23:15:00,910,931,21,61,FALSE,NA,"0.1.4"
"4703","646",2022-10-19 23:30:00,910,931,21,61,FALSE,NA,"0.1.4"
"4704","646",2022-10-19 23:45:00,910,931,21,61,FALSE,NA,"0.1.4"
"4705","646",2022-10-20,910,931,21,61,FALSE,NA,"0.1.4"
"4706","646",2022-10-20 00:15:00,910,931,21,61,FALSE,NA,"0.1.4"
"4707","646",2022-10-20 00:30:00,910,931,21,61,FALSE,NA,"0.1.4"
"4708","646",2022-10-20 00:45:00,909,931,22,61,FALSE,NA,"0.1.4"
"4709","646",2022-10-20 01:00:00,909,931,22,61,FALSE,NA,"0.1.4"
"4710","646",2022-10-20 01:15:00,909,931,22,61,FALSE,NA,"0.1.4"
"4711","646",2022-10-20 01:30:00,909,931,22,61,FALSE,NA,"0.1.4"
"4712","646",2022-10-20 01:45:00,909,931,22,61,FALSE,NA,"0.1.4"
"4713","646",2022-10-20 02:00:00,909,931,22,61,FALSE,NA,"0.1.4"
"4714","646",2022-10-20 02:15:00,909,931,22,61,FALSE,NA,"0.1.4"
"4715","646",2022-10-20 02:30:00,909,931,22,61,FALSE,NA,"0.1.4"
"4716","646",2022-10-20 02:45:00,909,931,22,61,FALSE,NA,"0.1.4"
"4717","646",2022-10-20 03:00:00,909,931,22,61,FALSE,NA,"0.1.4"
"4718","646",2022-10-20 03:15:00,909,931,22,61,FALSE,NA,"0.1.4"
"4719","646",2022-10-20 03:30:00,909,931,22,61,FALSE,NA,"0.1.4"
"4720","646",2022-10-20 03:45:00,909,931,22,61,FALSE,NA,"0.1.4"
"4721","646",2022-10-20 04:00:00,909,931,22,61,FALSE,NA,"0.1.4"
"4722","646",2022-10-20 04:15:00,909,931,22,61,FALSE,NA,"0.1.4"
"4723","646",2022-10-20 04:30:00,909,931,22,61,FALSE,NA,"0.1.4"
"4724","646",2022-10-20 04:45:00,910,931,21,61,FALSE,NA,"0.1.4"
"4725","646",2022-10-20 05:00:00,910,931,21,61,FALSE,NA,"0.1.4"
"4726","646",2022-10-20 05:15:00,910,931,21,61,FALSE,NA,"0.1.4"
"4727","646",2022-10-20 05:30:00,910,931,21,61,FALSE,NA,"0.1.4"
"4728","646",2022-10-20 05:45:00,910,931,21,61,FALSE,NA,"0.1.4"
"4729","646",2022-10-20 06:00:00,910,931,21,61,FALSE,NA,"0.1.4"
"4730","646",2022-10-20 06:15:00,910,931,21,61,FALSE,NA,"0.1.4"
"4731","646",2022-10-20 06:30:00,910,931,21,61,FALSE,NA,"0.1.4"
"4732","646",2022-10-20 06:45:00,910,931,21,61,FALSE,NA,"0.1.4"
"4733","646",2022-10-20 07:00:00,910,931,21,61,FALSE,NA,"0.1.4"
"4734","646",2022-10-20 07:15:00,910,931,21,61,FALSE,NA,"0.1.4"
"4735","646",2022-10-20 07:30:00,910,931,21,61,FALSE,NA,"0.1.4"
"4736","646",2022-10-20 07:45:00,910,931,21,61,FALSE,NA,"0.1.4"
"4737","646",2022-10-20 08:00:00,910,931,21,61,FALSE,NA,"0.1.4"
"4738","646",2022-10-20 08:15:00,910,931,21,61,FALSE,NA,"0.1.4"
"4739","646",2022-10-20 08:30:00,910,931,21,61,FALSE,NA,"0.1.4"
"4740","646",2022-10-20 08:45:00,910,931,21,61,FALSE,NA,"0.1.4"
"4741","646",2022-10-20 09:00:00,910,931,21,61,FALSE,NA,"0.1.4"
"4742","646",2022-10-20 09:15:00,910,931,21,61,FALSE,NA,"0.1.4"
"4743","646",2022-10-20 09:30:00,910,931,21,61,FALSE,NA,"0.1.4"
"4744","646",2022-10-20 09:45:00,910,931,21,61,FALSE,NA,"0.1.4"
"4745","646",2022-10-20 10:00:00,910,931,21,61,FALSE,NA,"0.1.4"
"4746","646",2022-10-20 10:15:00,910,931,21,61,FALSE,NA,"0.1.4"
"4747","646",2022-10-20 10:30:00,910,931,21,61,FALSE,NA,"0.1.4"
"4748","646",2022-10-20 10:45:00,910,931,21,61,FALSE,NA,"0.1.4"
"4749","646",2022-10-20 11:00:00,910,931,21,61,FALSE,NA,"0.1.4"
"4750","646",2022-10-20 11:15:00,910,931,21,61,FALSE,NA,"0.1.4"
"4751","646",2022-10-20 11:30:00,910,931,21,61,FALSE,NA,"0.1.4"
"4752","646",2022-10-20 11:45:00,910,931,21,61,FALSE,NA,"0.1.4"
"4753","646",2022-10-20 12:00:00,910,931,21,61,FALSE,NA,"0.1.4"
"4754","646",2022-10-20 12:15:00,910,931,21,61,FALSE,NA,"0.1.4"
"4755","646",2022-10-20 12:30:00,910,931,21,61,FALSE,NA,"0.1.4"
"4756","646",2022-10-20 12:45:00,910,931,21,61,FALSE,NA,"0.1.4"
"4757","646",2022-10-20 13:00:00,910,931,21,61,FALSE,NA,"0.1.4"
"4758","646",2022-10-20 13:15:00,910,931,21,61,FALSE,NA,"0.1.4"
"4759","646",2022-10-20 13:30:00,910,931,21,61,FALSE,NA,"0.1.4"
"4760","646",2022-10-20 13:45:00,910,931,21,61,FALSE,NA,"0.1.4"
"4761","646",2022-10-20 14:00:00,910,931,21,61,FALSE,NA,"0.1.4"
"4762","646",2022-10-20 14:15:00,910,931,21,61,FALSE,NA,"0.1.4"
"4763","646",2022-10-20 14:30:00,910,931,21,61,FALSE,NA,"0.1.4"
"4764","646",2022-10-20 14:45:00,910,931,21,61,FALSE,NA,"0.1.4"
"4765","646",2022-10-20 15:00:00,911,931,20,61,FALSE,NA,"0.1.4"
"4766","646",2022-10-20 15:15:00,910,931,21,61,FALSE,NA,"0.1.4"
"4767","646",2022-10-20 15:30:00,910,931,21,61,FALSE,NA,"0.1.4"
"4768","646",2022-10-20 15:45:00,910,931,21,61,FALSE,NA,"0.1.4"
"4769","646",2022-10-20 16:00:00,910,931,21,61,FALSE,NA,"0.1.4"
"4770","646",2022-10-20 16:15:00,910,931,21,61,FALSE,NA,"0.1.4"
"4771","646",2022-10-20 16:30:00,910,931,21,61,FALSE,NA,"0.1.4"
"4772","646",2022-10-20 16:45:00,910,931,21,61,FALSE,NA,"0.1.4"
"4773","646",2022-10-20 17:00:00,910,931,21,61,FALSE,NA,"0.1.4"
"4774","646",2022-10-20 17:15:00,910,931,21,61,FALSE,NA,"0.1.4"
"4775","646",2022-10-20 17:30:00,910,931,21,61,FALSE,NA,"0.1.4"
"4776","646",2022-10-20 17:45:00,910,931,21,61,FALSE,NA,"0.1.4"
"4777","646",2022-10-20 18:00:00,910,931,21,61,FALSE,NA,"0.1.4"
"4778","646",2022-10-20 18:15:00,910,931,21,61,FALSE,NA,"0.1.4"
"4779","646",2022-10-20 18:30:00,910,931,21,61,FALSE,NA,"0.1.4"
"4780","646",2022-10-20 18:45:00,910,931,21,61,FALSE,NA,"0.1.4"
"4781","646",2022-10-20 19:00:00,910,931,21,61,FALSE,NA,"0.1.4"
"4782","646",2022-10-20 19:15:00,910,931,21,61,FALSE,NA,"0.1.4"
"4783","646",2022-10-20 19:30:00,910,931,21,61,FALSE,NA,"0.1.4"
"4784","646",2022-10-20 19:45:00,910,931,21,61,FALSE,NA,"0.1.4"
"4785","646",2022-10-20 20:00:00,910,931,21,61,FALSE,NA,"0.1.4"
"4786","646",2022-10-20 20:15:00,910,931,21,61,FALSE,NA,"0.1.4"
"4787","646",2022-10-20 20:30:00,910,931,21,61,FALSE,NA,"0.1.4"
"4788","646",2022-10-20 20:45:00,910,931,21,61,FALSE,NA,"0.1.4"
"4789","646",2022-10-20 21:00:00,910,931,21,61,FALSE,NA,"0.1.4"
"4790","646",2022-10-20 21:15:00,910,931,21,61,FALSE,NA,"0.1.4"
"4791","646",2022-10-20 21:30:00,910,931,21,61,FALSE,NA,"0.1.4"
"4792","646",2022-10-20 21:45:00,910,931,21,61,FALSE,NA,"0.1.4"
"4793","646",2022-10-20 22:00:00,910,931,21,61,FALSE,NA,"0.1.4"
"4794","646",2022-10-20 22:15:00,910,931,21,61,FALSE,NA,"0.1.4"
"4795","646",2022-10-20 22:30:00,910,931,21,61,FALSE,NA,"0.1.4"
"4796","646",2022-10-20 22:45:00,910,931,21,61,FALSE,NA,"0.1.4"
"4797","646",2022-10-20 23:00:00,909,931,22,61,FALSE,NA,"0.1.4"
"4798","646",2022-10-20 23:15:00,909,931,22,61,FALSE,NA,"0.1.4"
"4799","646",2022-10-20 23:30:00,909,931,22,61,FALSE,NA,"0.1.4"
"4800","646",2022-10-20 23:45:00,909,931,22,61,FALSE,NA,"0.1.4"
"4801","646",2022-10-21,909,931,22,61,FALSE,NA,"0.1.4"
"4802","646",2022-10-21 00:15:00,909,931,22,61,FALSE,NA,"0.1.4"
"4803","646",2022-10-21 00:30:00,909,931,22,61,FALSE,NA,"0.1.4"
"4804","646",2022-10-21 00:45:00,909,931,22,61,FALSE,NA,"0.1.4"
"4805","646",2022-10-21 01:00:00,909,931,22,61,FALSE,NA,"0.1.4"
"4806","646",2022-10-21 01:15:00,909,931,22,61,FALSE,NA,"0.1.4"
"4807","646",2022-10-21 01:30:00,909,931,22,61,FALSE,NA,"0.1.4"
"4808","646",2022-10-21 01:45:00,909,931,22,61,FALSE,NA,"0.1.4"
"4809","646",2022-10-21 02:00:00,909,931,22,61,FALSE,NA,"0.1.4"
"4810","646",2022-10-21 02:15:00,909,931,22,61,FALSE,NA,"0.1.4"
"4811","646",2022-10-21 02:30:00,909,931,22,61,FALSE,NA,"0.1.4"
"4812","646",2022-10-21 02:45:00,909,931,22,61,FALSE,NA,"0.1.4"
"4813","646",2022-10-21 03:00:00,909,931,22,61,FALSE,NA,"0.1.4"
"4814","646",2022-10-21 03:15:00,909,931,22,61,FALSE,NA,"0.1.4"
"4815","646",2022-10-21 03:30:00,909,931,22,61,FALSE,NA,"0.1.4"
"4816","646",2022-10-21 03:45:00,909,931,22,61,FALSE,NA,"0.1.4"
"4817","646",2022-10-21 04:00:00,909,931,22,61,FALSE,NA,"0.1.4"
"4818","646",2022-10-21 04:15:00,909,931,22,61,FALSE,NA,"0.1.4"
"4819","646",2022-10-21 04:30:00,909,931,22,61,FALSE,NA,"0.1.4"
"4820","646",2022-10-21 04:45:00,909,931,22,61,FALSE,NA,"0.1.4"
"4821","646",2022-10-21 05:00:00,909,931,22,61,FALSE,NA,"0.1.4"
"4822","646",2022-10-21 05:15:00,909,931,22,61,FALSE,NA,"0.1.4"
"4823","646",2022-10-21 05:30:00,909,931,22,61,FALSE,NA,"0.1.4"
"4824","646",2022-10-21 05:45:00,909,931,22,61,FALSE,NA,"0.1.4"
"4825","646",2022-10-21 06:00:00,909,931,22,61,FALSE,NA,"0.1.4"
"4826","646",2022-10-21 06:15:00,909,931,22,61,FALSE,NA,"0.1.4"
"4827","646",2022-10-21 06:30:00,909,931,22,61,FALSE,NA,"0.1.4"
"4828","646",2022-10-21 06:45:00,909,931,22,61,FALSE,NA,"0.1.4"
"4829","646",2022-10-21 07:00:00,909,931,22,61,FALSE,NA,"0.1.4"
"4830","646",2022-10-21 07:15:00,909,931,22,61,FALSE,NA,"0.1.4"
"4831","646",2022-10-21 07:30:00,909,931,22,61,FALSE,NA,"0.1.4"
"4832","646",2022-10-21 07:45:00,909,931,22,61,FALSE,NA,"0.1.4"
"4833","646",2022-10-21 08:00:00,909,931,22,61,FALSE,NA,"0.1.4"
"4834","646",2022-10-21 08:15:00,909,931,22,61,FALSE,NA,"0.1.4"
"4835","646",2022-10-21 08:30:00,909,931,22,61,FALSE,NA,"0.1.4"
"4836","646",2022-10-21 08:45:00,909,931,22,61,FALSE,NA,"0.1.4"
"4837","646",2022-10-21 09:00:00,909,931,22,61,FALSE,NA,"0.1.4"
"4838","646",2022-10-21 09:15:00,909,931,22,61,FALSE,NA,"0.1.4"
"4839","646",2022-10-21 09:30:00,909,931,22,61,FALSE,NA,"0.1.4"
"4840","646",2022-10-21 09:45:00,909,931,22,61,FALSE,NA,"0.1.4"
"4841","646",2022-10-21 10:00:00,909,931,22,61,FALSE,NA,"0.1.4"
"4842","646",2022-10-21 10:15:00,909,931,22,61,FALSE,NA,"0.1.4"
"4843","646",2022-10-21 10:30:00,909,931,22,61,FALSE,NA,"0.1.4"
"4844","646",2022-10-21 10:45:00,909,931,22,61,FALSE,NA,"0.1.4"
"4845","646",2022-10-21 11:00:00,910,931,21,61,FALSE,NA,"0.1.4"
"4846","646",2022-10-21 11:15:00,910,931,21,61,FALSE,NA,"0.1.4"
"4847","646",2022-10-21 11:30:00,910,931,21,61,FALSE,NA,"0.1.4"
"4848","646",2022-10-21 11:45:00,909,931,22,61,FALSE,NA,"0.1.4"
"4849","646",2022-10-21 12:00:00,909,931,22,61,FALSE,NA,"0.1.4"
"4850","646",2022-10-21 12:15:00,909,931,22,61,FALSE,NA,"0.1.4"
"4851","646",2022-10-21 12:30:00,909,931,22,61,FALSE,NA,"0.1.4"
"4852","646",2022-10-21 12:45:00,909,931,22,61,FALSE,NA,"0.1.4"
"4853","646",2022-10-21 13:00:00,910,931,21,61,FALSE,NA,"0.1.4"
"4854","646",2022-10-21 13:15:00,910,931,21,61,FALSE,NA,"0.1.4"
"4855","646",2022-10-21 13:30:00,910,931,21,61,FALSE,NA,"0.1.4"
"4856","646",2022-10-21 13:45:00,910,931,21,61,FALSE,NA,"0.1.4"
"4857","646",2022-10-21 14:00:00,910,931,21,61,FALSE,NA,"0.1.4"
"4858","646",2022-10-21 14:15:00,910,931,21,61,FALSE,NA,"0.1.4"
"4859","646",2022-10-21 14:30:00,910,931,21,61,FALSE,NA,"0.1.4"
"4860","646",2022-10-21 14:45:00,910,931,21,61,FALSE,NA,"0.1.4"
"4861","646",2022-10-21 15:00:00,910,931,21,61,FALSE,NA,"0.1.4"
"4862","646",2022-10-21 15:15:00,910,931,21,61,FALSE,NA,"0.1.4"
"4863","646",2022-10-21 15:30:00,910,931,21,61,FALSE,NA,"0.1.4"
"4864","646",2022-10-21 15:45:00,910,931,21,61,FALSE,NA,"0.1.4"
"4865","646",2022-10-21 16:00:00,910,931,21,61,FALSE,NA,"0.1.4"
"4866","646",2022-10-21 16:15:00,910,931,21,61,FALSE,NA,"0.1.4"
"4867","646",2022-10-21 16:30:00,910,931,21,61,FALSE,NA,"0.1.4"
"4868","646",2022-10-21 16:45:00,910,931,21,61,FALSE,NA,"0.1.4"
"4869","646",2022-10-21 17:00:00,910,931,21,61,FALSE,NA,"0.1.4"
"4870","646",2022-10-21 17:15:00,910,931,21,61,FALSE,NA,"0.1.4"
"4871","646",2022-10-21 17:30:00,910,931,21,61,FALSE,NA,"0.1.4"
"4872","646",2022-10-21 17:45:00,910,931,21,61,FALSE,NA,"0.1.4"
"4873","646",2022-10-21 18:00:00,910,931,21,61,FALSE,NA,"0.1.4"
"4874","646",2022-10-21 18:15:00,910,931,21,61,FALSE,NA,"0.1.4"
"4875","646",2022-10-21 18:30:00,910,931,21,61,FALSE,NA,"0.1.4"
"4876","646",2022-10-21 18:45:00,910,931,21,61,FALSE,NA,"0.1.4"
"4877","646",2022-10-21 19:00:00,910,931,21,61,FALSE,NA,"0.1.4"
"4878","646",2022-10-21 19:15:00,910,931,21,61,FALSE,NA,"0.1.4"
"4879","646",2022-10-21 19:30:00,910,931,21,61,FALSE,NA,"0.1.4"
"4880","646",2022-10-21 19:45:00,910,931,21,61,FALSE,NA,"0.1.4"
"4881","646",2022-10-21 20:00:00,910,931,21,61,FALSE,NA,"0.1.4"
"4882","646",2022-10-21 20:15:00,910,931,21,61,FALSE,NA,"0.1.4"
"4883","646",2022-10-21 20:30:00,910,931,21,61,FALSE,NA,"0.1.4"
"4884","646",2022-10-21 20:45:00,910,931,21,61,FALSE,NA,"0.1.4"
"4885","646",2022-10-21 21:00:00,910,931,21,61,FALSE,NA,"0.1.4"
"4886","646",2022-10-21 21:15:00,910,931,21,61,FALSE,NA,"0.1.4"
"4887","646",2022-10-21 21:30:00,910,931,21,61,FALSE,NA,"0.1.4"
"4888","646",2022-10-21 21:45:00,910,931,21,61,FALSE,NA,"0.1.4"
"4889","646",2022-10-21 22:00:00,910,931,21,61,FALSE,NA,"0.1.4"
"4890","646",2022-10-21 22:15:00,910,931,21,61,FALSE,NA,"0.1.4"
"4891","646",2022-10-21 22:30:00,910,931,21,61,FALSE,NA,"0.1.4"
"4892","646",2022-10-21 22:45:00,910,931,21,61,FALSE,NA,"0.1.4"
"4893","646",2022-10-21 23:00:00,910,931,21,61,FALSE,NA,"0.1.4"
"4894","646",2022-10-21 23:15:00,910,931,21,61,FALSE,NA,"0.1.4"
"4895","646",2022-10-21 23:30:00,910,931,21,61,FALSE,NA,"0.1.4"
"4896","646",2022-10-21 23:45:00,910,931,21,61,FALSE,NA,"0.1.4"
"4897","646",2022-10-22,910,931,21,61,FALSE,NA,"0.1.4"
"4898","646",2022-10-22 00:15:00,910,931,21,61,FALSE,NA,"0.1.4"
"4899","646",2022-10-22 00:30:00,910,931,21,61,FALSE,NA,"0.1.4"
"4900","646",2022-10-22 00:45:00,910,931,21,61,FALSE,NA,"0.1.4"
"4901","646",2022-10-22 01:00:00,910,931,21,61,FALSE,NA,"0.1.4"
"4902","646",2022-10-22 01:15:00,910,931,21,61,FALSE,NA,"0.1.4"
"4903","646",2022-10-22 01:30:00,910,931,21,61,FALSE,NA,"0.1.4"
"4904","646",2022-10-22 01:45:00,910,931,21,61,FALSE,NA,"0.1.4"
"4905","646",2022-10-22 02:00:00,910,931,21,61,FALSE,NA,"0.1.4"
"4906","646",2022-10-22 02:15:00,910,931,21,61,FALSE,NA,"0.1.4"
"4907","646",2022-10-22 02:30:00,910,931,21,61,FALSE,NA,"0.1.4"
"4908","646",2022-10-22 02:45:00,910,931,21,61,FALSE,NA,"0.1.4"
"4909","646",2022-10-22 03:00:00,910,931,21,61,FALSE,NA,"0.1.4"
"4910","646",2022-10-22 03:15:00,911,931,20,61,FALSE,NA,"0.1.4"
"4911","646",2022-10-22 03:30:00,911,931,20,61,FALSE,NA,"0.1.4"
"4912","646",2022-10-22 03:45:00,911,931,20,61,FALSE,NA,"0.1.4"
"4913","646",2022-10-22 04:00:00,911,931,20,61,FALSE,NA,"0.1.4"
"4914","646",2022-10-22 04:15:00,912,931,19,61,FALSE,NA,"0.1.4"
"4915","646",2022-10-22 04:30:00,911,931,20,61,FALSE,NA,"0.1.4"
"4916","646",2022-10-22 04:45:00,912,931,19,61,FALSE,NA,"0.1.4"
"4917","646",2022-10-22 05:00:00,916,931,15,61,FALSE,NA,"0.1.4"
"4918","646",2022-10-22 05:15:00,918,931,13,61,FALSE,NA,"0.1.4"
"4919","646",2022-10-22 05:30:00,918,931,13,61,FALSE,NA,"0.1.4"
"4920","646",2022-10-22 05:45:00,918,931,13,61,FALSE,NA,"0.1.4"
"4921","646",2022-10-22 06:00:00,918,931,13,61,FALSE,NA,"0.1.4"
"4922","646",2022-10-22 06:15:00,918,931,13,61,FALSE,NA,"0.1.4"
"4923","646",2022-10-22 06:30:00,918,931,13,61,FALSE,NA,"0.1.4"
"4924","646",2022-10-22 06:45:00,917,931,14,61,FALSE,NA,"0.1.4"
"4925","646",2022-10-22 07:00:00,919,931,12,61,FALSE,NA,"0.1.4"
"4926","646",2022-10-22 07:15:00,919,931,12,61,FALSE,NA,"0.1.4"
"4927","646",2022-10-22 07:30:00,919,931,12,61,FALSE,NA,"0.1.4"
"4928","646",2022-10-22 07:45:00,919,931,12,61,FALSE,NA,"0.1.4"
"4929","646",2022-10-22 08:00:00,919,931,12,61,FALSE,NA,"0.1.4"
"4930","646",2022-10-22 08:15:00,919,931,12,61,FALSE,NA,"0.1.4"
"4931","646",2022-10-22 08:30:00,919,931,12,61,FALSE,NA,"0.1.4"
"4932","646",2022-10-22 08:45:00,919,931,12,61,FALSE,NA,"0.1.4"
"4933","646",2022-10-22 09:00:00,919,931,12,61,FALSE,NA,"0.1.4"
"4934","646",2022-10-22 09:15:00,919,931,12,61,FALSE,NA,"0.1.4"
"4935","646",2022-10-22 09:30:00,922,931,9,61,FALSE,NA,"0.1.4"
"4936","646",2022-10-22 09:45:00,922,931,9,61,FALSE,NA,"0.1.4"
"4937","646",2022-10-22 10:00:00,922,931,9,61,FALSE,NA,"0.1.4"
"4938","646",2022-10-22 10:15:00,922,931,9,61,FALSE,NA,"0.1.4"
"4939","646",2022-10-22 10:30:00,922,931,9,61,FALSE,NA,"0.1.4"
"4940","646",2022-10-22 10:45:00,922,931,9,61,FALSE,NA,"0.1.4"
"4941","646",2022-10-22 11:00:00,922,931,9,61,FALSE,NA,"0.1.4"
"4942","646",2022-10-22 11:15:00,922,931,9,61,FALSE,NA,"0.1.4"
"4943","646",2022-10-22 11:30:00,922,931,9,61,FALSE,NA,"0.1.4"
"4944","646",2022-10-22 11:45:00,922,931,9,61,FALSE,NA,"0.1.4"
"4945","646",2022-10-22 12:00:00,922,931,9,61,FALSE,NA,"0.1.4"
"4946","646",2022-10-22 12:15:00,922,931,9,61,FALSE,NA,"0.1.4"
"4947","646",2022-10-22 12:30:00,922,931,9,61,FALSE,NA,"0.1.4"
"4948","646",2022-10-22 12:45:00,922,931,9,61,FALSE,NA,"0.1.4"
"4949","646",2022-10-22 13:00:00,922,931,9,61,FALSE,NA,"0.1.4"
"4950","646",2022-10-22 13:15:00,922,931,9,61,FALSE,NA,"0.1.4"
"4951","646",2022-10-22 13:30:00,922,931,9,61,FALSE,NA,"0.1.4"
"4952","646",2022-10-22 13:45:00,922,931,9,61,FALSE,NA,"0.1.4"
"4953","646",2022-10-22 14:00:00,923,931,8,61,FALSE,NA,"0.1.4"
"4954","646",2022-10-22 14:15:00,922,931,9,61,FALSE,NA,"0.1.4"
"4955","646",2022-10-22 14:30:00,924,931,7,61,FALSE,NA,"0.1.4"
"4956","646",2022-10-22 14:45:00,923,931,8,61,FALSE,NA,"0.1.4"
"4957","646",2022-10-22 15:00:00,923,931,8,61,FALSE,NA,"0.1.4"
"4958","646",2022-10-22 15:15:00,923,931,8,61,FALSE,NA,"0.1.4"
"4959","646",2022-10-22 15:30:00,925,931,6,61,FALSE,NA,"0.1.4"
"4960","646",2022-10-22 15:45:00,924,931,7,61,FALSE,NA,"0.1.4"
"4961","646",2022-10-22 16:00:00,925,931,6,61,FALSE,NA,"0.1.4"
"4962","646",2022-10-22 16:15:00,925,931,6,61,FALSE,NA,"0.1.4"
"4963","646",2022-10-22 16:30:00,925,931,6,61,FALSE,NA,"0.1.4"
"4964","646",2022-10-22 16:45:00,925,931,6,61,FALSE,NA,"0.1.4"
"4965","646",2022-10-22 17:00:00,925,931,6,61,FALSE,NA,"0.1.4"
"4966","646",2022-10-22 17:15:00,925,931,6,61,FALSE,NA,"0.1.4"
"4967","646",2022-10-22 17:30:00,925,931,6,61,FALSE,NA,"0.1.4"
"4968","646",2022-10-22 17:45:00,925,931,6,61,FALSE,NA,"0.1.4"
"4969","646",2022-10-22 18:00:00,926,931,5,61,FALSE,NA,"0.1.4"
"4970","646",2022-10-22 18:15:00,926,931,5,61,FALSE,NA,"0.1.4"
"4971","646",2022-10-22 18:30:00,926,931,5,61,FALSE,NA,"0.1.4"
"4972","646",2022-10-22 18:45:00,926,931,5,61,FALSE,NA,"0.1.4"
"4973","646",2022-10-22 19:00:00,926,931,5,61,FALSE,NA,"0.1.4"
"4974","646",2022-10-22 19:15:00,928,931,3,61,FALSE,NA,"0.1.4"
"4975","646",2022-10-22 19:30:00,928,931,3,61,FALSE,NA,"0.1.4"
"4976","646",2022-10-22 19:45:00,928,931,3,61,FALSE,NA,"0.1.4"
"4977","646",2022-10-22 20:00:00,928,931,3,61,FALSE,NA,"0.1.4"
"4978","646",2022-10-22 20:15:00,928,931,3,61,FALSE,NA,"0.1.4"
"4979","646",2022-10-22 20:30:00,928,931,3,61,FALSE,NA,"0.1.4"
"4980","646",2022-10-22 20:45:00,929,931,2,61,FALSE,NA,"0.1.4"
"4981","646",2022-10-22 21:00:00,928,931,3,61,FALSE,NA,"0.1.4"
"4982","646",2022-10-22 21:15:00,927,931,4,61,FALSE,NA,"0.1.4"
"4983","646",2022-10-22 21:30:00,928,931,3,61,FALSE,NA,"0.1.4"
"4984","646",2022-10-22 21:45:00,928,931,3,61,FALSE,NA,"0.1.4"
"4985","646",2022-10-22 22:00:00,928,931,3,61,FALSE,NA,"0.1.4"
"4986","646",2022-10-22 22:15:00,928,931,3,61,FALSE,NA,"0.1.4"
"4987","646",2022-10-22 22:30:00,928,931,3,61,FALSE,NA,"0.1.4"
"4988","646",2022-10-22 22:45:00,928,931,3,61,FALSE,NA,"0.1.4"
"4989","646",2022-10-22 23:00:00,928,931,3,61,FALSE,NA,"0.1.4"
"4990","646",2022-10-22 23:15:00,928,931,3,61,FALSE,NA,"0.1.4"
"4991","646",2022-10-22 23:30:00,928,931,3,61,FALSE,NA,"0.1.4"
"4992","646",2022-10-22 23:45:00,928,931,3,61,FALSE,NA,"0.1.4"
"4993","646",2022-10-23,928,931,3,61,FALSE,NA,"0.1.4"
"4994","646",2022-10-23 00:15:00,928,931,3,61,FALSE,NA,"0.1.4"
"4995","646",2022-10-23 00:30:00,928,931,3,61,FALSE,NA,"0.1.4"
"4996","646",2022-10-23 00:45:00,928,931,3,61,FALSE,NA,"0.1.4"
"4997","646",2022-10-23 01:00:00,932,932,0,62,FALSE,NA,"0.1.4"
"4998","646",2022-10-23 01:15:00,930,932,2,62,FALSE,NA,"0.1.4"
"4999","646",2022-10-23 01:30:00,931,932,1,62,FALSE,NA,"0.1.4"
"5000","646",2022-10-23 01:45:00,932,932,0,62,FALSE,NA,"0.1.4"
"5001","646",2022-10-23 02:00:00,932,932,0,62,FALSE,NA,"0.1.4"
"5002","646",2022-10-23 02:15:00,931,932,1,62,FALSE,NA,"0.1.4"
"5003","646",2022-10-23 02:30:00,931,932,1,62,FALSE,NA,"0.1.4"
"5004","646",2022-10-23 02:45:00,932,932,0,62,FALSE,NA,"0.1.4"
"5005","646",2022-10-23 03:00:00,931,932,1,62,FALSE,NA,"0.1.4"
"5006","646",2022-10-23 03:15:00,931,932,1,62,FALSE,NA,"0.1.4"
"5007","646",2022-10-23 03:30:00,931,932,1,62,FALSE,NA,"0.1.4"
"5008","646",2022-10-23 03:45:00,932,932,0,62,FALSE,NA,"0.1.4"
"5009","646",2022-10-23 04:00:00,932,932,0,62,FALSE,NA,"0.1.4"
"5010","646",2022-10-23 04:15:00,932,932,0,62,FALSE,NA,"0.1.4"
"5011","646",2022-10-23 04:30:00,933,933,0,63,FALSE,NA,"0.1.4"
"5012","646",2022-10-23 04:45:00,933,933,0,63,FALSE,NA,"0.1.4"
"5013","646",2022-10-23 05:00:00,932,933,1,63,FALSE,NA,"0.1.4"
"5014","646",2022-10-23 05:15:00,932,933,1,63,FALSE,NA,"0.1.4"
"5015","646",2022-10-23 05:30:00,932,933,1,63,FALSE,NA,"0.1.4"
"5016","646",2022-10-23 05:45:00,932,933,1,63,FALSE,NA,"0.1.4"
"5017","646",2022-10-23 06:00:00,932,933,1,63,FALSE,NA,"0.1.4"
"5018","646",2022-10-23 06:15:00,932,933,1,63,FALSE,NA,"0.1.4"
"5019","646",2022-10-23 06:30:00,933,933,0,63,FALSE,NA,"0.1.4"
"5020","646",2022-10-23 06:45:00,933,933,0,63,FALSE,NA,"0.1.4"
"5021","646",2022-10-23 07:00:00,933,933,0,63,FALSE,NA,"0.1.4"
"5022","646",2022-10-23 07:15:00,933,933,0,63,FALSE,NA,"0.1.4"
"5023","646",2022-10-23 07:30:00,934,934,0,64,FALSE,NA,"0.1.4"
"5024","646",2022-10-23 07:45:00,934,934,0,64,FALSE,NA,"0.1.4"
"5025","646",2022-10-23 08:00:00,933,934,1,64,FALSE,NA,"0.1.4"
"5026","646",2022-10-23 08:15:00,933,934,1,64,FALSE,NA,"0.1.4"
"5027","646",2022-10-23 08:30:00,932,934,2,64,FALSE,NA,"0.1.4"
"5028","646",2022-10-23 08:45:00,933,934,1,64,FALSE,NA,"0.1.4"
"5029","646",2022-10-23 09:00:00,933,934,1,64,FALSE,NA,"0.1.4"
"5030","646",2022-10-23 09:15:00,934,934,0,64,FALSE,NA,"0.1.4"
"5031","646",2022-10-23 09:30:00,933,934,1,64,FALSE,NA,"0.1.4"
"5032","646",2022-10-23 09:45:00,933,934,1,64,FALSE,NA,"0.1.4"
"5033","646",2022-10-23 10:00:00,933,934,1,64,FALSE,NA,"0.1.4"
"5034","646",2022-10-23 10:15:00,933,934,1,64,FALSE,NA,"0.1.4"
"5035","646",2022-10-23 10:30:00,933,934,1,64,FALSE,NA,"0.1.4"
"5036","646",2022-10-23 10:45:00,934,934,0,64,FALSE,NA,"0.1.4"
"5037","646",2022-10-23 11:00:00,933,934,1,64,FALSE,NA,"0.1.4"
"5038","646",2022-10-23 11:15:00,934,934,0,64,FALSE,NA,"0.1.4"
"5039","646",2022-10-23 11:30:00,933,934,1,64,FALSE,NA,"0.1.4"
"5040","646",2022-10-23 11:45:00,934,934,0,64,FALSE,NA,"0.1.4"
"5041","646",2022-10-23 12:00:00,934,934,0,64,FALSE,NA,"0.1.4"
"5042","646",2022-10-23 12:15:00,934,934,0,64,FALSE,NA,"0.1.4"
"5043","646",2022-10-23 12:30:00,934,934,0,64,FALSE,NA,"0.1.4"
"5044","646",2022-10-23 12:45:00,934,934,0,64,FALSE,NA,"0.1.4"
"5045","646",2022-10-23 13:00:00,934,934,0,64,FALSE,NA,"0.1.4"
"5046","646",2022-10-23 13:15:00,934,934,0,64,FALSE,NA,"0.1.4"
"5047","646",2022-10-23 13:30:00,934,934,0,64,FALSE,NA,"0.1.4"
"5048","646",2022-10-23 13:45:00,934,934,0,64,FALSE,NA,"0.1.4"
"5049","646",2022-10-23 14:00:00,936,936,0,66,FALSE,NA,"0.1.4"
"5050","646",2022-10-23 14:15:00,935,936,1,66,FALSE,NA,"0.1.4"
"5051","646",2022-10-23 14:30:00,935,936,1,66,FALSE,NA,"0.1.4"
"5052","646",2022-10-23 14:45:00,935,936,1,66,FALSE,NA,"0.1.4"
"5053","646",2022-10-23 15:00:00,935,936,1,66,FALSE,NA,"0.1.4"
"5054","646",2022-10-23 15:15:00,937,937,0,67,FALSE,NA,"0.1.4"
"5055","646",2022-10-23 15:30:00,937,937,0,67,FALSE,NA,"0.1.4"
"5056","646",2022-10-23 15:45:00,937,937,0,67,FALSE,NA,"0.1.4"
"5057","646",2022-10-23 16:00:00,937,937,0,67,FALSE,NA,"0.1.4"
"5058","646",2022-10-23 16:15:00,937,937,0,67,FALSE,NA,"0.1.4"
"5059","646",2022-10-23 16:30:00,937,937,0,67,FALSE,NA,"0.1.4"
"5060","646",2022-10-23 16:45:00,937,937,0,67,FALSE,NA,"0.1.4"
"5061","646",2022-10-23 17:00:00,937,937,0,67,FALSE,NA,"0.1.4"
"5062","646",2022-10-23 17:15:00,937,937,0,67,FALSE,NA,"0.1.4"
"5063","646",2022-10-23 17:30:00,937,937,0,67,FALSE,NA,"0.1.4"
"5064","646",2022-10-23 17:45:00,937,937,0,67,FALSE,NA,"0.1.4"
"5065","646",2022-10-23 18:00:00,937,937,0,67,FALSE,NA,"0.1.4"
"5066","646",2022-10-23 18:15:00,936,937,1,67,FALSE,NA,"0.1.4"
"5067","646",2022-10-23 18:30:00,936,937,1,67,FALSE,NA,"0.1.4"
"5068","646",2022-10-23 18:45:00,937,937,0,67,FALSE,NA,"0.1.4"
"5069","646",2022-10-23 19:00:00,937,937,0,67,FALSE,NA,"0.1.4"
"5070","646",2022-10-23 19:15:00,937,937,0,67,FALSE,NA,"0.1.4"
"5071","646",2022-10-23 19:30:00,937,937,0,67,FALSE,NA,"0.1.4"
"5072","646",2022-10-23 19:45:00,937,937,0,67,FALSE,NA,"0.1.4"
"5073","646",2022-10-23 20:00:00,936,937,1,67,FALSE,NA,"0.1.4"
"5074","646",2022-10-23 20:15:00,936,937,1,67,FALSE,NA,"0.1.4"
"5075","646",2022-10-23 20:30:00,936,937,1,67,FALSE,NA,"0.1.4"
"5076","646",2022-10-23 20:45:00,936,937,1,67,FALSE,NA,"0.1.4"
"5077","646",2022-10-23 21:00:00,936,937,1,67,FALSE,NA,"0.1.4"
"5078","646",2022-10-23 21:15:00,936,937,1,67,FALSE,NA,"0.1.4"
"5079","646",2022-10-23 21:30:00,938,938,0,68,FALSE,NA,"0.1.4"
"5080","646",2022-10-23 21:45:00,937,938,1,68,FALSE,NA,"0.1.4"
"5081","646",2022-10-23 22:00:00,937,938,1,68,FALSE,NA,"0.1.4"
"5082","646",2022-10-23 22:15:00,937,938,1,68,FALSE,NA,"0.1.4"
"5083","646",2022-10-23 22:30:00,937,938,1,68,FALSE,NA,"0.1.4"
"5084","646",2022-10-23 22:45:00,937,938,1,68,FALSE,NA,"0.1.4"
"5085","646",2022-10-23 23:00:00,937,938,1,68,FALSE,NA,"0.1.4"
"5086","646",2022-10-23 23:15:00,937,938,1,68,FALSE,NA,"0.1.4"
"5087","646",2022-10-23 23:30:00,937,938,1,68,FALSE,NA,"0.1.4"
"5088","646",2022-10-23 23:45:00,937,938,1,68,FALSE,NA,"0.1.4"
"5089","646",2022-10-24,937,938,1,68,FALSE,NA,"0.1.4"
"5090","646",2022-10-24 00:15:00,937,938,1,68,FALSE,NA,"0.1.4"
"5091","646",2022-10-24 00:30:00,937,938,1,68,FALSE,NA,"0.1.4"
"5092","646",2022-10-24 00:45:00,937,938,1,68,FALSE,NA,"0.1.4"
"5093","646",2022-10-24 01:00:00,937,938,1,68,FALSE,NA,"0.1.4"
"5094","646",2022-10-24 01:15:00,937,938,1,68,FALSE,NA,"0.1.4"
"5095","646",2022-10-24 01:30:00,937,938,1,68,FALSE,NA,"0.1.4"
"5096","646",2022-10-24 01:45:00,937,938,1,68,FALSE,NA,"0.1.4"
"5097","646",2022-10-24 02:00:00,937,938,1,68,FALSE,NA,"0.1.4"
"5098","646",2022-10-24 02:15:00,937,938,1,68,FALSE,NA,"0.1.4"
"5099","646",2022-10-24 02:30:00,936,938,2,68,FALSE,NA,"0.1.4"
"5100","646",2022-10-24 02:45:00,937,938,1,68,FALSE,NA,"0.1.4"
"5101","646",2022-10-24 03:00:00,937,938,1,68,FALSE,NA,"0.1.4"
"5102","646",2022-10-24 03:15:00,936,938,2,68,FALSE,NA,"0.1.4"
"5103","646",2022-10-24 03:30:00,937,938,1,68,FALSE,NA,"0.1.4"
"5104","646",2022-10-24 03:45:00,936,938,2,68,FALSE,NA,"0.1.4"
"5105","646",2022-10-24 04:00:00,937,938,1,68,FALSE,NA,"0.1.4"
"5106","646",2022-10-24 04:15:00,937,938,1,68,FALSE,NA,"0.1.4"
"5107","646",2022-10-24 04:30:00,937,938,1,68,FALSE,NA,"0.1.4"
"5108","646",2022-10-24 04:45:00,937,938,1,68,FALSE,NA,"0.1.4"
"5109","646",2022-10-24 05:00:00,937,938,1,68,FALSE,NA,"0.1.4"
"5110","646",2022-10-24 05:15:00,937,938,1,68,FALSE,NA,"0.1.4"
"5111","646",2022-10-24 05:30:00,937,938,1,68,FALSE,NA,"0.1.4"
"5112","646",2022-10-24 05:45:00,937,938,1,68,FALSE,NA,"0.1.4"
"5113","646",2022-10-24 06:00:00,937,938,1,68,FALSE,NA,"0.1.4"
"5114","646",2022-10-24 06:15:00,937,938,1,68,FALSE,NA,"0.1.4"
"5115","646",2022-10-24 06:30:00,937,938,1,68,FALSE,NA,"0.1.4"
"5116","646",2022-10-24 06:45:00,938,938,0,68,FALSE,NA,"0.1.4"
"5117","646",2022-10-24 07:00:00,937,938,1,68,FALSE,NA,"0.1.4"
"5118","646",2022-10-24 07:15:00,937,938,1,68,TRUE,NA,"0.1.4"
"5119","646",2022-10-24 07:30:00,937,938,1,68,TRUE,NA,"0.1.4"
"5120","646",2022-10-24 07:45:00,937,938,1,68,TRUE,NA,"0.1.4"
"5121","646",2022-10-24 08:00:00,937,938,1,68,TRUE,NA,"0.1.4"
"5122","646",2022-10-24 08:15:00,937,938,1,68,TRUE,NA,"0.1.4"
"5123","646",2022-10-24 08:30:00,937,938,1,68,TRUE,NA,"0.1.4"
"5124","646",2022-10-24 08:45:00,937,938,1,68,TRUE,NA,"0.1.4"
"5125","646",2022-10-24 09:00:00,937,938,1,68,TRUE,NA,"0.1.4"
"5126","646",2022-10-24 09:15:00,938,938,0,68,TRUE,NA,"0.1.4"
"5127","646",2022-10-24 09:30:00,938,938,0,68,TRUE,NA,"0.1.4"
"5128","646",2022-10-24 09:45:00,938,938,0,68,TRUE,NA,"0.1.4"
"5129","646",2022-10-24 10:00:00,938,938,0,68,TRUE,NA,"0.1.4"
"5130","646",2022-10-24 10:15:00,938,938,0,68,TRUE,NA,"0.1.4"
"5131","646",2022-10-24 10:30:00,938,938,0,68,TRUE,NA,"0.1.4"
"5132","646",2022-10-24 10:45:00,938,938,0,68,TRUE,NA,"0.1.4"
"5133","646",2022-10-24 11:00:00,938,938,0,68,FALSE,NA,"0.1.4"
"5134","646",2022-10-24 11:15:00,938,938,0,68,FALSE,NA,"0.1.4"
"5135","646",2022-10-24 11:30:00,938,938,0,68,FALSE,NA,"0.1.4"
"5136","646",2022-10-24 11:45:00,938,938,0,68,FALSE,NA,"0.1.4"
"5137","646",2022-10-24 12:00:00,937,938,1,68,FALSE,NA,"0.1.4"
"5138","646",2022-10-24 12:15:00,938,938,0,68,FALSE,NA,"0.1.4"
"5139","646",2022-10-24 12:30:00,938,938,0,68,FALSE,NA,"0.1.4"
"5140","646",2022-10-24 12:45:00,938,938,0,68,FALSE,NA,"0.1.4"
"5141","646",2022-10-24 13:00:00,938,938,0,68,FALSE,NA,"0.1.4"
"5142","646",2022-10-24 13:15:00,937,938,1,68,FALSE,NA,"0.1.4"
"5143","646",2022-10-24 13:30:00,937,938,1,68,FALSE,NA,"0.1.4"
"5144","646",2022-10-24 13:45:00,938,938,0,68,FALSE,NA,"0.1.4"
"5145","646",2022-10-24 14:00:00,937,938,1,68,FALSE,NA,"0.1.4"
"5146","646",2022-10-24 14:15:00,937,938,1,68,FALSE,NA,"0.1.4"
"5147","646",2022-10-24 14:30:00,936,938,2,68,FALSE,NA,"0.1.4"
"5148","646",2022-10-24 14:45:00,937,938,1,68,FALSE,NA,"0.1.4"
"5149","646",2022-10-24 15:00:00,937,938,1,68,FALSE,NA,"0.1.4"
"5150","646",2022-10-24 15:15:00,937,938,1,68,FALSE,NA,"0.1.4"
"5151","646",2022-10-24 15:30:00,937,938,1,68,FALSE,NA,"0.1.4"
"5152","646",2022-10-24 15:45:00,937,938,1,68,FALSE,NA,"0.1.4"
"5153","646",2022-10-24 16:00:00,937,938,1,68,FALSE,NA,"0.1.4"
"5154","646",2022-10-24 16:15:00,937,938,1,68,FALSE,NA,"0.1.4"
"5155","646",2022-10-24 16:30:00,938,938,0,68,FALSE,NA,"0.1.4"
"5156","646",2022-10-24 16:45:00,939,939,0,69,FALSE,NA,"0.1.4"
"5157","646",2022-10-24 17:00:00,938,939,1,69,FALSE,NA,"0.1.4"
"5158","646",2022-10-24 17:15:00,940,940,0,70,FALSE,NA,"0.1.4"
"5159","646",2022-10-24 17:30:00,940,940,0,70,FALSE,NA,"0.1.4"
"5160","646",2022-10-24 17:45:00,941,941,0,71,FALSE,NA,"0.1.4"
"5161","646",2022-10-24 18:00:00,940,941,1,71,FALSE,NA,"0.1.4"
"5162","646",2022-10-24 18:15:00,941,941,0,71,FALSE,NA,"0.1.4"
"5163","646",2022-10-24 18:30:00,941,941,0,71,FALSE,NA,"0.1.4"
"5164","646",2022-10-24 18:45:00,940,941,1,71,FALSE,NA,"0.1.4"
"5165","646",2022-10-24 19:00:00,941,941,0,71,FALSE,NA,"0.1.4"
"5166","646",2022-10-24 19:15:00,941,941,0,71,FALSE,NA,"0.1.4"
"5167","646",2022-10-24 19:30:00,945,945,0,75,FALSE,NA,"0.1.4"
"5168","646",2022-10-24 19:45:00,944,945,1,75,FALSE,NA,"0.1.4"
"5169","646",2022-10-24 20:00:00,945,945,0,75,FALSE,NA,"0.1.4"
"5170","646",2022-10-24 20:15:00,945,945,0,75,FALSE,NA,"0.1.4"
"5171","646",2022-10-24 20:30:00,945,945,0,75,FALSE,NA,"0.1.4"
"5172","646",2022-10-24 20:45:00,945,945,0,75,FALSE,NA,"0.1.4"
"5173","646",2022-10-24 21:00:00,945,945,0,75,FALSE,NA,"0.1.4"
"5174","646",2022-10-24 21:15:00,946,946,0,76,FALSE,NA,"0.1.4"
"5175","646",2022-10-24 21:30:00,946,946,0,76,FALSE,NA,"0.1.4"
"5176","646",2022-10-24 21:45:00,947,947,0,77,FALSE,NA,"0.1.4"
"5177","646",2022-10-24 22:00:00,947,947,0,77,FALSE,NA,"0.1.4"
"5178","646",2022-10-24 22:15:00,947,947,0,77,FALSE,NA,"0.1.4"
"5179","646",2022-10-24 22:30:00,947,947,0,77,FALSE,NA,"0.1.4"
"5180","646",2022-10-24 22:45:00,947,947,0,77,FALSE,NA,"0.1.4"
"5181","646",2022-10-24 23:00:00,947,947,0,77,FALSE,NA,"0.1.4"
"5182","646",2022-10-24 23:15:00,947,947,0,77,FALSE,NA,"0.1.4"
"5183","646",2022-10-24 23:30:00,947,947,0,77,FALSE,NA,"0.1.4"
"5184","646",2022-10-24 23:45:00,948,948,0,78,FALSE,NA,"0.1.4"
"5185","646",2022-10-25,947,948,1,78,FALSE,NA,"0.1.4"
"5186","646",2022-10-25 00:15:00,947,948,1,78,FALSE,NA,"0.1.4"
"5187","646",2022-10-25 00:30:00,947,948,1,78,FALSE,NA,"0.1.4"
"5188","646",2022-10-25 00:45:00,947,948,1,78,FALSE,NA,"0.1.4"
"5189","646",2022-10-25 01:00:00,948,948,0,78,FALSE,NA,"0.1.4"
"5190","646",2022-10-25 01:15:00,947,948,1,78,FALSE,NA,"0.1.4"
"5191","646",2022-10-25 01:30:00,948,948,0,78,FALSE,NA,"0.1.4"
"5192","646",2022-10-25 01:45:00,947,948,1,78,FALSE,NA,"0.1.4"
"5193","646",2022-10-25 02:00:00,947,948,1,78,FALSE,NA,"0.1.4"
"5194","646",2022-10-25 02:15:00,948,948,0,78,FALSE,NA,"0.1.4"
"5195","646",2022-10-25 02:30:00,948,948,0,78,FALSE,NA,"0.1.4"
"5196","646",2022-10-25 02:45:00,949,949,0,79,FALSE,NA,"0.1.4"
"5197","646",2022-10-25 03:00:00,949,949,0,79,FALSE,NA,"0.1.4"
"5198","646",2022-10-25 03:15:00,949,949,0,79,FALSE,NA,"0.1.4"
"5199","646",2022-10-25 03:30:00,949,949,0,79,FALSE,NA,"0.1.4"
"5200","646",2022-10-25 03:45:00,949,949,0,79,FALSE,NA,"0.1.4"
"5201","646",2022-10-25 04:00:00,949,949,0,79,FALSE,NA,"0.1.4"
"5202","646",2022-10-25 04:15:00,949,949,0,79,FALSE,NA,"0.1.4"
"5203","646",2022-10-25 04:30:00,949,949,0,79,FALSE,NA,"0.1.4"
"5204","646",2022-10-25 04:45:00,950,950,0,80,FALSE,NA,"0.1.4"
"5205","646",2022-10-25 05:00:00,950,950,0,80,FALSE,NA,"0.1.4"
"5206","646",2022-10-25 05:15:00,950,950,0,80,FALSE,NA,"0.1.4"
"5207","646",2022-10-25 05:30:00,950,950,0,80,FALSE,NA,"0.1.4"
"5208","646",2022-10-25 05:45:00,949,950,1,80,FALSE,NA,"0.1.4"
"5209","646",2022-10-25 06:00:00,949,950,1,80,FALSE,NA,"0.1.4"
"5210","646",2022-10-25 06:15:00,949,950,1,80,FALSE,NA,"0.1.4"
"5211","646",2022-10-25 06:30:00,949,950,1,80,FALSE,NA,"0.1.4"
"5212","646",2022-10-25 06:45:00,949,950,1,80,FALSE,NA,"0.1.4"
"5213","646",2022-10-25 07:00:00,949,950,1,80,FALSE,NA,"0.1.4"
"5214","646",2022-10-25 07:15:00,949,950,1,80,FALSE,NA,"0.1.4"
"5215","646",2022-10-25 07:30:00,949,950,1,80,FALSE,NA,"0.1.4"
"5216","646",2022-10-25 07:45:00,949,950,1,80,FALSE,NA,"0.1.4"
"5217","646",2022-10-25 08:00:00,949,950,1,80,FALSE,NA,"0.1.4"
"5218","646",2022-10-25 08:15:00,949,950,1,80,FALSE,NA,"0.1.4"
"5219","646",2022-10-25 08:30:00,949,950,1,80,FALSE,NA,"0.1.4"
"5220","646",2022-10-25 08:45:00,949,950,1,80,FALSE,NA,"0.1.4"
"5221","646",2022-10-25 09:00:00,949,950,1,80,FALSE,NA,"0.1.4"
"5222","646",2022-10-25 09:15:00,948,950,2,80,FALSE,NA,"0.1.4"
"5223","646",2022-10-25 09:30:00,948,950,2,80,FALSE,NA,"0.1.4"
"5224","646",2022-10-25 09:45:00,949,950,1,80,FALSE,NA,"0.1.4"
"5225","646",2022-10-25 10:00:00,949,950,1,80,FALSE,NA,"0.1.4"
"5226","646",2022-10-25 10:15:00,949,950,1,80,FALSE,NA,"0.1.4"
"5227","646",2022-10-25 10:30:00,948,950,2,80,FALSE,NA,"0.1.4"
"5228","646",2022-10-25 10:45:00,948,950,2,80,FALSE,NA,"0.1.4"
"5229","646",2022-10-25 11:00:00,948,950,2,80,FALSE,NA,"0.1.4"
"5230","646",2022-10-25 11:15:00,948,950,2,80,FALSE,NA,"0.1.4"
"5231","646",2022-10-25 11:30:00,948,950,2,80,FALSE,NA,"0.1.4"
"5232","646",2022-10-25 11:45:00,948,950,2,80,FALSE,NA,"0.1.4"
"5233","646",2022-10-25 12:00:00,949,950,1,80,FALSE,NA,"0.1.4"
"5234","646",2022-10-25 12:15:00,949,950,1,80,FALSE,NA,"0.1.4"
"5235","646",2022-10-25 12:30:00,948,950,2,80,FALSE,NA,"0.1.4"
"5236","646",2022-10-25 12:45:00,951,951,0,81,FALSE,NA,"0.1.4"
"5237","646",2022-10-25 13:00:00,950,951,1,81,FALSE,NA,"0.1.4"
"5238","646",2022-10-25 13:15:00,951,951,0,81,FALSE,NA,"0.1.4"
"5239","646",2022-10-25 13:30:00,950,951,1,81,FALSE,NA,"0.1.4"
"5240","646",2022-10-25 13:45:00,950,951,1,81,FALSE,NA,"0.1.4"
"5241","646",2022-10-25 14:00:00,950,951,1,81,FALSE,NA,"0.1.4"
"5242","646",2022-10-25 14:15:00,950,951,1,81,FALSE,NA,"0.1.4"
"5243","646",2022-10-25 14:30:00,950,951,1,81,FALSE,NA,"0.1.4"
"5244","646",2022-10-25 14:45:00,950,951,1,81,FALSE,NA,"0.1.4"
"5245","646",2022-10-25 15:00:00,950,951,1,81,FALSE,NA,"0.1.4"
"5246","646",2022-10-25 15:15:00,950,951,1,81,FALSE,NA,"0.1.4"
"5247","646",2022-10-25 15:30:00,950,951,1,81,FALSE,NA,"0.1.4"
"5248","646",2022-10-25 15:45:00,950,951,1,81,FALSE,NA,"0.1.4"
"5249","646",2022-10-25 16:00:00,950,951,1,81,FALSE,NA,"0.1.4"
"5250","646",2022-10-25 16:15:00,950,951,1,81,FALSE,NA,"0.1.4"
"5251","646",2022-10-25 16:30:00,950,951,1,81,FALSE,NA,"0.1.4"
"5252","646",2022-10-25 16:45:00,950,951,1,81,FALSE,NA,"0.1.4"
"5253","646",2022-10-25 17:00:00,950,951,1,81,FALSE,NA,"0.1.4"
"5254","646",2022-10-25 17:15:00,950,951,1,81,FALSE,NA,"0.1.4"
"5255","646",2022-10-25 17:30:00,950,951,1,81,FALSE,NA,"0.1.4"
"5256","646",2022-10-25 17:45:00,950,951,1,81,FALSE,NA,"0.1.4"
"5257","646",2022-10-25 18:00:00,950,951,1,81,FALSE,NA,"0.1.4"
"5258","646",2022-10-25 18:15:00,950,951,1,81,FALSE,NA,"0.1.4"
"5259","646",2022-10-25 18:30:00,950,951,1,81,FALSE,NA,"0.1.4"
"5260","646",2022-10-25 18:45:00,950,951,1,81,FALSE,NA,"0.1.4"
"5261","646",2022-10-25 19:00:00,950,951,1,81,FALSE,NA,"0.1.4"
"5262","646",2022-10-25 19:15:00,950,951,1,81,FALSE,NA,"0.1.4"
"5263","646",2022-10-25 19:30:00,950,951,1,81,FALSE,NA,"0.1.4"
"5264","646",2022-10-25 19:45:00,950,951,1,81,FALSE,NA,"0.1.4"
"5265","646",2022-10-25 20:00:00,950,951,1,81,FALSE,NA,"0.1.4"
"5266","646",2022-10-25 20:15:00,951,951,0,81,FALSE,NA,"0.1.4"
"5267","646",2022-10-25 20:30:00,951,951,0,81,FALSE,NA,"0.1.4"
"5268","646",2022-10-25 20:45:00,951,951,0,81,FALSE,NA,"0.1.4"
"5269","646",2022-10-25 21:00:00,951,951,0,81,FALSE,NA,"0.1.4"
"5270","646",2022-10-25 21:15:00,951,951,0,81,FALSE,NA,"0.1.4"
"5271","646",2022-10-25 21:30:00,951,951,0,81,FALSE,NA,"0.1.4"
"5272","646",2022-10-25 21:45:00,951,951,0,81,FALSE,NA,"0.1.4"
"5273","646",2022-10-25 22:00:00,951,951,0,81,FALSE,NA,"0.1.4"
"5274","646",2022-10-25 22:15:00,951,951,0,81,FALSE,NA,"0.1.4"
"5275","646",2022-10-25 22:30:00,951,951,0,81,FALSE,NA,"0.1.4"
"5276","646",2022-10-25 22:45:00,951,951,0,81,FALSE,NA,"0.1.4"
"5277","646",2022-10-25 23:00:00,951,951,0,81,FALSE,NA,"0.1.4"
"5278","646",2022-10-25 23:15:00,951,951,0,81,FALSE,NA,"0.1.4"
"5279","646",2022-10-25 23:30:00,951,951,0,81,FALSE,NA,"0.1.4"
"5280","646",2022-10-25 23:45:00,951,951,0,81,FALSE,NA,"0.1.4"
"5281","646",2022-10-26,951,951,0,81,FALSE,NA,"0.1.4"
"5282","646",2022-10-26 00:15:00,951,951,0,81,FALSE,NA,"0.1.4"
"5283","646",2022-10-26 00:30:00,951,951,0,81,FALSE,NA,"0.1.4"
"5284","646",2022-10-26 00:45:00,951,951,0,81,FALSE,NA,"0.1.4"
"5285","646",2022-10-26 01:00:00,951,951,0,81,FALSE,NA,"0.1.4"
"5286","646",2022-10-26 01:15:00,952,952,0,82,FALSE,NA,"0.1.4"
"5287","646",2022-10-26 01:30:00,951,952,1,82,FALSE,NA,"0.1.4"
"5288","646",2022-10-26 01:45:00,951,952,1,82,FALSE,NA,"0.1.4"
"5289","646",2022-10-26 02:00:00,951,952,1,82,FALSE,NA,"0.1.4"
"5290","646",2022-10-26 02:15:00,950,952,2,82,FALSE,NA,"0.1.4"
"5291","646",2022-10-26 02:30:00,951,952,1,82,FALSE,NA,"0.1.4"
"5292","646",2022-10-26 02:45:00,951,952,1,82,FALSE,NA,"0.1.4"
"5293","646",2022-10-26 03:00:00,951,952,1,82,FALSE,NA,"0.1.4"
"5294","646",2022-10-26 03:15:00,953,953,0,83,FALSE,NA,"0.1.4"
"5295","646",2022-10-26 03:30:00,954,954,0,84,FALSE,NA,"0.1.4"
"5296","646",2022-10-26 03:45:00,954,954,0,84,FALSE,NA,"0.1.4"
"5297","646",2022-10-26 04:00:00,954,954,0,84,FALSE,NA,"0.1.4"
"5298","646",2022-10-26 04:15:00,954,954,0,84,FALSE,NA,"0.1.4"
"5299","646",2022-10-26 04:30:00,954,954,0,84,FALSE,NA,"0.1.4"
"5300","646",2022-10-26 04:45:00,955,955,0,85,FALSE,NA,"0.1.4"
"5301","646",2022-10-26 05:00:00,956,956,0,86,FALSE,NA,"0.1.4"
"5302","646",2022-10-26 05:15:00,956,956,0,86,FALSE,NA,"0.1.4"
"5303","646",2022-10-26 05:30:00,956,956,0,86,FALSE,NA,"0.1.4"
"5304","646",2022-10-26 05:45:00,956,956,0,86,FALSE,NA,"0.1.4"
"5305","646",2022-10-26 06:00:00,956,956,0,86,FALSE,NA,"0.1.4"
"5306","646",2022-10-26 06:15:00,957,957,0,87,FALSE,NA,"0.1.4"
"5307","646",2022-10-26 06:30:00,956,957,1,87,FALSE,NA,"0.1.4"
"5308","646",2022-10-26 06:45:00,956,957,1,87,FALSE,NA,"0.1.4"
"5309","646",2022-10-26 07:00:00,956,957,1,87,FALSE,NA,"0.1.4"
"5310","646",2022-10-26 07:15:00,957,957,0,87,FALSE,NA,"0.1.4"
"5311","646",2022-10-26 07:30:00,956,957,1,87,TRUE,NA,"0.1.4"
"5312","646",2022-10-26 07:45:00,957,957,0,87,TRUE,NA,"0.1.4"
"5313","646",2022-10-26 08:00:00,956,957,1,87,TRUE,NA,"0.1.4"
"5314","646",2022-10-26 08:15:00,957,957,0,87,TRUE,NA,"0.1.4"
"5315","646",2022-10-26 08:30:00,957,957,0,87,TRUE,NA,"0.1.4"
"5316","646",2022-10-26 08:45:00,957,957,0,87,TRUE,NA,"0.1.4"
"5317","646",2022-10-26 09:00:00,956,957,1,87,TRUE,NA,"0.1.4"
"5318","646",2022-10-26 09:15:00,956,957,1,87,TRUE,NA,"0.1.4"
"5319","646",2022-10-26 09:30:00,956,957,1,87,TRUE,NA,"0.1.4"
"5320","646",2022-10-26 09:45:00,956,957,1,87,TRUE,NA,"0.1.4"
"5321","646",2022-10-26 10:00:00,955,957,2,87,TRUE,NA,"0.1.4"
"5322","646",2022-10-26 10:15:00,955,957,2,87,TRUE,NA,"0.1.4"
"5323","646",2022-10-26 10:30:00,955,957,2,87,TRUE,NA,"0.1.4"
"5324","646",2022-10-26 10:45:00,956,957,1,87,TRUE,NA,"0.1.4"
"5325","646",2022-10-26 11:00:00,956,957,1,87,TRUE,NA,"0.1.4"
"5326","646",2022-10-26 11:15:00,955,957,2,87,TRUE,NA,"0.1.4"
"5327","646",2022-10-26 11:30:00,955,957,2,87,TRUE,NA,"0.1.4"
"5328","646",2022-10-26 11:45:00,955,957,2,87,TRUE,NA,"0.1.4"
"5329","646",2022-10-26 12:00:00,956,957,1,87,TRUE,NA,"0.1.4"
"5330","646",2022-10-26 12:15:00,957,957,0,87,TRUE,NA,"0.1.4"
"5331","646",2022-10-26 12:30:00,957,957,0,87,TRUE,NA,"0.1.4"
"5332","646",2022-10-26 12:45:00,957,957,0,87,TRUE,NA,"0.1.4"
"5333","646",2022-10-26 13:00:00,957,957,0,87,TRUE,NA,"0.1.4"
"5334","646",2022-10-26 13:15:00,957,957,0,87,TRUE,NA,"0.1.4"
"5335","646",2022-10-26 13:30:00,957,957,0,87,TRUE,NA,"0.1.4"
"5336","646",2022-10-26 13:45:00,957,957,0,87,TRUE,NA,"0.1.4"
"5337","646",2022-10-26 14:00:00,957,957,0,87,TRUE,NA,"0.1.4"
"5338","646",2022-10-26 14:15:00,956,957,1,87,TRUE,NA,"0.1.4"
"5339","646",2022-10-26 14:30:00,957,957,0,87,TRUE,NA,"0.1.4"
"5340","646",2022-10-26 14:45:00,957,957,0,87,TRUE,NA,"0.1.4"
"5341","646",2022-10-26 15:00:00,957,957,0,87,TRUE,NA,"0.1.4"
"5342","646",2022-10-26 15:15:00,957,957,0,87,TRUE,NA,"0.1.4"
"5343","646",2022-10-26 15:30:00,957,957,0,87,TRUE,NA,"0.1.4"
"5344","646",2022-10-26 15:45:00,957,957,0,87,TRUE,NA,"0.1.4"
"5345","646",2022-10-26 16:00:00,957,957,0,87,TRUE,NA,"0.1.4"
"5346","646",2022-10-26 16:15:00,957,957,0,87,FALSE,NA,"0.1.4"
"5347","646",2022-10-26 16:30:00,957,957,0,87,FALSE,NA,"0.1.4"
"5348","646",2022-10-26 16:45:00,957,957,0,87,FALSE,NA,"0.1.4"
"5349","646",2022-10-26 17:00:00,957,957,0,87,FALSE,NA,"0.1.4"
"5350","646",2022-10-26 17:15:00,957,957,0,87,FALSE,NA,"0.1.4"
"5351","646",2022-10-26 17:30:00,957,957,0,87,FALSE,NA,"0.1.4"
"5352","646",2022-10-26 17:45:00,957,957,0,87,FALSE,NA,"0.1.4"
"5353","646",2022-10-26 18:00:00,957,957,0,87,FALSE,NA,"0.1.4"
"5354","646",2022-10-26 18:15:00,957,957,0,87,FALSE,NA,"0.1.4"
"5355","646",2022-10-26 18:30:00,957,957,0,87,FALSE,NA,"0.1.4"
"5356","646",2022-10-26 18:45:00,957,957,0,87,FALSE,NA,"0.1.4"
"5357","646",2022-10-26 19:00:00,957,957,0,87,FALSE,NA,"0.1.4"
"5358","646",2022-10-26 19:15:00,957,957,0,87,FALSE,NA,"0.1.4"
"5359","646",2022-10-26 19:30:00,957,957,0,87,FALSE,NA,"0.1.4"
"5360","646",2022-10-26 19:45:00,957,957,0,87,FALSE,NA,"0.1.4"
"5361","646",2022-10-26 20:00:00,957,957,0,87,FALSE,NA,"0.1.4"
"5362","646",2022-10-26 20:15:00,957,957,0,87,FALSE,NA,"0.1.4"
"5363","646",2022-10-26 20:30:00,957,957,0,87,FALSE,NA,"0.1.4"
"5364","646",2022-10-26 20:45:00,957,957,0,87,FALSE,NA,"0.1.4"
"5365","646",2022-10-26 21:00:00,957,957,0,87,FALSE,NA,"0.1.4"
"5366","646",2022-10-26 21:15:00,957,957,0,87,FALSE,NA,"0.1.4"
"5367","646",2022-10-26 21:30:00,957,957,0,87,FALSE,NA,"0.1.4"
"5368","646",2022-10-26 21:45:00,957,957,0,87,FALSE,NA,"0.1.4"
"5369","646",2022-10-26 22:00:00,957,957,0,87,FALSE,NA,"0.1.4"
"5370","646",2022-10-26 22:15:00,957,957,0,87,FALSE,NA,"0.1.4"
"5371","646",2022-10-26 22:30:00,957,957,0,87,FALSE,NA,"0.1.4"
"5372","646",2022-10-26 22:45:00,957,957,0,87,FALSE,NA,"0.1.4"
"5373","646",2022-10-26 23:00:00,957,957,0,87,FALSE,NA,"0.1.4"
"5374","646",2022-10-26 23:15:00,957,957,0,87,FALSE,NA,"0.1.4"
"5375","646",2022-10-26 23:30:00,956,957,1,87,FALSE,NA,"0.1.4"
"5376","646",2022-10-26 23:45:00,956,957,1,87,FALSE,NA,"0.1.4"
"5377","646",2022-10-27,957,957,0,87,FALSE,NA,"0.1.4"
"5378","646",2022-10-27 00:15:00,957,957,0,87,FALSE,NA,"0.1.4"
"5379","646",2022-10-27 00:30:00,957,957,0,87,FALSE,NA,"0.1.4"
"5380","646",2022-10-27 00:45:00,957,957,0,87,FALSE,NA,"0.1.4"
"5381","646",2022-10-27 01:00:00,957,957,0,87,FALSE,NA,"0.1.4"
"5382","646",2022-10-27 01:15:00,957,957,0,87,FALSE,NA,"0.1.4"
"5383","646",2022-10-27 01:30:00,956,957,1,87,FALSE,NA,"0.1.4"
"5384","646",2022-10-27 01:45:00,956,957,1,87,FALSE,NA,"0.1.4"
"5385","646",2022-10-27 02:00:00,957,957,0,87,FALSE,NA,"0.1.4"
"5386","646",2022-10-27 02:15:00,957,957,0,87,FALSE,NA,"0.1.4"
"5387","646",2022-10-27 02:30:00,957,957,0,87,FALSE,NA,"0.1.4"
"5388","646",2022-10-27 02:45:00,957,957,0,87,FALSE,NA,"0.1.4"
"5389","646",2022-10-27 03:00:00,957,957,0,87,FALSE,NA,"0.1.4"
"5390","646",2022-10-27 03:15:00,957,957,0,87,FALSE,NA,"0.1.4"
"5391","646",2022-10-27 03:30:00,957,957,0,87,FALSE,NA,"0.1.4"
"5392","646",2022-10-27 03:45:00,957,957,0,87,FALSE,NA,"0.1.4"
"5393","646",2022-10-27 04:00:00,957,957,0,87,FALSE,NA,"0.1.4"
"5394","646",2022-10-27 04:15:00,957,957,0,87,FALSE,NA,"0.1.4"
"5395","646",2022-10-27 04:30:00,957,957,0,87,FALSE,NA,"0.1.4"
"5396","646",2022-10-27 04:45:00,956,957,1,87,FALSE,NA,"0.1.4"
"5397","646",2022-10-27 05:00:00,957,957,0,87,FALSE,NA,"0.1.4"
"5398","646",2022-10-27 05:15:00,957,957,0,87,FALSE,NA,"0.1.4"
"5399","646",2022-10-27 05:30:00,957,957,0,87,FALSE,NA,"0.1.4"
"5400","646",2022-10-27 05:45:00,957,957,0,87,FALSE,NA,"0.1.4"
"5401","646",2022-10-27 06:00:00,957,957,0,87,FALSE,NA,"0.1.4"
"5402","646",2022-10-27 06:15:00,957,957,0,87,FALSE,NA,"0.1.4"
"5403","646",2022-10-27 06:30:00,958,958,0,88,FALSE,NA,"0.1.4"
"5404","646",2022-10-27 06:45:00,958,958,0,88,TRUE,NA,"0.1.4"
"5405","646",2022-10-27 07:00:00,959,959,0,89,TRUE,NA,"0.1.4"
"5406","646",2022-10-27 07:15:00,959,959,0,89,TRUE,NA,"0.1.4"
"5407","646",2022-10-27 07:30:00,958,959,1,89,FALSE,NA,"0.1.4"
"5408","646",2022-10-27 07:45:00,958,959,1,89,FALSE,NA,"0.1.4"
"5409","646",2022-10-27 08:00:00,958,959,1,89,FALSE,NA,"0.1.4"
"5410","646",2022-10-27 08:15:00,958,959,1,89,TRUE,NA,"0.1.4"
"5411","646",2022-10-27 08:30:00,960,960,0,90,TRUE,NA,"0.1.4"
"5412","646",2022-10-27 08:45:00,960,960,0,90,TRUE,NA,"0.1.4"
"5413","646",2022-10-27 09:00:00,960,960,0,90,TRUE,NA,"0.1.4"
"5414","646",2022-10-27 09:15:00,960,960,0,90,TRUE,NA,"0.1.4"
"5415","646",2022-10-27 09:30:00,960,960,0,90,TRUE,NA,"0.1.4"
"5416","646",2022-10-27 09:45:00,960,960,0,90,TRUE,NA,"0.1.4"
"5417","646",2022-10-27 10:00:00,960,960,0,90,TRUE,NA,"0.1.4"
"5418","646",2022-10-27 10:15:00,960,960,0,90,TRUE,NA,"0.1.4"
"5419","646",2022-10-27 10:30:00,959,960,1,90,TRUE,NA,"0.1.4"
"5420","646",2022-10-27 10:45:00,959,960,1,90,TRUE,NA,"0.1.4"
"5421","646",2022-10-27 11:00:00,959,960,1,90,TRUE,NA,"0.1.4"
"5422","646",2022-10-27 11:15:00,959,960,1,90,TRUE,NA,"0.1.4"
"5423","646",2022-10-27 11:30:00,959,960,1,90,TRUE,NA,"0.1.4"
"5424","646",2022-10-27 11:45:00,959,960,1,90,TRUE,NA,"0.1.4"
"5425","646",2022-10-27 12:00:00,959,960,1,90,TRUE,NA,"0.1.4"
"5426","646",2022-10-27 12:15:00,959,960,1,90,TRUE,NA,"0.1.4"
"5427","646",2022-10-27 12:30:00,958,960,2,90,TRUE,NA,"0.1.4"
"5428","646",2022-10-27 12:45:00,959,960,1,90,TRUE,NA,"0.1.4"
"5429","646",2022-10-27 13:00:00,959,960,1,90,TRUE,NA,"0.1.4"
"5430","646",2022-10-27 13:15:00,959,960,1,90,TRUE,NA,"0.1.4"
"5431","646",2022-10-27 13:30:00,959,960,1,90,TRUE,NA,"0.1.4"
"5432","646",2022-10-27 13:45:00,960,960,0,90,TRUE,NA,"0.1.4"
"5433","646",2022-10-27 14:00:00,959,960,1,90,TRUE,NA,"0.1.4"
"5434","646",2022-10-27 14:15:00,958,960,2,90,TRUE,NA,"0.1.4"
"5435","646",2022-10-27 14:30:00,958,960,2,90,TRUE,NA,"0.1.4"
"5436","646",2022-10-27 14:45:00,958,960,2,90,TRUE,NA,"0.1.4"
"5437","646",2022-10-27 15:00:00,958,960,2,90,TRUE,NA,"0.1.4"
"5438","646",2022-10-27 15:15:00,958,960,2,90,TRUE,NA,"0.1.4"
"5439","646",2022-10-27 15:30:00,958,960,2,90,TRUE,NA,"0.1.4"
"5440","646",2022-10-27 15:45:00,958,960,2,90,TRUE,NA,"0.1.4"
"5441","646",2022-10-27 16:00:00,958,960,2,90,TRUE,NA,"0.1.4"
"5442","646",2022-10-27 16:15:00,958,960,2,90,TRUE,NA,"0.1.4"
"5443","646",2022-10-27 16:30:00,958,960,2,90,TRUE,NA,"0.1.4"
"5444","646",2022-10-27 16:45:00,958,960,2,90,TRUE,NA,"0.1.4"
"5445","646",2022-10-27 17:00:00,958,960,2,90,TRUE,NA,"0.1.4"
"5446","646",2022-10-27 17:15:00,958,960,2,90,TRUE,NA,"0.1.4"
"5447","646",2022-10-27 17:30:00,958,960,2,90,TRUE,NA,"0.1.4"
"5448","646",2022-10-27 17:45:00,958,960,2,90,TRUE,NA,"0.1.4"
"5449","646",2022-10-27 18:00:00,958,960,2,90,TRUE,NA,"0.1.4"
"5450","646",2022-10-27 18:15:00,958,960,2,90,TRUE,NA,"0.1.4"
"5451","646",2022-10-27 18:30:00,958,960,2,90,TRUE,NA,"0.1.4"
"5452","646",2022-10-27 18:45:00,958,960,2,90,TRUE,NA,"0.1.4"
"5453","646",2022-10-27 19:00:00,958,960,2,90,TRUE,NA,"0.1.4"
"5454","646",2022-10-27 19:15:00,958,960,2,90,FALSE,NA,"0.1.4"
"5455","646",2022-10-27 19:30:00,958,960,2,90,FALSE,NA,"0.1.4"
"5456","646",2022-10-27 19:45:00,958,960,2,90,FALSE,NA,"0.1.4"
"5457","646",2022-10-27 20:00:00,958,960,2,90,FALSE,NA,"0.1.4"
"5458","646",2022-10-27 20:15:00,958,960,2,90,FALSE,NA,"0.1.4"
"5459","646",2022-10-27 20:30:00,958,960,2,90,FALSE,NA,"0.1.4"
"5460","646",2022-10-27 20:45:00,958,960,2,90,FALSE,NA,"0.1.4"
"5461","646",2022-10-27 21:00:00,958,960,2,90,FALSE,NA,"0.1.4"
"5462","646",2022-10-27 21:15:00,958,960,2,90,FALSE,NA,"0.1.4"
"5463","646",2022-10-27 21:30:00,958,960,2,90,FALSE,NA,"0.1.4"
"5464","646",2022-10-27 21:45:00,959,960,1,90,FALSE,NA,"0.1.4"
"5465","646",2022-10-27 22:00:00,958,960,2,90,FALSE,NA,"0.1.4"
"5466","646",2022-10-27 22:15:00,958,960,2,90,FALSE,NA,"0.1.4"
"5467","646",2022-10-27 22:30:00,959,960,1,90,FALSE,NA,"0.1.4"
"5468","646",2022-10-27 22:45:00,959,960,1,90,FALSE,NA,"0.1.4"
"5469","646",2022-10-27 23:00:00,959,960,1,90,FALSE,NA,"0.1.4"
"5470","646",2022-10-27 23:15:00,959,960,1,90,FALSE,NA,"0.1.4"
"5471","646",2022-10-27 23:30:00,959,960,1,90,FALSE,NA,"0.1.4"
"5472","646",2022-10-27 23:45:00,959,960,1,90,FALSE,NA,"0.1.4"
"5473","646",2022-10-28,958,960,2,90,FALSE,NA,"0.1.4"
"5474","646",2022-10-28 00:15:00,959,960,1,90,FALSE,NA,"0.1.4"
"5475","646",2022-10-28 00:30:00,958,960,2,90,FALSE,NA,"0.1.4"
"5476","646",2022-10-28 00:45:00,959,960,1,90,FALSE,NA,"0.1.4"
"5477","646",2022-10-28 01:00:00,959,960,1,90,FALSE,NA,"0.1.4"
"5478","646",2022-10-28 01:15:00,959,960,1,90,FALSE,NA,"0.1.4"
"5479","646",2022-10-28 01:30:00,958,960,2,90,FALSE,NA,"0.1.4"
"5480","646",2022-10-28 01:45:00,959,960,1,90,FALSE,NA,"0.1.4"
"5481","646",2022-10-28 02:00:00,959,960,1,90,FALSE,NA,"0.1.4"
"5482","646",2022-10-28 02:15:00,959,960,1,90,FALSE,NA,"0.1.4"
"5483","646",2022-10-28 02:30:00,959,960,1,90,FALSE,NA,"0.1.4"
"5484","646",2022-10-28 02:45:00,958,960,2,90,FALSE,NA,"0.1.4"
"5485","646",2022-10-28 03:00:00,959,960,1,90,FALSE,NA,"0.1.4"
"5486","646",2022-10-28 03:15:00,958,960,2,90,FALSE,NA,"0.1.4"
"5487","646",2022-10-28 03:30:00,958,960,2,90,FALSE,NA,"0.1.4"
"5488","646",2022-10-28 03:45:00,958,960,2,90,FALSE,NA,"0.1.4"
"5489","646",2022-10-28 04:00:00,958,960,2,90,FALSE,NA,"0.1.4"
"5490","646",2022-10-28 04:15:00,958,960,2,90,FALSE,NA,"0.1.4"
"5491","646",2022-10-28 04:30:00,958,960,2,90,FALSE,NA,"0.1.4"
"5492","646",2022-10-28 04:45:00,958,960,2,90,FALSE,NA,"0.1.4"
"5493","646",2022-10-28 05:00:00,958,960,2,90,FALSE,NA,"0.1.4"
"5494","646",2022-10-28 05:15:00,958,960,2,90,FALSE,NA,"0.1.4"
"5495","646",2022-10-28 05:30:00,958,960,2,90,FALSE,NA,"0.1.4"
"5496","646",2022-10-28 05:45:00,958,960,2,90,FALSE,NA,"0.1.4"
"5497","646",2022-10-28 06:00:00,958,960,2,90,FALSE,NA,"0.1.4"
"5498","646",2022-10-28 06:15:00,958,960,2,90,FALSE,NA,"0.1.4"
"5499","646",2022-10-28 06:30:00,958,960,2,90,FALSE,NA,"0.1.4"
"5500","646",2022-10-28 06:45:00,958,960,2,90,FALSE,NA,"0.1.4"
"5501","646",2022-10-28 07:00:00,959,960,1,90,TRUE,NA,"0.1.4"
"5502","646",2022-10-28 07:15:00,958,960,2,90,TRUE,NA,"0.1.4"
"5503","646",2022-10-28 07:30:00,958,960,2,90,TRUE,NA,"0.1.4"
"5504","646",2022-10-28 07:45:00,958,960,2,90,TRUE,NA,"0.1.4"
"5505","646",2022-10-28 08:00:00,958,960,2,90,TRUE,NA,"0.1.4"
"5506","646",2022-10-28 08:15:00,958,960,2,90,TRUE,NA,"0.1.4"
"5507","646",2022-10-28 08:30:00,959,960,1,90,TRUE,NA,"0.1.4"
"5508","646",2022-10-28 08:45:00,959,960,1,90,TRUE,NA,"0.1.4"
"5509","646",2022-10-28 09:00:00,959,960,1,90,TRUE,NA,"0.1.4"
"5510","646",2022-10-28 09:15:00,959,960,1,90,TRUE,NA,"0.1.4"
"5511","646",2022-10-28 09:30:00,959,960,1,90,TRUE,NA,"0.1.4"
"5512","646",2022-10-28 09:45:00,959,960,1,90,TRUE,NA,"0.1.4"
"5513","646",2022-10-28 10:00:00,959,960,1,90,TRUE,NA,"0.1.4"
"5514","646",2022-10-28 10:15:00,959,960,1,90,TRUE,NA,"0.1.4"
"5515","646",2022-10-28 10:30:00,959,960,1,90,TRUE,NA,"0.1.4"
"5516","646",2022-10-28 10:45:00,959,960,1,90,TRUE,NA,"0.1.4"
"5517","646",2022-10-28 11:00:00,958,960,2,90,TRUE,NA,"0.1.4"
"5518","646",2022-10-28 11:15:00,959,960,1,90,TRUE,NA,"0.1.4"
"5519","646",2022-10-28 11:30:00,959,960,1,90,TRUE,NA,"0.1.4"
"5520","646",2022-10-28 11:45:00,959,960,1,90,TRUE,NA,"0.1.4"
"5521","646",2022-10-28 12:00:00,959,960,1,90,TRUE,NA,"0.1.4"
"5522","646",2022-10-28 12:15:00,959,960,1,90,TRUE,NA,"0.1.4"
"5523","646",2022-10-28 12:30:00,959,960,1,90,TRUE,NA,"0.1.4"
"5524","646",2022-10-28 12:45:00,959,960,1,90,TRUE,NA,"0.1.4"
"5525","646",2022-10-28 13:00:00,959,960,1,90,TRUE,NA,"0.1.4"
"5526","646",2022-10-28 13:15:00,959,960,1,90,TRUE,NA,"0.1.4"
"5527","646",2022-10-28 13:30:00,959,960,1,90,TRUE,NA,"0.1.4"
"5528","646",2022-10-28 13:45:00,959,960,1,90,TRUE,NA,"0.1.4"
"5529","646",2022-10-28 14:00:00,958,960,2,90,TRUE,NA,"0.1.4"
"5530","646",2022-10-28 14:15:00,959,960,1,90,TRUE,NA,"0.1.4"
"5531","646",2022-10-28 14:30:00,959,960,1,90,TRUE,NA,"0.1.4"
"5532","646",2022-10-28 14:45:00,960,960,0,90,TRUE,NA,"0.1.4"
"5533","646",2022-10-28 15:00:00,960,960,0,90,TRUE,NA,"0.1.4"
"5534","646",2022-10-28 15:15:00,960,960,0,90,TRUE,NA,"0.1.4"
"5535","646",2022-10-28 15:30:00,959,960,1,90,TRUE,NA,"0.1.4"
"5536","646",2022-10-28 15:45:00,960,960,0,90,TRUE,NA,"0.1.4"
"5537","646",2022-10-28 16:00:00,960,960,0,90,TRUE,NA,"0.1.4"
"5538","646",2022-10-28 16:15:00,960,960,0,90,TRUE,NA,"0.1.4"
"5539","646",2022-10-28 16:30:00,960,960,0,90,TRUE,NA,"0.1.4"
"5540","646",2022-10-28 16:45:00,960,960,0,90,TRUE,NA,"0.1.4"
"5541","646",2022-10-28 17:00:00,960,960,0,90,TRUE,NA,"0.1.4"
"5542","646",2022-10-28 17:15:00,960,960,0,90,TRUE,NA,"0.1.4"
"5543","646",2022-10-28 17:30:00,960,960,0,90,TRUE,NA,"0.1.4"
"5544","646",2022-10-28 17:45:00,960,960,0,90,TRUE,NA,"0.1.4"
"5545","646",2022-10-28 18:00:00,960,960,0,90,FALSE,NA,"0.1.4"
"5546","646",2022-10-28 18:15:00,960,960,0,90,FALSE,NA,"0.1.4"
"5547","646",2022-10-28 18:30:00,960,960,0,90,FALSE,NA,"0.1.4"
"5548","646",2022-10-28 18:45:00,961,961,0,91,FALSE,NA,"0.1.4"
"5549","646",2022-10-28 19:00:00,961,961,0,91,FALSE,NA,"0.1.4"
"5550","646",2022-10-28 19:15:00,961,961,0,91,FALSE,NA,"0.1.4"
"5551","646",2022-10-28 19:30:00,961,961,0,91,FALSE,NA,"0.1.4"
"5552","646",2022-10-28 19:45:00,961,961,0,91,FALSE,NA,"0.1.4"
"5553","646",2022-10-28 20:00:00,961,961,0,91,FALSE,NA,"0.1.4"
"5554","646",2022-10-28 20:15:00,961,961,0,91,FALSE,NA,"0.1.4"
"5555","646",2022-10-28 20:30:00,961,961,0,91,FALSE,NA,"0.1.4"
"5556","646",2022-10-28 20:45:00,961,961,0,91,FALSE,NA,"0.1.4"
"5557","646",2022-10-28 21:00:00,961,961,0,91,FALSE,NA,"0.1.4"
"5558","646",2022-10-28 21:15:00,961,961,0,91,FALSE,NA,"0.1.4"
"5559","646",2022-10-28 21:30:00,961,961,0,91,FALSE,NA,"0.1.4"
"5560","646",2022-10-28 21:45:00,961,961,0,91,FALSE,NA,"0.1.4"
"5561","646",2022-10-28 22:00:00,961,961,0,91,FALSE,NA,"0.1.4"
"5562","646",2022-10-28 22:15:00,961,961,0,91,FALSE,NA,"0.1.4"
"5563","646",2022-10-28 22:30:00,961,961,0,91,FALSE,NA,"0.1.4"
"5564","646",2022-10-28 22:45:00,961,961,0,91,FALSE,NA,"0.1.4"
"5565","646",2022-10-28 23:00:00,961,961,0,91,FALSE,NA,"0.1.4"
"5566","646",2022-10-28 23:15:00,961,961,0,91,FALSE,NA,"0.1.4"
"5567","646",2022-10-28 23:30:00,961,961,0,91,FALSE,NA,"0.1.4"
"5568","646",2022-10-28 23:45:00,961,961,0,91,FALSE,NA,"0.1.4"
"5569","646",2022-10-29,961,961,0,91,FALSE,NA,"0.1.4"
"5570","646",2022-10-29 00:15:00,961,961,0,91,FALSE,NA,"0.1.4"
"5571","646",2022-10-29 00:30:00,961,961,0,91,FALSE,NA,"0.1.4"
"5572","646",2022-10-29 00:45:00,961,961,0,91,FALSE,NA,"0.1.4"
"5573","646",2022-10-29 01:00:00,961,961,0,91,FALSE,NA,"0.1.4"
"5574","646",2022-10-29 01:15:00,961,961,0,91,FALSE,NA,"0.1.4"
"5575","646",2022-10-29 01:30:00,961,961,0,91,FALSE,NA,"0.1.4"
"5576","646",2022-10-29 01:45:00,961,961,0,91,FALSE,NA,"0.1.4"
"5577","646",2022-10-29 02:00:00,961,961,0,91,FALSE,NA,"0.1.4"
"5578","646",2022-10-29 02:15:00,961,961,0,91,FALSE,NA,"0.1.4"
"5579","646",2022-10-29 02:30:00,961,961,0,91,FALSE,NA,"0.1.4"
"5580","646",2022-10-29 02:45:00,961,961,0,91,FALSE,NA,"0.1.4"
"5581","646",2022-10-29 03:00:00,961,961,0,91,FALSE,NA,"0.1.4"
"5582","646",2022-10-29 03:15:00,961,961,0,91,FALSE,NA,"0.1.4"
"5583","646",2022-10-29 03:30:00,961,961,0,91,FALSE,NA,"0.1.4"
"5584","646",2022-10-29 03:45:00,961,961,0,91,FALSE,NA,"0.1.4"
"5585","646",2022-10-29 04:00:00,961,961,0,91,FALSE,NA,"0.1.4"
"5586","646",2022-10-29 04:15:00,961,961,0,91,FALSE,NA,"0.1.4"
"5587","646",2022-10-29 04:30:00,961,961,0,91,FALSE,NA,"0.1.4"
"5588","646",2022-10-29 04:45:00,961,961,0,91,FALSE,NA,"0.1.4"
"5589","646",2022-10-29 05:00:00,961,961,0,91,FALSE,NA,"0.1.4"
"5590","646",2022-10-29 05:15:00,961,961,0,91,FALSE,NA,"0.1.4"
"5591","646",2022-10-29 05:30:00,961,961,0,91,FALSE,NA,"0.1.4"
"5592","646",2022-10-29 05:45:00,961,961,0,91,FALSE,NA,"0.1.4"
"5593","646",2022-10-29 06:00:00,961,961,0,91,FALSE,NA,"0.1.4"
"5594","646",2022-10-29 06:15:00,961,961,0,91,FALSE,NA,"0.1.4"
"5595","646",2022-10-29 06:30:00,961,961,0,91,FALSE,NA,"0.1.4"
"5596","646",2022-10-29 06:45:00,961,961,0,91,FALSE,NA,"0.1.4"
"5597","646",2022-10-29 07:00:00,961,961,0,91,FALSE,NA,"0.1.4"
"5598","646",2022-10-29 07:15:00,961,961,0,91,FALSE,NA,"0.1.4"
"5599","646",2022-10-29 07:30:00,961,961,0,91,FALSE,NA,"0.1.4"
"5600","646",2022-10-29 07:45:00,961,961,0,91,FALSE,NA,"0.1.4"
"5601","646",2022-10-29 08:00:00,961,961,0,91,FALSE,NA,"0.1.4"
"5602","646",2022-10-29 08:15:00,961,961,0,91,FALSE,NA,"0.1.4"
"5603","646",2022-10-29 08:30:00,961,961,0,91,FALSE,NA,"0.1.4"
"5604","646",2022-10-29 08:45:00,961,961,0,91,FALSE,NA,"0.1.4"
"5605","646",2022-10-29 09:00:00,961,961,0,91,FALSE,NA,"0.1.4"
"5606","646",2022-10-29 09:15:00,961,961,0,91,FALSE,NA,"0.1.4"
"5607","646",2022-10-29 09:30:00,961,961,0,91,FALSE,NA,"0.1.4"
"5608","646",2022-10-29 09:45:00,961,961,0,91,FALSE,NA,"0.1.4"
"5609","646",2022-10-29 10:00:00,961,961,0,91,FALSE,NA,"0.1.4"
"5610","646",2022-10-29 10:15:00,961,961,0,91,FALSE,NA,"0.1.4"
"5611","646",2022-10-29 10:30:00,961,961,0,91,FALSE,NA,"0.1.4"
"5612","646",2022-10-29 10:45:00,961,961,0,91,FALSE,NA,"0.1.4"
"5613","646",2022-10-29 11:00:00,961,961,0,91,FALSE,NA,"0.1.4"
"5614","646",2022-10-29 11:15:00,961,961,0,91,FALSE,NA,"0.1.4"
"5615","646",2022-10-29 11:30:00,961,961,0,91,FALSE,NA,"0.1.4"
"5616","646",2022-10-29 11:45:00,961,961,0,91,FALSE,NA,"0.1.4"
"5617","646",2022-10-29 12:00:00,961,961,0,91,FALSE,NA,"0.1.4"
"5618","646",2022-10-29 12:15:00,960,961,1,91,FALSE,NA,"0.1.4"
"5619","646",2022-10-29 12:30:00,960,961,1,91,FALSE,NA,"0.1.4"
"5620","646",2022-10-29 12:45:00,960,961,1,91,FALSE,NA,"0.1.4"
"5621","646",2022-10-29 13:00:00,960,961,1,91,FALSE,NA,"0.1.4"
"5622","646",2022-10-29 13:15:00,961,961,0,91,FALSE,NA,"0.1.4"
"5623","646",2022-10-29 13:30:00,960,961,1,91,FALSE,NA,"0.1.4"
"5624","646",2022-10-29 13:45:00,961,961,0,91,FALSE,NA,"0.1.4"
"5625","646",2022-10-29 14:00:00,962,962,0,92,FALSE,NA,"0.1.4"
"5626","646",2022-10-29 14:15:00,962,962,0,92,FALSE,NA,"0.1.4"
"5627","646",2022-10-29 14:30:00,961,962,1,92,FALSE,NA,"0.1.4"
"5628","646",2022-10-29 14:45:00,961,962,1,92,FALSE,NA,"0.1.4"
"5629","646",2022-10-29 15:00:00,961,962,1,92,FALSE,NA,"0.1.4"
"5630","646",2022-10-29 15:15:00,961,962,1,92,FALSE,NA,"0.1.4"
"5631","646",2022-10-29 15:30:00,961,962,1,92,FALSE,NA,"0.1.4"
"5632","646",2022-10-29 15:45:00,961,962,1,92,FALSE,NA,"0.1.4"
"5633","646",2022-10-29 16:00:00,961,962,1,92,FALSE,NA,"0.1.4"
"5634","646",2022-10-29 16:15:00,962,962,0,92,TRUE,NA,"0.1.4"
"5635","646",2022-10-29 16:30:00,962,962,0,92,TRUE,NA,"0.1.4"
"5636","646",2022-10-29 16:45:00,961,962,1,92,FALSE,NA,"0.1.4"
"5637","646",2022-10-29 17:00:00,961,962,1,92,FALSE,NA,"0.1.4"
"5638","646",2022-10-29 17:15:00,961,962,1,92,FALSE,NA,"0.1.4"
"5639","646",2022-10-29 17:30:00,961,962,1,92,FALSE,NA,"0.1.4"
"5640","646",2022-10-29 17:45:00,962,962,0,92,FALSE,NA,"0.1.4"
"5641","646",2022-10-29 18:00:00,962,962,0,92,FALSE,NA,"0.1.4"
"5642","646",2022-10-29 18:15:00,962,962,0,92,FALSE,NA,"0.1.4"
"5643","646",2022-10-29 18:30:00,961,962,1,92,FALSE,NA,"0.1.4"
"5644","646",2022-10-29 18:45:00,961,962,1,92,FALSE,NA,"0.1.4"
"5645","646",2022-10-29 19:00:00,961,962,1,92,FALSE,NA,"0.1.4"
"5646","646",2022-10-29 19:15:00,961,962,1,92,FALSE,NA,"0.1.4"
"5647","646",2022-10-29 19:30:00,961,962,1,92,FALSE,NA,"0.1.4"
"5648","646",2022-10-29 19:45:00,961,962,1,92,FALSE,NA,"0.1.4"
"5649","646",2022-10-29 20:00:00,962,962,0,92,FALSE,NA,"0.1.4"
"5650","646",2022-10-29 20:15:00,962,962,0,92,FALSE,NA,"0.1.4"
"5651","646",2022-10-29 20:30:00,962,962,0,92,FALSE,NA,"0.1.4"
"5652","646",2022-10-29 20:45:00,962,962,0,92,FALSE,NA,"0.1.4"
"5653","646",2022-10-29 21:00:00,962,962,0,92,FALSE,NA,"0.1.4"
"5654","646",2022-10-29 21:15:00,962,962,0,92,FALSE,NA,"0.1.4"
"5655","646",2022-10-29 21:30:00,962,962,0,92,FALSE,NA,"0.1.4"
"5656","646",2022-10-29 21:45:00,961,962,1,92,FALSE,NA,"0.1.4"
"5657","646",2022-10-29 22:00:00,962,962,0,92,FALSE,NA,"0.1.4"
"5658","646",2022-10-29 22:15:00,962,962,0,92,FALSE,NA,"0.1.4"
"5659","646",2022-10-29 22:30:00,962,962,0,92,FALSE,NA,"0.1.4"
"5660","646",2022-10-29 22:45:00,961,962,1,92,FALSE,NA,"0.1.4"
"5661","646",2022-10-29 23:00:00,961,962,1,92,FALSE,NA,"0.1.4"
"5662","646",2022-10-29 23:15:00,961,962,1,92,FALSE,NA,"0.1.4"
"5663","646",2022-10-29 23:30:00,962,962,0,92,FALSE,NA,"0.1.4"
"5664","646",2022-10-29 23:45:00,962,962,0,92,FALSE,NA,"0.1.4"
"5665","646",2022-10-30,961,962,1,92,FALSE,NA,"0.1.4"
"5666","646",2022-10-30 00:15:00,961,962,1,92,FALSE,NA,"0.1.4"
"5667","646",2022-10-30 00:30:00,962,962,0,92,FALSE,NA,"0.1.4"
"5668","646",2022-10-30 00:45:00,961,962,1,92,FALSE,NA,"0.1.4"
"5669","646",2022-10-30 01:00:00,961,962,1,92,FALSE,NA,"0.1.4"
"5670","646",2022-10-30 01:15:00,962,962,0,92,FALSE,NA,"0.1.4"
"5671","646",2022-10-30 01:30:00,962,962,0,92,FALSE,NA,"0.1.4"
"5672","646",2022-10-30 01:45:00,962,962,0,92,FALSE,NA,"0.1.4"
"5673","646",2022-10-30 02:00:00,962,962,0,92,FALSE,NA,"0.1.4"
"5674","646",2022-10-30 02:15:00,962,962,0,92,FALSE,NA,"0.1.4"
"5675","646",2022-10-30 02:30:00,962,962,0,92,FALSE,NA,"0.1.4"
"5676","646",2022-10-30 02:45:00,962,962,0,92,FALSE,NA,"0.1.4"
"5677","646",2022-10-30 03:00:00,962,962,0,92,FALSE,NA,"0.1.4"
"5678","646",2022-10-30 03:15:00,962,962,0,92,FALSE,NA,"0.1.4"
"5679","646",2022-10-30 03:30:00,962,962,0,92,FALSE,NA,"0.1.4"
"5680","646",2022-10-30 03:45:00,962,962,0,92,FALSE,NA,"0.1.4"
"5681","646",2022-10-30 04:00:00,962,962,0,92,FALSE,NA,"0.1.4"
"5682","646",2022-10-30 04:15:00,961,962,1,92,FALSE,NA,"0.1.4"
"5683","646",2022-10-30 04:30:00,962,962,0,92,FALSE,NA,"0.1.4"
"5684","646",2022-10-30 04:45:00,961,962,1,92,FALSE,NA,"0.1.4"
"5685","646",2022-10-30 05:00:00,961,962,1,92,FALSE,NA,"0.1.4"
"5686","646",2022-10-30 05:15:00,961,962,1,92,FALSE,NA,"0.1.4"
"5687","646",2022-10-30 05:30:00,961,962,1,92,FALSE,NA,"0.1.4"
"5688","646",2022-10-30 05:45:00,962,962,0,92,FALSE,NA,"0.1.4"
"5689","646",2022-10-30 06:00:00,961,962,1,92,FALSE,NA,"0.1.4"
"5690","646",2022-10-30 06:15:00,961,962,1,92,FALSE,NA,"0.1.4"
"5691","646",2022-10-30 06:30:00,961,962,1,92,FALSE,NA,"0.1.4"
"5692","646",2022-10-30 06:45:00,962,962,0,92,FALSE,NA,"0.1.4"
"5693","646",2022-10-30 07:00:00,962,962,0,92,FALSE,NA,"0.1.4"
"5694","646",2022-10-30 07:15:00,962,962,0,92,FALSE,NA,"0.1.4"
"5695","646",2022-10-30 07:30:00,962,962,0,92,FALSE,NA,"0.1.4"
"5696","646",2022-10-30 07:45:00,962,962,0,92,FALSE,NA,"0.1.4"
"5697","646",2022-10-30 08:00:00,962,962,0,92,FALSE,NA,"0.1.4"
"5698","646",2022-10-30 08:15:00,962,962,0,92,FALSE,NA,"0.1.4"
"5699","646",2022-10-30 08:30:00,962,962,0,92,FALSE,NA,"0.1.4"
"5700","646",2022-10-30 08:45:00,962,962,0,92,FALSE,NA,"0.1.4"
"5701","646",2022-10-30 09:00:00,962,962,0,92,FALSE,NA,"0.1.4"
"5702","646",2022-10-30 09:15:00,962,962,0,92,FALSE,NA,"0.1.4"
"5703","646",2022-10-30 09:30:00,962,962,0,92,FALSE,NA,"0.1.4"
"5704","646",2022-10-30 09:45:00,962,962,0,92,FALSE,NA,"0.1.4"
"5705","646",2022-10-30 10:00:00,962,962,0,92,FALSE,NA,"0.1.4"
"5706","646",2022-10-30 10:15:00,962,962,0,92,FALSE,NA,"0.1.4"
"5707","646",2022-10-30 10:30:00,962,962,0,92,FALSE,NA,"0.1.4"
"5708","646",2022-10-30 10:45:00,962,962,0,92,FALSE,NA,"0.1.4"
"5709","646",2022-10-30 11:00:00,962,962,0,92,FALSE,NA,"0.1.4"
"5710","646",2022-10-30 11:15:00,962,962,0,92,FALSE,NA,"0.1.4"
"5711","646",2022-10-30 11:30:00,962,962,0,92,FALSE,NA,"0.1.4"
"5712","646",2022-10-30 11:45:00,962,962,0,92,FALSE,NA,"0.1.4"
"5713","646",2022-10-30 12:00:00,962,962,0,92,FALSE,NA,"0.1.4"
"5714","646",2022-10-30 12:15:00,962,962,0,92,FALSE,NA,"0.1.4"
"5715","646",2022-10-30 12:30:00,962,962,0,92,FALSE,NA,"0.1.4"
"5716","646",2022-10-30 12:45:00,962,962,0,92,FALSE,NA,"0.1.4"
"5717","646",2022-10-30 13:00:00,962,962,0,92,FALSE,NA,"0.1.4"
"5718","646",2022-10-30 13:15:00,962,962,0,92,FALSE,NA,"0.1.4"
"5719","646",2022-10-30 13:30:00,962,962,0,92,FALSE,NA,"0.1.4"
"5720","646",2022-10-30 13:45:00,962,962,0,92,FALSE,NA,"0.1.4"
"5721","646",2022-10-30 14:00:00,962,962,0,92,FALSE,NA,"0.1.4"
"5722","646",2022-10-30 14:15:00,962,962,0,92,FALSE,NA,"0.1.4"
"5723","646",2022-10-30 14:30:00,962,962,0,92,FALSE,NA,"0.1.4"
"5724","646",2022-10-30 14:45:00,962,962,0,92,FALSE,NA,"0.1.4"
"5725","646",2022-10-30 15:00:00,962,962,0,92,FALSE,NA,"0.1.4"
"5726","646",2022-10-30 15:15:00,962,962,0,92,FALSE,NA,"0.1.4"
"5727","646",2022-10-30 15:30:00,962,962,0,92,FALSE,NA,"0.1.4"
"5728","646",2022-10-30 15:45:00,962,962,0,92,FALSE,NA,"0.1.4"
"5729","646",2022-10-30 16:00:00,962,962,0,92,FALSE,NA,"0.1.4"
"5730","646",2022-10-30 16:15:00,962,962,0,92,FALSE,NA,"0.1.4"
"5731","646",2022-10-30 16:30:00,962,962,0,92,FALSE,NA,"0.1.4"
"5732","646",2022-10-30 16:45:00,962,962,0,92,FALSE,NA,"0.1.4"
"5733","646",2022-10-30 17:00:00,962,962,0,92,FALSE,NA,"0.1.4"
"5734","646",2022-10-30 17:15:00,962,962,0,92,FALSE,NA,"0.1.4"
"5735","646",2022-10-30 17:30:00,962,962,0,92,FALSE,NA,"0.1.4"
"5736","646",2022-10-30 17:45:00,962,962,0,92,FALSE,NA,"0.1.4"
"5737","646",2022-10-30 18:00:00,962,962,0,92,FALSE,NA,"0.1.4"
"5738","646",2022-10-30 18:15:00,962,962,0,92,FALSE,NA,"0.1.4"
"5739","646",2022-10-30 18:30:00,962,962,0,92,FALSE,NA,"0.1.4"
"5740","646",2022-10-30 18:45:00,962,962,0,92,FALSE,NA,"0.1.4"
"5741","646",2022-10-30 19:00:00,962,962,0,92,FALSE,NA,"0.1.4"
"5742","646",2022-10-30 19:15:00,962,962,0,92,FALSE,NA,"0.1.4"
"5743","646",2022-10-30 19:30:00,962,962,0,92,FALSE,NA,"0.1.4"
"5744","646",2022-10-30 19:45:00,962,962,0,92,FALSE,NA,"0.1.4"
"5745","646",2022-10-30 20:00:00,962,962,0,92,FALSE,NA,"0.1.4"
"5746","646",2022-10-30 20:15:00,962,962,0,92,FALSE,NA,"0.1.4"
"5747","646",2022-10-30 20:30:00,962,962,0,92,FALSE,NA,"0.1.4"
"5748","646",2022-10-30 20:45:00,962,962,0,92,FALSE,NA,"0.1.4"
"5749","646",2022-10-30 21:00:00,962,962,0,92,FALSE,NA,"0.1.4"
"5750","646",2022-10-30 21:15:00,962,962,0,92,FALSE,NA,"0.1.4"
"5751","646",2022-10-30 21:30:00,962,962,0,92,FALSE,NA,"0.1.4"
"5752","646",2022-10-30 21:45:00,962,962,0,92,FALSE,NA,"0.1.4"
"5753","646",2022-10-30 22:00:00,962,962,0,92,FALSE,NA,"0.1.4"
"5754","646",2022-10-30 22:15:00,962,962,0,92,FALSE,NA,"0.1.4"
"5755","646",2022-10-30 22:30:00,962,962,0,92,FALSE,NA,"0.1.4"
"5756","646",2022-10-30 22:45:00,962,962,0,92,FALSE,NA,"0.1.4"
"5757","646",2022-10-30 23:00:00,962,962,0,92,FALSE,NA,"0.1.4"
"5758","646",2022-10-30 23:15:00,962,962,0,92,FALSE,NA,"0.1.4"
"5759","646",2022-10-30 23:30:00,962,962,0,92,FALSE,NA,"0.1.4"
"5760","646",2022-10-30 23:45:00,962,962,0,92,FALSE,NA,"0.1.4"
"5761","646",2022-10-31,962,962,0,92,FALSE,NA,"0.1.4"
"5762","646",2022-10-31 00:15:00,962,962,0,92,FALSE,NA,"0.1.4"
"5763","646",2022-10-31 00:30:00,962,962,0,92,FALSE,NA,"0.1.4"
"5764","646",2022-10-31 00:45:00,961,962,1,92,FALSE,NA,"0.1.4"
"5765","646",2022-10-31 01:00:00,961,962,1,92,FALSE,NA,"0.1.4"
"5766","646",2022-10-31 01:15:00,961,962,1,92,FALSE,NA,"0.1.4"
"5767","646",2022-10-31 01:30:00,961,962,1,92,FALSE,NA,"0.1.4"
"5768","646",2022-10-31 01:45:00,961,962,1,92,FALSE,NA,"0.1.4"
"5769","646",2022-10-31 02:00:00,961,962,1,92,FALSE,NA,"0.1.4"
"5770","646",2022-10-31 02:15:00,961,962,1,92,FALSE,NA,"0.1.4"
"5771","646",2022-10-31 02:30:00,961,962,1,92,FALSE,NA,"0.1.4"
"5772","646",2022-10-31 02:45:00,961,962,1,92,FALSE,NA,"0.1.4"
"5773","646",2022-10-31 03:00:00,961,962,1,92,FALSE,NA,"0.1.4"
"5774","646",2022-10-31 03:15:00,962,962,0,92,FALSE,NA,"0.1.4"
"5775","646",2022-10-31 03:30:00,962,962,0,92,FALSE,NA,"0.1.4"
"5776","646",2022-10-31 03:45:00,961,962,1,92,FALSE,NA,"0.1.4"
"5777","646",2022-10-31 04:00:00,961,962,1,92,FALSE,NA,"0.1.4"
"5778","646",2022-10-31 04:15:00,961,962,1,92,FALSE,NA,"0.1.4"
"5779","646",2022-10-31 04:30:00,962,962,0,92,FALSE,NA,"0.1.4"
"5780","646",2022-10-31 04:45:00,962,962,0,92,FALSE,NA,"0.1.4"
"5781","646",2022-10-31 05:00:00,962,962,0,92,FALSE,NA,"0.1.4"
"5782","646",2022-10-31 05:15:00,962,962,0,92,FALSE,NA,"0.1.4"
"5783","646",2022-10-31 05:30:00,962,962,0,92,FALSE,NA,"0.1.4"
"5784","646",2022-10-31 05:45:00,962,962,0,92,FALSE,NA,"0.1.4"
"5785","646",2022-10-31 06:00:00,962,962,0,92,FALSE,NA,"0.1.4"
"5786","646",2022-10-31 06:15:00,961,962,1,92,FALSE,NA,"0.1.4"
"5787","646",2022-10-31 06:30:00,962,962,0,92,FALSE,NA,"0.1.4"
"5788","646",2022-10-31 06:45:00,962,962,0,92,FALSE,NA,"0.1.4"
"5789","646",2022-10-31 07:00:00,962,962,0,92,FALSE,NA,"0.1.4"
"5790","646",2022-10-31 07:15:00,962,962,0,92,FALSE,NA,"0.1.4"
"5791","646",2022-10-31 07:30:00,962,962,0,92,FALSE,NA,"0.1.4"
"5792","646",2022-10-31 07:45:00,962,962,0,92,FALSE,NA,"0.1.4"
"5793","646",2022-10-31 08:00:00,962,962,0,92,FALSE,NA,"0.1.4"
"5794","646",2022-10-31 08:15:00,962,962,0,92,FALSE,NA,"0.1.4"
"5795","646",2022-10-31 08:30:00,962,962,0,92,FALSE,NA,"0.1.4"
"5796","646",2022-10-31 08:45:00,962,962,0,92,FALSE,NA,"0.1.4"
"5797","646",2022-10-31 09:00:00,962,962,0,92,FALSE,NA,"0.1.4"
"5798","646",2022-10-31 09:15:00,962,962,0,92,FALSE,NA,"0.1.4"
"5799","646",2022-10-31 09:30:00,962,962,0,92,FALSE,NA,"0.1.4"
"5800","646",2022-10-31 09:45:00,962,962,0,92,FALSE,NA,"0.1.4"
"5801","646",2022-10-31 10:00:00,962,962,0,92,FALSE,NA,"0.1.4"
"5802","646",2022-10-31 10:15:00,962,962,0,92,FALSE,NA,"0.1.4"
"5803","646",2022-10-31 10:30:00,962,962,0,92,FALSE,NA,"0.1.4"
"5804","646",2022-10-31 10:45:00,962,962,0,92,FALSE,NA,"0.1.4"
"5805","646",2022-10-31 11:00:00,962,962,0,92,FALSE,NA,"0.1.4"
"5806","646",2022-10-31 11:15:00,962,962,0,92,FALSE,NA,"0.1.4"
"5807","646",2022-10-31 11:30:00,962,962,0,92,FALSE,NA,"0.1.4"
"5808","646",2022-10-31 11:45:00,962,962,0,92,FALSE,NA,"0.1.4"
"5809","646",2022-10-31 12:00:00,962,962,0,92,FALSE,NA,"0.1.4"
"5810","646",2022-10-31 12:15:00,962,962,0,92,FALSE,NA,"0.1.4"
"5811","646",2022-10-31 12:30:00,962,962,0,92,FALSE,NA,"0.1.4"
"5812","646",2022-10-31 12:45:00,962,962,0,92,FALSE,NA,"0.1.4"
"5813","646",2022-10-31 13:00:00,962,962,0,92,FALSE,NA,"0.1.4"
"5814","646",2022-10-31 13:15:00,962,962,0,92,FALSE,NA,"0.1.4"
"5815","646",2022-10-31 13:30:00,962,962,0,92,FALSE,NA,"0.1.4"
"5816","646",2022-10-31 13:45:00,962,962,0,92,FALSE,NA,"0.1.4"
"5817","646",2022-10-31 14:00:00,962,962,0,92,FALSE,NA,"0.1.4"
"5818","646",2022-10-31 14:15:00,962,962,0,92,FALSE,NA,"0.1.4"
"5819","646",2022-10-31 14:30:00,962,962,0,92,FALSE,NA,"0.1.4"
"5820","646",2022-10-31 14:45:00,962,962,0,92,FALSE,NA,"0.1.4"
"5821","646",2022-10-31 15:00:00,962,962,0,92,FALSE,NA,"0.1.4"
"5822","646",2022-10-31 15:15:00,962,962,0,92,FALSE,NA,"0.1.4"
"5823","646",2022-10-31 15:30:00,962,962,0,92,FALSE,NA,"0.1.4"
"5824","646",2022-10-31 15:45:00,962,962,0,92,FALSE,NA,"0.1.4"
"5825","646",2022-10-31 16:00:00,962,962,0,92,FALSE,NA,"0.1.4"
"5826","646",2022-10-31 16:15:00,962,962,0,92,FALSE,NA,"0.1.4"
"5827","646",2022-10-31 16:30:00,962,962,0,92,FALSE,NA,"0.1.4"
"5828","646",2022-10-31 16:45:00,962,962,0,92,FALSE,NA,"0.1.4"
"5829","646",2022-10-31 17:00:00,962,962,0,92,FALSE,NA,"0.1.4"
"5830","646",2022-10-31 17:15:00,962,962,0,92,FALSE,NA,"0.1.4"
"5831","646",2022-10-31 17:30:00,962,962,0,92,FALSE,NA,"0.1.4"
"5832","646",2022-10-31 17:45:00,962,962,0,92,FALSE,NA,"0.1.4"
"5833","646",2022-10-31 18:00:00,962,962,0,92,FALSE,NA,"0.1.4"
"5834","646",2022-10-31 18:15:00,962,962,0,92,FALSE,NA,"0.1.4"
"5835","646",2022-10-31 18:30:00,962,962,0,92,FALSE,NA,"0.1.4"
"5836","646",2022-10-31 18:45:00,962,962,0,92,FALSE,NA,"0.1.4"
"5837","646",2022-10-31 19:00:00,962,962,0,92,FALSE,NA,"0.1.4"
"5838","646",2022-10-31 19:15:00,962,962,0,92,FALSE,NA,"0.1.4"
"5839","646",2022-10-31 19:30:00,962,962,0,92,FALSE,NA,"0.1.4"
"5840","646",2022-10-31 19:45:00,962,962,0,92,FALSE,NA,"0.1.4"
"5841","646",2022-10-31 20:00:00,962,962,0,92,FALSE,NA,"0.1.4"
"5842","646",2022-10-31 20:15:00,962,962,0,92,FALSE,NA,"0.1.4"
"5843","646",2022-10-31 20:30:00,962,962,0,92,FALSE,NA,"0.1.4"
"5844","646",2022-10-31 20:45:00,962,962,0,92,FALSE,NA,"0.1.4"
"5845","646",2022-10-31 21:00:00,962,962,0,92,FALSE,NA,"0.1.4"
"5846","646",2022-10-31 21:15:00,962,962,0,92,FALSE,NA,"0.1.4"
"5847","646",2022-10-31 21:30:00,962,962,0,92,FALSE,NA,"0.1.4"
"5848","646",2022-10-31 21:45:00,962,962,0,92,FALSE,NA,"0.1.4"
"5849","646",2022-10-31 22:00:00,962,962,0,92,FALSE,NA,"0.1.4"
"5850","646",2022-10-31 22:15:00,962,962,0,92,FALSE,NA,"0.1.4"
"5851","646",2022-10-31 22:30:00,962,962,0,92,FALSE,NA,"0.1.4"
"5852","646",2022-10-31 22:45:00,962,962,0,92,FALSE,NA,"0.1.4"
"5853","646",2022-10-31 23:00:00,962,962,0,92,FALSE,NA,"0.1.4"
"5854","646",2022-10-31 23:15:00,962,962,0,92,FALSE,NA,"0.1.4"
"5855","646",2022-10-31 23:30:00,962,962,0,92,FALSE,NA,"0.1.4"
"5856","646",2022-10-31 23:45:00,962,962,0,92,FALSE,NA,"0.1.4"
"5857","646",2022-11-01,962,962,0,92,FALSE,NA,"0.1.4"
"5858","646",2022-11-01 00:15:00,962,962,0,92,FALSE,NA,"0.1.4"
"5859","646",2022-11-01 00:30:00,962,962,0,92,FALSE,NA,"0.1.4"
"5860","646",2022-11-01 00:45:00,962,962,0,92,FALSE,NA,"0.1.4"
"5861","646",2022-11-01 01:00:00,962,962,0,92,FALSE,NA,"0.1.4"
"5862","646",2022-11-01 01:15:00,962,962,0,92,FALSE,NA,"0.1.4"
"5863","646",2022-11-01 01:30:00,962,962,0,92,FALSE,NA,"0.1.4"
"5864","646",2022-11-01 01:45:00,962,962,0,92,FALSE,NA,"0.1.4"
"5865","646",2022-11-01 02:00:00,962,962,0,92,FALSE,NA,"0.1.4"
"5866","646",2022-11-01 02:15:00,962,962,0,92,FALSE,NA,"0.1.4"
"5867","646",2022-11-01 02:30:00,962,962,0,92,FALSE,NA,"0.1.4"
"5868","646",2022-11-01 02:45:00,962,962,0,92,FALSE,NA,"0.1.4"
"5869","646",2022-11-01 03:00:00,962,962,0,92,FALSE,NA,"0.1.4"
"5870","646",2022-11-01 03:15:00,962,962,0,92,FALSE,NA,"0.1.4"
"5871","646",2022-11-01 03:30:00,962,962,0,92,FALSE,NA,"0.1.4"
"5872","646",2022-11-01 03:45:00,962,962,0,92,FALSE,NA,"0.1.4"
"5873","646",2022-11-01 04:00:00,962,962,0,92,FALSE,NA,"0.1.4"
"5874","646",2022-11-01 04:15:00,962,962,0,92,FALSE,NA,"0.1.4"
"5875","646",2022-11-01 04:30:00,962,962,0,92,FALSE,NA,"0.1.4"
"5876","646",2022-11-01 04:45:00,962,962,0,92,FALSE,NA,"0.1.4"
"5877","646",2022-11-01 05:00:00,962,962,0,92,FALSE,NA,"0.1.4"
"5878","646",2022-11-01 05:15:00,962,962,0,92,FALSE,NA,"0.1.4"
"5879","646",2022-11-01 05:30:00,962,962,0,92,FALSE,NA,"0.1.4"
"5880","646",2022-11-01 05:45:00,962,962,0,92,FALSE,NA,"0.1.4"
"5881","646",2022-11-01 06:00:00,962,962,0,92,FALSE,NA,"0.1.4"
"5882","646",2022-11-01 06:15:00,962,962,0,92,FALSE,NA,"0.1.4"
"5883","646",2022-11-01 06:30:00,962,962,0,92,FALSE,NA,"0.1.4"
"5884","646",2022-11-01 06:45:00,962,962,0,92,FALSE,NA,"0.1.4"
"5885","646",2022-11-01 07:00:00,962,962,0,92,FALSE,NA,"0.1.4"
"5886","646",2022-11-01 07:15:00,962,962,0,92,FALSE,NA,"0.1.4"
"5887","646",2022-11-01 07:30:00,962,962,0,92,FALSE,NA,"0.1.4"
"5888","646",2022-11-01 07:45:00,962,962,0,92,FALSE,NA,"0.1.4"
"5889","646",2022-11-01 08:00:00,962,962,0,92,FALSE,NA,"0.1.4"
"5890","646",2022-11-01 08:15:00,962,962,0,92,FALSE,NA,"0.1.4"
"5891","646",2022-11-01 08:30:00,962,962,0,92,FALSE,NA,"0.1.4"
"5892","646",2022-11-01 08:45:00,962,962,0,92,FALSE,NA,"0.1.4"
"5893","646",2022-11-01 09:00:00,962,962,0,92,FALSE,NA,"0.1.4"
"5894","646",2022-11-01 09:15:00,962,962,0,92,FALSE,NA,"0.1.4"
"5895","646",2022-11-01 09:30:00,962,962,0,92,FALSE,NA,"0.1.4"
"5896","646",2022-11-01 09:45:00,962,962,0,92,FALSE,NA,"0.1.4"
"5897","646",2022-11-01 10:00:00,963,963,0,93,FALSE,NA,"0.1.4"
"5898","646",2022-11-01 10:15:00,962,963,1,93,FALSE,NA,"0.1.4"
"5899","646",2022-11-01 10:30:00,963,963,0,93,FALSE,NA,"0.1.4"
"5900","646",2022-11-01 10:45:00,962,963,1,93,FALSE,NA,"0.1.4"
"5901","646",2022-11-01 11:00:00,962,963,1,93,FALSE,NA,"0.1.4"
"5902","646",2022-11-01 11:15:00,962,963,1,93,FALSE,NA,"0.1.4"
"5903","646",2022-11-01 11:30:00,962,963,1,93,FALSE,NA,"0.1.4"
"5904","646",2022-11-01 11:45:00,962,963,1,93,FALSE,NA,"0.1.4"
"5905","646",2022-11-01 12:00:00,962,963,1,93,FALSE,NA,"0.1.4"
"5906","646",2022-11-01 12:15:00,963,963,0,93,FALSE,NA,"0.1.4"
"5907","646",2022-11-01 12:30:00,963,963,0,93,FALSE,NA,"0.1.4"
"5908","646",2022-11-01 12:45:00,963,963,0,93,FALSE,NA,"0.1.4"
"5909","646",2022-11-01 13:00:00,963,963,0,93,FALSE,NA,"0.1.4"
"5910","646",2022-11-01 13:15:00,964,964,0,94,TRUE,NA,"0.1.4"
"5911","646",2022-11-01 13:30:00,963,964,1,94,FALSE,NA,"0.1.4"
"5912","646",2022-11-01 13:45:00,964,964,0,94,FALSE,NA,"0.1.4"
"5913","646",2022-11-01 14:00:00,964,964,0,94,FALSE,NA,"0.1.4"
"5914","646",2022-11-01 14:15:00,963,964,1,94,TRUE,NA,"0.1.4"
"5915","646",2022-11-01 14:30:00,963,964,1,94,FALSE,NA,"0.1.4"
"5916","646",2022-11-01 14:45:00,964,964,0,94,FALSE,NA,"0.1.4"
"5917","646",2022-11-01 15:00:00,964,964,0,94,FALSE,NA,"0.1.4"
"5918","646",2022-11-01 15:15:00,964,964,0,94,TRUE,NA,"0.1.4"
"5919","646",2022-11-01 15:30:00,964,964,0,94,TRUE,NA,"0.1.4"
"5920","646",2022-11-01 15:45:00,964,964,0,94,TRUE,NA,"0.1.4"
"5921","646",2022-11-01 16:00:00,964,964,0,94,TRUE,NA,"0.1.4"
"5922","646",2022-11-01 16:15:00,965,965,0,95,TRUE,NA,"0.1.4"
"5923","646",2022-11-01 16:30:00,965,965,0,95,TRUE,NA,"0.1.4"
"5924","646",2022-11-01 16:45:00,964,965,1,95,TRUE,NA,"0.1.4"
"5925","646",2022-11-01 17:00:00,964,965,1,95,TRUE,NA,"0.1.4"
"5926","646",2022-11-01 17:15:00,964,965,1,95,TRUE,NA,"0.1.4"
"5927","646",2022-11-01 17:30:00,964,965,1,95,TRUE,NA,"0.1.4"
"5928","646",2022-11-01 17:45:00,964,965,1,95,TRUE,NA,"0.1.4"
"5929","646",2022-11-01 18:00:00,964,965,1,95,TRUE,NA,"0.1.4"
"5930","646",2022-11-01 18:15:00,966,966,0,96,TRUE,NA,"0.1.4"
"5931","646",2022-11-01 18:30:00,965,966,1,96,TRUE,NA,"0.1.4"
"5932","646",2022-11-01 18:45:00,964,966,2,96,TRUE,NA,"0.1.4"
"5933","646",2022-11-01 19:00:00,965,966,1,96,TRUE,NA,"0.1.4"
"5934","646",2022-11-01 19:15:00,965,966,1,96,TRUE,NA,"0.1.4"
"5935","646",2022-11-01 19:30:00,965,966,1,96,TRUE,NA,"0.1.4"
"5936","646",2022-11-01 19:45:00,965,966,1,96,TRUE,NA,"0.1.4"
"5937","646",2022-11-01 20:00:00,965,966,1,96,TRUE,NA,"0.1.4"
"5938","646",2022-11-01 20:15:00,965,966,1,96,TRUE,NA,"0.1.4"
"5939","646",2022-11-01 20:30:00,965,966,1,96,FALSE,NA,"0.1.4"
"5940","646",2022-11-01 20:45:00,965,966,1,96,FALSE,NA,"0.1.4"
"5941","646",2022-11-01 21:00:00,965,966,1,96,FALSE,NA,"0.1.4"
"5942","646",2022-11-01 21:15:00,965,966,1,96,FALSE,NA,"0.1.4"
"5943","646",2022-11-01 21:30:00,965,966,1,96,FALSE,NA,"0.1.4"
"5944","646",2022-11-01 21:45:00,965,966,1,96,FALSE,NA,"0.1.4"
"5945","646",2022-11-01 22:00:00,965,966,1,96,FALSE,NA,"0.1.4"
"5946","646",2022-11-01 22:15:00,965,966,1,96,FALSE,NA,"0.1.4"
"5947","646",2022-11-01 22:30:00,965,966,1,96,FALSE,NA,"0.1.4"
"5948","646",2022-11-01 22:45:00,965,966,1,96,FALSE,NA,"0.1.4"
"5949","646",2022-11-01 23:00:00,965,966,1,96,FALSE,NA,"0.1.4"
"5950","646",2022-11-01 23:15:00,965,966,1,96,FALSE,NA,"0.1.4"
"5951","646",2022-11-01 23:30:00,965,966,1,96,FALSE,NA,"0.1.4"
"5952","646",2022-11-01 23:45:00,965,966,1,96,FALSE,NA,"0.1.4"
"5953","646",2022-11-02,965,966,1,96,FALSE,NA,"0.1.4"
"5954","646",2022-11-02 00:15:00,965,966,1,96,FALSE,NA,"0.1.4"
"5955","646",2022-11-02 00:30:00,965,966,1,96,FALSE,NA,"0.1.4"
"5956","646",2022-11-02 00:45:00,965,966,1,96,FALSE,NA,"0.1.4"
"5957","646",2022-11-02 01:00:00,965,966,1,96,TRUE,NA,"0.1.4"
"5958","646",2022-11-02 01:15:00,964,966,2,96,TRUE,NA,"0.1.4"
"5959","646",2022-11-02 01:30:00,965,966,1,96,TRUE,NA,"0.1.4"
"5960","646",2022-11-02 01:45:00,965,966,1,96,TRUE,NA,"0.1.4"
"5961","646",2022-11-02 02:00:00,965,966,1,96,TRUE,NA,"0.1.4"
"5962","646",2022-11-02 02:15:00,965,966,1,96,TRUE,NA,"0.1.4"
"5963","646",2022-11-02 02:30:00,965,966,1,96,TRUE,NA,"0.1.4"
"5964","646",2022-11-02 02:45:00,965,966,1,96,TRUE,NA,"0.1.4"
"5965","646",2022-11-02 03:00:00,965,966,1,96,TRUE,NA,"0.1.4"
"5966","646",2022-11-02 03:15:00,965,966,1,96,TRUE,NA,"0.1.4"
"5967","646",2022-11-02 03:30:00,964,966,2,96,TRUE,NA,"0.1.4"
"5968","646",2022-11-02 03:45:00,964,966,2,96,TRUE,NA,"0.1.4"
"5969","646",2022-11-02 04:00:00,966,966,0,96,TRUE,NA,"0.1.4"
"5970","646",2022-11-02 04:15:00,966,966,0,96,TRUE,NA,"0.1.4"
"5971","646",2022-11-02 04:30:00,965,966,1,96,TRUE,NA,"0.1.4"
"5972","646",2022-11-02 04:45:00,965,966,1,96,TRUE,NA,"0.1.4"
"5973","646",2022-11-02 05:00:00,965,966,1,96,TRUE,NA,"0.1.4"
"5974","646",2022-11-02 05:15:00,965,966,1,96,TRUE,NA,"0.1.4"
"5975","646",2022-11-02 05:30:00,966,966,0,96,TRUE,NA,"0.1.4"
"5976","646",2022-11-02 05:45:00,966,966,0,96,TRUE,NA,"0.1.4"
"5977","646",2022-11-02 06:00:00,966,966,0,96,TRUE,NA,"0.1.4"
"5978","646",2022-11-02 06:15:00,966,966,0,96,TRUE,NA,"0.1.4"
"5979","646",2022-11-02 06:30:00,966,966,0,96,TRUE,NA,"0.1.4"
"5980","646",2022-11-02 06:45:00,966,966,0,96,TRUE,NA,"0.1.4"
"5981","646",2022-11-02 07:00:00,966,966,0,96,TRUE,NA,"0.1.4"
"5982","646",2022-11-02 07:15:00,966,966,0,96,TRUE,NA,"0.1.4"
"5983","646",2022-11-02 07:30:00,966,966,0,96,TRUE,NA,"0.1.4"
"5984","646",2022-11-02 07:45:00,966,966,0,96,TRUE,NA,"0.1.4"
"5985","646",2022-11-02 08:00:00,967,967,0,97,TRUE,NA,"0.1.4"
"5986","646",2022-11-02 08:15:00,966,967,1,97,TRUE,NA,"0.1.4"
"5987","646",2022-11-02 08:30:00,966,967,1,97,TRUE,NA,"0.1.4"
"5988","646",2022-11-02 08:45:00,967,967,0,97,TRUE,NA,"0.1.4"
"5989","646",2022-11-02 09:00:00,967,967,0,97,TRUE,NA,"0.1.4"
"5990","646",2022-11-02 09:15:00,967,967,0,97,TRUE,NA,"0.1.4"
"5991","646",2022-11-02 09:30:00,966,967,1,97,TRUE,NA,"0.1.4"
"5992","646",2022-11-02 09:45:00,966,967,1,97,TRUE,NA,"0.1.4"
"5993","646",2022-11-02 10:00:00,966,967,1,97,TRUE,NA,"0.1.4"
"5994","646",2022-11-02 10:15:00,966,967,1,97,TRUE,NA,"0.1.4"
"5995","646",2022-11-02 10:30:00,966,967,1,97,TRUE,NA,"0.1.4"
"5996","646",2022-11-02 10:45:00,966,967,1,97,TRUE,NA,"0.1.4"
"5997","646",2022-11-02 11:00:00,966,967,1,97,TRUE,NA,"0.1.4"
"5998","646",2022-11-02 11:15:00,966,967,1,97,TRUE,NA,"0.1.4"
"5999","646",2022-11-02 11:30:00,967,967,0,97,TRUE,NA,"0.1.4"
"6000","646",2022-11-02 11:45:00,967,967,0,97,TRUE,NA,"0.1.4"
"6001","646",2022-11-02 12:00:00,966,967,1,97,TRUE,NA,"0.1.4"
"6002","646",2022-11-02 12:15:00,967,967,0,97,TRUE,NA,"0.1.4"
"6003","646",2022-11-02 12:30:00,968,968,0,98,TRUE,NA,"0.1.4"
"6004","646",2022-11-02 12:45:00,968,968,0,98,TRUE,NA,"0.1.4"
"6005","646",2022-11-02 13:00:00,968,968,0,98,TRUE,NA,"0.1.4"
"6006","646",2022-11-02 13:15:00,968,968,0,98,TRUE,NA,"0.1.4"
"6007","646",2022-11-02 13:30:00,968,968,0,98,TRUE,NA,"0.1.4"
"6008","646",2022-11-02 13:45:00,967,968,1,98,TRUE,NA,"0.1.4"
"6009","646",2022-11-02 14:00:00,967,968,1,98,TRUE,NA,"0.1.4"
"6010","646",2022-11-02 14:15:00,967,968,1,98,TRUE,NA,"0.1.4"
"6011","646",2022-11-02 14:30:00,967,968,1,98,TRUE,NA,"0.1.4"
"6012","646",2022-11-02 14:45:00,967,968,1,98,TRUE,NA,"0.1.4"
"6013","646",2022-11-02 15:00:00,967,968,1,98,TRUE,NA,"0.1.4"
"6014","646",2022-11-02 15:15:00,967,968,1,98,TRUE,NA,"0.1.4"
"6015","646",2022-11-02 15:30:00,967,968,1,98,TRUE,NA,"0.1.4"
"6016","646",2022-11-02 15:45:00,967,968,1,98,TRUE,NA,"0.1.4"
"6017","646",2022-11-02 16:00:00,967,968,1,98,TRUE,NA,"0.1.4"
"6018","646",2022-11-02 16:15:00,967,968,1,98,TRUE,NA,"0.1.4"
"6019","646",2022-11-02 16:30:00,967,968,1,98,TRUE,NA,"0.1.4"
"6020","646",2022-11-02 16:45:00,967,968,1,98,TRUE,NA,"0.1.4"
"6021","646",2022-11-02 17:00:00,967,968,1,98,TRUE,NA,"0.1.4"
"6022","646",2022-11-02 17:15:00,967,968,1,98,TRUE,NA,"0.1.4"
"6023","646",2022-11-02 17:30:00,967,968,1,98,TRUE,NA,"0.1.4"
"6024","646",2022-11-02 17:45:00,967,968,1,98,TRUE,NA,"0.1.4"
"6025","646",2022-11-02 18:00:00,967,968,1,98,TRUE,NA,"0.1.4"
"6026","646",2022-11-02 18:15:00,967,968,1,98,TRUE,NA,"0.1.4"
"6027","646",2022-11-02 18:30:00,967,968,1,98,TRUE,NA,"0.1.4"
"6028","646",2022-11-02 18:45:00,967,968,1,98,TRUE,NA,"0.1.4"
"6029","646",2022-11-02 19:00:00,967,968,1,98,TRUE,NA,"0.1.4"
"6030","646",2022-11-02 19:15:00,967,968,1,98,TRUE,NA,"0.1.4"
"6031","646",2022-11-02 19:30:00,967,968,1,98,TRUE,NA,"0.1.4"
"6032","646",2022-11-02 19:45:00,968,968,0,98,TRUE,NA,"0.1.4"
"6033","646",2022-11-02 20:00:00,968,968,0,98,TRUE,NA,"0.1.4"
"6034","646",2022-11-02 20:15:00,968,968,0,98,TRUE,NA,"0.1.4"
"6035","646",2022-11-02 20:30:00,968,968,0,98,TRUE,NA,"0.1.4"
"6036","646",2022-11-02 20:45:00,968,968,0,98,TRUE,NA,"0.1.4"
"6037","646",2022-11-02 21:00:00,968,968,0,98,TRUE,NA,"0.1.4"
"6038","646",2022-11-02 21:15:00,967,968,1,98,TRUE,NA,"0.1.4"
"6039","646",2022-11-02 21:30:00,968,968,0,98,TRUE,NA,"0.1.4"
"6040","646",2022-11-02 21:45:00,967,968,1,98,TRUE,NA,"0.1.4"
"6041","646",2022-11-02 22:00:00,967,968,1,98,TRUE,NA,"0.1.4"
"6042","646",2022-11-02 22:15:00,967,968,1,98,TRUE,NA,"0.1.4"
"6043","646",2022-11-02 22:30:00,967,968,1,98,TRUE,NA,"0.1.4"
"6044","646",2022-11-02 22:45:00,967,968,1,98,TRUE,NA,"0.1.4"
"6045","646",2022-11-02 23:00:00,967,968,1,98,TRUE,NA,"0.1.4"
"6046","646",2022-11-02 23:15:00,967,968,1,98,TRUE,NA,"0.1.4"
"6047","646",2022-11-02 23:30:00,967,968,1,98,TRUE,NA,"0.1.4"
"6048","646",2022-11-02 23:45:00,966,968,2,98,TRUE,NA,"0.1.4"
"6049","646",2022-11-03,966,968,2,98,TRUE,NA,"0.1.4"
"6050","646",2022-11-03 00:15:00,966,968,2,98,TRUE,NA,"0.1.4"
"6051","646",2022-11-03 00:30:00,966,968,2,98,TRUE,NA,"0.1.4"
"6052","646",2022-11-03 00:45:00,966,968,2,98,TRUE,NA,"0.1.4"
"6053","646",2022-11-03 01:00:00,966,968,2,98,TRUE,NA,"0.1.4"
"6054","646",2022-11-03 01:15:00,966,968,2,98,TRUE,NA,"0.1.4"
"6055","646",2022-11-03 01:30:00,966,968,2,98,TRUE,NA,"0.1.4"
"6056","646",2022-11-03 01:45:00,966,968,2,98,TRUE,NA,"0.1.4"
"6057","646",2022-11-03 02:00:00,966,968,2,98,TRUE,NA,"0.1.4"
"6058","646",2022-11-03 02:15:00,966,968,2,98,TRUE,NA,"0.1.4"
"6059","646",2022-11-03 02:30:00,966,968,2,98,TRUE,NA,"0.1.4"
"6060","646",2022-11-03 02:45:00,966,968,2,98,TRUE,NA,"0.1.4"
"6061","646",2022-11-03 03:00:00,966,968,2,98,TRUE,NA,"0.1.4"
"6062","646",2022-11-03 03:15:00,966,968,2,98,TRUE,NA,"0.1.4"
"6063","646",2022-11-03 03:30:00,966,968,2,98,TRUE,NA,"0.1.4"
"6064","646",2022-11-03 03:45:00,966,968,2,98,TRUE,NA,"0.1.4"
"6065","646",2022-11-03 04:00:00,967,968,1,98,TRUE,NA,"0.1.4"
"6066","646",2022-11-03 04:15:00,967,968,1,98,TRUE,NA,"0.1.4"
"6067","646",2022-11-03 04:30:00,967,968,1,98,TRUE,NA,"0.1.4"
"6068","646",2022-11-03 04:45:00,967,968,1,98,TRUE,NA,"0.1.4"
"6069","646",2022-11-03 05:00:00,966,968,2,98,TRUE,NA,"0.1.4"
"6070","646",2022-11-03 05:15:00,966,968,2,98,TRUE,NA,"0.1.4"
"6071","646",2022-11-03 05:30:00,966,968,2,98,TRUE,NA,"0.1.4"
"6072","646",2022-11-03 05:45:00,966,968,2,98,TRUE,NA,"0.1.4"
"6073","646",2022-11-03 06:00:00,966,968,2,98,TRUE,NA,"0.1.4"
"6074","646",2022-11-03 06:15:00,966,968,2,98,TRUE,NA,"0.1.4"
"6075","646",2022-11-03 06:30:00,966,968,2,98,TRUE,NA,"0.1.4"
"6076","646",2022-11-03 06:45:00,966,968,2,98,TRUE,NA,"0.1.4"
"6077","646",2022-11-03 07:00:00,966,968,2,98,TRUE,NA,"0.1.4"
"6078","646",2022-11-03 07:15:00,966,968,2,98,TRUE,NA,"0.1.4"
"6079","646",2022-11-03 07:30:00,966,968,2,98,TRUE,NA,"0.1.4"
"6080","646",2022-11-03 07:45:00,967,968,1,98,TRUE,NA,"0.1.4"
"6081","646",2022-11-03 08:00:00,967,968,1,98,TRUE,NA,"0.1.4"
"6082","646",2022-11-03 08:15:00,967,968,1,98,TRUE,NA,"0.1.4"
"6083","646",2022-11-03 08:30:00,967,968,1,98,TRUE,NA,"0.1.4"
"6084","646",2022-11-03 08:45:00,967,968,1,98,TRUE,NA,"0.1.4"
"6085","646",2022-11-03 09:00:00,967,968,1,98,TRUE,NA,"0.1.4"
"6086","646",2022-11-03 09:15:00,966,968,2,98,TRUE,NA,"0.1.4"
"6087","646",2022-11-03 09:30:00,966,968,2,98,TRUE,NA,"0.1.4"
"6088","646",2022-11-03 09:45:00,966,968,2,98,TRUE,NA,"0.1.4"
"6089","646",2022-11-03 10:00:00,966,968,2,98,TRUE,NA,"0.1.4"
"6090","646",2022-11-03 10:15:00,966,968,2,98,TRUE,NA,"0.1.4"
"6091","646",2022-11-03 10:30:00,966,968,2,98,TRUE,NA,"0.1.4"
"6092","646",2022-11-03 10:45:00,966,968,2,98,TRUE,NA,"0.1.4"
"6093","646",2022-11-03 11:00:00,966,968,2,98,TRUE,NA,"0.1.4"
"6094","646",2022-11-03 11:15:00,966,968,2,98,TRUE,NA,"0.1.4"
"6095","646",2022-11-03 11:30:00,966,968,2,98,TRUE,NA,"0.1.4"
"6096","646",2022-11-03 11:45:00,966,968,2,98,TRUE,NA,"0.1.4"
"6097","646",2022-11-03 12:00:00,967,968,1,98,TRUE,NA,"0.1.4"
"6098","646",2022-11-03 12:15:00,967,968,1,98,TRUE,NA,"0.1.4"
"6099","646",2022-11-03 12:30:00,967,968,1,98,TRUE,NA,"0.1.4"
"6100","646",2022-11-03 12:45:00,967,968,1,98,TRUE,NA,"0.1.4"
"6101","646",2022-11-03 13:00:00,967,968,1,98,TRUE,NA,"0.1.4"
"6102","646",2022-11-03 13:15:00,967,968,1,98,TRUE,NA,"0.1.4"
"6103","646",2022-11-03 13:30:00,966,968,2,98,TRUE,NA,"0.1.4"
"6104","646",2022-11-03 13:45:00,967,968,1,98,TRUE,NA,"0.1.4"
"6105","646",2022-11-03 14:00:00,967,968,1,98,TRUE,NA,"0.1.4"
"6106","646",2022-11-03 14:15:00,967,968,1,98,TRUE,NA,"0.1.4"
"6107","646",2022-11-03 14:30:00,967,968,1,98,TRUE,NA,"0.1.4"
"6108","646",2022-11-03 14:45:00,967,968,1,98,TRUE,NA,"0.1.4"
"6109","646",2022-11-03 15:00:00,967,968,1,98,TRUE,NA,"0.1.4"
"6110","646",2022-11-03 15:15:00,967,968,1,98,TRUE,NA,"0.1.4"
"6111","646",2022-11-03 15:30:00,967,968,1,98,TRUE,NA,"0.1.4"
"6112","646",2022-11-03 15:45:00,967,968,1,98,TRUE,NA,"0.1.4"
"6113","646",2022-11-03 16:00:00,967,968,1,98,TRUE,NA,"0.1.4"
"6114","646",2022-11-03 16:15:00,967,968,1,98,TRUE,NA,"0.1.4"
"6115","646",2022-11-03 16:30:00,967,968,1,98,TRUE,NA,"0.1.4"
"6116","646",2022-11-03 16:45:00,967,968,1,98,TRUE,NA,"0.1.4"
"6117","646",2022-11-03 17:00:00,967,968,1,98,TRUE,NA,"0.1.4"
"6118","646",2022-11-03 17:15:00,967,968,1,98,TRUE,NA,"0.1.4"
"6119","646",2022-11-03 17:30:00,967,968,1,98,TRUE,NA,"0.1.4"
"6120","646",2022-11-03 17:45:00,967,968,1,98,TRUE,NA,"0.1.4"
"6121","646",2022-11-03 18:00:00,967,968,1,98,TRUE,NA,"0.1.4"
"6122","646",2022-11-03 18:15:00,967,968,1,98,TRUE,NA,"0.1.4"
"6123","646",2022-11-03 18:30:00,967,968,1,98,TRUE,NA,"0.1.4"
"6124","646",2022-11-03 18:45:00,967,968,1,98,TRUE,NA,"0.1.4"
"6125","646",2022-11-03 19:00:00,967,968,1,98,TRUE,NA,"0.1.4"
"6126","646",2022-11-03 19:15:00,967,968,1,98,TRUE,NA,"0.1.4"
"6127","646",2022-11-03 19:30:00,967,968,1,98,TRUE,NA,"0.1.4"
"6128","646",2022-11-03 19:45:00,967,968,1,98,TRUE,NA,"0.1.4"
"6129","646",2022-11-03 20:00:00,967,968,1,98,TRUE,NA,"0.1.4"
"6130","646",2022-11-03 20:15:00,967,968,1,98,TRUE,NA,"0.1.4"
"6131","646",2022-11-03 20:30:00,967,968,1,98,TRUE,NA,"0.1.4"
"6132","646",2022-11-03 20:45:00,967,968,1,98,TRUE,NA,"0.1.4"
"6133","646",2022-11-03 21:00:00,967,968,1,98,TRUE,NA,"0.1.4"
"6134","646",2022-11-03 21:15:00,967,968,1,98,TRUE,NA,"0.1.4"
"6135","646",2022-11-03 21:30:00,966,968,2,98,TRUE,NA,"0.1.4"
"6136","646",2022-11-03 21:45:00,966,968,2,98,TRUE,NA,"0.1.4"
"6137","646",2022-11-03 22:00:00,966,968,2,98,TRUE,NA,"0.1.4"
"6138","646",2022-11-03 22:15:00,966,968,2,98,TRUE,NA,"0.1.4"
"6139","646",2022-11-03 22:30:00,966,968,2,98,TRUE,NA,"0.1.4"
"6140","646",2022-11-03 22:45:00,966,968,2,98,TRUE,NA,"0.1.4"
"6141","646",2022-11-03 23:00:00,966,968,2,98,TRUE,NA,"0.1.4"
"6142","646",2022-11-03 23:15:00,966,968,2,98,TRUE,NA,"0.1.4"
"6143","646",2022-11-03 23:30:00,966,968,2,98,TRUE,NA,"0.1.4"
"6144","646",2022-11-03 23:45:00,966,968,2,98,TRUE,NA,"0.1.4"
"6145","646",2022-11-04,966,968,2,98,TRUE,NA,"0.1.4"
"6146","646",2022-11-04 00:15:00,966,968,2,98,TRUE,NA,"0.1.4"
"6147","646",2022-11-04 00:30:00,966,968,2,98,TRUE,NA,"0.1.4"
"6148","646",2022-11-04 00:45:00,966,968,2,98,TRUE,NA,"0.1.4"
"6149","646",2022-11-04 01:00:00,966,968,2,98,TRUE,NA,"0.1.4"
"6150","646",2022-11-04 01:15:00,966,968,2,98,TRUE,NA,"0.1.4"
"6151","646",2022-11-04 01:30:00,966,968,2,98,TRUE,NA,"0.1.4"
"6152","646",2022-11-04 01:45:00,966,968,2,98,TRUE,NA,"0.1.4"
"6153","646",2022-11-04 02:00:00,966,968,2,98,TRUE,NA,"0.1.4"
"6154","646",2022-11-04 02:15:00,966,968,2,98,TRUE,NA,"0.1.4"
"6155","646",2022-11-04 02:30:00,966,968,2,98,TRUE,NA,"0.1.4"
"6156","646",2022-11-04 02:45:00,966,968,2,98,TRUE,NA,"0.1.4"
"6157","646",2022-11-04 03:00:00,966,968,2,98,TRUE,NA,"0.1.4"
"6158","646",2022-11-04 03:15:00,966,968,2,98,TRUE,NA,"0.1.4"
"6159","646",2022-11-04 03:30:00,966,968,2,98,TRUE,NA,"0.1.4"
"6160","646",2022-11-04 03:45:00,966,968,2,98,TRUE,NA,"0.1.4"
"6161","646",2022-11-04 04:00:00,966,968,2,98,TRUE,NA,"0.1.4"
"6162","646",2022-11-04 04:15:00,966,968,2,98,TRUE,NA,"0.1.4"
"6163","646",2022-11-04 04:30:00,966,968,2,98,TRUE,NA,"0.1.4"
"6164","646",2022-11-04 04:45:00,966,968,2,98,TRUE,NA,"0.1.4"
"6165","646",2022-11-04 05:00:00,967,968,1,98,TRUE,NA,"0.1.4"
"6166","646",2022-11-04 05:15:00,967,968,1,98,TRUE,NA,"0.1.4"
"6167","646",2022-11-04 05:30:00,967,968,1,98,TRUE,NA,"0.1.4"
"6168","646",2022-11-04 05:45:00,967,968,1,98,TRUE,NA,"0.1.4"
"6169","646",2022-11-04 06:00:00,967,968,1,98,TRUE,NA,"0.1.4"
"6170","646",2022-11-04 06:15:00,967,968,1,98,TRUE,NA,"0.1.4"
"6171","646",2022-11-04 06:30:00,967,968,1,98,TRUE,NA,"0.1.4"
"6172","646",2022-11-04 06:45:00,967,968,1,98,TRUE,NA,"0.1.4"
"6173","646",2022-11-04 07:00:00,967,968,1,98,TRUE,NA,"0.1.4"
"6174","646",2022-11-04 07:15:00,966,968,2,98,TRUE,NA,"0.1.4"
"6175","646",2022-11-04 07:30:00,967,968,1,98,TRUE,NA,"0.1.4"
"6176","646",2022-11-04 07:45:00,967,968,1,98,TRUE,NA,"0.1.4"
"6177","646",2022-11-04 08:00:00,966,968,2,98,TRUE,NA,"0.1.4"
"6178","646",2022-11-04 08:15:00,966,968,2,98,TRUE,NA,"0.1.4"
"6179","646",2022-11-04 08:30:00,967,968,1,98,TRUE,NA,"0.1.4"
"6180","646",2022-11-04 08:45:00,967,968,1,98,TRUE,NA,"0.1.4"
"6181","646",2022-11-04 09:00:00,967,968,1,98,TRUE,NA,"0.1.4"
"6182","646",2022-11-04 09:15:00,967,968,1,98,TRUE,NA,"0.1.4"
"6183","646",2022-11-04 09:30:00,967,968,1,98,TRUE,NA,"0.1.4"
"6184","646",2022-11-04 09:45:00,967,968,1,98,TRUE,NA,"0.1.4"
"6185","646",2022-11-04 10:00:00,967,968,1,98,TRUE,NA,"0.1.4"
"6186","646",2022-11-04 10:15:00,967,968,1,98,TRUE,NA,"0.1.4"
"6187","646",2022-11-04 10:30:00,967,968,1,98,TRUE,NA,"0.1.4"
"6188","646",2022-11-04 10:45:00,967,968,1,98,TRUE,NA,"0.1.4"
"6189","646",2022-11-04 11:00:00,967,968,1,98,TRUE,NA,"0.1.4"
"6190","646",2022-11-04 11:15:00,967,968,1,98,TRUE,NA,"0.1.4"
"6191","646",2022-11-04 11:30:00,967,968,1,98,TRUE,NA,"0.1.4"
"6192","646",2022-11-04 11:45:00,967,968,1,98,TRUE,NA,"0.1.4"
"6193","646",2022-11-04 12:00:00,967,968,1,98,TRUE,NA,"0.1.4"
"6194","646",2022-11-04 12:15:00,967,968,1,98,TRUE,NA,"0.1.4"
"6195","646",2022-11-04 12:30:00,969,969,0,99,TRUE,NA,"0.1.4"
"6196","646",2022-11-04 12:45:00,969,969,0,99,TRUE,NA,"0.1.4"
"6197","646",2022-11-04 13:00:00,969,969,0,99,TRUE,NA,"0.1.4"
"6198","646",2022-11-04 13:15:00,968,969,1,99,TRUE,NA,"0.1.4"
"6199","646",2022-11-04 13:30:00,969,969,0,99,TRUE,NA,"0.1.4"
"6200","646",2022-11-04 13:45:00,970,970,0,100,TRUE,NA,"0.1.4"
"6201","646",2022-11-04 14:00:00,970,970,0,100,TRUE,NA,"0.1.4"
"6202","646",2022-11-04 14:15:00,970,970,0,100,TRUE,NA,"0.1.4"
"6203","646",2022-11-04 14:30:00,970,970,0,100,TRUE,NA,"0.1.4"
"6204","646",2022-11-04 14:45:00,970,970,0,100,TRUE,NA,"0.1.4"
"6205","646",2022-11-04 15:00:00,970,970,0,100,TRUE,NA,"0.1.4"
"6206","646",2022-11-04 15:15:00,970,970,0,100,TRUE,NA,"0.1.4"
"6207","646",2022-11-04 15:30:00,971,971,0,101,TRUE,NA,"0.1.4"
"6208","646",2022-11-04 15:45:00,971,971,0,101,TRUE,NA,"0.1.4"
"6209","646",2022-11-04 16:00:00,971,971,0,101,TRUE,NA,"0.1.4"
"6210","646",2022-11-04 16:15:00,971,971,0,101,TRUE,NA,"0.1.4"
"6211","646",2022-11-04 16:30:00,971,971,0,101,TRUE,NA,"0.1.4"
"6212","646",2022-11-04 16:45:00,971,971,0,101,FALSE,NA,"0.1.4"
"6213","646",2022-11-04 17:00:00,971,971,0,101,FALSE,NA,"0.1.4"
"6214","646",2022-11-04 17:15:00,971,971,0,101,FALSE,NA,"0.1.4"
"6215","646",2022-11-04 17:30:00,971,971,0,101,FALSE,NA,"0.1.4"
"6216","646",2022-11-04 17:45:00,971,971,0,101,FALSE,NA,"0.1.4"
"6217","646",2022-11-04 18:00:00,972,972,0,102,FALSE,NA,"0.1.4"
"6218","646",2022-11-04 18:15:00,973,973,0,103,FALSE,NA,"0.1.4"
"6219","646",2022-11-04 18:30:00,974,974,0,104,FALSE,NA,"0.1.4"
"6220","646",2022-11-04 18:45:00,975,975,0,105,FALSE,NA,"0.1.4"
"6221","646",2022-11-04 19:00:00,974,975,1,105,FALSE,NA,"0.1.4"
"6222","646",2022-11-04 19:15:00,974,975,1,105,FALSE,NA,"0.1.4"
"6223","646",2022-11-04 19:30:00,974,975,1,105,FALSE,NA,"0.1.4"
"6224","646",2022-11-04 19:45:00,974,975,1,105,FALSE,NA,"0.1.4"
"6225","646",2022-11-04 20:00:00,974,975,1,105,FALSE,NA,"0.1.4"
"6226","646",2022-11-04 20:15:00,974,975,1,105,FALSE,NA,"0.1.4"
"6227","646",2022-11-04 20:30:00,974,975,1,105,FALSE,NA,"0.1.4"
"6228","646",2022-11-04 20:45:00,974,975,1,105,FALSE,NA,"0.1.4"
"6229","646",2022-11-04 21:00:00,974,975,1,105,FALSE,NA,"0.1.4"
"6230","646",2022-11-04 21:15:00,974,975,1,105,FALSE,NA,"0.1.4"
"6231","646",2022-11-04 21:30:00,973,975,2,105,FALSE,NA,"0.1.4"
"6232","646",2022-11-04 21:45:00,973,975,2,105,FALSE,NA,"0.1.4"
"6233","646",2022-11-04 22:00:00,973,975,2,105,FALSE,NA,"0.1.4"
"6234","646",2022-11-04 22:15:00,975,975,0,105,FALSE,NA,"0.1.4"
"6235","646",2022-11-04 22:30:00,974,975,1,105,FALSE,NA,"0.1.4"
"6236","646",2022-11-04 22:45:00,974,975,1,105,FALSE,NA,"0.1.4"
"6237","646",2022-11-04 23:00:00,974,975,1,105,FALSE,NA,"0.1.4"
"6238","646",2022-11-04 23:15:00,975,975,0,105,FALSE,NA,"0.1.4"
"6239","646",2022-11-04 23:30:00,975,975,0,105,FALSE,NA,"0.1.4"
"6240","646",2022-11-04 23:45:00,974,975,1,105,FALSE,NA,"0.1.4"
"6241","646",2022-11-05,974,975,1,105,FALSE,NA,"0.1.4"
"6242","646",2022-11-05 00:15:00,974,975,1,105,FALSE,NA,"0.1.4"
"6243","646",2022-11-05 00:30:00,975,975,0,105,FALSE,NA,"0.1.4"
"6244","646",2022-11-05 00:45:00,975,975,0,105,FALSE,NA,"0.1.4"
"6245","646",2022-11-05 01:00:00,975,975,0,105,FALSE,NA,"0.1.4"
"6246","646",2022-11-05 01:15:00,975,975,0,105,FALSE,NA,"0.1.4"
"6247","646",2022-11-05 01:30:00,974,975,1,105,FALSE,NA,"0.1.4"
"6248","646",2022-11-05 01:45:00,975,975,0,105,FALSE,NA,"0.1.4"
"6249","646",2022-11-05 02:00:00,975,975,0,105,FALSE,NA,"0.1.4"
"6250","646",2022-11-05 02:15:00,975,975,0,105,FALSE,NA,"0.1.4"
"6251","646",2022-11-05 02:30:00,975,975,0,105,FALSE,NA,"0.1.4"
"6252","646",2022-11-05 02:45:00,975,975,0,105,FALSE,NA,"0.1.4"
"6253","646",2022-11-05 03:00:00,974,975,1,105,FALSE,NA,"0.1.4"
"6254","646",2022-11-05 03:15:00,974,975,1,105,FALSE,NA,"0.1.4"
"6255","646",2022-11-05 03:30:00,975,975,0,105,FALSE,NA,"0.1.4"
"6256","646",2022-11-05 03:45:00,975,975,0,105,FALSE,NA,"0.1.4"
"6257","646",2022-11-05 04:00:00,978,978,0,108,FALSE,NA,"0.1.4"
"6258","646",2022-11-05 04:15:00,976,978,2,108,FALSE,NA,"0.1.4"
"6259","646",2022-11-05 04:30:00,976,978,2,108,FALSE,NA,"0.1.4"
"6260","646",2022-11-05 04:45:00,976,978,2,108,FALSE,NA,"0.1.4"
"6261","646",2022-11-05 05:00:00,976,978,2,108,FALSE,NA,"0.1.4"
"6262","646",2022-11-05 05:15:00,976,978,2,108,FALSE,NA,"0.1.4"
"6263","646",2022-11-05 05:30:00,976,978,2,108,FALSE,NA,"0.1.4"
"6264","646",2022-11-05 05:45:00,976,978,2,108,FALSE,NA,"0.1.4"
"6265","646",2022-11-05 06:00:00,976,978,2,108,FALSE,NA,"0.1.4"
"6266","646",2022-11-05 06:15:00,976,978,2,108,FALSE,NA,"0.1.4"
"6267","646",2022-11-05 06:30:00,976,978,2,108,FALSE,NA,"0.1.4"
"6268","646",2022-11-05 06:45:00,976,978,2,108,FALSE,NA,"0.1.4"
"6269","646",2022-11-05 07:00:00,976,978,2,108,FALSE,NA,"0.1.4"
"6270","646",2022-11-05 07:15:00,976,978,2,108,FALSE,NA,"0.1.4"
"6271","646",2022-11-05 07:30:00,977,978,1,108,FALSE,NA,"0.1.4"
"6272","646",2022-11-05 07:45:00,976,978,2,108,FALSE,NA,"0.1.4"
"6273","646",2022-11-05 08:00:00,976,978,2,108,FALSE,NA,"0.1.4"
"6274","646",2022-11-05 08:15:00,978,978,0,108,FALSE,NA,"0.1.4"
"6275","646",2022-11-05 08:30:00,979,979,0,109,FALSE,NA,"0.1.4"
"6276","646",2022-11-05 08:45:00,978,979,1,109,FALSE,NA,"0.1.4"
"6277","646",2022-11-05 09:00:00,977,979,2,109,FALSE,NA,"0.1.4"
"6278","646",2022-11-05 09:15:00,977,979,2,109,FALSE,NA,"0.1.4"
"6279","646",2022-11-05 09:30:00,977,979,2,109,FALSE,NA,"0.1.4"
"6280","646",2022-11-05 09:45:00,976,979,3,109,FALSE,NA,"0.1.4"
"6281","646",2022-11-05 10:00:00,977,979,2,109,FALSE,NA,"0.1.4"
"6282","646",2022-11-05 10:15:00,976,979,3,109,FALSE,NA,"0.1.4"
"6283","646",2022-11-05 10:30:00,976,979,3,109,FALSE,NA,"0.1.4"
"6284","646",2022-11-05 10:45:00,976,979,3,109,FALSE,NA,"0.1.4"
"6285","646",2022-11-05 11:00:00,976,979,3,109,FALSE,NA,"0.1.4"
"6286","646",2022-11-05 11:15:00,977,979,2,109,FALSE,NA,"0.1.4"
"6287","646",2022-11-05 11:30:00,977,979,2,109,FALSE,NA,"0.1.4"
"6288","646",2022-11-05 11:45:00,977,979,2,109,FALSE,NA,"0.1.4"
"6289","646",2022-11-05 12:00:00,978,979,1,109,FALSE,NA,"0.1.4"
"6290","646",2022-11-05 12:15:00,979,979,0,109,FALSE,NA,"0.1.4"
"6291","646",2022-11-05 12:30:00,978,979,1,109,FALSE,NA,"0.1.4"
"6292","646",2022-11-05 12:45:00,979,979,0,109,FALSE,NA,"0.1.4"
"6293","646",2022-11-05 13:00:00,979,979,0,109,FALSE,NA,"0.1.4"
"6294","646",2022-11-05 13:15:00,979,979,0,109,FALSE,NA,"0.1.4"
"6295","646",2022-11-05 13:30:00,979,979,0,109,FALSE,NA,"0.1.4"
"6296","646",2022-11-05 13:45:00,978,979,1,109,FALSE,NA,"0.1.4"
"6297","646",2022-11-05 14:00:00,979,979,0,109,FALSE,NA,"0.1.4"
"6298","646",2022-11-05 14:15:00,979,979,0,109,FALSE,NA,"0.1.4"
"6299","646",2022-11-05 14:30:00,979,979,0,109,FALSE,NA,"0.1.4"
"6300","646",2022-11-05 14:45:00,978,979,1,109,FALSE,NA,"0.1.4"
"6301","646",2022-11-05 15:00:00,979,979,0,109,FALSE,NA,"0.1.4"
"6302","646",2022-11-05 15:15:00,978,979,1,109,FALSE,NA,"0.1.4"
"6303","646",2022-11-05 15:30:00,978,979,1,109,FALSE,NA,"0.1.4"
"6304","646",2022-11-05 15:45:00,979,979,0,109,FALSE,NA,"0.1.4"
"6305","646",2022-11-05 16:00:00,979,979,0,109,FALSE,NA,"0.1.4"
"6306","646",2022-11-05 16:15:00,979,979,0,109,FALSE,NA,"0.1.4"
"6307","646",2022-11-05 16:30:00,979,979,0,109,FALSE,NA,"0.1.4"
"6308","646",2022-11-05 16:45:00,979,979,0,109,FALSE,NA,"0.1.4"
"6309","646",2022-11-05 17:00:00,979,979,0,109,FALSE,NA,"0.1.4"
"6310","646",2022-11-05 17:15:00,979,979,0,109,FALSE,NA,"0.1.4"
"6311","646",2022-11-05 17:30:00,979,979,0,109,FALSE,NA,"0.1.4"
"6312","646",2022-11-05 17:45:00,979,979,0,109,FALSE,NA,"0.1.4"
"6313","646",2022-11-05 18:00:00,979,979,0,109,FALSE,NA,"0.1.4"
"6314","646",2022-11-05 18:15:00,979,979,0,109,FALSE,NA,"0.1.4"
"6315","646",2022-11-05 18:30:00,979,979,0,109,FALSE,NA,"0.1.4"
"6316","646",2022-11-05 18:45:00,979,979,0,109,FALSE,NA,"0.1.4"
"6317","646",2022-11-05 19:00:00,979,979,0,109,FALSE,NA,"0.1.4"
"6318","646",2022-11-05 19:15:00,979,979,0,109,FALSE,NA,"0.1.4"
"6319","646",2022-11-05 19:30:00,979,979,0,109,FALSE,NA,"0.1.4"
"6320","646",2022-11-05 19:45:00,979,979,0,109,FALSE,NA,"0.1.4"
"6321","646",2022-11-05 20:00:00,979,979,0,109,FALSE,NA,"0.1.4"
"6322","646",2022-11-05 20:15:00,979,979,0,109,FALSE,NA,"0.1.4"
"6323","646",2022-11-05 20:30:00,979,979,0,109,FALSE,NA,"0.1.4"
"6324","646",2022-11-05 20:45:00,979,979,0,109,FALSE,NA,"0.1.4"
"6325","646",2022-11-05 21:00:00,979,979,0,109,FALSE,NA,"0.1.4"
"6326","646",2022-11-05 21:15:00,979,979,0,109,FALSE,NA,"0.1.4"
"6327","646",2022-11-05 21:30:00,979,979,0,109,FALSE,NA,"0.1.4"
"6328","646",2022-11-05 21:45:00,979,979,0,109,FALSE,NA,"0.1.4"
"6329","646",2022-11-05 22:00:00,979,979,0,109,FALSE,NA,"0.1.4"
"6330","646",2022-11-05 22:15:00,979,979,0,109,FALSE,NA,"0.1.4"
"6331","646",2022-11-05 22:30:00,979,979,0,109,FALSE,NA,"0.1.4"
"6332","646",2022-11-05 22:45:00,979,979,0,109,FALSE,NA,"0.1.4"
"6333","646",2022-11-05 23:00:00,979,979,0,109,FALSE,NA,"0.1.4"
"6334","646",2022-11-05 23:15:00,979,979,0,109,FALSE,NA,"0.1.4"
"6335","646",2022-11-05 23:30:00,979,979,0,109,FALSE,NA,"0.1.4"
"6336","646",2022-11-05 23:45:00,979,979,0,109,FALSE,NA,"0.1.4"
"6337","646",2022-11-06,979,979,0,109,FALSE,NA,"0.1.4"
"6338","646",2022-11-06 00:15:00,979,979,0,109,FALSE,NA,"0.1.4"
"6339","646",2022-11-06 00:30:00,979,979,0,109,FALSE,NA,"0.1.4"
"6340","646",2022-11-06 00:45:00,979,979,0,109,FALSE,NA,"0.1.4"
"6341","646",2022-11-06 01:00:00,979,979,0,109,FALSE,NA,"0.1.4"
"6342","646",2022-11-06 01:15:00,978,979,1,109,FALSE,NA,"0.1.4"
"6343","646",2022-11-06 01:30:00,978,979,1,109,FALSE,NA,"0.1.4"
"6344","646",2022-11-06 01:45:00,978,979,1,109,FALSE,NA,"0.1.4"
"6345","646",2022-11-06 02:00:00,978,979,1,109,FALSE,NA,"0.1.4"
"6346","646",2022-11-06 02:15:00,978,979,1,109,FALSE,NA,"0.1.4"
"6347","646",2022-11-06 02:30:00,978,979,1,109,FALSE,NA,"0.1.4"
"6348","646",2022-11-06 02:45:00,978,979,1,109,FALSE,NA,"0.1.4"
"6349","646",2022-11-06 03:00:00,978,979,1,109,FALSE,NA,"0.1.4"
"6350","646",2022-11-06 03:15:00,978,979,1,109,FALSE,NA,"0.1.4"
"6351","646",2022-11-06 03:30:00,977,979,2,109,FALSE,NA,"0.1.4"
"6352","646",2022-11-06 03:45:00,977,979,2,109,FALSE,NA,"0.1.4"
"6353","646",2022-11-06 04:00:00,977,979,2,109,FALSE,NA,"0.1.4"
"6354","646",2022-11-06 04:15:00,978,979,1,109,FALSE,NA,"0.1.4"
"6355","646",2022-11-06 04:30:00,977,979,2,109,FALSE,NA,"0.1.4"
"6356","646",2022-11-06 04:45:00,977,979,2,109,FALSE,NA,"0.1.4"
"6357","646",2022-11-06 05:00:00,977,979,2,109,FALSE,NA,"0.1.4"
"6358","646",2022-11-06 05:15:00,977,979,2,109,FALSE,NA,"0.1.4"
"6359","646",2022-11-06 05:30:00,977,979,2,109,FALSE,NA,"0.1.4"
"6360","646",2022-11-06 05:45:00,977,979,2,109,FALSE,NA,"0.1.4"
"6361","646",2022-11-06 06:00:00,977,979,2,109,FALSE,NA,"0.1.4"
"6362","646",2022-11-06 06:15:00,977,979,2,109,FALSE,NA,"0.1.4"
"6363","646",2022-11-06 06:30:00,978,979,1,109,FALSE,NA,"0.1.4"
"6364","646",2022-11-06 06:45:00,978,979,1,109,FALSE,NA,"0.1.4"
"6365","646",2022-11-06 07:00:00,978,979,1,109,FALSE,NA,"0.1.4"
"6366","646",2022-11-06 07:15:00,977,979,2,109,FALSE,NA,"0.1.4"
"6367","646",2022-11-06 07:30:00,978,979,1,109,TRUE,NA,"0.1.4"
"6368","646",2022-11-06 07:45:00,977,979,2,109,FALSE,NA,"0.1.4"
"6369","646",2022-11-06 08:00:00,977,979,2,109,FALSE,NA,"0.1.4"
"6370","646",2022-11-06 08:15:00,977,979,2,109,TRUE,NA,"0.1.4"
"6371","646",2022-11-06 08:30:00,978,979,1,109,TRUE,NA,"0.1.4"
"6372","646",2022-11-06 08:45:00,978,979,1,109,TRUE,NA,"0.1.4"
"6373","646",2022-11-06 09:00:00,978,979,1,109,TRUE,NA,"0.1.4"
"6374","646",2022-11-06 09:15:00,978,979,1,109,TRUE,NA,"0.1.4"
"6375","646",2022-11-06 09:30:00,978,979,1,109,TRUE,NA,"0.1.4"
"6376","646",2022-11-06 09:45:00,978,979,1,109,TRUE,NA,"0.1.4"
"6377","646",2022-11-06 10:00:00,978,979,1,109,TRUE,NA,"0.1.4"
"6378","646",2022-11-06 10:15:00,978,979,1,109,TRUE,NA,"0.1.4"
"6379","646",2022-11-06 10:30:00,978,979,1,109,TRUE,NA,"0.1.4"
"6380","646",2022-11-06 10:45:00,978,979,1,109,TRUE,NA,"0.1.4"
"6381","646",2022-11-06 11:00:00,978,979,1,109,TRUE,NA,"0.1.4"
"6382","646",2022-11-06 11:15:00,978,979,1,109,TRUE,NA,"0.1.4"
"6383","646",2022-11-06 11:30:00,978,979,1,109,TRUE,NA,"0.1.4"
"6384","646",2022-11-06 11:45:00,978,979,1,109,TRUE,NA,"0.1.4"
"6385","646",2022-11-06 12:00:00,978,979,1,109,TRUE,NA,"0.1.4"
"6386","646",2022-11-06 12:15:00,978,979,1,109,TRUE,NA,"0.1.4"
"6387","646",2022-11-06 12:30:00,978,979,1,109,TRUE,NA,"0.1.4"
"6388","646",2022-11-06 12:45:00,978,979,1,109,TRUE,NA,"0.1.4"
"6389","646",2022-11-06 13:00:00,978,979,1,109,TRUE,NA,"0.1.4"
"6390","646",2022-11-06 13:15:00,978,979,1,109,TRUE,NA,"0.1.4"
"6391","646",2022-11-06 13:30:00,978,979,1,109,TRUE,NA,"0.1.4"
"6392","646",2022-11-06 13:45:00,978,979,1,109,TRUE,NA,"0.1.4"
"6393","646",2022-11-06 14:00:00,978,979,1,109,TRUE,NA,"0.1.4"
"6394","646",2022-11-06 14:15:00,978,979,1,109,TRUE,NA,"0.1.4"
"6395","646",2022-11-06 14:30:00,978,979,1,109,TRUE,NA,"0.1.4"
"6396","646",2022-11-06 14:45:00,978,979,1,109,TRUE,NA,"0.1.4"
"6397","646",2022-11-06 15:00:00,978,979,1,109,TRUE,NA,"0.1.4"
"6398","646",2022-11-06 15:15:00,978,979,1,109,TRUE,NA,"0.1.4"
"6399","646",2022-11-06 15:30:00,978,979,1,109,TRUE,NA,"0.1.4"
"6400","646",2022-11-06 15:45:00,978,979,1,109,TRUE,NA,"0.1.4"
"6401","646",2022-11-06 16:00:00,978,979,1,109,TRUE,NA,"0.1.4"
"6402","646",2022-11-06 16:15:00,978,979,1,109,TRUE,NA,"0.1.4"
"6403","646",2022-11-06 16:30:00,979,979,0,109,TRUE,NA,"0.1.4"
"6404","646",2022-11-06 16:45:00,979,979,0,109,TRUE,NA,"0.1.4"
"6405","646",2022-11-06 17:00:00,979,979,0,109,TRUE,NA,"0.1.4"
"6406","646",2022-11-06 17:15:00,979,979,0,109,TRUE,NA,"0.1.4"
"6407","646",2022-11-06 17:30:00,979,979,0,109,TRUE,NA,"0.1.4"
"6408","646",2022-11-06 17:45:00,979,979,0,109,TRUE,NA,"0.1.4"
"6409","646",2022-11-06 18:00:00,979,979,0,109,TRUE,NA,"0.1.4"
"6410","646",2022-11-06 18:15:00,979,979,0,109,TRUE,NA,"0.1.4"
"6411","646",2022-11-06 18:30:00,979,979,0,109,TRUE,NA,"0.1.4"
"6412","646",2022-11-06 18:45:00,979,979,0,109,TRUE,NA,"0.1.4"
"6413","646",2022-11-06 19:00:00,980,980,0,110,TRUE,NA,"0.1.4"
"6414","646",2022-11-06 19:15:00,981,981,0,111,TRUE,NA,"0.1.4"
"6415","646",2022-11-06 19:30:00,980,981,1,111,TRUE,NA,"0.1.4"
"6416","646",2022-11-06 19:45:00,980,981,1,111,TRUE,NA,"0.1.4"
"6417","646",2022-11-06 20:00:00,980,981,1,111,TRUE,NA,"0.1.4"
"6418","646",2022-11-06 20:15:00,980,981,1,111,TRUE,NA,"0.1.4"
"6419","646",2022-11-06 20:30:00,980,981,1,111,TRUE,NA,"0.1.4"
"6420","646",2022-11-06 20:45:00,979,981,2,111,TRUE,NA,"0.1.4"
"6421","646",2022-11-06 21:00:00,979,981,2,111,TRUE,NA,"0.1.4"
"6422","646",2022-11-06 21:15:00,979,981,2,111,TRUE,NA,"0.1.4"
"6423","646",2022-11-06 21:30:00,979,981,2,111,TRUE,NA,"0.1.4"
"6424","646",2022-11-06 21:45:00,979,981,2,111,TRUE,NA,"0.1.4"
"6425","646",2022-11-06 22:00:00,979,981,2,111,TRUE,NA,"0.1.4"
"6426","646",2022-11-06 22:15:00,979,981,2,111,TRUE,NA,"0.1.4"
"6427","646",2022-11-06 22:30:00,979,981,2,111,TRUE,NA,"0.1.4"
"6428","646",2022-11-06 22:45:00,979,981,2,111,TRUE,NA,"0.1.4"
"6429","646",2022-11-06 23:00:00,979,981,2,111,TRUE,NA,"0.1.4"
"6430","646",2022-11-06 23:15:00,979,981,2,111,TRUE,NA,"0.1.4"
"6431","646",2022-11-06 23:30:00,979,981,2,111,TRUE,NA,"0.1.4"
"6432","646",2022-11-06 23:45:00,979,981,2,111,TRUE,NA,"0.1.4"
"6433","646",2022-11-07,980,981,1,111,TRUE,NA,"0.1.4"
"6434","646",2022-11-07 00:15:00,981,981,0,111,TRUE,NA,"0.1.4"
"6435","646",2022-11-07 00:30:00,981,981,0,111,TRUE,NA,"0.1.4"
"6436","646",2022-11-07 00:45:00,981,981,0,111,TRUE,NA,"0.1.4"
"6437","646",2022-11-07 01:00:00,981,981,0,111,TRUE,NA,"0.1.4"
"6438","646",2022-11-07 01:15:00,981,981,0,111,TRUE,NA,"0.1.4"
"6439","646",2022-11-07 01:30:00,981,981,0,111,TRUE,NA,"0.1.4"
"6440","646",2022-11-07 01:45:00,981,981,0,111,TRUE,NA,"0.1.4"
"6441","646",2022-11-07 02:00:00,981,981,0,111,TRUE,NA,"0.1.4"
"6442","646",2022-11-07 02:15:00,981,981,0,111,TRUE,NA,"0.1.4"
"6443","646",2022-11-07 02:30:00,981,981,0,111,TRUE,NA,"0.1.4"
"6444","646",2022-11-07 02:45:00,981,981,0,111,TRUE,NA,"0.1.4"
"6445","646",2022-11-07 03:00:00,981,981,0,111,TRUE,NA,"0.1.4"
"6446","646",2022-11-07 03:15:00,981,981,0,111,TRUE,NA,"0.1.4"
"6447","646",2022-11-07 03:30:00,981,981,0,111,TRUE,NA,"0.1.4"
"6448","646",2022-11-07 03:45:00,981,981,0,111,TRUE,NA,"0.1.4"
"6449","646",2022-11-07 04:00:00,981,981,0,111,TRUE,NA,"0.1.4"
"6450","646",2022-11-07 04:15:00,981,981,0,111,TRUE,NA,"0.1.4"
"6451","646",2022-11-07 04:30:00,981,981,0,111,TRUE,NA,"0.1.4"
"6452","646",2022-11-07 04:45:00,981,981,0,111,TRUE,NA,"0.1.4"
"6453","646",2022-11-07 05:00:00,983,983,0,113,TRUE,NA,"0.1.4"
"6454","646",2022-11-07 05:15:00,983,983,0,113,TRUE,NA,"0.1.4"
"6455","646",2022-11-07 05:30:00,982,983,1,113,TRUE,NA,"0.1.4"
"6456","646",2022-11-07 05:45:00,982,983,1,113,TRUE,NA,"0.1.4"
"6457","646",2022-11-07 06:00:00,982,983,1,113,TRUE,NA,"0.1.4"
"6458","646",2022-11-07 06:15:00,982,983,1,113,TRUE,NA,"0.1.4"
"6459","646",2022-11-07 06:30:00,982,983,1,113,TRUE,NA,"0.1.4"
"6460","646",2022-11-07 06:45:00,982,983,1,113,TRUE,NA,"0.1.4"
"6461","646",2022-11-07 07:00:00,982,983,1,113,TRUE,NA,"0.1.4"
"6462","646",2022-11-07 07:15:00,981,983,2,113,TRUE,NA,"0.1.4"
"6463","646",2022-11-07 07:30:00,982,983,1,113,TRUE,NA,"0.1.4"
"6464","646",2022-11-07 07:45:00,982,983,1,113,TRUE,NA,"0.1.4"
"6465","646",2022-11-07 08:00:00,982,983,1,113,TRUE,NA,"0.1.4"
"6466","646",2022-11-07 08:15:00,981,983,2,113,TRUE,NA,"0.1.4"
"6467","646",2022-11-07 08:30:00,982,983,1,113,TRUE,NA,"0.1.4"
"6468","646",2022-11-07 08:45:00,982,983,1,113,TRUE,NA,"0.1.4"
"6469","646",2022-11-07 09:00:00,982,983,1,113,TRUE,NA,"0.1.4"
"6470","646",2022-11-07 09:15:00,984,984,0,114,TRUE,NA,"0.1.4"
"6471","646",2022-11-07 09:30:00,984,984,0,114,TRUE,NA,"0.1.4"
"6472","646",2022-11-07 09:45:00,983,984,1,114,TRUE,NA,"0.1.4"
"6473","646",2022-11-07 10:00:00,983,984,1,114,TRUE,NA,"0.1.4"
"6474","646",2022-11-07 10:15:00,983,984,1,114,TRUE,NA,"0.1.4"
"6475","646",2022-11-07 10:30:00,983,984,1,114,TRUE,NA,"0.1.4"
"6476","646",2022-11-07 10:45:00,983,984,1,114,TRUE,NA,"0.1.4"
"6477","646",2022-11-07 11:00:00,983,984,1,114,TRUE,NA,"0.1.4"
"6478","646",2022-11-07 11:15:00,983,984,1,114,TRUE,NA,"0.1.4"
"6479","646",2022-11-07 11:30:00,983,984,1,114,TRUE,NA,"0.1.4"
"6480","646",2022-11-07 11:45:00,983,984,1,114,TRUE,NA,"0.1.4"
"6481","646",2022-11-07 12:00:00,983,984,1,114,TRUE,NA,"0.1.4"
"6482","646",2022-11-07 12:15:00,983,984,1,114,TRUE,NA,"0.1.4"
"6483","646",2022-11-07 12:30:00,983,984,1,114,TRUE,NA,"0.1.4"
"6484","646",2022-11-07 12:45:00,983,984,1,114,TRUE,NA,"0.1.4"
"6485","646",2022-11-07 13:00:00,983,984,1,114,TRUE,NA,"0.1.4"
"6486","646",2022-11-07 13:15:00,983,984,1,114,TRUE,NA,"0.1.4"
"6487","646",2022-11-07 13:30:00,983,984,1,114,TRUE,NA,"0.1.4"
"6488","646",2022-11-07 13:45:00,983,984,1,114,TRUE,NA,"0.1.4"
"6489","646",2022-11-07 14:00:00,983,984,1,114,TRUE,NA,"0.1.4"
"6490","646",2022-11-07 14:15:00,983,984,1,114,TRUE,NA,"0.1.4"
"6491","646",2022-11-07 14:30:00,983,984,1,114,TRUE,NA,"0.1.4"
"6492","646",2022-11-07 14:45:00,983,984,1,114,TRUE,NA,"0.1.4"
"6493","646",2022-11-07 15:00:00,983,984,1,114,TRUE,NA,"0.1.4"
"6494","646",2022-11-07 15:15:00,983,984,1,114,TRUE,NA,"0.1.4"
"6495","646",2022-11-07 15:30:00,983,984,1,114,TRUE,NA,"0.1.4"
"6496","646",2022-11-07 15:45:00,983,984,1,114,TRUE,NA,"0.1.4"
"6497","646",2022-11-07 16:00:00,983,984,1,114,TRUE,NA,"0.1.4"
"6498","646",2022-11-07 16:15:00,983,984,1,114,TRUE,NA,"0.1.4"
"6499","646",2022-11-07 16:30:00,983,984,1,114,TRUE,NA,"0.1.4"
"6500","646",2022-11-07 16:45:00,983,984,1,114,TRUE,NA,"0.1.4"
"6501","646",2022-11-07 17:00:00,983,984,1,114,TRUE,NA,"0.1.4"
"6502","646",2022-11-07 17:15:00,983,984,1,114,TRUE,NA,"0.1.4"
"6503","646",2022-11-07 17:30:00,983,984,1,114,TRUE,NA,"0.1.4"
"6504","646",2022-11-07 17:45:00,983,984,1,114,TRUE,NA,"0.1.4"
"6505","646",2022-11-07 18:00:00,983,984,1,114,TRUE,NA,"0.1.4"
"6506","646",2022-11-07 18:15:00,983,984,1,114,TRUE,NA,"0.1.4"
"6507","646",2022-11-07 18:30:00,983,984,1,114,TRUE,NA,"0.1.4"
"6508","646",2022-11-07 18:45:00,983,984,1,114,TRUE,NA,"0.1.4"
"6509","646",2022-11-07 19:00:00,983,984,1,114,TRUE,NA,"0.1.4"
"6510","646",2022-11-07 19:15:00,983,984,1,114,TRUE,NA,"0.1.4"
"6511","646",2022-11-07 19:30:00,983,984,1,114,TRUE,NA,"0.1.4"
"6512","646",2022-11-07 19:45:00,983,984,1,114,TRUE,NA,"0.1.4"
"6513","646",2022-11-07 20:00:00,983,984,1,114,TRUE,NA,"0.1.4"
"6514","646",2022-11-07 20:15:00,983,984,1,114,TRUE,NA,"0.1.4"
"6515","646",2022-11-07 20:30:00,983,984,1,114,TRUE,NA,"0.1.4"
"6516","646",2022-11-07 20:45:00,983,984,1,114,TRUE,NA,"0.1.4"
"6517","646",2022-11-07 21:00:00,983,984,1,114,TRUE,NA,"0.1.4"
"6518","646",2022-11-07 21:15:00,983,984,1,114,TRUE,NA,"0.1.4"
"6519","646",2022-11-07 21:30:00,983,984,1,114,TRUE,NA,"0.1.4"
"6520","646",2022-11-07 21:45:00,983,984,1,114,TRUE,NA,"0.1.4"
"6521","646",2022-11-07 22:00:00,983,984,1,114,TRUE,NA,"0.1.4"
"6522","646",2022-11-07 22:15:00,983,984,1,114,TRUE,NA,"0.1.4"
"6523","646",2022-11-07 22:30:00,983,984,1,114,TRUE,NA,"0.1.4"
"6524","646",2022-11-07 22:45:00,983,984,1,114,TRUE,NA,"0.1.4"
"6525","646",2022-11-07 23:00:00,983,984,1,114,TRUE,NA,"0.1.4"
"6526","646",2022-11-07 23:15:00,983,984,1,114,TRUE,NA,"0.1.4"
"6527","646",2022-11-07 23:30:00,983,984,1,114,TRUE,NA,"0.1.4"
"6528","646",2022-11-07 23:45:00,983,984,1,114,TRUE,NA,"0.1.4"
"6529","646",2022-11-08,983,984,1,114,TRUE,NA,"0.1.4"
"6530","646",2022-11-08 00:15:00,983,984,1,114,TRUE,NA,"0.1.4"
"6531","646",2022-11-08 00:30:00,983,984,1,114,TRUE,NA,"0.1.4"
"6532","646",2022-11-08 00:45:00,983,984,1,114,TRUE,NA,"0.1.4"
"6533","646",2022-11-08 01:00:00,983,984,1,114,TRUE,NA,"0.1.4"
"6534","646",2022-11-08 01:15:00,983,984,1,114,TRUE,NA,"0.1.4"
"6535","646",2022-11-08 01:30:00,983,984,1,114,TRUE,NA,"0.1.4"
"6536","646",2022-11-08 01:45:00,983,984,1,114,TRUE,NA,"0.1.4"
"6537","646",2022-11-08 02:00:00,983,984,1,114,TRUE,NA,"0.1.4"
"6538","646",2022-11-08 02:15:00,983,984,1,114,TRUE,NA,"0.1.4"
"6539","646",2022-11-08 02:30:00,983,984,1,114,TRUE,NA,"0.1.4"
"6540","646",2022-11-08 02:45:00,983,984,1,114,TRUE,NA,"0.1.4"
"6541","646",2022-11-08 03:00:00,983,984,1,114,TRUE,NA,"0.1.4"
"6542","646",2022-11-08 03:15:00,983,984,1,114,TRUE,NA,"0.1.4"
"6543","646",2022-11-08 03:30:00,983,984,1,114,TRUE,NA,"0.1.4"
"6544","646",2022-11-08 03:45:00,983,984,1,114,TRUE,NA,"0.1.4"
"6545","646",2022-11-08 04:00:00,983,984,1,114,TRUE,NA,"0.1.4"
"6546","646",2022-11-08 04:15:00,983,984,1,114,TRUE,NA,"0.1.4"
"6547","646",2022-11-08 04:30:00,983,984,1,114,TRUE,NA,"0.1.4"
"6548","646",2022-11-08 04:45:00,983,984,1,114,TRUE,NA,"0.1.4"
"6549","646",2022-11-08 05:00:00,983,984,1,114,TRUE,NA,"0.1.4"
"6550","646",2022-11-08 05:15:00,983,984,1,114,TRUE,NA,"0.1.4"
"6551","646",2022-11-08 05:30:00,983,984,1,114,TRUE,NA,"0.1.4"
"6552","646",2022-11-08 05:45:00,983,984,1,114,TRUE,NA,"0.1.4"
"6553","646",2022-11-08 06:00:00,983,984,1,114,TRUE,NA,"0.1.4"
"6554","646",2022-11-08 06:15:00,983,984,1,114,TRUE,NA,"0.1.4"
"6555","646",2022-11-08 06:30:00,983,984,1,114,TRUE,NA,"0.1.4"
"6556","646",2022-11-08 06:45:00,983,984,1,114,TRUE,NA,"0.1.4"
"6557","646",2022-11-08 07:00:00,983,984,1,114,TRUE,NA,"0.1.4"
"6558","646",2022-11-08 07:15:00,983,984,1,114,TRUE,NA,"0.1.4"
"6559","646",2022-11-08 07:30:00,983,984,1,114,TRUE,NA,"0.1.4"
"6560","646",2022-11-08 07:45:00,983,984,1,114,TRUE,NA,"0.1.4"
"6561","646",2022-11-08 08:00:00,983,984,1,114,TRUE,NA,"0.1.4"
"6562","646",2022-11-08 08:15:00,983,984,1,114,TRUE,NA,"0.1.4"
"6563","646",2022-11-08 08:30:00,983,984,1,114,TRUE,NA,"0.1.4"
"6564","646",2022-11-08 08:45:00,983,984,1,114,TRUE,NA,"0.1.4"
"6565","646",2022-11-08 09:00:00,983,984,1,114,TRUE,NA,"0.1.4"
"6566","646",2022-11-08 09:15:00,983,984,1,114,TRUE,NA,"0.1.4"
"6567","646",2022-11-08 09:30:00,983,984,1,114,TRUE,NA,"0.1.4"
"6568","646",2022-11-08 09:45:00,983,984,1,114,TRUE,NA,"0.1.4"
"6569","646",2022-11-08 10:00:00,983,984,1,114,TRUE,NA,"0.1.4"
"6570","646",2022-11-08 10:15:00,983,984,1,114,TRUE,NA,"0.1.4"
"6571","646",2022-11-08 10:30:00,983,984,1,114,TRUE,NA,"0.1.4"
"6572","646",2022-11-08 10:45:00,983,984,1,114,TRUE,NA,"0.1.4"
"6573","646",2022-11-08 11:00:00,983,984,1,114,TRUE,NA,"0.1.4"
"6574","646",2022-11-08 11:15:00,983,984,1,114,TRUE,NA,"0.1.4"
"6575","646",2022-11-08 11:30:00,983,984,1,114,TRUE,NA,"0.1.4"
"6576","646",2022-11-08 11:45:00,983,984,1,114,TRUE,NA,"0.1.4"
"6577","646",2022-11-08 12:00:00,983,984,1,114,TRUE,NA,"0.1.4"
"6578","646",2022-11-08 12:15:00,983,984,1,114,TRUE,NA,"0.1.4"
"6579","646",2022-11-08 12:30:00,983,984,1,114,TRUE,NA,"0.1.4"
"6580","646",2022-11-08 12:45:00,983,984,1,114,TRUE,NA,"0.1.4"
"6581","646",2022-11-08 13:00:00,983,984,1,114,TRUE,NA,"0.1.4"
"6582","646",2022-11-08 13:15:00,984,984,0,114,TRUE,NA,"0.1.4"
"6583","646",2022-11-08 13:30:00,984,984,0,114,TRUE,NA,"0.1.4"
"6584","646",2022-11-08 13:45:00,984,984,0,114,TRUE,NA,"0.1.4"
"6585","646",2022-11-08 14:00:00,984,984,0,114,TRUE,NA,"0.1.4"
"6586","646",2022-11-08 14:15:00,984,984,0,114,TRUE,NA,"0.1.4"
"6587","646",2022-11-08 14:30:00,983,984,1,114,TRUE,NA,"0.1.4"
"6588","646",2022-11-08 14:45:00,983,984,1,114,TRUE,NA,"0.1.4"
"6589","646",2022-11-08 15:00:00,983,984,1,114,TRUE,NA,"0.1.4"
"6590","646",2022-11-08 15:15:00,984,984,0,114,TRUE,NA,"0.1.4"
"6591","646",2022-11-08 15:30:00,984,984,0,114,TRUE,NA,"0.1.4"
"6592","646",2022-11-08 15:45:00,984,984,0,114,TRUE,NA,"0.1.4"
"6593","646",2022-11-08 16:00:00,984,984,0,114,TRUE,NA,"0.1.4"
"6594","646",2022-11-08 16:15:00,984,984,0,114,TRUE,NA,"0.1.4"
"6595","646",2022-11-08 16:30:00,984,984,0,114,TRUE,NA,"0.1.4"
"6596","646",2022-11-08 16:45:00,984,984,0,114,TRUE,NA,"0.1.4"
"6597","646",2022-11-08 17:00:00,984,984,0,114,TRUE,NA,"0.1.4"
"6598","646",2022-11-08 17:15:00,984,984,0,114,TRUE,NA,"0.1.4"
"6599","646",2022-11-08 17:30:00,984,984,0,114,TRUE,NA,"0.1.4"
"6600","646",2022-11-08 17:45:00,984,984,0,114,TRUE,NA,"0.1.4"
"6601","646",2022-11-08 18:00:00,984,984,0,114,TRUE,NA,"0.1.4"
"6602","646",2022-11-08 18:15:00,984,984,0,114,TRUE,NA,"0.1.4"
"6603","646",2022-11-08 18:30:00,984,984,0,114,TRUE,NA,"0.1.4"
"6604","646",2022-11-08 18:45:00,984,984,0,114,TRUE,NA,"0.1.4"
"6605","646",2022-11-08 19:00:00,984,984,0,114,TRUE,NA,"0.1.4"
"6606","646",2022-11-08 19:15:00,984,984,0,114,TRUE,NA,"0.1.4"
"6607","646",2022-11-08 19:30:00,984,984,0,114,TRUE,NA,"0.1.4"
"6608","646",2022-11-08 19:45:00,984,984,0,114,TRUE,NA,"0.1.4"
"6609","646",2022-11-08 20:00:00,984,984,0,114,TRUE,NA,"0.1.4"
"6610","646",2022-11-08 20:15:00,984,984,0,114,TRUE,NA,"0.1.4"
"6611","646",2022-11-08 20:30:00,984,984,0,114,TRUE,NA,"0.1.4"
"6612","646",2022-11-08 20:45:00,984,984,0,114,TRUE,NA,"0.1.4"
"6613","646",2022-11-08 21:00:00,984,984,0,114,TRUE,NA,"0.1.4"
"6614","646",2022-11-08 21:15:00,984,984,0,114,TRUE,NA,"0.1.4"
"6615","646",2022-11-08 21:30:00,984,984,0,114,TRUE,NA,"0.1.4"
"6616","646",2022-11-08 21:45:00,984,984,0,114,TRUE,NA,"0.1.4"
"6617","646",2022-11-08 22:00:00,984,984,0,114,TRUE,NA,"0.1.4"
"6618","646",2022-11-08 22:15:00,984,984,0,114,TRUE,NA,"0.1.4"
"6619","646",2022-11-08 22:30:00,984,984,0,114,TRUE,NA,"0.1.4"
"6620","646",2022-11-08 22:45:00,984,984,0,114,TRUE,NA,"0.1.4"
"6621","646",2022-11-08 23:00:00,984,984,0,114,TRUE,NA,"0.1.4"
"6622","646",2022-11-08 23:15:00,984,984,0,114,TRUE,NA,"0.1.4"
"6623","646",2022-11-08 23:30:00,984,984,0,114,TRUE,NA,"0.1.4"
"6624","646",2022-11-08 23:45:00,984,984,0,114,TRUE,NA,"0.1.4"
"6625","646",2022-11-09,984,984,0,114,TRUE,NA,"0.1.4"
"6626","646",2022-11-09 00:15:00,984,984,0,114,TRUE,NA,"0.1.4"
"6627","646",2022-11-09 00:30:00,984,984,0,114,TRUE,NA,"0.1.4"
"6628","646",2022-11-09 00:45:00,984,984,0,114,TRUE,NA,"0.1.4"
"6629","646",2022-11-09 01:00:00,984,984,0,114,TRUE,NA,"0.1.4"
"6630","646",2022-11-09 01:15:00,984,984,0,114,TRUE,NA,"0.1.4"
"6631","646",2022-11-09 01:30:00,984,984,0,114,TRUE,NA,"0.1.4"
"6632","646",2022-11-09 01:45:00,984,984,0,114,TRUE,NA,"0.1.4"
"6633","646",2022-11-09 02:00:00,984,984,0,114,TRUE,NA,"0.1.4"
"6634","646",2022-11-09 02:15:00,984,984,0,114,TRUE,NA,"0.1.4"
"6635","646",2022-11-09 02:30:00,984,984,0,114,TRUE,NA,"0.1.4"
"6636","646",2022-11-09 02:45:00,984,984,0,114,TRUE,NA,"0.1.4"
"6637","646",2022-11-09 03:00:00,984,984,0,114,TRUE,NA,"0.1.4"
"6638","646",2022-11-09 03:15:00,984,984,0,114,TRUE,NA,"0.1.4"
"6639","646",2022-11-09 03:30:00,984,984,0,114,TRUE,NA,"0.1.4"
"6640","646",2022-11-09 03:45:00,984,984,0,114,TRUE,NA,"0.1.4"
"6641","646",2022-11-09 04:00:00,984,984,0,114,TRUE,NA,"0.1.4"
"6642","646",2022-11-09 04:15:00,984,984,0,114,TRUE,NA,"0.1.4"
"6643","646",2022-11-09 04:30:00,984,984,0,114,TRUE,NA,"0.1.4"
"6644","646",2022-11-09 04:45:00,984,984,0,114,TRUE,NA,"0.1.4"
"6645","646",2022-11-09 05:00:00,984,984,0,114,TRUE,NA,"0.1.4"
"6646","646",2022-11-09 05:15:00,984,984,0,114,TRUE,NA,"0.1.4"
"6647","646",2022-11-09 05:30:00,984,984,0,114,TRUE,NA,"0.1.4"
"6648","646",2022-11-09 05:45:00,984,984,0,114,TRUE,NA,"0.1.4"
"6649","646",2022-11-09 06:00:00,984,984,0,114,TRUE,NA,"0.1.4"
"6650","646",2022-11-09 06:15:00,984,984,0,114,TRUE,NA,"0.1.4"
"6651","646",2022-11-09 06:30:00,984,984,0,114,TRUE,NA,"0.1.4"
"6652","646",2022-11-09 06:45:00,984,984,0,114,TRUE,NA,"0.1.4"
"6653","646",2022-11-09 07:00:00,984,984,0,114,TRUE,NA,"0.1.4"
"6654","646",2022-11-09 07:15:00,984,984,0,114,TRUE,NA,"0.1.4"
"6655","646",2022-11-09 07:30:00,984,984,0,114,TRUE,NA,"0.1.4"
"6656","646",2022-11-09 07:45:00,984,984,0,114,TRUE,NA,"0.1.4"
"6657","646",2022-11-09 08:00:00,984,984,0,114,TRUE,NA,"0.1.4"
"6658","646",2022-11-09 08:15:00,984,984,0,114,TRUE,NA,"0.1.4"
"6659","646",2022-11-09 08:30:00,984,984,0,114,TRUE,NA,"0.1.4"
"6660","646",2022-11-09 08:45:00,984,984,0,114,TRUE,NA,"0.1.4"
"6661","646",2022-11-09 09:00:00,984,984,0,114,TRUE,NA,"0.1.4"
"6662","646",2022-11-09 09:15:00,984,984,0,114,TRUE,NA,"0.1.4"
"6663","646",2022-11-09 09:30:00,984,984,0,114,TRUE,NA,"0.1.4"
"6664","646",2022-11-09 09:45:00,984,984,0,114,TRUE,NA,"0.1.4"
"6665","646",2022-11-09 10:00:00,984,984,0,114,TRUE,NA,"0.1.4"
"6666","646",2022-11-09 10:15:00,984,984,0,114,TRUE,NA,"0.1.4"
"6667","646",2022-11-09 10:30:00,984,984,0,114,TRUE,NA,"0.1.4"
"6668","646",2022-11-09 10:45:00,984,984,0,114,TRUE,NA,"0.1.4"
"6669","646",2022-11-09 11:00:00,984,984,0,114,TRUE,NA,"0.1.4"
"6670","646",2022-11-09 11:15:00,984,984,0,114,TRUE,NA,"0.1.4"
"6671","646",2022-11-09 11:30:00,984,984,0,114,TRUE,NA,"0.1.4"
"6672","646",2022-11-09 11:45:00,984,984,0,114,TRUE,NA,"0.1.4"
"6673","646",2022-11-09 12:00:00,984,984,0,114,TRUE,NA,"0.1.4"
"6674","646",2022-11-09 12:15:00,984,984,0,114,TRUE,NA,"0.1.4"
"6675","646",2022-11-09 12:30:00,984,984,0,114,TRUE,NA,"0.1.4"
"6676","646",2022-11-09 12:45:00,984,984,0,114,TRUE,NA,"0.1.4"
"6677","646",2022-11-09 13:00:00,984,984,0,114,TRUE,NA,"0.1.4"
"6678","646",2022-11-09 13:15:00,984,984,0,114,TRUE,NA,"0.1.4"
"6679","646",2022-11-09 13:30:00,985,985,0,115,TRUE,NA,"0.1.4"
"6680","646",2022-11-09 13:45:00,984,985,1,115,TRUE,NA,"0.1.4"
"6681","646",2022-11-09 14:00:00,984,985,1,115,TRUE,NA,"0.1.4"
"6682","646",2022-11-09 14:15:00,984,985,1,115,TRUE,NA,"0.1.4"
"6683","646",2022-11-09 14:30:00,984,985,1,115,TRUE,NA,"0.1.4"
"6684","646",2022-11-09 14:45:00,984,985,1,115,TRUE,NA,"0.1.4"
"6685","646",2022-11-09 15:00:00,985,985,0,115,TRUE,NA,"0.1.4"
"6686","646",2022-11-09 15:15:00,984,985,1,115,TRUE,NA,"0.1.4"
"6687","646",2022-11-09 15:30:00,984,985,1,115,TRUE,NA,"0.1.4"
"6688","646",2022-11-09 15:45:00,984,985,1,115,TRUE,NA,"0.1.4"
"6689","646",2022-11-09 16:00:00,984,985,1,115,TRUE,NA,"0.1.4"
"6690","646",2022-11-09 16:15:00,984,985,1,115,TRUE,NA,"0.1.4"
"6691","646",2022-11-09 16:30:00,984,985,1,115,TRUE,NA,"0.1.4"
"6692","646",2022-11-09 16:45:00,984,985,1,115,TRUE,NA,"0.1.4"
"6693","646",2022-11-09 17:00:00,984,985,1,115,TRUE,NA,"0.1.4"
"6694","646",2022-11-09 17:15:00,984,985,1,115,TRUE,NA,"0.1.4"
"6695","646",2022-11-09 17:30:00,984,985,1,115,TRUE,NA,"0.1.4"
"6696","646",2022-11-09 17:45:00,984,985,1,115,TRUE,NA,"0.1.4"
"6697","646",2022-11-09 18:00:00,984,985,1,115,TRUE,NA,"0.1.4"
"6698","646",2022-11-09 18:15:00,984,985,1,115,TRUE,NA,"0.1.4"
"6699","646",2022-11-09 18:30:00,984,985,1,115,TRUE,NA,"0.1.4"
"6700","646",2022-11-09 18:45:00,984,985,1,115,TRUE,NA,"0.1.4"
"6701","646",2022-11-09 19:00:00,984,985,1,115,TRUE,NA,"0.1.4"
"6702","646",2022-11-09 19:15:00,984,985,1,115,TRUE,NA,"0.1.4"
"6703","646",2022-11-09 19:30:00,984,985,1,115,TRUE,NA,"0.1.4"
"6704","646",2022-11-09 19:45:00,984,985,1,115,TRUE,NA,"0.1.4"
"6705","646",2022-11-09 20:00:00,984,985,1,115,TRUE,NA,"0.1.4"
"6706","646",2022-11-09 20:15:00,984,985,1,115,TRUE,NA,"0.1.4"
"6707","646",2022-11-09 20:30:00,984,985,1,115,TRUE,NA,"0.1.4"
"6708","646",2022-11-09 20:45:00,984,985,1,115,TRUE,NA,"0.1.4"
"6709","646",2022-11-09 21:00:00,984,985,1,115,TRUE,NA,"0.1.4"
"6710","646",2022-11-09 21:15:00,984,985,1,115,TRUE,NA,"0.1.4"
"6711","646",2022-11-09 21:30:00,984,985,1,115,TRUE,NA,"0.1.4"
"6712","646",2022-11-09 21:45:00,984,985,1,115,TRUE,NA,"0.1.4"
"6713","646",2022-11-09 22:00:00,984,985,1,115,TRUE,NA,"0.1.4"
"6714","646",2022-11-09 22:15:00,984,985,1,115,TRUE,NA,"0.1.4"
"6715","646",2022-11-09 22:30:00,984,985,1,115,TRUE,NA,"0.1.4"
"6716","646",2022-11-09 22:45:00,984,985,1,115,TRUE,NA,"0.1.4"
"6717","646",2022-11-09 23:00:00,984,985,1,115,TRUE,NA,"0.1.4"
"6718","646",2022-11-09 23:15:00,984,985,1,115,TRUE,NA,"0.1.4"
"6719","646",2022-11-09 23:30:00,984,985,1,115,TRUE,NA,"0.1.4"
"6720","646",2022-11-09 23:45:00,984,985,1,115,TRUE,NA,"0.1.4"
"6721","646",2022-11-10,984,985,1,115,TRUE,NA,"0.1.4"
"6722","646",2022-11-10 00:15:00,984,985,1,115,TRUE,NA,"0.1.4"
"6723","646",2022-11-10 00:30:00,984,985,1,115,TRUE,NA,"0.1.4"
"6724","646",2022-11-10 00:45:00,984,985,1,115,TRUE,NA,"0.1.4"
"6725","646",2022-11-10 01:00:00,984,985,1,115,TRUE,NA,"0.1.4"
"6726","646",2022-11-10 01:15:00,984,985,1,115,TRUE,NA,"0.1.4"
"6727","646",2022-11-10 01:30:00,984,985,1,115,TRUE,NA,"0.1.4"
"6728","646",2022-11-10 01:45:00,984,985,1,115,TRUE,NA,"0.1.4"
"6729","646",2022-11-10 02:00:00,984,985,1,115,TRUE,NA,"0.1.4"
"6730","646",2022-11-10 02:15:00,984,985,1,115,TRUE,NA,"0.1.4"
"6731","646",2022-11-10 02:30:00,984,985,1,115,TRUE,NA,"0.1.4"
"6732","646",2022-11-10 02:45:00,984,985,1,115,TRUE,NA,"0.1.4"
"6733","646",2022-11-10 03:00:00,984,985,1,115,TRUE,NA,"0.1.4"
"6734","646",2022-11-10 03:15:00,984,985,1,115,TRUE,NA,"0.1.4"
"6735","646",2022-11-10 03:30:00,984,985,1,115,TRUE,NA,"0.1.4"
"6736","646",2022-11-10 03:45:00,984,985,1,115,TRUE,NA,"0.1.4"
"6737","646",2022-11-10 04:00:00,984,985,1,115,TRUE,NA,"0.1.4"
"6738","646",2022-11-10 04:15:00,984,985,1,115,TRUE,NA,"0.1.4"
"6739","646",2022-11-10 04:30:00,984,985,1,115,TRUE,NA,"0.1.4"
"6740","646",2022-11-10 04:45:00,984,985,1,115,TRUE,NA,"0.1.4"
"6741","646",2022-11-10 05:00:00,984,985,1,115,TRUE,NA,"0.1.4"
"6742","646",2022-11-10 05:15:00,984,985,1,115,TRUE,NA,"0.1.4"
"6743","646",2022-11-10 05:30:00,984,985,1,115,TRUE,NA,"0.1.4"
"6744","646",2022-11-10 05:45:00,984,985,1,115,TRUE,NA,"0.1.4"
"6745","646",2022-11-10 06:00:00,984,985,1,115,TRUE,NA,"0.1.4"
"6746","646",2022-11-10 06:15:00,984,985,1,115,TRUE,NA,"0.1.4"
"6747","646",2022-11-10 06:30:00,984,985,1,115,TRUE,NA,"0.1.4"
"6748","646",2022-11-10 06:45:00,984,985,1,115,TRUE,NA,"0.1.4"
"6749","646",2022-11-10 07:00:00,984,985,1,115,TRUE,NA,"0.1.4"
"6750","646",2022-11-10 07:15:00,984,985,1,115,TRUE,NA,"0.1.4"
"6751","646",2022-11-10 07:30:00,984,985,1,115,TRUE,NA,"0.1.4"
"6752","646",2022-11-10 07:45:00,984,985,1,115,TRUE,NA,"0.1.4"
"6753","646",2022-11-10 08:00:00,984,985,1,115,TRUE,NA,"0.1.4"
"6754","646",2022-11-10 08:15:00,984,985,1,115,TRUE,NA,"0.1.4"
"6755","646",2022-11-10 08:30:00,984,985,1,115,TRUE,NA,"0.1.4"
"6756","646",2022-11-10 08:45:00,984,985,1,115,TRUE,NA,"0.1.4"
"6757","646",2022-11-10 09:00:00,984,985,1,115,TRUE,NA,"0.1.4"
"6758","646",2022-11-10 09:15:00,984,985,1,115,TRUE,NA,"0.1.4"
"6759","646",2022-11-10 09:30:00,984,985,1,115,TRUE,NA,"0.1.4"
"6760","646",2022-11-10 09:45:00,984,985,1,115,TRUE,NA,"0.1.4"
"6761","646",2022-11-10 10:00:00,984,985,1,115,TRUE,NA,"0.1.4"
"6762","646",2022-11-10 10:15:00,984,985,1,115,TRUE,NA,"0.1.4"
"6763","646",2022-11-10 10:30:00,984,985,1,115,TRUE,NA,"0.1.4"
"6764","646",2022-11-10 10:45:00,984,985,1,115,TRUE,NA,"0.1.4"
"6765","646",2022-11-10 11:00:00,984,985,1,115,TRUE,NA,"0.1.4"
"6766","646",2022-11-10 11:15:00,984,985,1,115,TRUE,NA,"0.1.4"
"6767","646",2022-11-10 11:30:00,984,985,1,115,TRUE,NA,"0.1.4"
"6768","646",2022-11-10 11:45:00,984,985,1,115,TRUE,NA,"0.1.4"
"6769","646",2022-11-10 12:00:00,984,985,1,115,TRUE,NA,"0.1.4"
"6770","646",2022-11-10 12:15:00,984,985,1,115,TRUE,NA,"0.1.4"
"6771","646",2022-11-10 12:30:00,984,985,1,115,TRUE,NA,"0.1.4"
"6772","646",2022-11-10 12:45:00,984,985,1,115,TRUE,NA,"0.1.4"
"6773","646",2022-11-10 13:00:00,984,985,1,115,TRUE,NA,"0.1.4"
"6774","646",2022-11-10 13:15:00,985,985,0,115,TRUE,NA,"0.1.4"
"6775","646",2022-11-10 13:30:00,985,985,0,115,TRUE,NA,"0.1.4"
"6776","646",2022-11-10 13:45:00,985,985,0,115,TRUE,NA,"0.1.4"
"6777","646",2022-11-10 14:00:00,986,986,0,116,TRUE,NA,"0.1.4"
"6778","646",2022-11-10 14:15:00,985,986,1,116,TRUE,NA,"0.1.4"
"6779","646",2022-11-10 14:30:00,985,986,1,116,TRUE,NA,"0.1.4"
"6780","646",2022-11-10 14:45:00,985,986,1,116,TRUE,NA,"0.1.4"
"6781","646",2022-11-10 15:00:00,985,986,1,116,TRUE,NA,"0.1.4"
"6782","646",2022-11-10 15:15:00,985,986,1,116,TRUE,NA,"0.1.4"
"6783","646",2022-11-10 15:30:00,986,986,0,116,TRUE,NA,"0.1.4"
"6784","646",2022-11-10 15:45:00,985,986,1,116,TRUE,NA,"0.1.4"
"6785","646",2022-11-10 16:00:00,985,986,1,116,TRUE,NA,"0.1.4"
"6786","646",2022-11-10 16:15:00,985,986,1,116,TRUE,NA,"0.1.4"
"6787","646",2022-11-10 16:30:00,985,986,1,116,TRUE,NA,"0.1.4"
"6788","646",2022-11-10 16:45:00,985,986,1,116,TRUE,NA,"0.1.4"
"6789","646",2022-11-10 17:00:00,985,986,1,116,TRUE,NA,"0.1.4"
"6790","646",2022-11-10 17:15:00,985,986,1,116,TRUE,NA,"0.1.4"
"6791","646",2022-11-10 17:30:00,985,986,1,116,TRUE,NA,"0.1.4"
"6792","646",2022-11-10 17:45:00,985,986,1,116,TRUE,NA,"0.1.4"
"6793","646",2022-11-10 18:00:00,985,986,1,116,TRUE,NA,"0.1.4"
"6794","646",2022-11-10 18:15:00,985,986,1,116,TRUE,NA,"0.1.4"
"6795","646",2022-11-10 18:30:00,985,986,1,116,TRUE,NA,"0.1.4"
"6796","646",2022-11-10 18:45:00,985,986,1,116,TRUE,NA,"0.1.4"
"6797","646",2022-11-10 19:00:00,985,986,1,116,TRUE,NA,"0.1.4"
"6798","646",2022-11-10 19:15:00,985,986,1,116,TRUE,NA,"0.1.4"
"6799","646",2022-11-10 19:30:00,985,986,1,116,TRUE,NA,"0.1.4"
"6800","646",2022-11-10 19:45:00,985,986,1,116,TRUE,NA,"0.1.4"
"6801","646",2022-11-10 20:00:00,985,986,1,116,TRUE,NA,"0.1.4"
"6802","646",2022-11-10 20:15:00,985,986,1,116,TRUE,NA,"0.1.4"
"6803","646",2022-11-10 20:30:00,985,986,1,116,TRUE,NA,"0.1.4"
"6804","646",2022-11-10 20:45:00,985,986,1,116,TRUE,NA,"0.1.4"
"6805","646",2022-11-10 21:00:00,985,986,1,116,TRUE,NA,"0.1.4"
"6806","646",2022-11-10 21:15:00,985,986,1,116,TRUE,NA,"0.1.4"
"6807","646",2022-11-10 21:30:00,985,986,1,116,TRUE,NA,"0.1.4"
"6808","646",2022-11-10 21:45:00,985,986,1,116,TRUE,NA,"0.1.4"
"6809","646",2022-11-10 22:00:00,985,986,1,116,TRUE,NA,"0.1.4"
"6810","646",2022-11-10 22:15:00,985,986,1,116,TRUE,NA,"0.1.4"
"6811","646",2022-11-10 22:30:00,985,986,1,116,TRUE,NA,"0.1.4"
"6812","646",2022-11-10 22:45:00,985,986,1,116,TRUE,NA,"0.1.4"
"6813","646",2022-11-10 23:00:00,985,986,1,116,TRUE,NA,"0.1.4"
"6814","646",2022-11-10 23:15:00,985,986,1,116,TRUE,NA,"0.1.4"
"6815","646",2022-11-10 23:30:00,985,986,1,116,TRUE,NA,"0.1.4"
"6816","646",2022-11-10 23:45:00,985,986,1,116,TRUE,NA,"0.1.4"
"6817","646",2022-11-11,985,986,1,116,TRUE,NA,"0.1.4"
"6818","646",2022-11-11 00:15:00,985,986,1,116,TRUE,NA,"0.1.4"
"6819","646",2022-11-11 00:30:00,985,986,1,116,TRUE,NA,"0.1.4"
"6820","646",2022-11-11 00:45:00,985,986,1,116,TRUE,NA,"0.1.4"
"6821","646",2022-11-11 01:00:00,985,986,1,116,TRUE,NA,"0.1.4"
"6822","646",2022-11-11 01:15:00,985,986,1,116,TRUE,NA,"0.1.4"
"6823","646",2022-11-11 01:30:00,985,986,1,116,TRUE,NA,"0.1.4"
"6824","646",2022-11-11 01:45:00,985,986,1,116,TRUE,NA,"0.1.4"
"6825","646",2022-11-11 02:00:00,985,986,1,116,TRUE,NA,"0.1.4"
"6826","646",2022-11-11 02:15:00,985,986,1,116,TRUE,NA,"0.1.4"
"6827","646",2022-11-11 02:30:00,985,986,1,116,TRUE,NA,"0.1.4"
"6828","646",2022-11-11 02:45:00,985,986,1,116,TRUE,NA,"0.1.4"
"6829","646",2022-11-11 03:00:00,985,986,1,116,TRUE,NA,"0.1.4"
"6830","646",2022-11-11 03:15:00,985,986,1,116,TRUE,NA,"0.1.4"
"6831","646",2022-11-11 03:30:00,985,986,1,116,TRUE,NA,"0.1.4"
"6832","646",2022-11-11 03:45:00,985,986,1,116,TRUE,NA,"0.1.4"
"6833","646",2022-11-11 04:00:00,985,986,1,116,TRUE,NA,"0.1.4"
"6834","646",2022-11-11 04:15:00,985,986,1,116,TRUE,NA,"0.1.4"
"6835","646",2022-11-11 04:30:00,985,986,1,116,TRUE,NA,"0.1.4"
"6836","646",2022-11-11 04:45:00,985,986,1,116,TRUE,NA,"0.1.4"
"6837","646",2022-11-11 05:00:00,985,986,1,116,TRUE,NA,"0.1.4"
"6838","646",2022-11-11 05:15:00,985,986,1,116,TRUE,NA,"0.1.4"
"6839","646",2022-11-11 05:30:00,985,986,1,116,TRUE,NA,"0.1.4"
"6840","646",2022-11-11 05:45:00,985,986,1,116,TRUE,NA,"0.1.4"
"6841","646",2022-11-11 06:00:00,985,986,1,116,TRUE,NA,"0.1.4"
"6842","646",2022-11-11 06:15:00,985,986,1,116,TRUE,NA,"0.1.4"
"6843","646",2022-11-11 06:30:00,985,986,1,116,TRUE,NA,"0.1.4"
"6844","646",2022-11-11 06:45:00,985,986,1,116,TRUE,NA,"0.1.4"
"6845","646",2022-11-11 07:00:00,985,986,1,116,TRUE,NA,"0.1.4"
"6846","646",2022-11-11 07:15:00,985,986,1,116,TRUE,NA,"0.1.4"
"6847","646",2022-11-11 07:30:00,985,986,1,116,TRUE,NA,"0.1.4"
"6848","646",2022-11-11 07:45:00,985,986,1,116,TRUE,NA,"0.1.4"
"6849","646",2022-11-11 08:00:00,985,986,1,116,TRUE,NA,"0.1.4"
"6850","646",2022-11-11 08:15:00,985,986,1,116,TRUE,NA,"0.1.4"
"6851","646",2022-11-11 08:30:00,985,986,1,116,TRUE,NA,"0.1.4"
"6852","646",2022-11-11 08:45:00,985,986,1,116,TRUE,NA,"0.1.4"
"6853","646",2022-11-11 09:00:00,985,986,1,116,TRUE,NA,"0.1.4"
"6854","646",2022-11-11 09:15:00,985,986,1,116,TRUE,NA,"0.1.4"
"6855","646",2022-11-11 09:30:00,985,986,1,116,TRUE,NA,"0.1.4"
"6856","646",2022-11-11 09:45:00,985,986,1,116,TRUE,NA,"0.1.4"
"6857","646",2022-11-11 10:00:00,985,986,1,116,TRUE,NA,"0.1.4"
"6858","646",2022-11-11 10:15:00,985,986,1,116,TRUE,NA,"0.1.4"
"6859","646",2022-11-11 10:30:00,985,986,1,116,TRUE,NA,"0.1.4"
"6860","646",2022-11-11 10:45:00,985,986,1,116,TRUE,NA,"0.1.4"
"6861","646",2022-11-11 11:00:00,985,986,1,116,TRUE,NA,"0.1.4"
"6862","646",2022-11-11 11:15:00,985,986,1,116,TRUE,NA,"0.1.4"
"6863","646",2022-11-11 11:30:00,985,986,1,116,TRUE,NA,"0.1.4"
"6864","646",2022-11-11 11:45:00,985,986,1,116,TRUE,NA,"0.1.4"
"6865","646",2022-11-11 12:00:00,985,986,1,116,TRUE,NA,"0.1.4"
"6866","646",2022-11-11 12:15:00,985,986,1,116,TRUE,NA,"0.1.4"
"6867","646",2022-11-11 12:30:00,985,986,1,116,TRUE,NA,"0.1.4"
"6868","646",2022-11-11 12:45:00,985,986,1,116,TRUE,NA,"0.1.4"
"6869","646",2022-11-11 13:00:00,985,986,1,116,TRUE,NA,"0.1.4"
"6870","646",2022-11-11 13:15:00,985,986,1,116,TRUE,NA,"0.1.4"
"6871","646",2022-11-11 13:30:00,985,986,1,116,TRUE,NA,"0.1.4"
"6872","646",2022-11-11 13:45:00,985,986,1,116,TRUE,NA,"0.1.4"
"6873","646",2022-11-11 14:00:00,985,986,1,116,TRUE,NA,"0.1.4"
"6874","646",2022-11-11 14:15:00,985,986,1,116,TRUE,NA,"0.1.4"
"6875","646",2022-11-11 14:30:00,985,986,1,116,TRUE,NA,"0.1.4"
"6876","646",2022-11-11 14:45:00,985,986,1,116,TRUE,NA,"0.1.4"
"6877","646",2022-11-11 15:00:00,985,986,1,116,TRUE,NA,"0.1.4"
"6878","646",2022-11-11 15:15:00,985,986,1,116,TRUE,NA,"0.1.4"
"6879","646",2022-11-11 15:30:00,985,986,1,116,TRUE,NA,"0.1.4"
"6880","646",2022-11-11 15:45:00,985,986,1,116,TRUE,NA,"0.1.4"
"6881","646",2022-11-11 16:00:00,985,986,1,116,TRUE,NA,"0.1.4"
"6882","646",2022-11-11 16:15:00,985,986,1,116,TRUE,NA,"0.1.4"
"6883","646",2022-11-11 16:30:00,985,986,1,116,TRUE,NA,"0.1.4"
"6884","646",2022-11-11 16:45:00,985,986,1,116,TRUE,NA,"0.1.4"
"6885","646",2022-11-11 17:00:00,985,986,1,116,TRUE,NA,"0.1.4"
"6886","646",2022-11-11 17:15:00,985,986,1,116,TRUE,NA,"0.1.4"
"6887","646",2022-11-11 17:30:00,985,986,1,116,TRUE,NA,"0.1.4"
"6888","646",2022-11-11 17:45:00,985,986,1,116,TRUE,NA,"0.1.4"
"6889","646",2022-11-11 18:00:00,985,986,1,116,TRUE,NA,"0.1.4"
"6890","646",2022-11-11 18:15:00,985,986,1,116,TRUE,NA,"0.1.4"
"6891","646",2022-11-11 18:30:00,985,986,1,116,TRUE,NA,"0.1.4"
"6892","646",2022-11-11 18:45:00,985,986,1,116,TRUE,NA,"0.1.4"
"6893","646",2022-11-11 19:00:00,985,986,1,116,TRUE,NA,"0.1.4"
"6894","646",2022-11-11 19:15:00,985,986,1,116,TRUE,NA,"0.1.4"
"6895","646",2022-11-11 19:30:00,985,986,1,116,TRUE,NA,"0.1.4"
"6896","646",2022-11-11 19:45:00,985,986,1,116,TRUE,NA,"0.1.4"
"6897","646",2022-11-11 20:00:00,985,986,1,116,TRUE,NA,"0.1.4"
"6898","646",2022-11-11 20:15:00,985,986,1,116,TRUE,NA,"0.1.4"
"6899","646",2022-11-11 20:30:00,985,986,1,116,TRUE,NA,"0.1.4"
"6900","646",2022-11-11 20:45:00,985,986,1,116,TRUE,NA,"0.1.4"
"6901","646",2022-11-11 21:00:00,985,986,1,116,TRUE,NA,"0.1.4"
"6902","646",2022-11-11 21:15:00,985,986,1,116,TRUE,NA,"0.1.4"
"6903","646",2022-11-11 21:30:00,985,986,1,116,TRUE,NA,"0.1.4"
"6904","646",2022-11-11 21:45:00,986,986,0,116,TRUE,NA,"0.1.4"
"6905","646",2022-11-11 22:00:00,985,986,1,116,TRUE,NA,"0.1.4"
"6906","646",2022-11-11 22:15:00,985,986,1,116,FALSE,NA,"0.1.4"
"6907","646",2022-11-11 22:30:00,985,986,1,116,FALSE,NA,"0.1.4"
"6908","646",2022-11-11 22:45:00,985,986,1,116,FALSE,NA,"0.1.4"
"6909","646",2022-11-11 23:00:00,985,986,1,116,TRUE,NA,"0.1.4"
"6910","646",2022-11-11 23:15:00,985,986,1,116,TRUE,NA,"0.1.4"
"6911","646",2022-11-11 23:30:00,985,986,1,116,TRUE,NA,"0.1.4"
"6912","646",2022-11-11 23:45:00,985,986,1,116,TRUE,NA,"0.1.4"
"6913","646",2022-11-12,985,986,1,116,TRUE,NA,"0.1.4"
"6914","646",2022-11-12 00:15:00,985,986,1,116,TRUE,NA,"0.1.4"
"6915","646",2022-11-12 00:30:00,985,986,1,116,TRUE,NA,"0.1.4"
"6916","646",2022-11-12 00:45:00,985,986,1,116,TRUE,NA,"0.1.4"
"6917","646",2022-11-12 01:00:00,985,986,1,116,TRUE,NA,"0.1.4"
"6918","646",2022-11-12 01:15:00,985,986,1,116,TRUE,NA,"0.1.4"
"6919","646",2022-11-12 01:30:00,985,986,1,116,TRUE,NA,"0.1.4"
"6920","646",2022-11-12 01:45:00,985,986,1,116,TRUE,NA,"0.1.4"
"6921","646",2022-11-12 02:00:00,985,986,1,116,TRUE,NA,"0.1.4"
"6922","646",2022-11-12 02:15:00,985,986,1,116,TRUE,NA,"0.1.4"
"6923","646",2022-11-12 02:30:00,985,986,1,116,TRUE,NA,"0.1.4"
"6924","646",2022-11-12 02:45:00,985,986,1,116,TRUE,NA,"0.1.4"
"6925","646",2022-11-12 03:00:00,985,986,1,116,TRUE,NA,"0.1.4"
"6926","646",2022-11-12 03:15:00,985,986,1,116,TRUE,NA,"0.1.4"
"6927","646",2022-11-12 03:30:00,985,986,1,116,TRUE,NA,"0.1.4"
"6928","646",2022-11-12 03:45:00,985,986,1,116,TRUE,NA,"0.1.4"
"6929","646",2022-11-12 04:00:00,985,986,1,116,TRUE,NA,"0.1.4"
"6930","646",2022-11-12 04:15:00,985,986,1,116,TRUE,NA,"0.1.4"
"6931","646",2022-11-12 04:30:00,985,986,1,116,TRUE,NA,"0.1.4"
"6932","646",2022-11-12 04:45:00,985,986,1,116,TRUE,NA,"0.1.4"
"6933","646",2022-11-12 05:00:00,985,986,1,116,TRUE,NA,"0.1.4"
"6934","646",2022-11-12 05:15:00,985,986,1,116,TRUE,NA,"0.1.4"
"6935","646",2022-11-12 05:30:00,985,986,1,116,TRUE,NA,"0.1.4"
"6936","646",2022-11-12 05:45:00,985,986,1,116,TRUE,NA,"0.1.4"
"6937","646",2022-11-12 06:00:00,985,986,1,116,TRUE,NA,"0.1.4"
"6938","646",2022-11-12 06:15:00,985,986,1,116,TRUE,NA,"0.1.4"
"6939","646",2022-11-12 06:30:00,985,986,1,116,TRUE,NA,"0.1.4"
"6940","646",2022-11-12 06:45:00,985,986,1,116,TRUE,NA,"0.1.4"
"6941","646",2022-11-12 07:00:00,985,986,1,116,TRUE,NA,"0.1.4"
"6942","646",2022-11-12 07:15:00,985,986,1,116,TRUE,NA,"0.1.4"
"6943","646",2022-11-12 07:30:00,985,986,1,116,TRUE,NA,"0.1.4"
"6944","646",2022-11-12 07:45:00,985,986,1,116,TRUE,NA,"0.1.4"
"6945","646",2022-11-12 08:00:00,985,986,1,116,TRUE,NA,"0.1.4"
"6946","646",2022-11-12 08:15:00,985,986,1,116,TRUE,NA,"0.1.4"
"6947","646",2022-11-12 08:30:00,985,986,1,116,TRUE,NA,"0.1.4"
"6948","646",2022-11-12 08:45:00,985,986,1,116,TRUE,NA,"0.1.4"
"6949","646",2022-11-12 09:00:00,985,986,1,116,TRUE,NA,"0.1.4"
"6950","646",2022-11-12 09:15:00,985,986,1,116,TRUE,NA,"0.1.4"
"6951","646",2022-11-12 09:30:00,985,986,1,116,TRUE,NA,"0.1.4"
"6952","646",2022-11-12 09:45:00,985,986,1,116,TRUE,NA,"0.1.4"
"6953","646",2022-11-12 10:00:00,985,986,1,116,TRUE,NA,"0.1.4"
"6954","646",2022-11-12 10:15:00,985,986,1,116,TRUE,NA,"0.1.4"
"6955","646",2022-11-12 10:30:00,985,986,1,116,TRUE,NA,"0.1.4"
"6956","646",2022-11-12 10:45:00,985,986,1,116,TRUE,NA,"0.1.4"
"6957","646",2022-11-12 11:00:00,985,986,1,116,TRUE,NA,"0.1.4"
"6958","646",2022-11-12 11:15:00,985,986,1,116,TRUE,NA,"0.1.4"
"6959","646",2022-11-12 11:30:00,985,986,1,116,TRUE,NA,"0.1.4"
"6960","646",2022-11-12 11:45:00,985,986,1,116,TRUE,NA,"0.1.4"
"6961","646",2022-11-12 12:00:00,985,986,1,116,TRUE,NA,"0.1.4"
"6962","646",2022-11-12 12:15:00,985,986,1,116,TRUE,NA,"0.1.4"
"6963","646",2022-11-12 12:30:00,985,986,1,116,TRUE,NA,"0.1.4"
"6964","646",2022-11-12 12:45:00,985,986,1,116,TRUE,NA,"0.1.4"
"6965","646",2022-11-12 13:00:00,985,986,1,116,TRUE,NA,"0.1.4"
"6966","646",2022-11-12 13:15:00,985,986,1,116,TRUE,NA,"0.1.4"
"6967","646",2022-11-12 13:30:00,985,986,1,116,TRUE,NA,"0.1.4"
"6968","646",2022-11-12 13:45:00,985,986,1,116,TRUE,NA,"0.1.4"
"6969","646",2022-11-12 14:00:00,985,986,1,116,TRUE,NA,"0.1.4"
"6970","646",2022-11-12 14:15:00,985,986,1,116,TRUE,NA,"0.1.4"
"6971","646",2022-11-12 14:30:00,985,986,1,116,TRUE,NA,"0.1.4"
"6972","646",2022-11-12 14:45:00,985,986,1,116,TRUE,NA,"0.1.4"
"6973","646",2022-11-12 15:00:00,985,986,1,116,TRUE,NA,"0.1.4"
"6974","646",2022-11-12 15:15:00,985,986,1,116,TRUE,NA,"0.1.4"
"6975","646",2022-11-12 15:30:00,985,986,1,116,TRUE,NA,"0.1.4"
"6976","646",2022-11-12 15:45:00,985,986,1,116,TRUE,NA,"0.1.4"
"6977","646",2022-11-12 16:00:00,985,986,1,116,TRUE,NA,"0.1.4"
"6978","646",2022-11-12 16:15:00,985,986,1,116,TRUE,NA,"0.1.4"
"6979","646",2022-11-12 16:30:00,985,986,1,116,TRUE,NA,"0.1.4"
"6980","646",2022-11-12 16:45:00,985,986,1,116,TRUE,NA,"0.1.4"
"6981","646",2022-11-12 17:00:00,985,986,1,116,TRUE,NA,"0.1.4"
"6982","646",2022-11-12 17:15:00,985,986,1,116,TRUE,NA,"0.1.4"
"6983","646",2022-11-12 17:30:00,985,986,1,116,TRUE,NA,"0.1.4"
"6984","646",2022-11-12 17:45:00,985,986,1,116,TRUE,NA,"0.1.4"
"6985","646",2022-11-12 18:00:00,985,986,1,116,TRUE,NA,"0.1.4"
"6986","646",2022-11-12 18:15:00,985,986,1,116,TRUE,NA,"0.1.4"
"6987","646",2022-11-12 18:30:00,985,986,1,116,TRUE,NA,"0.1.4"
"6988","646",2022-11-12 18:45:00,985,986,1,116,TRUE,NA,"0.1.4"
"6989","646",2022-11-12 19:00:00,985,986,1,116,TRUE,NA,"0.1.4"
"6990","646",2022-11-12 19:15:00,985,986,1,116,TRUE,NA,"0.1.4"
"6991","646",2022-11-12 19:30:00,985,986,1,116,TRUE,NA,"0.1.4"
"6992","646",2022-11-12 19:45:00,985,986,1,116,TRUE,NA,"0.1.4"
"6993","646",2022-11-12 20:00:00,985,986,1,116,TRUE,NA,"0.1.4"
"6994","646",2022-11-12 20:15:00,985,986,1,116,TRUE,NA,"0.1.4"
"6995","646",2022-11-12 20:30:00,985,986,1,116,TRUE,NA,"0.1.4"
"6996","646",2022-11-12 20:45:00,985,986,1,116,TRUE,NA,"0.1.4"
"6997","646",2022-11-12 21:00:00,985,986,1,116,TRUE,NA,"0.1.4"
"6998","646",2022-11-12 21:15:00,985,986,1,116,TRUE,NA,"0.1.4"
"6999","646",2022-11-12 21:30:00,985,986,1,116,TRUE,NA,"0.1.4"
"7000","646",2022-11-12 21:45:00,985,986,1,116,TRUE,NA,"0.1.4"
"7001","646",2022-11-12 22:00:00,985,986,1,116,TRUE,NA,"0.1.4"
"7002","646",2022-11-12 22:15:00,985,986,1,116,TRUE,NA,"0.1.4"
"7003","646",2022-11-12 22:30:00,985,986,1,116,TRUE,NA,"0.1.4"
"7004","646",2022-11-12 22:45:00,985,986,1,116,TRUE,NA,"0.1.4"
"7005","646",2022-11-12 23:00:00,985,986,1,116,TRUE,NA,"0.1.4"
"7006","646",2022-11-12 23:15:00,985,986,1,116,TRUE,NA,"0.1.4"
"7007","646",2022-11-12 23:30:00,985,986,1,116,TRUE,NA,"0.1.4"
"7008","646",2022-11-12 23:45:00,985,986,1,116,TRUE,NA,"0.1.4"
"7009","646",2022-11-13,985,986,1,116,TRUE,NA,"0.1.4"
"7010","646",2022-11-13 00:15:00,985,986,1,116,TRUE,NA,"0.1.4"
"7011","646",2022-11-13 00:30:00,985,986,1,116,TRUE,NA,"0.1.4"
"7012","646",2022-11-13 00:45:00,985,986,1,116,TRUE,NA,"0.1.4"
"7013","646",2022-11-13 01:00:00,985,986,1,116,TRUE,NA,"0.1.4"
"7014","646",2022-11-13 01:15:00,985,986,1,116,TRUE,NA,"0.1.4"
"7015","646",2022-11-13 01:30:00,985,986,1,116,TRUE,NA,"0.1.4"
"7016","646",2022-11-13 01:45:00,985,986,1,116,TRUE,NA,"0.1.4"
"7017","646",2022-11-13 02:00:00,985,986,1,116,TRUE,NA,"0.1.4"
"7018","646",2022-11-13 02:15:00,985,986,1,116,TRUE,NA,"0.1.4"
"7019","646",2022-11-13 02:30:00,985,986,1,116,TRUE,NA,"0.1.4"
"7020","646",2022-11-13 02:45:00,985,986,1,116,TRUE,NA,"0.1.4"
"7021","646",2022-11-13 03:00:00,985,986,1,116,TRUE,NA,"0.1.4"
"7022","646",2022-11-13 03:15:00,985,986,1,116,TRUE,NA,"0.1.4"
"7023","646",2022-11-13 03:30:00,985,986,1,116,TRUE,NA,"0.1.4"
"7024","646",2022-11-13 03:45:00,985,986,1,116,TRUE,NA,"0.1.4"
"7025","646",2022-11-13 04:00:00,985,986,1,116,TRUE,NA,"0.1.4"
"7026","646",2022-11-13 04:15:00,985,986,1,116,TRUE,NA,"0.1.4"
"7027","646",2022-11-13 04:30:00,985,986,1,116,TRUE,NA,"0.1.4"
"7028","646",2022-11-13 04:45:00,985,986,1,116,TRUE,NA,"0.1.4"
"7029","646",2022-11-13 05:00:00,985,986,1,116,TRUE,NA,"0.1.4"
"7030","646",2022-11-13 05:15:00,985,986,1,116,TRUE,NA,"0.1.4"
"7031","646",2022-11-13 05:30:00,985,986,1,116,TRUE,NA,"0.1.4"
"7032","646",2022-11-13 05:45:00,985,986,1,116,TRUE,NA,"0.1.4"
"7033","646",2022-11-13 06:00:00,985,986,1,116,TRUE,NA,"0.1.4"
"7034","646",2022-11-13 06:15:00,985,986,1,116,TRUE,NA,"0.1.4"
"7035","646",2022-11-13 06:30:00,985,986,1,116,TRUE,NA,"0.1.4"
"7036","646",2022-11-13 06:45:00,985,986,1,116,TRUE,NA,"0.1.4"
"7037","646",2022-11-13 07:00:00,985,986,1,116,TRUE,NA,"0.1.4"
"7038","646",2022-11-13 07:15:00,985,986,1,116,TRUE,NA,"0.1.4"
"7039","646",2022-11-13 07:30:00,985,986,1,116,TRUE,NA,"0.1.4"
"7040","646",2022-11-13 07:45:00,985,986,1,116,TRUE,NA,"0.1.4"
"7041","646",2022-11-13 08:00:00,985,986,1,116,TRUE,NA,"0.1.4"
"7042","646",2022-11-13 08:15:00,985,986,1,116,TRUE,NA,"0.1.4"
"7043","646",2022-11-13 08:30:00,985,986,1,116,TRUE,NA,"0.1.4"
"7044","646",2022-11-13 08:45:00,985,986,1,116,TRUE,NA,"0.1.4"
"7045","646",2022-11-13 09:00:00,985,986,1,116,TRUE,NA,"0.1.4"
"7046","646",2022-11-13 09:15:00,985,986,1,116,TRUE,NA,"0.1.4"
"7047","646",2022-11-13 09:30:00,985,986,1,116,TRUE,NA,"0.1.4"
"7048","646",2022-11-13 09:45:00,985,986,1,116,TRUE,NA,"0.1.4"
"7049","646",2022-11-13 10:00:00,985,986,1,116,TRUE,NA,"0.1.4"
"7050","646",2022-11-13 10:15:00,985,986,1,116,TRUE,NA,"0.1.4"
"7051","646",2022-11-13 10:30:00,985,986,1,116,TRUE,NA,"0.1.4"
"7052","646",2022-11-13 10:45:00,985,986,1,116,TRUE,NA,"0.1.4"
"7053","646",2022-11-13 11:00:00,985,986,1,116,TRUE,NA,"0.1.4"
"7054","646",2022-11-13 11:15:00,985,986,1,116,TRUE,NA,"0.1.4"
"7055","646",2022-11-13 11:30:00,985,986,1,116,TRUE,NA,"0.1.4"
"7056","646",2022-11-13 11:45:00,985,986,1,116,TRUE,NA,"0.1.4"
"7057","646",2022-11-13 12:00:00,985,986,1,116,TRUE,NA,"0.1.4"
"7058","646",2022-11-13 12:15:00,985,986,1,116,TRUE,NA,"0.1.4"
"7059","646",2022-11-13 12:30:00,985,986,1,116,TRUE,NA,"0.1.4"
"7060","646",2022-11-13 12:45:00,985,986,1,116,TRUE,NA,"0.1.4"
"7061","646",2022-11-13 13:00:00,985,986,1,116,TRUE,NA,"0.1.4"
"7062","646",2022-11-13 13:15:00,985,986,1,116,TRUE,NA,"0.1.4"
"7063","646",2022-11-13 13:30:00,985,986,1,116,TRUE,NA,"0.1.4"
"7064","646",2022-11-13 13:45:00,985,986,1,116,TRUE,NA,"0.1.4"
"7065","646",2022-11-13 14:00:00,985,986,1,116,TRUE,NA,"0.1.4"
"7066","646",2022-11-13 14:15:00,985,986,1,116,TRUE,NA,"0.1.4"
"7067","646",2022-11-13 14:30:00,985,986,1,116,TRUE,NA,"0.1.4"
"7068","646",2022-11-13 14:45:00,985,986,1,116,TRUE,NA,"0.1.4"
"7069","646",2022-11-13 15:00:00,985,986,1,116,TRUE,NA,"0.1.4"
"7070","646",2022-11-13 15:15:00,985,986,1,116,TRUE,NA,"0.1.4"
"7071","646",2022-11-13 15:30:00,985,986,1,116,TRUE,NA,"0.1.4"
"7072","646",2022-11-13 15:45:00,985,986,1,116,TRUE,NA,"0.1.4"
"7073","646",2022-11-13 16:00:00,985,986,1,116,TRUE,NA,"0.1.4"
"7074","646",2022-11-13 16:15:00,985,986,1,116,TRUE,NA,"0.1.4"
"7075","646",2022-11-13 16:30:00,985,986,1,116,TRUE,NA,"0.1.4"
"7076","646",2022-11-13 16:45:00,985,986,1,116,TRUE,NA,"0.1.4"
"7077","646",2022-11-13 17:00:00,985,986,1,116,TRUE,NA,"0.1.4"
"7078","646",2022-11-13 17:15:00,985,986,1,116,TRUE,NA,"0.1.4"
"7079","646",2022-11-13 17:30:00,985,986,1,116,TRUE,NA,"0.1.4"
"7080","646",2022-11-13 17:45:00,985,986,1,116,TRUE,NA,"0.1.4"
"7081","646",2022-11-13 18:00:00,985,986,1,116,TRUE,NA,"0.1.4"
"7082","646",2022-11-13 18:15:00,985,986,1,116,TRUE,NA,"0.1.4"
"7083","646",2022-11-13 18:30:00,985,986,1,116,TRUE,NA,"0.1.4"
"7084","646",2022-11-13 18:45:00,985,986,1,116,TRUE,NA,"0.1.4"
"7085","646",2022-11-13 19:00:00,985,986,1,116,TRUE,NA,"0.1.4"
"7086","646",2022-11-13 19:15:00,985,986,1,116,TRUE,NA,"0.1.4"
"7087","646",2022-11-13 19:30:00,985,986,1,116,TRUE,NA,"0.1.4"
"7088","646",2022-11-13 19:45:00,985,986,1,116,TRUE,NA,"0.1.4"
"7089","646",2022-11-13 20:00:00,985,986,1,116,TRUE,NA,"0.1.4"
"7090","646",2022-11-13 20:15:00,985,986,1,116,TRUE,NA,"0.1.4"
"7091","646",2022-11-13 20:30:00,985,986,1,116,TRUE,NA,"0.1.4"
"7092","646",2022-11-13 20:45:00,985,986,1,116,TRUE,NA,"0.1.4"
"7093","646",2022-11-13 21:00:00,985,986,1,116,TRUE,NA,"0.1.4"
"7094","646",2022-11-13 21:15:00,985,986,1,116,TRUE,NA,"0.1.4"
"7095","646",2022-11-13 21:30:00,985,986,1,116,TRUE,NA,"0.1.4"
"7096","646",2022-11-13 21:45:00,985,986,1,116,TRUE,NA,"0.1.4"
"7097","646",2022-11-13 22:00:00,985,986,1,116,TRUE,NA,"0.1.4"
"7098","646",2022-11-13 22:15:00,985,986,1,116,TRUE,NA,"0.1.4"
"7099","646",2022-11-13 22:30:00,985,986,1,116,TRUE,NA,"0.1.4"
"7100","646",2022-11-13 22:45:00,985,986,1,116,TRUE,NA,"0.1.4"
"7101","646",2022-11-13 23:00:00,985,986,1,116,TRUE,NA,"0.1.4"
"7102","646",2022-11-13 23:15:00,985,986,1,116,TRUE,NA,"0.1.4"
"7103","646",2022-11-13 23:30:00,985,986,1,116,TRUE,NA,"0.1.4"
"7104","646",2022-11-13 23:45:00,985,986,1,116,TRUE,NA,"0.1.4"
"7105","646",2022-11-14,985,986,1,116,TRUE,NA,"0.1.4"
"7106","646",2022-11-14 00:15:00,985,986,1,116,TRUE,NA,"0.1.4"
"7107","646",2022-11-14 00:30:00,985,986,1,116,TRUE,NA,"0.1.4"
"7108","646",2022-11-14 00:45:00,985,986,1,116,TRUE,NA,"0.1.4"
"7109","646",2022-11-14 01:00:00,985,986,1,116,TRUE,NA,"0.1.4"
"7110","646",2022-11-14 01:15:00,985,986,1,116,TRUE,NA,"0.1.4"
"7111","646",2022-11-14 01:30:00,985,986,1,116,TRUE,NA,"0.1.4"
"7112","646",2022-11-14 01:45:00,985,986,1,116,TRUE,NA,"0.1.4"
"7113","646",2022-11-14 02:00:00,985,986,1,116,TRUE,NA,"0.1.4"
"7114","646",2022-11-14 02:15:00,985,986,1,116,TRUE,NA,"0.1.4"
"7115","646",2022-11-14 02:30:00,985,986,1,116,TRUE,NA,"0.1.4"
"7116","646",2022-11-14 02:45:00,985,986,1,116,TRUE,NA,"0.1.4"
"7117","646",2022-11-14 03:00:00,985,986,1,116,TRUE,NA,"0.1.4"
"7118","646",2022-11-14 03:15:00,985,986,1,116,TRUE,NA,"0.1.4"
"7119","646",2022-11-14 03:30:00,985,986,1,116,TRUE,NA,"0.1.4"
"7120","646",2022-11-14 03:45:00,985,986,1,116,TRUE,NA,"0.1.4"
"7121","646",2022-11-14 04:00:00,985,986,1,116,TRUE,NA,"0.1.4"
"7122","646",2022-11-14 04:15:00,985,986,1,116,TRUE,NA,"0.1.4"
"7123","646",2022-11-14 04:30:00,985,986,1,116,TRUE,NA,"0.1.4"
"7124","646",2022-11-14 04:45:00,985,986,1,116,TRUE,NA,"0.1.4"
"7125","646",2022-11-14 05:00:00,985,986,1,116,TRUE,NA,"0.1.4"
"7126","646",2022-11-14 05:15:00,985,986,1,116,TRUE,NA,"0.1.4"
"7127","646",2022-11-14 05:30:00,985,986,1,116,TRUE,NA,"0.1.4"
"7128","646",2022-11-14 05:45:00,985,986,1,116,TRUE,NA,"0.1.4"
"7129","646",2022-11-14 06:00:00,985,986,1,116,TRUE,NA,"0.1.4"
"7130","646",2022-11-14 06:15:00,985,986,1,116,TRUE,NA,"0.1.4"
"7131","646",2022-11-14 06:30:00,985,986,1,116,TRUE,NA,"0.1.4"
"7132","646",2022-11-14 06:45:00,985,986,1,116,TRUE,NA,"0.1.4"
"7133","646",2022-11-14 07:00:00,985,986,1,116,TRUE,NA,"0.1.4"
"7134","646",2022-11-14 07:15:00,985,986,1,116,TRUE,NA,"0.1.4"
"7135","646",2022-11-14 07:30:00,985,986,1,116,TRUE,NA,"0.1.4"
"7136","646",2022-11-14 07:45:00,985,986,1,116,TRUE,NA,"0.1.4"
"7137","646",2022-11-14 08:00:00,985,986,1,116,TRUE,NA,"0.1.4"
"7138","646",2022-11-14 08:15:00,985,986,1,116,TRUE,NA,"0.1.4"
"7139","646",2022-11-14 08:30:00,985,986,1,116,TRUE,NA,"0.1.4"
"7140","646",2022-11-14 08:45:00,985,986,1,116,TRUE,NA,"0.1.4"
"7141","646",2022-11-14 09:00:00,985,986,1,116,TRUE,NA,"0.1.4"
"7142","646",2022-11-14 09:15:00,985,986,1,116,TRUE,NA,"0.1.4"
"7143","646",2022-11-14 09:30:00,985,986,1,116,TRUE,NA,"0.1.4"
"7144","646",2022-11-14 09:45:00,985,986,1,116,TRUE,NA,"0.1.4"
"7145","646",2022-11-14 10:00:00,985,986,1,116,TRUE,NA,"0.1.4"
"7146","646",2022-11-14 10:15:00,985,986,1,116,TRUE,NA,"0.1.4"
"7147","646",2022-11-14 10:30:00,985,986,1,116,TRUE,NA,"0.1.4"
"7148","646",2022-11-14 10:45:00,985,986,1,116,TRUE,NA,"0.1.4"
"7149","646",2022-11-14 11:00:00,985,986,1,116,TRUE,NA,"0.1.4"
"7150","646",2022-11-14 11:15:00,985,986,1,116,TRUE,NA,"0.1.4"
"7151","646",2022-11-14 11:30:00,985,986,1,116,TRUE,NA,"0.1.4"
"7152","646",2022-11-14 11:45:00,985,986,1,116,TRUE,NA,"0.1.4"
"7153","646",2022-11-14 12:00:00,985,986,1,116,TRUE,NA,"0.1.4"
"7154","646",2022-11-14 12:15:00,986,986,0,116,TRUE,NA,"0.1.4"
"7155","646",2022-11-14 12:30:00,986,986,0,116,TRUE,NA,"0.1.4"
"7156","646",2022-11-14 12:45:00,985,986,1,116,TRUE,NA,"0.1.4"
"7157","646",2022-11-14 13:00:00,985,986,1,116,TRUE,NA,"0.1.4"
"7158","646",2022-11-14 13:15:00,985,986,1,116,TRUE,NA,"0.1.4"
"7159","646",2022-11-14 13:30:00,985,986,1,116,TRUE,NA,"0.1.4"
"7160","646",2022-11-14 13:45:00,986,986,0,116,TRUE,NA,"0.1.4"
"7161","646",2022-11-14 14:00:00,986,986,0,116,TRUE,NA,"0.1.4"
"7162","646",2022-11-14 14:15:00,985,986,1,116,TRUE,NA,"0.1.4"
"7163","646",2022-11-14 14:30:00,985,986,1,116,TRUE,NA,"0.1.4"
"7164","646",2022-11-14 14:45:00,985,986,1,116,TRUE,NA,"0.1.4"
"7165","646",2022-11-14 15:00:00,985,986,1,116,TRUE,NA,"0.1.4"
"7166","646",2022-11-14 15:15:00,985,986,1,116,TRUE,NA,"0.1.4"
"7167","646",2022-11-14 15:30:00,985,986,1,116,TRUE,NA,"0.1.4"
"7168","646",2022-11-14 15:45:00,985,986,1,116,TRUE,NA,"0.1.4"
"7169","646",2022-11-14 16:00:00,985,986,1,116,TRUE,NA,"0.1.4"
"7170","646",2022-11-14 16:15:00,985,986,1,116,TRUE,NA,"0.1.4"
"7171","646",2022-11-14 16:30:00,985,986,1,116,TRUE,NA,"0.1.4"
"7172","646",2022-11-14 16:45:00,985,986,1,116,TRUE,NA,"0.1.4"
"7173","646",2022-11-14 17:00:00,985,986,1,116,TRUE,NA,"0.1.4"
"7174","646",2022-11-14 17:15:00,986,986,0,116,TRUE,NA,"0.1.4"
"7175","646",2022-11-14 17:30:00,986,986,0,116,TRUE,NA,"0.1.4"
"7176","646",2022-11-14 17:45:00,986,986,0,116,TRUE,NA,"0.1.4"
"7177","646",2022-11-14 18:00:00,985,986,1,116,TRUE,NA,"0.1.4"
"7178","646",2022-11-14 18:15:00,985,986,1,116,TRUE,NA,"0.1.4"
"7179","646",2022-11-14 18:30:00,985,986,1,116,TRUE,NA,"0.1.4"
"7180","646",2022-11-14 18:45:00,985,986,1,116,TRUE,NA,"0.1.4"
"7181","646",2022-11-14 19:00:00,985,986,1,116,TRUE,NA,"0.1.4"
"7182","646",2022-11-14 19:15:00,986,986,0,116,TRUE,NA,"0.1.4"
"7183","646",2022-11-14 19:30:00,985,986,1,116,TRUE,NA,"0.1.4"
"7184","646",2022-11-14 19:45:00,985,986,1,116,TRUE,NA,"0.1.4"
"7185","646",2022-11-14 20:00:00,986,986,0,116,TRUE,NA,"0.1.4"
"7186","646",2022-11-14 20:15:00,986,986,0,116,TRUE,NA,"0.1.4"
"7187","646",2022-11-14 20:30:00,986,986,0,116,TRUE,NA,"0.1.4"
"7188","646",2022-11-14 20:45:00,986,986,0,116,TRUE,NA,"0.1.4"
"7189","646",2022-11-14 21:00:00,986,986,0,116,TRUE,NA,"0.1.4"
"7190","646",2022-11-14 21:15:00,985,986,1,116,TRUE,NA,"0.1.4"
"7191","646",2022-11-14 21:30:00,986,986,0,116,TRUE,NA,"0.1.4"
"7192","646",2022-11-14 21:45:00,985,986,1,116,TRUE,NA,"0.1.4"
"7193","646",2022-11-14 22:00:00,985,986,1,116,TRUE,NA,"0.1.4"
"7194","646",2022-11-14 22:15:00,985,986,1,116,TRUE,NA,"0.1.4"
"7195","646",2022-11-14 22:30:00,985,986,1,116,TRUE,NA,"0.1.4"
"7196","646",2022-11-14 22:45:00,985,986,1,116,TRUE,NA,"0.1.4"
"7197","646",2022-11-14 23:00:00,985,986,1,116,TRUE,NA,"0.1.4"
"7198","646",2022-11-14 23:15:00,985,986,1,116,TRUE,NA,"0.1.4"
"7199","646",2022-11-14 23:30:00,985,986,1,116,TRUE,NA,"0.1.4"
"7200","646",2022-11-14 23:45:00,985,986,1,116,TRUE,NA,"0.1.4"
"7201","646",2022-11-15,985,986,1,116,TRUE,NA,"0.1.4"
"7202","646",2022-11-15 00:15:00,985,986,1,116,TRUE,NA,"0.1.4"
"7203","646",2022-11-15 00:30:00,985,986,1,116,TRUE,NA,"0.1.4"
"7204","646",2022-11-15 00:45:00,985,986,1,116,TRUE,NA,"0.1.4"
"7205","646",2022-11-15 01:00:00,985,986,1,116,TRUE,NA,"0.1.4"
"7206","646",2022-11-15 01:15:00,985,986,1,116,TRUE,NA,"0.1.4"
"7207","646",2022-11-15 01:30:00,985,986,1,116,TRUE,NA,"0.1.4"
"7208","646",2022-11-15 01:45:00,985,986,1,116,TRUE,NA,"0.1.4"
"7209","646",2022-11-15 02:00:00,985,986,1,116,TRUE,NA,"0.1.4"
"7210","646",2022-11-15 02:15:00,985,986,1,116,TRUE,NA,"0.1.4"
"7211","646",2022-11-15 02:30:00,985,986,1,116,TRUE,NA,"0.1.4"
"7212","646",2022-11-15 02:45:00,985,986,1,116,TRUE,NA,"0.1.4"
"7213","646",2022-11-15 03:00:00,985,986,1,116,TRUE,NA,"0.1.4"
"7214","646",2022-11-15 03:15:00,985,986,1,116,TRUE,NA,"0.1.4"
"7215","646",2022-11-15 03:30:00,985,986,1,116,TRUE,NA,"0.1.4"
"7216","646",2022-11-15 03:45:00,985,986,1,116,TRUE,NA,"0.1.4"
"7217","646",2022-11-15 04:00:00,985,986,1,116,TRUE,NA,"0.1.4"
"7218","646",2022-11-15 04:15:00,985,986,1,116,TRUE,NA,"0.1.4"
"7219","646",2022-11-15 04:30:00,984,986,2,116,TRUE,NA,"0.1.4"
"7220","646",2022-11-15 04:45:00,984,986,2,116,TRUE,NA,"0.1.4"
"7221","646",2022-11-15 05:00:00,984,986,2,116,TRUE,NA,"0.1.4"
"7222","646",2022-11-15 05:15:00,983,986,3,116,TRUE,NA,"0.1.4"
"7223","646",2022-11-15 05:30:00,983,986,3,116,TRUE,NA,"0.1.4"
"7224","646",2022-11-15 05:45:00,983,986,3,116,TRUE,NA,"0.1.4"
"7225","646",2022-11-15 06:00:00,983,986,3,116,TRUE,NA,"0.1.4"
"7226","646",2022-11-15 06:15:00,983,986,3,116,TRUE,NA,"0.1.4"
"7227","646",2022-11-15 06:30:00,983,986,3,116,TRUE,NA,"0.1.4"
"7228","646",2022-11-15 06:45:00,984,986,2,116,TRUE,NA,"0.1.4"
"7229","646",2022-11-15 07:00:00,983,986,3,116,TRUE,NA,"0.1.4"
"7230","646",2022-11-15 07:15:00,984,986,2,116,TRUE,NA,"0.1.4"
"7231","646",2022-11-15 07:30:00,984,986,2,116,TRUE,NA,"0.1.4"
"7232","646",2022-11-15 07:45:00,984,986,2,116,TRUE,NA,"0.1.4"
"7233","646",2022-11-15 08:00:00,984,986,2,116,TRUE,NA,"0.1.4"
"7234","646",2022-11-15 08:15:00,984,986,2,116,TRUE,NA,"0.1.4"
"7235","646",2022-11-15 08:30:00,984,986,2,116,TRUE,NA,"0.1.4"
"7236","646",2022-11-15 08:45:00,984,986,2,116,TRUE,NA,"0.1.4"
"7237","646",2022-11-15 09:00:00,984,986,2,116,TRUE,NA,"0.1.4"
"7238","646",2022-11-15 09:15:00,984,986,2,116,TRUE,NA,"0.1.4"
"7239","646",2022-11-15 09:30:00,984,986,2,116,TRUE,NA,"0.1.4"
"7240","646",2022-11-15 09:45:00,984,986,2,116,TRUE,NA,"0.1.4"
"7241","646",2022-11-15 10:00:00,984,986,2,116,TRUE,NA,"0.1.4"
"7242","646",2022-11-15 10:15:00,984,986,2,116,TRUE,NA,"0.1.4"
"7243","646",2022-11-15 10:30:00,984,986,2,116,TRUE,NA,"0.1.4"
"7244","646",2022-11-15 10:45:00,984,986,2,116,TRUE,NA,"0.1.4"
"7245","646",2022-11-15 11:00:00,984,986,2,116,TRUE,NA,"0.1.4"
"7246","646",2022-11-15 11:15:00,984,986,2,116,TRUE,NA,"0.1.4"
"7247","646",2022-11-15 11:30:00,984,986,2,116,TRUE,NA,"0.1.4"
"7248","646",2022-11-15 11:45:00,984,986,2,116,TRUE,NA,"0.1.4"
"7249","646",2022-11-15 12:00:00,984,986,2,116,TRUE,NA,"0.1.4"
"7250","646",2022-11-15 12:15:00,984,986,2,116,TRUE,NA,"0.1.4"
"7251","646",2022-11-15 12:30:00,984,986,2,116,TRUE,NA,"0.1.4"
"7252","646",2022-11-15 12:45:00,984,986,2,116,TRUE,NA,"0.1.4"
"7253","646",2022-11-15 13:00:00,984,986,2,116,TRUE,NA,"0.1.4"
"7254","646",2022-11-15 13:15:00,984,986,2,116,TRUE,NA,"0.1.4"
"7255","646",2022-11-15 13:30:00,1006,1006,0,136,TRUE,NA,"0.1.4"
"7256","646",2022-11-15 13:45:00,1006,1006,0,136,TRUE,NA,"0.1.4"
"7257","646",2022-11-15 14:00:00,1006,1006,0,136,TRUE,NA,"0.1.4"
"7258","646",2022-11-15 14:15:00,1006,1006,0,136,TRUE,NA,"0.1.4"
"7259","646",2022-11-15 14:30:00,1006,1006,0,136,TRUE,NA,"0.1.4"
"7260","646",2022-11-15 14:45:00,1005,1006,1,136,TRUE,NA,"0.1.4"
"7261","646",2022-11-15 15:00:00,1005,1006,1,136,TRUE,NA,"0.1.4"
"7262","646",2022-11-15 15:15:00,1005,1006,1,136,TRUE,NA,"0.1.4"
"7263","646",2022-11-15 15:30:00,1006,1006,0,136,TRUE,NA,"0.1.4"
"7264","646",2022-11-15 15:45:00,1005,1006,1,136,TRUE,NA,"0.1.4"
"7265","646",2022-11-15 16:00:00,1005,1006,1,136,TRUE,NA,"0.1.4"
"7266","646",2022-11-15 16:15:00,1005,1006,1,136,TRUE,NA,"0.1.4"
"7267","646",2022-11-15 16:30:00,1005,1006,1,136,TRUE,NA,"0.1.4"
"7268","646",2022-11-15 16:45:00,1005,1006,1,136,TRUE,NA,"0.1.4"
"7269","646",2022-11-15 17:00:00,1005,1006,1,136,TRUE,NA,"0.1.4"
"7270","646",2022-11-15 17:15:00,1005,1006,1,136,TRUE,NA,"0.1.4"
"7271","646",2022-11-15 17:30:00,1005,1006,1,136,TRUE,NA,"0.1.4"
"7272","646",2022-11-15 17:45:00,1005,1006,1,136,TRUE,NA,"0.1.4"
"7273","646",2022-11-15 18:00:00,1005,1006,1,136,TRUE,NA,"0.1.4"
"7274","646",2022-11-15 18:15:00,1005,1006,1,136,TRUE,NA,"0.1.4"
"7275","646",2022-11-15 18:30:00,1005,1006,1,136,TRUE,NA,"0.1.4"
"7276","646",2022-11-15 18:45:00,1004,1006,2,136,TRUE,NA,"0.1.4"
"7277","646",2022-11-15 19:00:00,1005,1006,1,136,TRUE,NA,"0.1.4"
"7278","646",2022-11-15 19:15:00,1002,1006,4,136,TRUE,NA,"0.1.4"
"7279","646",2022-11-15 19:30:00,999,1006,7,136,TRUE,NA,"0.1.4"
"7280","646",2022-11-15 19:45:00,997,1006,9,136,TRUE,NA,"0.1.4"
"7281","646",2022-11-15 20:00:00,997,1006,9,136,TRUE,NA,"0.1.4"
"7282","646",2022-11-15 20:15:00,997,1006,9,136,TRUE,NA,"0.1.4"
"7283","646",2022-11-15 20:30:00,997,1006,9,136,TRUE,NA,"0.1.4"
"7284","646",2022-11-15 20:45:00,998,1006,8,136,TRUE,NA,"0.1.4"
"7285","646",2022-11-15 21:00:00,998,1006,8,136,TRUE,NA,"0.1.4"
"7286","646",2022-11-15 21:15:00,997,1006,9,136,TRUE,NA,"0.1.4"
"7287","646",2022-11-15 21:30:00,998,1006,8,136,TRUE,NA,"0.1.4"
"7288","646",2022-11-15 21:45:00,998,1006,8,136,TRUE,NA,"0.1.4"
"7289","646",2022-11-15 22:00:00,998,1006,8,136,TRUE,NA,"0.1.4"
"7290","646",2022-11-15 22:15:00,997,1006,9,136,TRUE,NA,"0.1.4"
"7291","646",2022-11-15 22:30:00,997,1006,9,136,TRUE,NA,"0.1.4"
"7292","646",2022-11-15 22:45:00,997,1006,9,136,TRUE,NA,"0.1.4"
"7293","646",2022-11-15 23:00:00,998,1006,8,136,TRUE,NA,"0.1.4"
"7294","646",2022-11-15 23:15:00,998,1006,8,136,TRUE,NA,"0.1.4"
"7295","646",2022-11-15 23:30:00,998,1006,8,136,TRUE,NA,"0.1.4"
"7296","646",2022-11-15 23:45:00,998,1006,8,136,TRUE,NA,"0.1.4"
"7297","646",2022-11-16,998,1006,8,136,TRUE,NA,"0.1.4"
"7298","646",2022-11-16 00:15:00,998,1006,8,136,TRUE,NA,"0.1.4"
"7299","646",2022-11-16 00:30:00,998,1006,8,136,TRUE,NA,"0.1.4"
"7300","646",2022-11-16 00:45:00,998,1006,8,136,TRUE,NA,"0.1.4"
"7301","646",2022-11-16 01:00:00,998,1006,8,136,TRUE,NA,"0.1.4"
"7302","646",2022-11-16 01:15:00,998,1006,8,136,TRUE,NA,"0.1.4"
"7303","646",2022-11-16 01:30:00,998,1006,8,136,TRUE,NA,"0.1.4"
"7304","646",2022-11-16 01:45:00,998,1006,8,136,TRUE,NA,"0.1.4"
"7305","646",2022-11-16 02:00:00,998,1006,8,136,TRUE,NA,"0.1.4"
"7306","646",2022-11-16 02:15:00,998,1006,8,136,TRUE,NA,"0.1.4"
"7307","646",2022-11-16 02:30:00,998,1006,8,136,TRUE,NA,"0.1.4"
"7308","646",2022-11-16 02:45:00,998,1006,8,136,TRUE,NA,"0.1.4"
"7309","646",2022-11-16 03:00:00,998,1006,8,136,TRUE,NA,"0.1.4"
"7310","646",2022-11-16 03:15:00,998,1006,8,136,TRUE,NA,"0.1.4"
"7311","646",2022-11-16 03:30:00,998,1006,8,136,TRUE,NA,"0.1.4"
"7312","646",2022-11-16 03:45:00,998,1006,8,136,TRUE,NA,"0.1.4"
"7313","646",2022-11-16 04:00:00,998,1006,8,136,TRUE,NA,"0.1.4"
"7314","646",2022-11-16 04:15:00,998,1006,8,136,TRUE,NA,"0.1.4"
"7315","646",2022-11-16 04:30:00,998,1006,8,136,TRUE,NA,"0.1.4"
"7316","646",2022-11-16 04:45:00,998,1006,8,136,TRUE,NA,"0.1.4"
"7317","646",2022-11-16 05:00:00,998,1006,8,136,TRUE,NA,"0.1.4"
"7318","646",2022-11-16 05:15:00,998,1006,8,136,TRUE,NA,"0.1.4"
"7319","646",2022-11-16 05:30:00,998,1006,8,136,TRUE,NA,"0.1.4"
"7320","646",2022-11-16 05:45:00,998,1006,8,136,TRUE,NA,"0.1.4"
"7321","646",2022-11-16 06:00:00,998,1006,8,136,TRUE,NA,"0.1.4"
"7322","646",2022-11-16 06:15:00,998,1006,8,136,TRUE,NA,"0.1.4"
"7323","646",2022-11-16 06:30:00,998,1006,8,136,TRUE,NA,"0.1.4"
"7324","646",2022-11-16 06:45:00,998,1006,8,136,TRUE,NA,"0.1.4"
"7325","646",2022-11-16 07:00:00,998,1006,8,136,TRUE,NA,"0.1.4"
"7326","646",2022-11-16 07:15:00,998,1006,8,136,TRUE,NA,"0.1.4"
"7327","646",2022-11-16 07:30:00,998,1006,8,136,TRUE,NA,"0.1.4"
"7328","646",2022-11-16 07:45:00,998,1006,8,136,TRUE,NA,"0.1.4"
"7329","646",2022-11-16 08:00:00,998,1006,8,136,TRUE,NA,"0.1.4"
"7330","646",2022-11-16 08:15:00,998,1006,8,136,TRUE,NA,"0.1.4"
"7331","646",2022-11-16 08:30:00,998,1006,8,136,TRUE,NA,"0.1.4"
"7332","646",2022-11-16 08:45:00,998,1006,8,136,TRUE,NA,"0.1.4"
"7333","646",2022-11-16 09:00:00,998,1006,8,136,TRUE,NA,"0.1.4"
"7334","646",2022-11-16 09:15:00,998,1006,8,136,TRUE,NA,"0.1.4"
"7335","646",2022-11-16 09:30:00,998,1006,8,136,TRUE,NA,"0.1.4"
"7336","646",2022-11-16 09:45:00,998,1006,8,136,TRUE,NA,"0.1.4"
"7337","646",2022-11-16 10:00:00,998,1006,8,136,TRUE,NA,"0.1.4"
"7338","646",2022-11-16 10:15:00,998,1006,8,136,TRUE,NA,"0.1.4"
"7339","646",2022-11-16 10:30:00,998,1006,8,136,TRUE,NA,"0.1.4"
"7340","646",2022-11-16 10:45:00,998,1006,8,136,TRUE,NA,"0.1.4"
"7341","646",2022-11-16 11:00:00,998,1006,8,136,TRUE,NA,"0.1.4"
"7342","646",2022-11-16 11:15:00,998,1006,8,136,TRUE,NA,"0.1.4"
"7343","646",2022-11-16 11:30:00,998,1006,8,136,TRUE,NA,"0.1.4"
"7344","646",2022-11-16 11:45:00,998,1006,8,136,TRUE,NA,"0.1.4"
"7345","646",2022-11-16 12:00:00,998,1006,8,136,TRUE,NA,"0.1.4"
"7346","646",2022-11-16 12:15:00,998,1006,8,136,TRUE,NA,"0.1.4"
"7347","646",2022-11-16 12:30:00,998,1006,8,136,TRUE,NA,"0.1.4"
"7348","646",2022-11-16 12:45:00,998,1006,8,136,TRUE,NA,"0.1.4"
"7349","646",2022-11-16 13:00:00,998,1006,8,136,TRUE,NA,"0.1.4"
"7350","646",2022-11-16 13:15:00,998,1006,8,136,TRUE,NA,"0.1.4"
"7351","646",2022-11-16 13:30:00,998,1006,8,136,TRUE,NA,"0.1.4"
"7352","646",2022-11-16 13:45:00,998,1006,8,136,TRUE,NA,"0.1.4"
"7353","646",2022-11-16 14:00:00,998,1006,8,136,TRUE,NA,"0.1.4"
"7354","646",2022-11-16 14:15:00,998,1006,8,136,TRUE,NA,"0.1.4"
"7355","646",2022-11-16 14:30:00,998,1006,8,136,TRUE,NA,"0.1.4"
"7356","646",2022-11-16 14:45:00,998,1006,8,136,TRUE,NA,"0.1.4"
"7357","646",2022-11-16 15:00:00,998,1006,8,136,TRUE,NA,"0.1.4"
"7358","646",2022-11-16 15:15:00,998,1006,8,136,TRUE,NA,"0.1.4"
"7359","646",2022-11-16 15:30:00,998,1006,8,136,TRUE,NA,"0.1.4"
"7360","646",2022-11-16 15:45:00,998,1006,8,136,TRUE,NA,"0.1.4"
"7361","646",2022-11-16 16:00:00,998,1006,8,136,TRUE,NA,"0.1.4"
"7362","646",2022-11-16 16:15:00,998,1006,8,136,TRUE,NA,"0.1.4"
"7363","646",2022-11-16 16:30:00,998,1006,8,136,TRUE,NA,"0.1.4"
"7364","646",2022-11-16 16:45:00,998,1006,8,136,TRUE,NA,"0.1.4"
"7365","646",2022-11-16 17:00:00,998,1006,8,136,TRUE,NA,"0.1.4"
"7366","646",2022-11-16 17:15:00,998,1006,8,136,TRUE,NA,"0.1.4"
"7367","646",2022-11-16 17:30:00,998,1006,8,136,TRUE,NA,"0.1.4"
"7368","646",2022-11-16 17:45:00,998,1006,8,136,TRUE,NA,"0.1.4"
"7369","646",2022-11-16 18:00:00,998,1006,8,136,TRUE,NA,"0.1.4"
"7370","646",2022-11-16 18:15:00,998,1006,8,136,TRUE,NA,"0.1.4"
"7371","646",2022-11-16 18:30:00,998,1006,8,136,TRUE,NA,"0.1.4"
"7372","646",2022-11-16 18:45:00,998,1006,8,136,TRUE,NA,"0.1.4"
"7373","646",2022-11-16 19:00:00,998,1006,8,136,TRUE,NA,"0.1.4"
"7374","646",2022-11-16 19:15:00,998,1006,8,136,TRUE,NA,"0.1.4"
"7375","646",2022-11-16 19:30:00,998,1006,8,136,TRUE,NA,"0.1.4"
"7376","646",2022-11-16 19:45:00,998,1006,8,136,TRUE,NA,"0.1.4"
"7377","646",2022-11-16 20:00:00,998,1006,8,136,TRUE,NA,"0.1.4"
"7378","646",2022-11-16 20:15:00,998,1006,8,136,TRUE,NA,"0.1.4"
"7379","646",2022-11-16 20:30:00,998,1006,8,136,TRUE,NA,"0.1.4"
"7380","646",2022-11-16 20:45:00,998,1006,8,136,TRUE,NA,"0.1.4"
"7381","646",2022-11-16 21:00:00,998,1006,8,136,TRUE,NA,"0.1.4"
"7382","646",2022-11-16 21:15:00,998,1006,8,136,TRUE,NA,"0.1.4"
"7383","646",2022-11-16 21:30:00,998,1006,8,136,TRUE,NA,"0.1.4"
"7384","646",2022-11-16 21:45:00,998,1006,8,136,TRUE,NA,"0.1.4"
"7385","646",2022-11-16 22:00:00,998,1006,8,136,TRUE,NA,"0.1.4"
"7386","646",2022-11-16 22:15:00,998,1006,8,136,TRUE,NA,"0.1.4"
"7387","646",2022-11-16 22:30:00,998,1006,8,136,TRUE,NA,"0.1.4"
"7388","646",2022-11-16 22:45:00,998,1006,8,136,TRUE,NA,"0.1.4"
"7389","646",2022-11-16 23:00:00,998,1006,8,136,TRUE,NA,"0.1.4"
"7390","646",2022-11-16 23:15:00,998,1006,8,136,TRUE,NA,"0.1.4"
"7391","646",2022-11-16 23:30:00,998,1006,8,136,TRUE,NA,"0.1.4"
"7392","646",2022-11-16 23:45:00,998,1006,8,136,TRUE,NA,"0.1.4"
"7393","646",2022-11-17,998,1006,8,136,TRUE,NA,"0.1.4"
"7394","646",2022-11-17 00:15:00,998,1006,8,136,TRUE,NA,"0.1.4"
"7395","646",2022-11-17 00:30:00,998,1006,8,136,TRUE,NA,"0.1.4"
"7396","646",2022-11-17 00:45:00,998,1006,8,136,TRUE,NA,"0.1.4"
"7397","646",2022-11-17 01:00:00,998,1006,8,136,TRUE,NA,"0.1.4"
"7398","646",2022-11-17 01:15:00,998,1006,8,136,TRUE,NA,"0.1.4"
"7399","646",2022-11-17 01:30:00,998,1006,8,136,TRUE,NA,"0.1.4"
"7400","646",2022-11-17 01:45:00,998,1006,8,136,TRUE,NA,"0.1.4"
"7401","646",2022-11-17 02:00:00,998,1006,8,136,TRUE,NA,"0.1.4"
"7402","646",2022-11-17 02:15:00,998,1006,8,136,TRUE,NA,"0.1.4"
"7403","646",2022-11-17 02:30:00,998,1006,8,136,TRUE,NA,"0.1.4"
"7404","646",2022-11-17 02:45:00,998,1006,8,136,TRUE,NA,"0.1.4"
"7405","646",2022-11-17 03:00:00,998,1006,8,136,TRUE,NA,"0.1.4"
"7406","646",2022-11-17 03:15:00,998,1006,8,136,TRUE,NA,"0.1.4"
"7407","646",2022-11-17 03:30:00,998,1006,8,136,TRUE,NA,"0.1.4"
"7408","646",2022-11-17 03:45:00,998,1006,8,136,TRUE,NA,"0.1.4"
"7409","646",2022-11-17 04:00:00,998,1006,8,136,TRUE,NA,"0.1.4"
"7410","646",2022-11-17 04:15:00,998,1006,8,136,TRUE,NA,"0.1.4"
"7411","646",2022-11-17 04:30:00,998,1006,8,136,TRUE,NA,"0.1.4"
"7412","646",2022-11-17 04:45:00,998,1006,8,136,TRUE,NA,"0.1.4"
"7413","646",2022-11-17 05:00:00,998,1006,8,136,TRUE,NA,"0.1.4"
"7414","646",2022-11-17 05:15:00,998,1006,8,136,TRUE,NA,"0.1.4"
"7415","646",2022-11-17 05:30:00,998,1006,8,136,TRUE,NA,"0.1.4"
"7416","646",2022-11-17 05:45:00,998,1006,8,136,TRUE,NA,"0.1.4"
"7417","646",2022-11-17 06:00:00,998,1006,8,136,TRUE,NA,"0.1.4"
"7418","646",2022-11-17 06:15:00,998,1006,8,136,TRUE,NA,"0.1.4"
"7419","646",2022-11-17 06:30:00,998,1006,8,136,TRUE,NA,"0.1.4"
"7420","646",2022-11-17 06:45:00,998,1006,8,136,TRUE,NA,"0.1.4"
"7421","646",2022-11-17 07:00:00,998,1006,8,136,TRUE,NA,"0.1.4"
"7422","646",2022-11-17 07:15:00,998,1006,8,136,TRUE,NA,"0.1.4"
"7423","646",2022-11-17 07:30:00,998,1006,8,136,TRUE,NA,"0.1.4"
"7424","646",2022-11-17 07:45:00,998,1006,8,136,TRUE,NA,"0.1.4"
"7425","646",2022-11-17 08:00:00,998,1006,8,136,TRUE,NA,"0.1.4"
"7426","646",2022-11-17 08:15:00,998,1006,8,136,TRUE,NA,"0.1.4"
"7427","646",2022-11-17 08:30:00,998,1006,8,136,TRUE,NA,"0.1.4"
"7428","646",2022-11-17 08:45:00,998,1006,8,136,TRUE,NA,"0.1.4"
"7429","646",2022-11-17 09:00:00,998,1006,8,136,TRUE,NA,"0.1.4"
"7430","646",2022-11-17 09:15:00,998,1006,8,136,TRUE,NA,"0.1.4"
"7431","646",2022-11-17 09:30:00,998,1006,8,136,TRUE,NA,"0.1.4"
"7432","646",2022-11-17 09:45:00,998,1006,8,136,TRUE,NA,"0.1.4"
"7433","646",2022-11-17 10:00:00,998,1006,8,136,TRUE,NA,"0.1.4"
"7434","646",2022-11-17 10:15:00,998,1006,8,136,TRUE,NA,"0.1.4"
"7435","646",2022-11-17 10:30:00,998,1006,8,136,TRUE,NA,"0.1.4"
"7436","646",2022-11-17 10:45:00,998,1006,8,136,TRUE,NA,"0.1.4"
"7437","646",2022-11-17 11:00:00,998,1006,8,136,TRUE,NA,"0.1.4"
"7438","646",2022-11-17 11:15:00,998,1006,8,136,TRUE,NA,"0.1.4"
"7439","646",2022-11-17 11:30:00,998,1006,8,136,TRUE,NA,"0.1.4"
"7440","646",2022-11-17 11:45:00,998,1006,8,136,TRUE,NA,"0.1.4"
"7441","646",2022-11-17 12:00:00,998,1006,8,136,TRUE,NA,"0.1.4"
"7442","646",2022-11-17 12:15:00,998,1006,8,136,TRUE,NA,"0.1.4"
"7443","646",2022-11-17 12:30:00,998,1006,8,136,TRUE,NA,"0.1.4"
"7444","646",2022-11-17 12:45:00,998,1006,8,136,TRUE,NA,"0.1.4"
"7445","646",2022-11-17 13:00:00,998,1006,8,136,TRUE,NA,"0.1.4"
"7446","646",2022-11-17 13:15:00,998,1006,8,136,TRUE,NA,"0.1.4"
"7447","646",2022-11-17 13:30:00,998,1006,8,136,TRUE,NA,"0.1.4"
"7448","646",2022-11-17 13:45:00,998,1006,8,136,TRUE,NA,"0.1.4"
"7449","646",2022-11-17 14:00:00,998,1006,8,136,TRUE,NA,"0.1.4"
"7450","646",2022-11-17 14:15:00,998,1006,8,136,TRUE,NA,"0.1.4"
"7451","646",2022-11-17 14:30:00,998,1006,8,136,TRUE,NA,"0.1.4"
"7452","646",2022-11-17 14:45:00,998,1006,8,136,TRUE,NA,"0.1.4"
"7453","646",2022-11-17 15:00:00,998,1006,8,136,TRUE,NA,"0.1.4"
"7454","646",2022-11-17 15:15:00,998,1006,8,136,TRUE,NA,"0.1.4"
"7455","646",2022-11-17 15:30:00,998,1006,8,136,TRUE,NA,"0.1.4"
"7456","646",2022-11-17 15:45:00,998,1006,8,136,TRUE,NA,"0.1.4"
"7457","646",2022-11-17 16:00:00,998,1006,8,136,TRUE,NA,"0.1.4"
"7458","646",2022-11-17 16:15:00,998,1006,8,136,TRUE,NA,"0.1.4"
"7459","646",2022-11-17 16:30:00,998,1006,8,136,TRUE,NA,"0.1.4"
"7460","646",2022-11-17 16:45:00,998,1006,8,136,TRUE,NA,"0.1.4"
"7461","646",2022-11-17 17:00:00,998,1006,8,136,TRUE,NA,"0.1.4"
"7462","646",2022-11-17 17:15:00,998,1006,8,136,TRUE,NA,"0.1.4"
"7463","646",2022-11-17 17:30:00,998,1006,8,136,TRUE,NA,"0.1.4"
"7464","646",2022-11-17 17:45:00,998,1006,8,136,TRUE,NA,"0.1.4"
"7465","646",2022-11-17 18:00:00,998,1006,8,136,TRUE,NA,"0.1.4"
"7466","646",2022-11-17 18:15:00,998,1006,8,136,TRUE,NA,"0.1.4"
"7467","646",2022-11-17 18:30:00,998,1006,8,136,TRUE,NA,"0.1.4"
"7468","646",2022-11-17 18:45:00,998,1006,8,136,TRUE,NA,"0.1.4"
"7469","646",2022-11-17 19:00:00,998,1006,8,136,TRUE,NA,"0.1.4"
"7470","646",2022-11-17 19:15:00,998,1006,8,136,TRUE,NA,"0.1.4"
"7471","646",2022-11-17 19:30:00,998,1006,8,136,TRUE,NA,"0.1.4"
"7472","646",2022-11-17 19:45:00,998,1006,8,136,TRUE,NA,"0.1.4"
"7473","646",2022-11-17 20:00:00,998,1006,8,136,TRUE,NA,"0.1.4"
"7474","646",2022-11-17 20:15:00,998,1006,8,136,TRUE,NA,"0.1.4"
"7475","646",2022-11-17 20:30:00,998,1006,8,136,TRUE,NA,"0.1.4"
"7476","646",2022-11-17 20:45:00,998,1006,8,136,TRUE,NA,"0.1.4"
"7477","646",2022-11-17 21:00:00,998,1006,8,136,TRUE,NA,"0.1.4"
"7478","646",2022-11-17 21:15:00,998,1006,8,136,TRUE,NA,"0.1.4"
"7479","646",2022-11-17 21:30:00,998,1006,8,136,TRUE,NA,"0.1.4"
"7480","646",2022-11-17 21:45:00,998,1006,8,136,TRUE,NA,"0.1.4"
"7481","646",2022-11-17 22:00:00,998,1006,8,136,TRUE,NA,"0.1.4"
"7482","646",2022-11-17 22:15:00,998,1006,8,136,TRUE,NA,"0.1.4"
"7483","646",2022-11-17 22:30:00,998,1006,8,136,TRUE,NA,"0.1.4"
"7484","646",2022-11-17 22:45:00,998,1006,8,136,TRUE,NA,"0.1.4"
"7485","646",2022-11-17 23:00:00,998,1006,8,136,TRUE,NA,"0.1.4"
"7486","646",2022-11-17 23:15:00,998,1006,8,136,TRUE,NA,"0.1.4"
"7487","646",2022-11-17 23:30:00,998,1006,8,136,TRUE,NA,"0.1.4"
"7488","646",2022-11-17 23:45:00,998,1006,8,136,TRUE,NA,"0.1.4"
"7489","646",2022-11-18,998,1006,8,136,TRUE,NA,"0.1.4"
"7490","646",2022-11-18 00:15:00,998,1006,8,136,TRUE,NA,"0.1.4"
"7491","646",2022-11-18 00:30:00,998,1006,8,136,TRUE,NA,"0.1.4"
"7492","646",2022-11-18 00:45:00,998,1006,8,136,TRUE,NA,"0.1.4"
"7493","646",2022-11-18 01:00:00,998,1006,8,136,TRUE,NA,"0.1.4"
"7494","646",2022-11-18 01:15:00,998,1006,8,136,TRUE,NA,"0.1.4"
"7495","646",2022-11-18 01:30:00,998,1006,8,136,TRUE,NA,"0.1.4"
"7496","646",2022-11-18 01:45:00,998,1006,8,136,TRUE,NA,"0.1.4"
"7497","646",2022-11-18 02:00:00,998,1006,8,136,TRUE,NA,"0.1.4"
"7498","646",2022-11-18 02:15:00,998,1006,8,136,TRUE,NA,"0.1.4"
"7499","646",2022-11-18 02:30:00,998,1006,8,136,TRUE,NA,"0.1.4"
"7500","646",2022-11-18 02:45:00,998,1006,8,136,TRUE,NA,"0.1.4"
"7501","646",2022-11-18 03:00:00,998,1006,8,136,TRUE,NA,"0.1.4"
"7502","646",2022-11-18 03:15:00,998,1006,8,136,TRUE,NA,"0.1.4"
"7503","646",2022-11-18 03:30:00,998,1006,8,136,TRUE,NA,"0.1.4"
"7504","646",2022-11-18 03:45:00,998,1006,8,136,TRUE,NA,"0.1.4"
"7505","646",2022-11-18 04:00:00,998,1006,8,136,TRUE,NA,"0.1.4"
"7506","646",2022-11-18 04:15:00,998,1006,8,136,TRUE,NA,"0.1.4"
"7507","646",2022-11-18 04:30:00,998,1006,8,136,TRUE,NA,"0.1.4"
"7508","646",2022-11-18 04:45:00,998,1006,8,136,TRUE,NA,"0.1.4"
"7509","646",2022-11-18 05:00:00,998,1006,8,136,TRUE,NA,"0.1.4"
"7510","646",2022-11-18 05:15:00,998,1006,8,136,TRUE,NA,"0.1.4"
"7511","646",2022-11-18 05:30:00,998,1006,8,136,TRUE,NA,"0.1.4"
"7512","646",2022-11-18 05:45:00,998,1006,8,136,TRUE,NA,"0.1.4"
"7513","646",2022-11-18 06:00:00,998,1006,8,136,TRUE,NA,"0.1.4"
"7514","646",2022-11-18 06:15:00,998,1006,8,136,TRUE,NA,"0.1.4"
"7515","646",2022-11-18 06:30:00,998,1006,8,136,TRUE,NA,"0.1.4"
"7516","646",2022-11-18 06:45:00,998,1006,8,136,TRUE,NA,"0.1.4"
"7517","646",2022-11-18 07:00:00,998,1006,8,136,TRUE,NA,"0.1.4"
"7518","646",2022-11-18 07:15:00,998,1006,8,136,TRUE,NA,"0.1.4"
"7519","646",2022-11-18 07:30:00,998,1006,8,136,TRUE,NA,"0.1.4"
"7520","646",2022-11-18 07:45:00,998,1006,8,136,TRUE,NA,"0.1.4"
"7521","646",2022-11-18 08:00:00,998,1006,8,136,TRUE,NA,"0.1.4"
"7522","646",2022-11-18 08:15:00,998,1006,8,136,TRUE,NA,"0.1.4"
"7523","646",2022-11-18 08:30:00,998,1006,8,136,TRUE,NA,"0.1.4"
"7524","646",2022-11-18 08:45:00,998,1006,8,136,TRUE,NA,"0.1.4"
"7525","646",2022-11-18 09:00:00,998,1006,8,136,TRUE,NA,"0.1.4"
"7526","646",2022-11-18 09:15:00,998,1006,8,136,TRUE,NA,"0.1.4"
"7527","646",2022-11-18 09:30:00,998,1006,8,136,TRUE,NA,"0.1.4"
"7528","646",2022-11-18 09:45:00,998,1006,8,136,TRUE,NA,"0.1.4"
"7529","646",2022-11-18 10:00:00,998,1006,8,136,TRUE,NA,"0.1.4"
"7530","646",2022-11-18 10:15:00,998,1006,8,136,TRUE,NA,"0.1.4"
"7531","646",2022-11-18 10:30:00,998,1006,8,136,TRUE,NA,"0.1.4"
"7532","646",2022-11-18 10:45:00,998,1006,8,136,TRUE,NA,"0.1.4"
"7533","646",2022-11-18 11:00:00,998,1006,8,136,TRUE,NA,"0.1.4"
"7534","646",2022-11-18 11:15:00,998,1006,8,136,TRUE,NA,"0.1.4"
"7535","646",2022-11-18 11:30:00,998,1006,8,136,TRUE,NA,"0.1.4"
"7536","646",2022-11-18 11:45:00,998,1006,8,136,TRUE,NA,"0.1.4"
"7537","646",2022-11-18 12:00:00,998,1006,8,136,TRUE,NA,"0.1.4"
"7538","646",2022-11-18 12:15:00,998,1006,8,136,TRUE,NA,"0.1.4"
"7539","646",2022-11-18 12:30:00,998,1006,8,136,TRUE,NA,"0.1.4"
"7540","646",2022-11-18 12:45:00,998,1006,8,136,TRUE,NA,"0.1.4"
"7541","646",2022-11-18 13:00:00,998,1006,8,136,TRUE,NA,"0.1.4"
"7542","646",2022-11-18 13:15:00,998,1006,8,136,TRUE,NA,"0.1.4"
"7543","646",2022-11-18 13:30:00,998,1006,8,136,TRUE,NA,"0.1.4"
"7544","646",2022-11-18 13:45:00,998,1006,8,136,TRUE,NA,"0.1.4"
"7545","646",2022-11-18 14:00:00,997,1006,9,136,TRUE,NA,"0.1.4"
"7546","646",2022-11-18 14:15:00,997,1006,9,136,TRUE,NA,"0.1.4"
"7547","646",2022-11-18 14:30:00,997,1006,9,136,TRUE,NA,"0.1.4"
"7548","646",2022-11-18 14:45:00,997,1006,9,136,TRUE,NA,"0.1.4"
"7549","646",2022-11-18 15:00:00,996,1006,10,136,TRUE,NA,"0.1.4"
"7550","646",2022-11-18 15:15:00,996,1006,10,136,TRUE,NA,"0.1.4"
"7551","646",2022-11-18 15:30:00,992,1006,14,136,TRUE,NA,"0.1.4"
"7552","646",2022-11-18 15:45:00,991,1006,15,136,TRUE,NA,"0.1.4"
"7553","646",2022-11-18 16:00:00,991,1006,15,136,TRUE,NA,"0.1.4"
"7554","646",2022-11-18 16:15:00,991,1006,15,136,TRUE,NA,"0.1.4"
"7555","646",2022-11-18 16:30:00,990,1006,16,136,TRUE,NA,"0.1.4"
"7556","646",2022-11-18 16:45:00,990,1006,16,136,TRUE,NA,"0.1.4"
"7557","646",2022-11-18 17:00:00,990,1006,16,136,TRUE,NA,"0.1.4"
"7558","646",2022-11-18 17:15:00,990,1006,16,136,TRUE,NA,"0.1.4"
"7559","646",2022-11-18 17:30:00,991,1006,15,136,TRUE,NA,"0.1.4"
"7560","646",2022-11-18 17:45:00,990,1006,16,136,TRUE,NA,"0.1.4"
"7561","646",2022-11-18 18:00:00,987,1006,19,136,TRUE,NA,"0.1.4"
"7562","646",2022-11-18 18:15:00,990,1006,16,136,TRUE,NA,"0.1.4"
"7563","646",2022-11-18 18:30:00,989,1006,17,136,TRUE,NA,"0.1.4"
"7564","646",2022-11-18 18:45:00,989,1006,17,136,TRUE,NA,"0.1.4"
"7565","646",2022-11-18 19:00:00,989,1006,17,136,TRUE,NA,"0.1.4"
"7566","646",2022-11-18 19:15:00,989,1006,17,136,TRUE,NA,"0.1.4"
"7567","646",2022-11-18 19:30:00,989,1006,17,136,TRUE,NA,"0.1.4"
"7568","646",2022-11-18 19:45:00,989,1006,17,136,TRUE,NA,"0.1.4"
"7569","646",2022-11-18 20:00:00,989,1006,17,136,TRUE,NA,"0.1.4"
"7570","646",2022-11-18 20:15:00,989,1006,17,136,TRUE,NA,"0.1.4"
"7571","646",2022-11-18 20:30:00,990,1006,16,136,TRUE,NA,"0.1.4"
"7572","646",2022-11-18 20:45:00,990,1006,16,136,TRUE,NA,"0.1.4"
"7573","646",2022-11-18 21:00:00,990,1006,16,136,TRUE,NA,"0.1.4"
"7574","646",2022-11-18 21:15:00,990,1006,16,136,TRUE,NA,"0.1.4"
"7575","646",2022-11-18 21:30:00,990,1006,16,136,TRUE,NA,"0.1.4"
"7576","646",2022-11-18 21:45:00,990,1006,16,136,TRUE,NA,"0.1.4"
"7577","646",2022-11-18 22:00:00,990,1006,16,136,TRUE,NA,"0.1.4"
"7578","646",2022-11-18 22:15:00,990,1006,16,136,TRUE,NA,"0.1.4"
"7579","646",2022-11-18 22:30:00,990,1006,16,136,TRUE,NA,"0.1.4"
"7580","646",2022-11-18 22:45:00,990,1006,16,136,TRUE,NA,"0.1.4"
"7581","646",2022-11-18 23:00:00,990,1006,16,136,TRUE,NA,"0.1.4"
"7582","646",2022-11-18 23:15:00,990,1006,16,136,TRUE,NA,"0.1.4"
"7583","646",2022-11-18 23:30:00,990,1006,16,136,TRUE,NA,"0.1.4"
"7584","646",2022-11-18 23:45:00,989,1006,17,136,TRUE,NA,"0.1.4"
"7585","646",2022-11-19,989,1006,17,136,TRUE,NA,"0.1.4"
"7586","646",2022-11-19 00:15:00,990,1006,16,136,TRUE,NA,"0.1.4"
"7587","646",2022-11-19 00:30:00,989,1006,17,136,TRUE,NA,"0.1.4"
"7588","646",2022-11-19 00:45:00,989,1006,17,136,TRUE,NA,"0.1.4"
"7589","646",2022-11-19 01:00:00,989,1006,17,136,TRUE,NA,"0.1.4"
"7590","646",2022-11-19 01:15:00,989,1006,17,136,TRUE,NA,"0.1.4"
"7591","646",2022-11-19 01:30:00,989,1006,17,136,TRUE,NA,"0.1.4"
"7592","646",2022-11-19 01:45:00,989,1006,17,136,TRUE,NA,"0.1.4"
"7593","646",2022-11-19 02:00:00,989,1006,17,136,TRUE,NA,"0.1.4"
"7594","646",2022-11-19 02:15:00,989,1006,17,136,TRUE,NA,"0.1.4"
"7595","646",2022-11-19 02:30:00,989,1006,17,136,TRUE,NA,"0.1.4"
"7596","646",2022-11-19 02:45:00,989,1006,17,136,TRUE,NA,"0.1.4"
"7597","646",2022-11-19 03:00:00,989,1006,17,136,TRUE,NA,"0.1.4"
"7598","646",2022-11-19 03:15:00,989,1006,17,136,TRUE,NA,"0.1.4"
"7599","646",2022-11-19 03:30:00,989,1006,17,136,TRUE,NA,"0.1.4"
"7600","646",2022-11-19 03:45:00,989,1006,17,136,TRUE,NA,"0.1.4"
"7601","646",2022-11-19 04:00:00,989,1006,17,136,TRUE,NA,"0.1.4"
"7602","646",2022-11-19 04:15:00,989,1006,17,136,TRUE,NA,"0.1.4"
"7603","646",2022-11-19 04:30:00,989,1006,17,136,TRUE,NA,"0.1.4"
"7604","646",2022-11-19 04:45:00,989,1006,17,136,TRUE,NA,"0.1.4"
"7605","646",2022-11-19 05:00:00,989,1006,17,136,TRUE,NA,"0.1.4"
"7606","646",2022-11-19 05:15:00,989,1006,17,136,TRUE,NA,"0.1.4"
"7607","646",2022-11-19 05:30:00,989,1006,17,136,TRUE,NA,"0.1.4"
"7608","646",2022-11-19 05:45:00,989,1006,17,136,TRUE,NA,"0.1.4"
"7609","646",2022-11-19 06:00:00,989,1006,17,136,TRUE,NA,"0.1.4"
"7610","646",2022-11-19 06:15:00,989,1006,17,136,TRUE,NA,"0.1.4"
"7611","646",2022-11-19 06:30:00,989,1006,17,136,TRUE,NA,"0.1.4"
"7612","646",2022-11-19 06:45:00,989,1006,17,136,TRUE,NA,"0.1.4"
"7613","646",2022-11-19 07:00:00,989,1006,17,136,TRUE,NA,"0.1.4"
"7614","646",2022-11-19 07:15:00,989,1006,17,136,TRUE,NA,"0.1.4"
"7615","646",2022-11-19 07:30:00,989,1006,17,136,TRUE,NA,"0.1.4"
"7616","646",2022-11-19 07:45:00,989,1006,17,136,TRUE,NA,"0.1.4"
"7617","646",2022-11-19 08:00:00,989,1006,17,136,TRUE,NA,"0.1.4"
"7618","646",2022-11-19 08:15:00,989,1006,17,136,TRUE,NA,"0.1.4"
"7619","646",2022-11-19 08:30:00,989,1006,17,136,TRUE,NA,"0.1.4"
"7620","646",2022-11-19 08:45:00,989,1006,17,136,TRUE,NA,"0.1.4"
"7621","646",2022-11-19 09:00:00,989,1006,17,136,TRUE,NA,"0.1.4"
"7622","646",2022-11-19 09:15:00,989,1006,17,136,TRUE,NA,"0.1.4"
"7623","646",2022-11-19 09:30:00,989,1006,17,136,TRUE,NA,"0.1.4"
"7624","646",2022-11-19 09:45:00,989,1006,17,136,TRUE,NA,"0.1.4"
"7625","646",2022-11-19 10:00:00,989,1006,17,136,TRUE,NA,"0.1.4"
"7626","646",2022-11-19 10:15:00,989,1006,17,136,TRUE,NA,"0.1.4"
"7627","646",2022-11-19 10:30:00,989,1006,17,136,TRUE,NA,"0.1.4"
"7628","646",2022-11-19 10:45:00,989,1006,17,136,TRUE,NA,"0.1.4"
"7629","646",2022-11-19 11:00:00,989,1006,17,136,TRUE,NA,"0.1.4"
"7630","646",2022-11-19 11:15:00,989,1006,17,136,TRUE,NA,"0.1.4"
"7631","646",2022-11-19 11:30:00,989,1006,17,136,TRUE,NA,"0.1.4"
"7632","646",2022-11-19 11:45:00,989,1006,17,136,TRUE,NA,"0.1.4"
"7633","646",2022-11-19 12:00:00,989,1006,17,136,TRUE,NA,"0.1.4"
"7634","646",2022-11-19 12:15:00,989,1006,17,136,TRUE,NA,"0.1.4"
"7635","646",2022-11-19 12:30:00,989,1006,17,136,TRUE,NA,"0.1.4"
"7636","646",2022-11-19 12:45:00,989,1006,17,136,TRUE,NA,"0.1.4"
"7637","646",2022-11-19 13:00:00,989,1006,17,136,TRUE,NA,"0.1.4"
"7638","646",2022-11-19 13:15:00,989,1006,17,136,TRUE,NA,"0.1.4"
"7639","646",2022-11-19 13:30:00,989,1006,17,136,TRUE,NA,"0.1.4"
"7640","646",2022-11-19 13:45:00,989,1006,17,136,TRUE,NA,"0.1.4"
"7641","646",2022-11-19 14:00:00,989,1006,17,136,TRUE,NA,"0.1.4"
"7642","646",2022-11-19 14:15:00,989,1006,17,136,TRUE,NA,"0.1.4"
"7643","646",2022-11-19 14:30:00,989,1006,17,136,TRUE,NA,"0.1.4"
"7644","646",2022-11-19 14:45:00,989,1006,17,136,TRUE,NA,"0.1.4"
"7645","646",2022-11-19 15:00:00,989,1006,17,136,TRUE,NA,"0.1.4"
"7646","646",2022-11-19 15:15:00,989,1006,17,136,TRUE,NA,"0.1.4"
"7647","646",2022-11-19 15:30:00,989,1006,17,136,TRUE,NA,"0.1.4"
"7648","646",2022-11-19 15:45:00,989,1006,17,136,TRUE,NA,"0.1.4"
"7649","646",2022-11-19 16:00:00,989,1006,17,136,TRUE,NA,"0.1.4"
"7650","646",2022-11-19 16:15:00,988,1006,18,136,TRUE,NA,"0.1.4"
"7651","646",2022-11-19 16:30:00,987,1006,19,136,TRUE,NA,"0.1.4"
"7652","646",2022-11-19 16:45:00,987,1006,19,136,TRUE,NA,"0.1.4"
"7653","646",2022-11-19 17:00:00,986,1006,20,136,TRUE,NA,"0.1.4"
"7654","646",2022-11-19 17:15:00,985,1006,21,136,TRUE,NA,"0.1.4"
"7655","646",2022-11-19 17:30:00,984,1006,22,136,TRUE,NA,"0.1.4"
"7656","646",2022-11-19 17:45:00,983,1006,23,136,TRUE,NA,"0.1.4"
"7657","646",2022-11-19 18:00:00,981,1006,25,136,TRUE,NA,"0.1.4"
"7658","646",2022-11-19 18:15:00,978,1006,28,136,TRUE,NA,"0.1.4"
"7659","646",2022-11-19 18:30:00,974,1006,32,136,TRUE,NA,"0.1.4"
"7660","646",2022-11-19 18:45:00,975,1006,31,136,TRUE,NA,"0.1.4"
"7661","646",2022-11-19 19:00:00,975,1006,31,136,TRUE,NA,"0.1.4"
"7662","646",2022-11-19 19:15:00,975,1006,31,136,TRUE,NA,"0.1.4"
"7663","646",2022-11-19 19:30:00,975,1006,31,136,TRUE,NA,"0.1.4"
"7664","646",2022-11-19 19:45:00,975,1006,31,136,TRUE,NA,"0.1.4"
"7665","646",2022-11-19 20:00:00,975,1006,31,136,TRUE,NA,"0.1.4"
"7666","646",2022-11-19 20:15:00,975,1006,31,136,TRUE,NA,"0.1.4"
"7667","646",2022-11-19 20:30:00,975,1006,31,136,TRUE,NA,"0.1.4"
"7668","646",2022-11-19 20:45:00,974,1006,32,136,TRUE,NA,"0.1.4"
"7669","646",2022-11-19 21:00:00,975,1006,31,136,TRUE,NA,"0.1.4"
"7670","646",2022-11-19 21:15:00,977,1006,29,136,TRUE,NA,"0.1.4"
"7671","646",2022-11-19 21:30:00,981,1006,25,136,TRUE,NA,"0.1.4"
"7672","646",2022-11-19 21:45:00,982,1006,24,136,TRUE,NA,"0.1.4"
"7673","646",2022-11-19 22:00:00,982,1006,24,136,TRUE,NA,"0.1.4"
"7674","646",2022-11-19 22:15:00,983,1006,23,136,TRUE,NA,"0.1.4"
"7675","646",2022-11-19 22:30:00,983,1006,23,136,TRUE,NA,"0.1.4"
"7676","646",2022-11-19 22:45:00,983,1006,23,136,TRUE,NA,"0.1.4"
"7677","646",2022-11-19 23:00:00,983,1006,23,136,TRUE,NA,"0.1.4"
"7678","646",2022-11-19 23:15:00,983,1006,23,136,TRUE,NA,"0.1.4"
"7679","646",2022-11-19 23:30:00,983,1006,23,136,TRUE,NA,"0.1.4"
"7680","646",2022-11-19 23:45:00,984,1006,22,136,TRUE,NA,"0.1.4"
"7681","646",2022-11-20,984,1006,22,136,TRUE,NA,"0.1.4"
"7682","646",2022-11-20 00:15:00,984,1006,22,136,TRUE,NA,"0.1.4"
"7683","646",2022-11-20 00:30:00,984,1006,22,136,TRUE,NA,"0.1.4"
"7684","646",2022-11-20 00:45:00,984,1006,22,136,TRUE,NA,"0.1.4"
"7685","646",2022-11-20 01:00:00,985,1006,21,136,TRUE,NA,"0.1.4"
"7686","646",2022-11-20 01:15:00,984,1006,22,136,TRUE,NA,"0.1.4"
"7687","646",2022-11-20 01:30:00,984,1006,22,136,TRUE,NA,"0.1.4"
"7688","646",2022-11-20 01:45:00,984,1006,22,136,TRUE,NA,"0.1.4"
"7689","646",2022-11-20 02:00:00,984,1006,22,136,TRUE,NA,"0.1.4"
"7690","646",2022-11-20 02:15:00,984,1006,22,136,TRUE,NA,"0.1.4"
"7691","646",2022-11-20 02:30:00,984,1006,22,136,TRUE,NA,"0.1.4"
"7692","646",2022-11-20 02:45:00,984,1006,22,136,TRUE,NA,"0.1.4"
"7693","646",2022-11-20 03:00:00,984,1006,22,136,TRUE,NA,"0.1.4"
"7694","646",2022-11-20 03:15:00,984,1006,22,136,TRUE,NA,"0.1.4"
"7695","646",2022-11-20 03:30:00,984,1006,22,136,TRUE,NA,"0.1.4"
"7696","646",2022-11-20 03:45:00,984,1006,22,136,TRUE,NA,"0.1.4"
"7697","646",2022-11-20 04:00:00,984,1006,22,136,TRUE,NA,"0.1.4"
"7698","646",2022-11-20 04:15:00,984,1006,22,136,TRUE,NA,"0.1.4"
"7699","646",2022-11-20 04:30:00,984,1006,22,136,TRUE,NA,"0.1.4"
"7700","646",2022-11-20 04:45:00,984,1006,22,136,TRUE,NA,"0.1.4"
"7701","646",2022-11-20 05:00:00,984,1006,22,136,TRUE,NA,"0.1.4"
"7702","646",2022-11-20 05:15:00,984,1006,22,136,TRUE,NA,"0.1.4"
"7703","646",2022-11-20 05:30:00,984,1006,22,136,TRUE,NA,"0.1.4"
"7704","646",2022-11-20 05:45:00,984,1006,22,136,TRUE,NA,"0.1.4"
"7705","646",2022-11-20 06:00:00,984,1006,22,136,TRUE,NA,"0.1.4"
"7706","646",2022-11-20 06:15:00,984,1006,22,136,TRUE,NA,"0.1.4"
"7707","646",2022-11-20 06:30:00,984,1006,22,136,TRUE,NA,"0.1.4"
"7708","646",2022-11-20 06:45:00,984,1006,22,136,TRUE,NA,"0.1.4"
"7709","646",2022-11-20 07:00:00,984,1006,22,136,TRUE,NA,"0.1.4"
"7710","646",2022-11-20 07:15:00,984,1006,22,136,TRUE,NA,"0.1.4"
"7711","646",2022-11-20 07:30:00,984,1006,22,136,TRUE,NA,"0.1.4"
"7712","646",2022-11-20 07:45:00,984,1006,22,136,TRUE,NA,"0.1.4"
"7713","646",2022-11-20 08:00:00,984,1006,22,136,TRUE,NA,"0.1.4"
"7714","646",2022-11-20 08:15:00,984,1006,22,136,TRUE,NA,"0.1.4"
"7715","646",2022-11-20 08:30:00,984,1006,22,136,TRUE,NA,"0.1.4"
"7716","646",2022-11-20 08:45:00,984,1006,22,136,TRUE,NA,"0.1.4"
"7717","646",2022-11-20 09:00:00,984,1006,22,136,TRUE,NA,"0.1.4"
"7718","646",2022-11-20 09:15:00,984,1006,22,136,TRUE,NA,"0.1.4"
"7719","646",2022-11-20 09:30:00,984,1006,22,136,TRUE,NA,"0.1.4"
"7720","646",2022-11-20 09:45:00,984,1006,22,136,TRUE,NA,"0.1.4"
"7721","646",2022-11-20 10:00:00,984,1006,22,136,TRUE,NA,"0.1.4"
"7722","646",2022-11-20 10:15:00,984,1006,22,136,TRUE,NA,"0.1.4"
"7723","646",2022-11-20 10:30:00,984,1006,22,136,TRUE,NA,"0.1.4"
"7724","646",2022-11-20 10:45:00,984,1006,22,136,TRUE,NA,"0.1.4"
"7725","646",2022-11-20 11:00:00,984,1006,22,136,TRUE,NA,"0.1.4"
"7726","646",2022-11-20 11:15:00,984,1006,22,136,TRUE,NA,"0.1.4"
"7727","646",2022-11-20 11:30:00,984,1006,22,136,TRUE,NA,"0.1.4"
"7728","646",2022-11-20 11:45:00,984,1006,22,136,TRUE,NA,"0.1.4"
"7729","646",2022-11-20 12:00:00,984,1006,22,136,TRUE,NA,"0.1.4"
"7730","646",2022-11-20 12:15:00,984,1006,22,136,TRUE,NA,"0.1.4"
"7731","646",2022-11-20 12:30:00,984,1006,22,136,TRUE,NA,"0.1.4"
"7732","646",2022-11-20 12:45:00,984,1006,22,136,TRUE,NA,"0.1.4"
"7733","646",2022-11-20 13:00:00,984,1006,22,136,TRUE,NA,"0.1.4"
"7734","646",2022-11-20 13:15:00,984,1006,22,136,TRUE,NA,"0.1.4"
"7735","646",2022-11-20 13:30:00,984,1006,22,136,TRUE,NA,"0.1.4"
"7736","646",2022-11-20 13:45:00,984,1006,22,136,TRUE,NA,"0.1.4"
"7737","646",2022-11-20 14:00:00,984,1006,22,136,TRUE,NA,"0.1.4"
"7738","646",2022-11-20 14:15:00,984,1006,22,136,TRUE,NA,"0.1.4"
"7739","646",2022-11-20 14:30:00,984,1006,22,136,TRUE,NA,"0.1.4"
"7740","646",2022-11-20 14:45:00,984,1006,22,136,TRUE,NA,"0.1.4"
"7741","646",2022-11-20 15:00:00,984,1006,22,136,TRUE,NA,"0.1.4"
"7742","646",2022-11-20 15:15:00,984,1006,22,136,TRUE,NA,"0.1.4"
"7743","646",2022-11-20 15:30:00,984,1006,22,136,TRUE,NA,"0.1.4"
"7744","646",2022-11-20 15:45:00,984,1006,22,136,TRUE,NA,"0.1.4"
"7745","646",2022-11-20 16:00:00,984,1006,22,136,TRUE,NA,"0.1.4"
"7746","646",2022-11-20 16:15:00,984,1006,22,136,TRUE,NA,"0.1.4"
"7747","646",2022-11-20 16:30:00,984,1006,22,136,TRUE,NA,"0.1.4"
"7748","646",2022-11-20 16:45:00,984,1006,22,136,TRUE,NA,"0.1.4"
"7749","646",2022-11-20 17:00:00,984,1006,22,136,TRUE,NA,"0.1.4"
"7750","646",2022-11-20 17:15:00,984,1006,22,136,TRUE,NA,"0.1.4"
"7751","646",2022-11-20 17:30:00,984,1006,22,136,TRUE,NA,"0.1.4"
"7752","646",2022-11-20 17:45:00,984,1006,22,136,TRUE,NA,"0.1.4"
"7753","646",2022-11-20 18:00:00,984,1006,22,136,TRUE,NA,"0.1.4"
"7754","646",2022-11-20 18:15:00,984,1006,22,136,TRUE,NA,"0.1.4"
"7755","646",2022-11-20 18:30:00,984,1006,22,136,TRUE,NA,"0.1.4"
"7756","646",2022-11-20 18:45:00,984,1006,22,136,TRUE,NA,"0.1.4"
"7757","646",2022-11-20 19:00:00,984,1006,22,136,TRUE,NA,"0.1.4"
"7758","646",2022-11-20 19:15:00,984,1006,22,136,TRUE,NA,"0.1.4"
"7759","646",2022-11-20 19:30:00,984,1006,22,136,TRUE,NA,"0.1.4"
"7760","646",2022-11-20 19:45:00,984,1006,22,136,TRUE,NA,"0.1.4"
"7761","646",2022-11-20 20:00:00,984,1006,22,136,TRUE,NA,"0.1.4"
"7762","646",2022-11-20 20:15:00,984,1006,22,136,TRUE,NA,"0.1.4"
"7763","646",2022-11-20 20:30:00,984,1006,22,136,TRUE,NA,"0.1.4"
"7764","646",2022-11-20 20:45:00,984,1006,22,136,TRUE,NA,"0.1.4"
"7765","646",2022-11-20 21:00:00,984,1006,22,136,TRUE,NA,"0.1.4"
"7766","646",2022-11-20 21:15:00,984,1006,22,136,TRUE,NA,"0.1.4"
"7767","646",2022-11-20 21:30:00,984,1006,22,136,TRUE,NA,"0.1.4"
"7768","646",2022-11-20 21:45:00,984,1006,22,136,TRUE,NA,"0.1.4"
"7769","646",2022-11-20 22:00:00,984,1006,22,136,TRUE,NA,"0.1.4"
"7770","646",2022-11-20 22:15:00,984,1006,22,136,TRUE,NA,"0.1.4"
"7771","646",2022-11-20 22:30:00,984,1006,22,136,TRUE,NA,"0.1.4"
"7772","646",2022-11-20 22:45:00,984,1006,22,136,TRUE,NA,"0.1.4"
"7773","646",2022-11-20 23:00:00,984,1006,22,136,TRUE,NA,"0.1.4"
"7774","646",2022-11-20 23:15:00,984,1006,22,136,TRUE,NA,"0.1.4"
"7775","646",2022-11-20 23:30:00,984,1006,22,136,TRUE,NA,"0.1.4"
"7776","646",2022-11-20 23:45:00,984,1006,22,136,TRUE,NA,"0.1.4"
"7777","646",2022-11-21,984,1006,22,136,TRUE,NA,"0.1.4"
"7778","646",2022-11-21 00:15:00,984,1006,22,136,TRUE,NA,"0.1.4"
"7779","646",2022-11-21 00:30:00,984,1006,22,136,TRUE,NA,"0.1.4"
"7780","646",2022-11-21 00:45:00,984,1006,22,136,TRUE,NA,"0.1.4"
"7781","646",2022-11-21 01:00:00,984,1006,22,136,TRUE,NA,"0.1.4"
"7782","646",2022-11-21 01:15:00,984,1006,22,136,TRUE,NA,"0.1.4"
"7783","646",2022-11-21 01:30:00,984,1006,22,136,TRUE,NA,"0.1.4"
"7784","646",2022-11-21 01:45:00,984,1006,22,136,TRUE,NA,"0.1.4"
"7785","646",2022-11-21 02:00:00,984,1006,22,136,TRUE,NA,"0.1.4"
"7786","646",2022-11-21 02:15:00,984,1006,22,136,TRUE,NA,"0.1.4"
"7787","646",2022-11-21 02:30:00,984,1006,22,136,TRUE,NA,"0.1.4"
"7788","646",2022-11-21 02:45:00,984,1006,22,136,TRUE,NA,"0.1.4"
"7789","646",2022-11-21 03:00:00,984,1006,22,136,TRUE,NA,"0.1.4"
"7790","646",2022-11-21 03:15:00,984,1006,22,136,TRUE,NA,"0.1.4"
"7791","646",2022-11-21 03:30:00,984,1006,22,136,TRUE,NA,"0.1.4"
"7792","646",2022-11-21 03:45:00,984,1006,22,136,TRUE,NA,"0.1.4"
"7793","646",2022-11-21 04:00:00,984,1006,22,136,TRUE,NA,"0.1.4"
"7794","646",2022-11-21 04:15:00,984,1006,22,136,TRUE,NA,"0.1.4"
"7795","646",2022-11-21 04:30:00,984,1006,22,136,TRUE,NA,"0.1.4"
"7796","646",2022-11-21 04:45:00,984,1006,22,136,TRUE,NA,"0.1.4"
"7797","646",2022-11-21 05:00:00,984,1006,22,136,TRUE,NA,"0.1.4"
"7798","646",2022-11-21 05:15:00,984,1006,22,136,TRUE,NA,"0.1.4"
"7799","646",2022-11-21 05:30:00,984,1006,22,136,TRUE,NA,"0.1.4"
"7800","646",2022-11-21 05:45:00,984,1006,22,136,TRUE,NA,"0.1.4"
"7801","646",2022-11-21 06:00:00,984,1006,22,136,TRUE,NA,"0.1.4"
"7802","646",2022-11-21 06:15:00,984,1006,22,136,TRUE,NA,"0.1.4"
"7803","646",2022-11-21 06:30:00,984,1006,22,136,TRUE,NA,"0.1.4"
"7804","646",2022-11-21 06:45:00,984,1006,22,136,TRUE,NA,"0.1.4"
"7805","646",2022-11-21 07:00:00,984,1006,22,136,TRUE,NA,"0.1.4"
"7806","646",2022-11-21 07:15:00,984,1006,22,136,TRUE,NA,"0.1.4"
"7807","646",2022-11-21 07:30:00,984,1006,22,136,TRUE,NA,"0.1.4"
"7808","646",2022-11-21 07:45:00,984,1006,22,136,TRUE,NA,"0.1.4"
"7809","646",2022-11-21 08:00:00,984,1006,22,136,TRUE,NA,"0.1.4"
"7810","646",2022-11-21 08:15:00,984,1006,22,136,TRUE,NA,"0.1.4"
"7811","646",2022-11-21 08:30:00,984,1006,22,136,TRUE,NA,"0.1.4"
"7812","646",2022-11-21 08:45:00,984,1006,22,136,TRUE,NA,"0.1.4"
"7813","646",2022-11-21 09:00:00,984,1006,22,136,TRUE,NA,"0.1.4"
"7814","646",2022-11-21 09:15:00,984,1006,22,136,TRUE,NA,"0.1.4"
"7815","646",2022-11-21 09:30:00,984,1006,22,136,TRUE,NA,"0.1.4"
"7816","646",2022-11-21 09:45:00,984,1006,22,136,TRUE,NA,"0.1.4"
"7817","646",2022-11-21 10:00:00,984,1006,22,136,TRUE,NA,"0.1.4"
"7818","646",2022-11-21 10:15:00,984,1006,22,136,TRUE,NA,"0.1.4"
"7819","646",2022-11-21 10:30:00,984,1006,22,136,TRUE,NA,"0.1.4"
"7820","646",2022-11-21 10:45:00,984,1006,22,136,TRUE,NA,"0.1.4"
"7821","646",2022-11-21 11:00:00,984,1006,22,136,TRUE,NA,"0.1.4"
"7822","646",2022-11-21 11:15:00,984,1006,22,136,TRUE,NA,"0.1.4"
"7823","646",2022-11-21 11:30:00,984,1006,22,136,TRUE,NA,"0.1.4"
"7824","646",2022-11-21 11:45:00,984,1006,22,136,TRUE,NA,"0.1.4"
"7825","646",2022-11-21 12:00:00,984,1006,22,136,TRUE,NA,"0.1.4"
"7826","646",2022-11-21 12:15:00,984,1006,22,136,TRUE,NA,"0.1.4"
"7827","646",2022-11-21 12:30:00,984,1006,22,136,TRUE,NA,"0.1.4"
"7828","646",2022-11-21 12:45:00,984,1006,22,136,TRUE,NA,"0.1.4"
"7829","646",2022-11-21 13:00:00,984,1006,22,136,TRUE,NA,"0.1.4"
"7830","646",2022-11-21 13:15:00,984,1006,22,136,TRUE,NA,"0.1.4"
"7831","646",2022-11-21 13:30:00,984,1006,22,136,TRUE,NA,"0.1.4"
"7832","646",2022-11-21 13:45:00,984,1006,22,136,TRUE,NA,"0.1.4"
"7833","646",2022-11-21 14:00:00,984,1006,22,136,TRUE,NA,"0.1.4"
"7834","646",2022-11-21 14:15:00,984,1006,22,136,TRUE,NA,"0.1.4"
"7835","646",2022-11-21 14:30:00,984,1006,22,136,TRUE,NA,"0.1.4"
"7836","646",2022-11-21 14:45:00,984,1006,22,136,TRUE,NA,"0.1.4"
"7837","646",2022-11-21 15:00:00,984,1006,22,136,TRUE,NA,"0.1.4"
"7838","646",2022-11-21 15:15:00,984,1006,22,136,TRUE,NA,"0.1.4"
"7839","646",2022-11-21 15:30:00,984,1006,22,136,TRUE,NA,"0.1.4"
"7840","646",2022-11-21 15:45:00,984,1006,22,136,TRUE,NA,"0.1.4"
"7841","646",2022-11-21 16:00:00,984,1006,22,136,TRUE,NA,"0.1.4"
"7842","646",2022-11-21 16:15:00,984,1006,22,136,TRUE,NA,"0.1.4"
"7843","646",2022-11-21 16:30:00,984,1006,22,136,TRUE,NA,"0.1.4"
"7844","646",2022-11-21 16:45:00,984,1006,22,136,TRUE,NA,"0.1.4"
"7845","646",2022-11-21 17:00:00,984,1006,22,136,TRUE,NA,"0.1.4"
"7846","646",2022-11-21 17:15:00,984,1006,22,136,TRUE,NA,"0.1.4"
"7847","646",2022-11-21 17:30:00,984,1006,22,136,TRUE,NA,"0.1.4"
"7848","646",2022-11-21 17:45:00,984,1006,22,136,TRUE,NA,"0.1.4"
"7849","646",2022-11-21 18:00:00,984,1006,22,136,TRUE,NA,"0.1.4"
"7850","646",2022-11-21 18:15:00,984,1006,22,136,TRUE,NA,"0.1.4"
"7851","646",2022-11-21 18:30:00,984,1006,22,136,TRUE,NA,"0.1.4"
"7852","646",2022-11-21 18:45:00,984,1006,22,136,TRUE,NA,"0.1.4"
"7853","646",2022-11-21 19:00:00,984,1006,22,136,TRUE,NA,"0.1.4"
"7854","646",2022-11-21 19:15:00,984,1006,22,136,TRUE,NA,"0.1.4"
"7855","646",2022-11-21 19:30:00,984,1006,22,136,TRUE,NA,"0.1.4"
"7856","646",2022-11-21 19:45:00,984,1006,22,136,TRUE,NA,"0.1.4"
"7857","646",2022-11-21 20:00:00,984,1006,22,136,TRUE,NA,"0.1.4"
"7858","646",2022-11-21 20:15:00,984,1006,22,136,TRUE,NA,"0.1.4"
"7859","646",2022-11-21 20:30:00,984,1006,22,136,TRUE,NA,"0.1.4"
"7860","646",2022-11-21 20:45:00,984,1006,22,136,TRUE,NA,"0.1.4"
"7861","646",2022-11-21 21:00:00,984,1006,22,136,TRUE,NA,"0.1.4"
"7862","646",2022-11-21 21:15:00,984,1006,22,136,TRUE,NA,"0.1.4"
"7863","646",2022-11-21 21:30:00,984,1006,22,136,TRUE,NA,"0.1.4"
"7864","646",2022-11-21 21:45:00,984,1006,22,136,TRUE,NA,"0.1.4"
"7865","646",2022-11-21 22:00:00,984,1006,22,136,TRUE,NA,"0.1.4"
"7866","646",2022-11-21 22:15:00,984,1006,22,136,TRUE,NA,"0.1.4"
"7867","646",2022-11-21 22:30:00,984,1006,22,136,TRUE,NA,"0.1.4"
"7868","646",2022-11-21 22:45:00,984,1006,22,136,TRUE,NA,"0.1.4"
"7869","646",2022-11-21 23:00:00,984,1006,22,136,TRUE,NA,"0.1.4"
"7870","646",2022-11-21 23:15:00,984,1006,22,136,TRUE,NA,"0.1.4"
"7871","646",2022-11-21 23:30:00,984,1006,22,136,TRUE,NA,"0.1.4"
"7872","646",2022-11-21 23:45:00,984,1006,22,136,TRUE,NA,"0.1.4"
"7873","646",2022-11-22,984,1006,22,136,TRUE,NA,"0.1.4"
"7874","646",2022-11-22 00:15:00,984,1006,22,136,TRUE,NA,"0.1.4"
"7875","646",2022-11-22 00:30:00,984,1006,22,136,TRUE,NA,"0.1.4"
"7876","646",2022-11-22 00:45:00,984,1006,22,136,TRUE,NA,"0.1.4"
"7877","646",2022-11-22 01:00:00,984,1006,22,136,TRUE,NA,"0.1.4"
"7878","646",2022-11-22 01:15:00,984,1006,22,136,TRUE,NA,"0.1.4"
"7879","646",2022-11-22 01:30:00,984,1006,22,136,TRUE,NA,"0.1.4"
"7880","646",2022-11-22 01:45:00,984,1006,22,136,TRUE,NA,"0.1.4"
"7881","646",2022-11-22 02:00:00,984,1006,22,136,TRUE,NA,"0.1.4"
"7882","646",2022-11-22 02:15:00,984,1006,22,136,TRUE,NA,"0.1.4"
"7883","646",2022-11-22 02:30:00,984,1006,22,136,TRUE,NA,"0.1.4"
"7884","646",2022-11-22 02:45:00,984,1006,22,136,TRUE,NA,"0.1.4"
"7885","646",2022-11-22 03:00:00,984,1006,22,136,TRUE,NA,"0.1.4"
"7886","646",2022-11-22 03:15:00,984,1006,22,136,TRUE,NA,"0.1.4"
"7887","646",2022-11-22 03:30:00,984,1006,22,136,TRUE,NA,"0.1.4"
"7888","646",2022-11-22 03:45:00,984,1006,22,136,TRUE,NA,"0.1.4"
"7889","646",2022-11-22 04:00:00,984,1006,22,136,TRUE,NA,"0.1.4"
"7890","646",2022-11-22 04:15:00,984,1006,22,136,TRUE,NA,"0.1.4"
"7891","646",2022-11-22 04:30:00,984,1006,22,136,TRUE,NA,"0.1.4"
"7892","646",2022-11-22 04:45:00,984,1006,22,136,TRUE,NA,"0.1.4"
"7893","646",2022-11-22 05:00:00,984,1006,22,136,TRUE,NA,"0.1.4"
"7894","646",2022-11-22 05:15:00,984,1006,22,136,TRUE,NA,"0.1.4"
"7895","646",2022-11-22 05:30:00,984,1006,22,136,TRUE,NA,"0.1.4"
"7896","646",2022-11-22 05:45:00,984,1006,22,136,TRUE,NA,"0.1.4"
"7897","646",2022-11-22 06:00:00,984,1006,22,136,TRUE,NA,"0.1.4"
"7898","646",2022-11-22 06:15:00,984,1006,22,136,TRUE,NA,"0.1.4"
"7899","646",2022-11-22 06:30:00,984,1006,22,136,TRUE,NA,"0.1.4"
"7900","646",2022-11-22 06:45:00,984,1006,22,136,TRUE,NA,"0.1.4"
"7901","646",2022-11-22 07:00:00,984,1006,22,136,TRUE,NA,"0.1.4"
"7902","646",2022-11-22 07:15:00,984,1006,22,136,TRUE,NA,"0.1.4"
"7903","646",2022-11-22 07:30:00,984,1006,22,136,TRUE,NA,"0.1.4"
"7904","646",2022-11-22 07:45:00,984,1006,22,136,TRUE,NA,"0.1.4"
"7905","646",2022-11-22 08:00:00,984,1006,22,136,TRUE,NA,"0.1.4"
"7906","646",2022-11-22 08:15:00,984,1006,22,136,TRUE,NA,"0.1.4"
"7907","646",2022-11-22 08:30:00,984,1006,22,136,TRUE,NA,"0.1.4"
"7908","646",2022-11-22 08:45:00,984,1006,22,136,TRUE,NA,"0.1.4"
"7909","646",2022-11-22 09:00:00,984,1006,22,136,TRUE,NA,"0.1.4"
"7910","646",2022-11-22 09:15:00,984,1006,22,136,TRUE,NA,"0.1.4"
"7911","646",2022-11-22 09:30:00,984,1006,22,136,TRUE,NA,"0.1.4"
"7912","646",2022-11-22 09:45:00,984,1006,22,136,TRUE,NA,"0.1.4"
"7913","646",2022-11-22 10:00:00,984,1006,22,136,TRUE,NA,"0.1.4"
"7914","646",2022-11-22 10:15:00,984,1006,22,136,TRUE,NA,"0.1.4"
"7915","646",2022-11-22 10:30:00,984,1006,22,136,TRUE,NA,"0.1.4"
"7916","646",2022-11-22 10:45:00,984,1006,22,136,TRUE,NA,"0.1.4"
"7917","646",2022-11-22 11:00:00,984,1006,22,136,TRUE,NA,"0.1.4"
"7918","646",2022-11-22 11:15:00,984,1006,22,136,TRUE,NA,"0.1.4"
"7919","646",2022-11-22 11:30:00,984,1006,22,136,TRUE,NA,"0.1.4"
"7920","646",2022-11-22 11:45:00,984,1006,22,136,TRUE,NA,"0.1.4"
"7921","646",2022-11-22 12:00:00,984,1006,22,136,TRUE,NA,"0.1.4"
"7922","646",2022-11-22 12:15:00,984,1006,22,136,TRUE,NA,"0.1.4"
"7923","646",2022-11-22 12:30:00,984,1006,22,136,TRUE,NA,"0.1.4"
"7924","646",2022-11-22 12:45:00,984,1006,22,136,TRUE,NA,"0.1.4"
"7925","646",2022-11-22 13:00:00,984,1006,22,136,TRUE,NA,"0.1.4"
"7926","646",2022-11-22 13:15:00,984,1006,22,136,TRUE,NA,"0.1.4"
"7927","646",2022-11-22 13:30:00,984,1006,22,136,TRUE,NA,"0.1.4"
"7928","646",2022-11-22 13:45:00,984,1006,22,136,TRUE,NA,"0.1.4"
"7929","646",2022-11-22 14:00:00,984,1006,22,136,TRUE,NA,"0.1.4"
"7930","646",2022-11-22 14:15:00,984,1006,22,136,TRUE,NA,"0.1.4"
"7931","646",2022-11-22 14:30:00,984,1006,22,136,TRUE,NA,"0.1.4"
"7932","646",2022-11-22 14:45:00,984,1006,22,136,TRUE,NA,"0.1.4"
"7933","646",2022-11-22 15:00:00,984,1006,22,136,TRUE,NA,"0.1.4"
"7934","646",2022-11-22 15:15:00,984,1006,22,136,TRUE,NA,"0.1.4"
"7935","646",2022-11-22 15:30:00,984,1006,22,136,TRUE,NA,"0.1.4"
"7936","646",2022-11-22 15:45:00,984,1006,22,136,TRUE,NA,"0.1.4"
"7937","646",2022-11-22 16:00:00,984,1006,22,136,TRUE,NA,"0.1.4"
"7938","646",2022-11-22 16:15:00,984,1006,22,136,TRUE,NA,"0.1.4"
"7939","646",2022-11-22 16:30:00,984,1006,22,136,TRUE,NA,"0.1.4"
"7940","646",2022-11-22 16:45:00,984,1006,22,136,TRUE,NA,"0.1.4"
"7941","646",2022-11-22 17:00:00,984,1006,22,136,TRUE,NA,"0.1.4"
"7942","646",2022-11-22 17:15:00,984,1006,22,136,TRUE,NA,"0.1.4"
"7943","646",2022-11-22 17:30:00,984,1006,22,136,TRUE,NA,"0.1.4"
"7944","646",2022-11-22 17:45:00,984,1006,22,136,TRUE,NA,"0.1.4"
"7945","646",2022-11-22 18:00:00,984,1006,22,136,TRUE,NA,"0.1.4"
"7946","646",2022-11-22 18:15:00,984,1006,22,136,TRUE,NA,"0.1.4"
"7947","646",2022-11-22 18:30:00,984,1006,22,136,TRUE,NA,"0.1.4"
"7948","646",2022-11-22 18:45:00,984,1006,22,136,TRUE,NA,"0.1.4"
"7949","646",2022-11-22 19:00:00,984,1006,22,136,TRUE,NA,"0.1.4"
"7950","646",2022-11-22 19:15:00,984,1006,22,136,TRUE,NA,"0.1.4"
"7951","646",2022-11-22 19:30:00,984,1006,22,136,TRUE,NA,"0.1.4"
"7952","646",2022-11-22 19:45:00,984,1006,22,136,TRUE,NA,"0.1.4"
"7953","646",2022-11-22 20:00:00,984,1006,22,136,TRUE,NA,"0.1.4"
"7954","646",2022-11-22 20:15:00,984,1006,22,136,TRUE,NA,"0.1.4"
"7955","646",2022-11-22 20:30:00,984,1006,22,136,TRUE,NA,"0.1.4"
"7956","646",2022-11-22 20:45:00,984,1006,22,136,TRUE,NA,"0.1.4"
"7957","646",2022-11-22 21:00:00,984,1006,22,136,TRUE,NA,"0.1.4"
"7958","646",2022-11-22 21:15:00,984,1006,22,136,TRUE,NA,"0.1.4"
"7959","646",2022-11-22 21:30:00,984,1006,22,136,TRUE,NA,"0.1.4"
"7960","646",2022-11-22 21:45:00,984,1006,22,136,TRUE,NA,"0.1.4"
"7961","646",2022-11-22 22:00:00,984,1006,22,136,TRUE,NA,"0.1.4"
"7962","646",2022-11-22 22:15:00,984,1006,22,136,TRUE,NA,"0.1.4"
"7963","646",2022-11-22 22:30:00,984,1006,22,136,TRUE,NA,"0.1.4"
"7964","646",2022-11-22 22:45:00,984,1006,22,136,TRUE,NA,"0.1.4"
"7965","646",2022-11-22 23:00:00,984,1006,22,136,TRUE,NA,"0.1.4"
"7966","646",2022-11-22 23:15:00,984,1006,22,136,TRUE,NA,"0.1.4"
"7967","646",2022-11-22 23:30:00,984,1006,22,136,TRUE,NA,"0.1.4"
"7968","646",2022-11-22 23:45:00,984,1006,22,136,TRUE,NA,"0.1.4"
"7969","646",2022-11-23,984,1006,22,136,TRUE,NA,"0.1.4"
"7970","646",2022-11-23 00:15:00,984,1006,22,136,TRUE,NA,"0.1.4"
"7971","646",2022-11-23 00:30:00,984,1006,22,136,TRUE,NA,"0.1.4"
"7972","646",2022-11-23 00:45:00,984,1006,22,136,TRUE,NA,"0.1.4"
"7973","646",2022-11-23 01:00:00,983,1006,23,136,TRUE,NA,"0.1.4"
"7974","646",2022-11-23 01:15:00,984,1006,22,136,TRUE,NA,"0.1.4"
"7975","646",2022-11-23 01:30:00,984,1006,22,136,TRUE,NA,"0.1.4"
"7976","646",2022-11-23 01:45:00,984,1006,22,136,TRUE,NA,"0.1.4"
"7977","646",2022-11-23 02:00:00,984,1006,22,136,TRUE,NA,"0.1.4"
"7978","646",2022-11-23 02:15:00,984,1006,22,136,TRUE,NA,"0.1.4"
"7979","646",2022-11-23 02:30:00,984,1006,22,136,TRUE,NA,"0.1.4"
"7980","646",2022-11-23 02:45:00,984,1006,22,136,TRUE,NA,"0.1.4"
"7981","646",2022-11-23 03:00:00,983,1006,23,136,TRUE,NA,"0.1.4"
"7982","646",2022-11-23 03:15:00,984,1006,22,136,TRUE,NA,"0.1.4"
"7983","646",2022-11-23 03:30:00,983,1006,23,136,TRUE,NA,"0.1.4"
"7984","646",2022-11-23 03:45:00,983,1006,23,136,TRUE,NA,"0.1.4"
"7985","646",2022-11-23 04:00:00,983,1006,23,136,TRUE,NA,"0.1.4"
"7986","646",2022-11-23 04:15:00,983,1006,23,136,TRUE,NA,"0.1.4"
"7987","646",2022-11-23 04:30:00,983,1006,23,136,TRUE,NA,"0.1.4"
"7988","646",2022-11-23 04:45:00,983,1006,23,136,TRUE,NA,"0.1.4"
"7989","646",2022-11-23 05:00:00,983,1006,23,136,TRUE,NA,"0.1.4"
"7990","646",2022-11-23 05:15:00,983,1006,23,136,TRUE,NA,"0.1.4"
"7991","646",2022-11-23 05:30:00,984,1006,22,136,TRUE,NA,"0.1.4"
"7992","646",2022-11-23 05:45:00,984,1006,22,136,TRUE,NA,"0.1.4"
"7993","646",2022-11-23 06:00:00,984,1006,22,136,TRUE,NA,"0.1.4"
"7994","646",2022-11-23 06:15:00,984,1006,22,136,TRUE,NA,"0.1.4"
"7995","646",2022-11-23 06:30:00,984,1006,22,136,TRUE,NA,"0.1.4"
"7996","646",2022-11-23 06:45:00,983,1006,23,136,TRUE,NA,"0.1.4"
"7997","646",2022-11-23 07:00:00,983,1006,23,136,TRUE,NA,"0.1.4"
"7998","646",2022-11-23 07:15:00,983,1006,23,136,TRUE,NA,"0.1.4"
"7999","646",2022-11-23 07:30:00,983,1006,23,136,TRUE,NA,"0.1.4"
"8000","646",2022-11-23 07:45:00,983,1006,23,136,TRUE,NA,"0.1.4"
"8001","646",2022-11-23 08:00:00,984,1006,22,136,TRUE,NA,"0.1.4"
"8002","646",2022-11-23 08:15:00,983,1006,23,136,TRUE,NA,"0.1.4"
"8003","646",2022-11-23 08:30:00,983,1006,23,136,TRUE,NA,"0.1.4"
"8004","646",2022-11-23 08:45:00,983,1006,23,136,TRUE,NA,"0.1.4"
"8005","646",2022-11-23 09:00:00,983,1006,23,136,TRUE,NA,"0.1.4"
"8006","646",2022-11-23 09:15:00,983,1006,23,136,TRUE,NA,"0.1.4"
"8007","646",2022-11-23 09:30:00,983,1006,23,136,TRUE,NA,"0.1.4"
"8008","646",2022-11-23 09:45:00,983,1006,23,136,TRUE,NA,"0.1.4"
"8009","646",2022-11-23 10:00:00,983,1006,23,136,TRUE,NA,"0.1.4"
"8010","646",2022-11-23 10:15:00,983,1006,23,136,TRUE,NA,"0.1.4"
"8011","646",2022-11-23 10:30:00,983,1006,23,136,TRUE,NA,"0.1.4"
"8012","646",2022-11-23 10:45:00,983,1006,23,136,TRUE,NA,"0.1.4"
"8013","646",2022-11-23 11:00:00,983,1006,23,136,TRUE,NA,"0.1.4"
"8014","646",2022-11-23 11:15:00,983,1006,23,136,TRUE,NA,"0.1.4"
"8015","646",2022-11-23 11:30:00,983,1006,23,136,TRUE,NA,"0.1.4"
"8016","646",2022-11-23 11:45:00,983,1006,23,136,TRUE,NA,"0.1.4"
"8017","646",2022-11-23 12:00:00,983,1006,23,136,TRUE,NA,"0.1.4"
"8018","646",2022-11-23 12:15:00,983,1006,23,136,TRUE,NA,"0.1.4"
"8019","646",2022-11-23 12:30:00,984,1006,22,136,TRUE,NA,"0.1.4"
"8020","646",2022-11-23 12:45:00,984,1006,22,136,TRUE,NA,"0.1.4"
"8021","646",2022-11-23 13:00:00,983,1006,23,136,TRUE,NA,"0.1.4"
"8022","646",2022-11-23 13:15:00,983,1006,23,136,TRUE,NA,"0.1.4"
"8023","646",2022-11-23 13:30:00,983,1006,23,136,TRUE,NA,"0.1.4"
"8024","646",2022-11-23 13:45:00,983,1006,23,136,TRUE,NA,"0.1.4"
"8025","646",2022-11-23 14:00:00,983,1006,23,136,TRUE,NA,"0.1.4"
"8026","646",2022-11-23 14:15:00,983,1006,23,136,TRUE,NA,"0.1.4"
"8027","646",2022-11-23 14:30:00,983,1006,23,136,TRUE,NA,"0.1.4"
"8028","646",2022-11-23 14:45:00,983,1006,23,136,TRUE,NA,"0.1.4"
"8029","646",2022-11-23 15:00:00,983,1006,23,136,TRUE,NA,"0.1.4"
"8030","646",2022-11-23 15:15:00,983,1006,23,136,TRUE,NA,"0.1.4"
"8031","646",2022-11-23 15:30:00,983,1006,23,136,TRUE,NA,"0.1.4"
"8032","646",2022-11-23 15:45:00,983,1006,23,136,TRUE,NA,"0.1.4"
"8033","646",2022-11-23 16:00:00,983,1006,23,136,TRUE,NA,"0.1.4"
"8034","646",2022-11-23 16:15:00,983,1006,23,136,TRUE,NA,"0.1.4"
"8035","646",2022-11-23 16:30:00,983,1006,23,136,TRUE,NA,"0.1.4"
"8036","646",2022-11-23 16:45:00,983,1006,23,136,TRUE,NA,"0.1.4"
"8037","646",2022-11-23 17:00:00,983,1006,23,136,TRUE,NA,"0.1.4"
"8038","646",2022-11-23 17:15:00,983,1006,23,136,TRUE,NA,"0.1.4"
"8039","646",2022-11-23 17:30:00,983,1006,23,136,TRUE,NA,"0.1.4"
"8040","646",2022-11-23 17:45:00,983,1006,23,136,TRUE,NA,"0.1.4"
"8041","646",2022-11-23 18:00:00,983,1006,23,136,TRUE,NA,"0.1.4"
"8042","646",2022-11-23 18:15:00,983,1006,23,136,TRUE,NA,"0.1.4"
"8043","646",2022-11-23 18:30:00,983,1006,23,136,TRUE,NA,"0.1.4"
"8044","646",2022-11-23 18:45:00,983,1006,23,136,TRUE,NA,"0.1.4"
"8045","646",2022-11-23 19:00:00,983,1006,23,136,TRUE,NA,"0.1.4"
"8046","646",2022-11-23 19:15:00,983,1006,23,136,TRUE,NA,"0.1.4"
"8047","646",2022-11-23 19:30:00,983,1006,23,136,TRUE,NA,"0.1.4"
"8048","646",2022-11-23 19:45:00,983,1006,23,136,TRUE,NA,"0.1.4"
"8049","646",2022-11-23 20:00:00,983,1006,23,136,TRUE,NA,"0.1.4"
"8050","646",2022-11-23 20:15:00,983,1006,23,136,TRUE,NA,"0.1.4"
"8051","646",2022-11-23 20:30:00,983,1006,23,136,TRUE,NA,"0.1.4"
"8052","646",2022-11-23 20:45:00,983,1006,23,136,TRUE,NA,"0.1.4"
"8053","646",2022-11-23 21:00:00,983,1006,23,136,TRUE,NA,"0.1.4"
"8054","646",2022-11-23 21:15:00,983,1006,23,136,TRUE,NA,"0.1.4"
"8055","646",2022-11-23 21:30:00,983,1006,23,136,TRUE,NA,"0.1.4"
"8056","646",2022-11-23 21:45:00,983,1006,23,136,TRUE,NA,"0.1.4"
"8057","646",2022-11-23 22:00:00,983,1006,23,136,FALSE,NA,"0.1.4"
"8058","646",2022-11-23 22:15:00,983,1006,23,136,FALSE,NA,"0.1.4"
"8059","646",2022-11-23 22:30:00,983,1006,23,136,FALSE,NA,"0.1.4"
"8060","646",2022-11-23 22:45:00,983,1006,23,136,FALSE,NA,"0.1.4"
"8061","646",2022-11-23 23:00:00,983,1006,23,136,FALSE,NA,"0.1.4"
"8062","646",2022-11-23 23:15:00,983,1006,23,136,FALSE,NA,"0.1.4"
"8063","646",2022-11-23 23:30:00,983,1006,23,136,TRUE,NA,"0.1.4"
"8064","646",2022-11-23 23:45:00,983,1006,23,136,TRUE,NA,"0.1.4"
"8065","646",2022-11-24,983,1006,23,136,TRUE,NA,"0.1.4"
"8066","646",2022-11-24 00:15:00,983,1006,23,136,TRUE,NA,"0.1.4"
"8067","646",2022-11-24 00:30:00,983,1006,23,136,TRUE,NA,"0.1.4"
"8068","646",2022-11-24 00:45:00,983,1006,23,136,TRUE,NA,"0.1.4"
"8069","646",2022-11-24 01:00:00,983,1006,23,136,TRUE,NA,"0.1.4"
"8070","646",2022-11-24 01:15:00,983,1006,23,136,TRUE,NA,"0.1.4"
"8071","646",2022-11-24 01:30:00,983,1006,23,136,TRUE,NA,"0.1.4"
"8072","646",2022-11-24 01:45:00,983,1006,23,136,TRUE,NA,"0.1.4"
"8073","646",2022-11-24 02:00:00,983,1006,23,136,TRUE,NA,"0.1.4"
"8074","646",2022-11-24 02:15:00,983,1006,23,136,TRUE,NA,"0.1.4"
"8075","646",2022-11-24 02:30:00,983,1006,23,136,TRUE,NA,"0.1.4"
"8076","646",2022-11-24 02:45:00,983,1006,23,136,TRUE,NA,"0.1.4"
"8077","646",2022-11-24 03:00:00,983,1006,23,136,TRUE,NA,"0.1.4"
"8078","646",2022-11-24 03:15:00,983,1006,23,136,TRUE,NA,"0.1.4"
"8079","646",2022-11-24 03:30:00,983,1006,23,136,TRUE,NA,"0.1.4"
"8080","646",2022-11-24 03:45:00,983,1006,23,136,TRUE,NA,"0.1.4"
"8081","646",2022-11-24 04:00:00,983,1006,23,136,TRUE,NA,"0.1.4"
"8082","646",2022-11-24 04:15:00,983,1006,23,136,TRUE,NA,"0.1.4"
"8083","646",2022-11-24 04:30:00,983,1006,23,136,TRUE,NA,"0.1.4"
"8084","646",2022-11-24 04:45:00,983,1006,23,136,TRUE,NA,"0.1.4"
"8085","646",2022-11-24 05:00:00,983,1006,23,136,TRUE,NA,"0.1.4"
"8086","646",2022-11-24 05:15:00,983,1006,23,136,TRUE,NA,"0.1.4"
"8087","646",2022-11-24 05:30:00,983,1006,23,136,TRUE,NA,"0.1.4"
"8088","646",2022-11-24 05:45:00,983,1006,23,136,TRUE,NA,"0.1.4"
"8089","646",2022-11-24 06:00:00,983,1006,23,136,TRUE,NA,"0.1.4"
"8090","646",2022-11-24 06:15:00,983,1006,23,136,TRUE,NA,"0.1.4"
"8091","646",2022-11-24 06:30:00,983,1006,23,136,TRUE,NA,"0.1.4"
"8092","646",2022-11-24 06:45:00,983,1006,23,136,TRUE,NA,"0.1.4"
"8093","646",2022-11-24 07:00:00,983,1006,23,136,TRUE,NA,"0.1.4"
"8094","646",2022-11-24 07:15:00,983,1006,23,136,TRUE,NA,"0.1.4"
"8095","646",2022-11-24 07:30:00,983,1006,23,136,TRUE,NA,"0.1.4"
"8096","646",2022-11-24 07:45:00,983,1006,23,136,TRUE,NA,"0.1.4"
"8097","646",2022-11-24 08:00:00,983,1006,23,136,TRUE,NA,"0.1.4"
"8098","646",2022-11-24 08:15:00,983,1006,23,136,TRUE,NA,"0.1.4"
"8099","646",2022-11-24 08:30:00,983,1006,23,136,TRUE,NA,"0.1.4"
"8100","646",2022-11-24 08:45:00,983,1006,23,136,TRUE,NA,"0.1.4"
"8101","646",2022-11-24 09:00:00,983,1006,23,136,TRUE,NA,"0.1.4"
"8102","646",2022-11-24 09:15:00,983,1006,23,136,TRUE,NA,"0.1.4"
"8103","646",2022-11-24 09:30:00,983,1006,23,136,TRUE,NA,"0.1.4"
"8104","646",2022-11-24 09:45:00,983,1006,23,136,TRUE,NA,"0.1.4"
"8105","646",2022-11-24 10:00:00,983,1006,23,136,TRUE,NA,"0.1.4"
"8106","646",2022-11-24 10:15:00,983,1006,23,136,TRUE,NA,"0.1.4"
"8107","646",2022-11-24 10:30:00,983,1006,23,136,TRUE,NA,"0.1.4"
"8108","646",2022-11-24 10:45:00,983,1006,23,136,TRUE,NA,"0.1.4"
"8109","646",2022-11-24 11:00:00,983,1006,23,136,TRUE,NA,"0.1.4"
"8110","646",2022-11-24 11:15:00,983,1006,23,136,TRUE,NA,"0.1.4"
"8111","646",2022-11-24 11:30:00,983,1006,23,136,TRUE,NA,"0.1.4"
"8112","646",2022-11-24 11:45:00,983,1006,23,136,TRUE,NA,"0.1.4"
"8113","646",2022-11-24 12:00:00,983,1006,23,136,TRUE,NA,"0.1.4"
"8114","646",2022-11-24 12:15:00,983,1006,23,136,TRUE,NA,"0.1.4"
"8115","646",2022-11-24 12:30:00,983,1006,23,136,TRUE,NA,"0.1.4"
"8116","646",2022-11-24 12:45:00,983,1006,23,136,TRUE,NA,"0.1.4"
"8117","646",2022-11-24 13:00:00,983,1006,23,136,TRUE,NA,"0.1.4"
"8118","646",2022-11-24 13:15:00,983,1006,23,136,TRUE,NA,"0.1.4"
"8119","646",2022-11-24 13:30:00,983,1006,23,136,TRUE,NA,"0.1.4"
"8120","646",2022-11-24 13:45:00,983,1006,23,136,TRUE,NA,"0.1.4"
"8121","646",2022-11-24 14:00:00,983,1006,23,136,TRUE,NA,"0.1.4"
"8122","646",2022-11-24 14:15:00,983,1006,23,136,TRUE,NA,"0.1.4"
"8123","646",2022-11-24 14:30:00,983,1006,23,136,TRUE,NA,"0.1.4"
"8124","646",2022-11-24 14:45:00,983,1006,23,136,TRUE,NA,"0.1.4"
"8125","646",2022-11-24 15:00:00,983,1006,23,136,TRUE,NA,"0.1.4"
"8126","646",2022-11-24 15:15:00,983,1006,23,136,TRUE,NA,"0.1.4"
"8127","646",2022-11-24 15:30:00,983,1006,23,136,TRUE,NA,"0.1.4"
"8128","646",2022-11-24 15:45:00,983,1006,23,136,TRUE,NA,"0.1.4"
"8129","646",2022-11-24 16:00:00,983,1006,23,136,TRUE,NA,"0.1.4"
"8130","646",2022-11-24 16:15:00,983,1006,23,136,TRUE,NA,"0.1.4"
"8131","646",2022-11-24 16:30:00,983,1006,23,136,TRUE,NA,"0.1.4"
"8132","646",2022-11-24 16:45:00,983,1006,23,136,TRUE,NA,"0.1.4"
"8133","646",2022-11-24 17:00:00,983,1006,23,136,TRUE,NA,"0.1.4"
"8134","646",2022-11-24 17:15:00,983,1006,23,136,TRUE,NA,"0.1.4"
"8135","646",2022-11-24 17:30:00,983,1006,23,136,TRUE,NA,"0.1.4"
"8136","646",2022-11-24 17:45:00,983,1006,23,136,TRUE,NA,"0.1.4"
"8137","646",2022-11-24 18:00:00,983,1006,23,136,TRUE,NA,"0.1.4"
"8138","646",2022-11-24 18:15:00,983,1006,23,136,TRUE,NA,"0.1.4"
"8139","646",2022-11-24 18:30:00,983,1006,23,136,TRUE,NA,"0.1.4"
"8140","646",2022-11-24 18:45:00,983,1006,23,136,TRUE,NA,"0.1.4"
"8141","646",2022-11-24 19:00:00,983,1006,23,136,TRUE,NA,"0.1.4"
"8142","646",2022-11-24 19:15:00,983,1006,23,136,TRUE,NA,"0.1.4"
"8143","646",2022-11-24 19:30:00,983,1006,23,136,TRUE,NA,"0.1.4"
"8144","646",2022-11-24 19:45:00,983,1006,23,136,TRUE,NA,"0.1.4"
"8145","646",2022-11-24 20:00:00,983,1006,23,136,TRUE,NA,"0.1.4"
"8146","646",2022-11-24 20:15:00,983,1006,23,136,TRUE,NA,"0.1.4"
"8147","646",2022-11-24 20:30:00,983,1006,23,136,TRUE,NA,"0.1.4"
"8148","646",2022-11-24 20:45:00,983,1006,23,136,TRUE,NA,"0.1.4"
"8149","646",2022-11-24 21:00:00,983,1006,23,136,TRUE,NA,"0.1.4"
"8150","646",2022-11-24 21:15:00,983,1006,23,136,TRUE,NA,"0.1.4"
"8151","646",2022-11-24 21:30:00,983,1006,23,136,TRUE,NA,"0.1.4"
"8152","646",2022-11-24 21:45:00,983,1006,23,136,TRUE,NA,"0.1.4"
"8153","646",2022-11-24 22:00:00,983,1006,23,136,TRUE,NA,"0.1.4"
"8154","646",2022-11-24 22:15:00,983,1006,23,136,TRUE,NA,"0.1.4"
"8155","646",2022-11-24 22:30:00,983,1006,23,136,TRUE,NA,"0.1.4"
"8156","646",2022-11-24 22:45:00,983,1006,23,136,TRUE,NA,"0.1.4"
"8157","646",2022-11-24 23:00:00,983,1006,23,136,TRUE,NA,"0.1.4"
"8158","646",2022-11-24 23:15:00,983,1006,23,136,TRUE,NA,"0.1.4"
"8159","646",2022-11-24 23:30:00,983,1006,23,136,TRUE,NA,"0.1.4"
"8160","646",2022-11-24 23:45:00,983,1006,23,136,TRUE,NA,"0.1.4"
"8161","646",2022-11-25,983,1006,23,136,TRUE,NA,"0.1.4"
"8162","646",2022-11-25 00:15:00,983,1006,23,136,TRUE,NA,"0.1.4"
"8163","646",2022-11-25 00:30:00,983,1006,23,136,TRUE,NA,"0.1.4"
"8164","646",2022-11-25 00:45:00,983,1006,23,136,TRUE,NA,"0.1.4"
"8165","646",2022-11-25 01:00:00,983,1006,23,136,TRUE,NA,"0.1.4"
"8166","646",2022-11-25 01:15:00,983,1006,23,136,TRUE,NA,"0.1.4"
"8167","646",2022-11-25 01:30:00,983,1006,23,136,TRUE,NA,"0.1.4"
"8168","646",2022-11-25 01:45:00,983,1006,23,136,TRUE,NA,"0.1.4"
"8169","646",2022-11-25 02:00:00,983,1006,23,136,TRUE,NA,"0.1.4"
"8170","646",2022-11-25 02:15:00,983,1006,23,136,TRUE,NA,"0.1.4"
"8171","646",2022-11-25 02:30:00,983,1006,23,136,TRUE,NA,"0.1.4"
"8172","646",2022-11-25 02:45:00,983,1006,23,136,TRUE,NA,"0.1.4"
"8173","646",2022-11-25 03:00:00,983,1006,23,136,TRUE,NA,"0.1.4"
"8174","646",2022-11-25 03:15:00,983,1006,23,136,TRUE,NA,"0.1.4"
"8175","646",2022-11-25 03:30:00,983,1006,23,136,TRUE,NA,"0.1.4"
"8176","646",2022-11-25 03:45:00,983,1006,23,136,TRUE,NA,"0.1.4"
"8177","646",2022-11-25 04:00:00,983,1006,23,136,TRUE,NA,"0.1.4"
"8178","646",2022-11-25 04:15:00,983,1006,23,136,TRUE,NA,"0.1.4"
"8179","646",2022-11-25 04:30:00,983,1006,23,136,TRUE,NA,"0.1.4"
"8180","646",2022-11-25 04:45:00,983,1006,23,136,TRUE,NA,"0.1.4"
"8181","646",2022-11-25 05:00:00,983,1006,23,136,TRUE,NA,"0.1.4"
"8182","646",2022-11-25 05:15:00,983,1006,23,136,TRUE,NA,"0.1.4"
"8183","646",2022-11-25 05:30:00,983,1006,23,136,TRUE,NA,"0.1.4"
"8184","646",2022-11-25 05:45:00,983,1006,23,136,TRUE,NA,"0.1.4"
"8185","646",2022-11-25 06:00:00,983,1006,23,136,TRUE,NA,"0.1.4"
"8186","646",2022-11-25 06:15:00,983,1006,23,136,TRUE,NA,"0.1.4"
"8187","646",2022-11-25 06:30:00,983,1006,23,136,TRUE,NA,"0.1.4"
"8188","646",2022-11-25 06:45:00,983,1006,23,136,TRUE,NA,"0.1.4"
"8189","646",2022-11-25 07:00:00,983,1006,23,136,TRUE,NA,"0.1.4"
"8190","646",2022-11-25 07:15:00,983,1006,23,136,TRUE,NA,"0.1.4"
"8191","646",2022-11-25 07:30:00,983,1006,23,136,TRUE,NA,"0.1.4"
"8192","646",2022-11-25 07:45:00,983,1006,23,136,TRUE,NA,"0.1.4"
"8193","646",2022-11-25 08:00:00,983,1006,23,136,TRUE,NA,"0.1.4"
"8194","646",2022-11-25 08:15:00,983,1006,23,136,TRUE,NA,"0.1.4"
"8195","646",2022-11-25 08:30:00,983,1006,23,136,TRUE,NA,"0.1.4"
"8196","646",2022-11-25 08:45:00,983,1006,23,136,TRUE,NA,"0.1.4"
"8197","646",2022-11-25 09:00:00,983,1006,23,136,TRUE,NA,"0.1.4"
"8198","646",2022-11-25 09:15:00,983,1006,23,136,TRUE,NA,"0.1.4"
"8199","646",2022-11-25 09:30:00,983,1006,23,136,TRUE,NA,"0.1.4"
"8200","646",2022-11-25 09:45:00,983,1006,23,136,TRUE,NA,"0.1.4"
"8201","646",2022-11-25 10:00:00,983,1006,23,136,TRUE,NA,"0.1.4"
"8202","646",2022-11-25 10:15:00,983,1006,23,136,TRUE,NA,"0.1.4"
"8203","646",2022-11-25 10:30:00,983,1006,23,136,TRUE,NA,"0.1.4"
"8204","646",2022-11-25 10:45:00,983,1006,23,136,TRUE,NA,"0.1.4"
"8205","646",2022-11-25 11:00:00,983,1006,23,136,TRUE,NA,"0.1.4"
"8206","646",2022-11-25 11:15:00,983,1006,23,136,TRUE,NA,"0.1.4"
"8207","646",2022-11-25 11:30:00,983,1006,23,136,TRUE,NA,"0.1.4"
"8208","646",2022-11-25 11:45:00,983,1006,23,136,TRUE,NA,"0.1.4"
"8209","646",2022-11-25 12:00:00,983,1006,23,136,TRUE,NA,"0.1.4"
"8210","646",2022-11-25 12:15:00,983,1006,23,136,TRUE,NA,"0.1.4"
"8211","646",2022-11-25 12:30:00,983,1006,23,136,TRUE,NA,"0.1.4"
"8212","646",2022-11-25 12:45:00,983,1006,23,136,TRUE,NA,"0.1.4"
"8213","646",2022-11-25 13:00:00,983,1006,23,136,TRUE,NA,"0.1.4"
"8214","646",2022-11-25 13:15:00,983,1006,23,136,TRUE,NA,"0.1.4"
"8215","646",2022-11-25 13:30:00,983,1006,23,136,TRUE,NA,"0.1.4"
"8216","646",2022-11-25 13:45:00,983,1006,23,136,TRUE,NA,"0.1.4"
"8217","646",2022-11-25 14:00:00,983,1006,23,136,TRUE,NA,"0.1.4"
"8218","646",2022-11-25 14:15:00,983,1006,23,136,TRUE,NA,"0.1.4"
"8219","646",2022-11-25 14:30:00,983,1006,23,136,TRUE,NA,"0.1.4"
"8220","646",2022-11-25 14:45:00,983,1006,23,136,TRUE,NA,"0.1.4"
"8221","646",2022-11-25 15:00:00,983,1006,23,136,TRUE,NA,"0.1.4"
"8222","646",2022-11-25 15:15:00,983,1006,23,136,TRUE,NA,"0.1.4"
"8223","646",2022-11-25 15:30:00,983,1006,23,136,TRUE,NA,"0.1.4"
"8224","646",2022-11-25 15:45:00,983,1006,23,136,TRUE,NA,"0.1.4"
"8225","646",2022-11-25 16:00:00,983,1006,23,136,TRUE,NA,"0.1.4"
"8226","646",2022-11-25 16:15:00,983,1006,23,136,TRUE,NA,"0.1.4"
"8227","646",2022-11-25 16:30:00,983,1006,23,136,TRUE,NA,"0.1.4"
"8228","646",2022-11-25 16:45:00,983,1006,23,136,TRUE,NA,"0.1.4"
"8229","646",2022-11-25 17:00:00,983,1006,23,136,TRUE,NA,"0.1.4"
"8230","646",2022-11-25 17:15:00,983,1006,23,136,TRUE,NA,"0.1.4"
"8231","646",2022-11-25 17:30:00,983,1006,23,136,TRUE,NA,"0.1.4"
"8232","646",2022-11-25 17:45:00,983,1006,23,136,TRUE,NA,"0.1.4"
"8233","646",2022-11-25 18:00:00,983,1006,23,136,TRUE,NA,"0.1.4"
"8234","646",2022-11-25 18:15:00,983,1006,23,136,TRUE,NA,"0.1.4"
"8235","646",2022-11-25 18:30:00,983,1006,23,136,TRUE,NA,"0.1.4"
"8236","646",2022-11-25 18:45:00,983,1006,23,136,TRUE,NA,"0.1.4"
"8237","646",2022-11-25 19:00:00,983,1006,23,136,TRUE,NA,"0.1.4"
"8238","646",2022-11-25 19:15:00,983,1006,23,136,TRUE,NA,"0.1.4"
"8239","646",2022-11-25 19:30:00,983,1006,23,136,TRUE,NA,"0.1.4"
"8240","646",2022-11-25 19:45:00,983,1006,23,136,TRUE,NA,"0.1.4"
"8241","646",2022-11-25 20:00:00,983,1006,23,136,TRUE,NA,"0.1.4"
"8242","646",2022-11-25 20:15:00,983,1006,23,136,TRUE,NA,"0.1.4"
"8243","646",2022-11-25 20:30:00,983,1006,23,136,TRUE,NA,"0.1.4"
"8244","646",2022-11-25 20:45:00,983,1006,23,136,FALSE,NA,"0.1.4"
"8245","646",2022-11-25 21:00:00,983,1006,23,136,FALSE,NA,"0.1.4"
"8246","646",2022-11-25 21:15:00,983,1006,23,136,FALSE,NA,"0.1.4"
"8247","646",2022-11-25 21:30:00,983,1006,23,136,FALSE,NA,"0.1.4"
"8248","646",2022-11-25 21:45:00,983,1006,23,136,FALSE,NA,"0.1.4"
"8249","646",2022-11-25 22:00:00,983,1006,23,136,FALSE,NA,"0.1.4"
"8250","646",2022-11-25 22:15:00,983,1006,23,136,FALSE,NA,"0.1.4"
"8251","646",2022-11-25 22:30:00,983,1006,23,136,FALSE,NA,"0.1.4"
"8252","646",2022-11-25 22:45:00,983,1006,23,136,FALSE,NA,"0.1.4"
"8253","646",2022-11-25 23:00:00,983,1006,23,136,FALSE,NA,"0.1.4"
"8254","646",2022-11-25 23:15:00,983,1006,23,136,FALSE,NA,"0.1.4"
"8255","646",2022-11-25 23:30:00,983,1006,23,136,FALSE,NA,"0.1.4"
"8256","646",2022-11-25 23:45:00,983,1006,23,136,FALSE,NA,"0.1.4"
"8257","646",2022-11-26,983,1006,23,136,FALSE,NA,"0.1.4"
"8258","646",2022-11-26 00:15:00,983,1006,23,136,FALSE,NA,"0.1.4"
"8259","646",2022-11-26 00:30:00,983,1006,23,136,FALSE,NA,"0.1.4"
"8260","646",2022-11-26 00:45:00,983,1006,23,136,FALSE,NA,"0.1.4"
"8261","646",2022-11-26 01:00:00,983,1006,23,136,FALSE,NA,"0.1.4"
"8262","646",2022-11-26 01:15:00,983,1006,23,136,FALSE,NA,"0.1.4"
"8263","646",2022-11-26 01:30:00,983,1006,23,136,FALSE,NA,"0.1.4"
"8264","646",2022-11-26 01:45:00,983,1006,23,136,FALSE,NA,"0.1.4"
"8265","646",2022-11-26 02:00:00,983,1006,23,136,FALSE,NA,"0.1.4"
"8266","646",2022-11-26 02:15:00,984,1006,22,136,FALSE,NA,"0.1.4"
"8267","646",2022-11-26 02:30:00,983,1006,23,136,FALSE,NA,"0.1.4"
"8268","646",2022-11-26 02:45:00,983,1006,23,136,FALSE,NA,"0.1.4"
"8269","646",2022-11-26 03:00:00,983,1006,23,136,FALSE,NA,"0.1.4"
"8270","646",2022-11-26 03:15:00,983,1006,23,136,FALSE,NA,"0.1.4"
"8271","646",2022-11-26 03:30:00,983,1006,23,136,FALSE,NA,"0.1.4"
"8272","646",2022-11-26 03:45:00,983,1006,23,136,FALSE,NA,"0.1.4"
"8273","646",2022-11-26 04:00:00,983,1006,23,136,FALSE,NA,"0.1.4"
"8274","646",2022-11-26 04:15:00,983,1006,23,136,FALSE,NA,"0.1.4"
"8275","646",2022-11-26 04:30:00,983,1006,23,136,FALSE,NA,"0.1.4"
"8276","646",2022-11-26 04:45:00,983,1006,23,136,FALSE,NA,"0.1.4"
"8277","646",2022-11-26 05:00:00,983,1006,23,136,FALSE,NA,"0.1.4"
"8278","646",2022-11-26 05:15:00,984,1006,22,136,FALSE,NA,"0.1.4"
"8279","646",2022-11-26 05:30:00,983,1006,23,136,FALSE,NA,"0.1.4"
"8280","646",2022-11-26 05:45:00,983,1006,23,136,FALSE,NA,"0.1.4"
"8281","646",2022-11-26 06:00:00,983,1006,23,136,FALSE,NA,"0.1.4"
"8282","646",2022-11-26 06:15:00,983,1006,23,136,FALSE,NA,"0.1.4"
"8283","646",2022-11-26 06:30:00,983,1006,23,136,FALSE,NA,"0.1.4"
"8284","646",2022-11-26 06:45:00,983,1006,23,136,TRUE,NA,"0.1.4"
"8285","646",2022-11-26 07:00:00,984,1006,22,136,TRUE,NA,"0.1.4"
"8286","646",2022-11-26 07:15:00,983,1006,23,136,TRUE,NA,"0.1.4"
"8287","646",2022-11-26 07:30:00,984,1006,22,136,TRUE,NA,"0.1.4"
"8288","646",2022-11-26 07:45:00,983,1006,23,136,TRUE,NA,"0.1.4"
"8289","646",2022-11-26 08:00:00,983,1006,23,136,TRUE,NA,"0.1.4"
"8290","646",2022-11-26 08:15:00,984,1006,22,136,TRUE,NA,"0.1.4"
"8291","646",2022-11-26 08:30:00,983,1006,23,136,TRUE,NA,"0.1.4"
"8292","646",2022-11-26 08:45:00,983,1006,23,136,TRUE,NA,"0.1.4"
"8293","646",2022-11-26 09:00:00,983,1006,23,136,TRUE,NA,"0.1.4"
"8294","646",2022-11-26 09:15:00,983,1006,23,136,TRUE,NA,"0.1.4"
"8295","646",2022-11-26 09:30:00,983,1006,23,136,TRUE,NA,"0.1.4"
"8296","646",2022-11-26 09:45:00,984,1006,22,136,TRUE,NA,"0.1.4"
"8297","646",2022-11-26 10:00:00,983,1006,23,136,TRUE,NA,"0.1.4"
"8298","646",2022-11-26 10:15:00,984,1006,22,136,TRUE,NA,"0.1.4"
"8299","646",2022-11-26 10:30:00,983,1006,23,136,TRUE,NA,"0.1.4"
"8300","646",2022-11-26 10:45:00,984,1006,22,136,TRUE,NA,"0.1.4"
"8301","646",2022-11-26 11:00:00,984,1006,22,136,TRUE,NA,"0.1.4"
"8302","646",2022-11-26 11:15:00,983,1006,23,136,TRUE,NA,"0.1.4"
"8303","646",2022-11-26 11:30:00,983,1006,23,136,TRUE,NA,"0.1.4"
"8304","646",2022-11-26 11:45:00,983,1006,23,136,TRUE,NA,"0.1.4"
"8305","646",2022-11-26 12:00:00,984,1006,22,136,TRUE,NA,"0.1.4"
"8306","646",2022-11-26 12:15:00,984,1006,22,136,TRUE,NA,"0.1.4"
"8307","646",2022-11-26 12:30:00,984,1006,22,136,TRUE,NA,"0.1.4"
"8308","646",2022-11-26 12:45:00,983,1006,23,136,TRUE,NA,"0.1.4"
"8309","646",2022-11-26 13:00:00,984,1006,22,136,TRUE,NA,"0.1.4"
"8310","646",2022-11-26 13:15:00,984,1006,22,136,TRUE,NA,"0.1.4"
"8311","646",2022-11-26 13:30:00,984,1006,22,136,TRUE,NA,"0.1.4"
"8312","646",2022-11-26 13:45:00,984,1006,22,136,TRUE,NA,"0.1.4"
"8313","646",2022-11-26 14:00:00,984,1006,22,136,TRUE,NA,"0.1.4"
"8314","646",2022-11-26 14:15:00,983,1006,23,136,TRUE,NA,"0.1.4"
"8315","646",2022-11-26 14:30:00,984,1006,22,136,TRUE,NA,"0.1.4"
"8316","646",2022-11-26 14:45:00,984,1006,22,136,TRUE,NA,"0.1.4"
"8317","646",2022-11-26 15:00:00,984,1006,22,136,TRUE,NA,"0.1.4"
"8318","646",2022-11-26 15:15:00,984,1006,22,136,TRUE,NA,"0.1.4"
"8319","646",2022-11-26 15:30:00,984,1006,22,136,TRUE,NA,"0.1.4"
"8320","646",2022-11-26 15:45:00,984,1006,22,136,TRUE,NA,"0.1.4"
"8321","646",2022-11-26 16:00:00,984,1006,22,136,TRUE,NA,"0.1.4"
"8322","646",2022-11-26 16:15:00,984,1006,22,136,TRUE,NA,"0.1.4"
"8323","646",2022-11-26 16:30:00,984,1006,22,136,TRUE,NA,"0.1.4"
"8324","646",2022-11-26 16:45:00,984,1006,22,136,TRUE,NA,"0.1.4"
"8325","646",2022-11-26 17:00:00,983,1006,23,136,TRUE,NA,"0.1.4"
"8326","646",2022-11-26 17:15:00,984,1006,22,136,TRUE,NA,"0.1.4"
"8327","646",2022-11-26 17:30:00,984,1006,22,136,TRUE,NA,"0.1.4"
"8328","646",2022-11-26 17:45:00,984,1006,22,136,TRUE,NA,"0.1.4"
"8329","646",2022-11-26 18:00:00,984,1006,22,136,TRUE,NA,"0.1.4"
"8330","646",2022-11-26 18:15:00,984,1006,22,136,TRUE,NA,"0.1.4"
"8331","646",2022-11-26 18:30:00,984,1006,22,136,TRUE,NA,"0.1.4"
"8332","646",2022-11-26 18:45:00,984,1006,22,136,TRUE,NA,"0.1.4"
"8333","646",2022-11-26 19:00:00,984,1006,22,136,TRUE,NA,"0.1.4"
"8334","646",2022-11-26 19:15:00,984,1006,22,136,TRUE,NA,"0.1.4"
"8335","646",2022-11-26 19:30:00,984,1006,22,136,TRUE,NA,"0.1.4"
"8336","646",2022-11-26 19:45:00,984,1006,22,136,TRUE,NA,"0.1.4"
"8337","646",2022-11-26 20:00:00,984,1006,22,136,TRUE,NA,"0.1.4"
"8338","646",2022-11-26 20:15:00,984,1006,22,136,TRUE,NA,"0.1.4"
"8339","646",2022-11-26 20:30:00,984,1006,22,136,TRUE,NA,"0.1.4"
"8340","646",2022-11-26 20:45:00,984,1006,22,136,TRUE,NA,"0.1.4"
"8341","646",2022-11-26 21:00:00,984,1006,22,136,TRUE,NA,"0.1.4"
"8342","646",2022-11-26 21:15:00,984,1006,22,136,TRUE,NA,"0.1.4"
"8343","646",2022-11-26 21:30:00,984,1006,22,136,TRUE,NA,"0.1.4"
"8344","646",2022-11-26 21:45:00,984,1006,22,136,TRUE,NA,"0.1.4"
"8345","646",2022-11-26 22:00:00,984,1006,22,136,TRUE,NA,"0.1.4"
"8346","646",2022-11-26 22:15:00,984,1006,22,136,TRUE,NA,"0.1.4"
"8347","646",2022-11-26 22:30:00,984,1006,22,136,TRUE,NA,"0.1.4"
"8348","646",2022-11-26 22:45:00,984,1006,22,136,TRUE,NA,"0.1.4"
"8349","646",2022-11-26 23:00:00,984,1006,22,136,TRUE,NA,"0.1.4"
"8350","646",2022-11-26 23:15:00,984,1006,22,136,TRUE,NA,"0.1.4"
"8351","646",2022-11-26 23:30:00,984,1006,22,136,TRUE,NA,"0.1.4"
"8352","646",2022-11-26 23:45:00,984,1006,22,136,TRUE,NA,"0.1.4"
"8353","646",2022-11-27,984,1006,22,136,TRUE,NA,"0.1.4"
"8354","646",2022-11-27 00:15:00,984,1006,22,136,TRUE,NA,"0.1.4"
"8355","646",2022-11-27 00:30:00,984,1006,22,136,TRUE,NA,"0.1.4"
"8356","646",2022-11-27 00:45:00,984,1006,22,136,TRUE,NA,"0.1.4"
"8357","646",2022-11-27 01:00:00,984,1006,22,136,TRUE,NA,"0.1.4"
"8358","646",2022-11-27 01:15:00,984,1006,22,136,TRUE,NA,"0.1.4"
"8359","646",2022-11-27 01:30:00,984,1006,22,136,TRUE,NA,"0.1.4"
"8360","646",2022-11-27 01:45:00,984,1006,22,136,TRUE,NA,"0.1.4"
"8361","646",2022-11-27 02:00:00,984,1006,22,136,TRUE,NA,"0.1.4"
"8362","646",2022-11-27 02:15:00,984,1006,22,136,TRUE,NA,"0.1.4"
"8363","646",2022-11-27 02:30:00,984,1006,22,136,TRUE,NA,"0.1.4"
"8364","646",2022-11-27 02:45:00,984,1006,22,136,TRUE,NA,"0.1.4"
"8365","646",2022-11-27 03:00:00,984,1006,22,136,TRUE,NA,"0.1.4"
"8366","646",2022-11-27 03:15:00,984,1006,22,136,TRUE,NA,"0.1.4"
"8367","646",2022-11-27 03:30:00,984,1006,22,136,TRUE,NA,"0.1.4"
"8368","646",2022-11-27 03:45:00,984,1006,22,136,TRUE,NA,"0.1.4"
"8369","646",2022-11-27 04:00:00,984,1006,22,136,TRUE,NA,"0.1.4"
"8370","646",2022-11-27 04:15:00,984,1006,22,136,TRUE,NA,"0.1.4"
"8371","646",2022-11-27 04:30:00,984,1006,22,136,TRUE,NA,"0.1.4"
"8372","646",2022-11-27 04:45:00,984,1006,22,136,TRUE,NA,"0.1.4"
"8373","646",2022-11-27 05:00:00,984,1006,22,136,TRUE,NA,"0.1.4"
"8374","646",2022-11-27 05:15:00,984,1006,22,136,TRUE,NA,"0.1.4"
"8375","646",2022-11-27 05:30:00,984,1006,22,136,TRUE,NA,"0.1.4"
"8376","646",2022-11-27 05:45:00,984,1006,22,136,TRUE,NA,"0.1.4"
"8377","646",2022-11-27 06:00:00,984,1006,22,136,TRUE,NA,"0.1.4"
"8378","646",2022-11-27 06:15:00,984,1006,22,136,TRUE,NA,"0.1.4"
"8379","646",2022-11-27 06:30:00,984,1006,22,136,TRUE,NA,"0.1.4"
"8380","646",2022-11-27 06:45:00,984,1006,22,136,TRUE,NA,"0.1.4"
"8381","646",2022-11-27 07:00:00,984,1006,22,136,TRUE,NA,"0.1.4"
"8382","646",2022-11-27 07:15:00,984,1006,22,136,TRUE,NA,"0.1.4"
"8383","646",2022-11-27 07:30:00,984,1006,22,136,TRUE,NA,"0.1.4"
"8384","646",2022-11-27 07:45:00,984,1006,22,136,TRUE,NA,"0.1.4"
"8385","646",2022-11-27 08:00:00,984,1006,22,136,TRUE,NA,"0.1.4"
"8386","646",2022-11-27 08:15:00,984,1006,22,136,TRUE,NA,"0.1.4"
"8387","646",2022-11-27 08:30:00,984,1006,22,136,TRUE,NA,"0.1.4"
"8388","646",2022-11-27 08:45:00,984,1006,22,136,TRUE,NA,"0.1.4"
"8389","646",2022-11-27 09:00:00,984,1006,22,136,TRUE,NA,"0.1.4"
"8390","646",2022-11-27 09:15:00,984,1006,22,136,TRUE,NA,"0.1.4"
"8391","646",2022-11-27 09:30:00,984,1006,22,136,TRUE,NA,"0.1.4"
"8392","646",2022-11-27 09:45:00,984,1006,22,136,TRUE,NA,"0.1.4"
"8393","646",2022-11-27 10:00:00,984,1006,22,136,TRUE,NA,"0.1.4"
"8394","646",2022-11-27 10:15:00,984,1006,22,136,TRUE,NA,"0.1.4"
"8395","646",2022-11-27 10:30:00,984,1006,22,136,TRUE,NA,"0.1.4"
"8396","646",2022-11-27 10:45:00,984,1006,22,136,TRUE,NA,"0.1.4"
"8397","646",2022-11-27 11:00:00,984,1006,22,136,TRUE,NA,"0.1.4"
"8398","646",2022-11-27 11:15:00,984,1006,22,136,TRUE,NA,"0.1.4"
"8399","646",2022-11-27 11:30:00,984,1006,22,136,TRUE,NA,"0.1.4"
"8400","646",2022-11-27 11:45:00,984,1006,22,136,TRUE,NA,"0.1.4"
"8401","646",2022-11-27 12:00:00,984,1006,22,136,TRUE,NA,"0.1.4"
"8402","646",2022-11-27 12:15:00,984,1006,22,136,TRUE,NA,"0.1.4"
"8403","646",2022-11-27 12:30:00,984,1006,22,136,TRUE,NA,"0.1.4"
"8404","646",2022-11-27 12:45:00,984,1006,22,136,TRUE,NA,"0.1.4"
"8405","646",2022-11-27 13:00:00,984,1006,22,136,TRUE,NA,"0.1.4"
"8406","646",2022-11-27 13:15:00,984,1006,22,136,TRUE,NA,"0.1.4"
"8407","646",2022-11-27 13:30:00,984,1006,22,136,TRUE,NA,"0.1.4"
"8408","646",2022-11-27 13:45:00,984,1006,22,136,TRUE,NA,"0.1.4"
"8409","646",2022-11-27 14:00:00,984,1006,22,136,TRUE,NA,"0.1.4"
"8410","646",2022-11-27 14:15:00,984,1006,22,136,TRUE,NA,"0.1.4"
"8411","646",2022-11-27 14:30:00,984,1006,22,136,TRUE,NA,"0.1.4"
"8412","646",2022-11-27 14:45:00,984,1006,22,136,TRUE,NA,"0.1.4"
"8413","646",2022-11-27 15:00:00,984,1006,22,136,TRUE,NA,"0.1.4"
"8414","646",2022-11-27 15:15:00,984,1006,22,136,TRUE,NA,"0.1.4"
"8415","646",2022-11-27 15:30:00,984,1006,22,136,TRUE,NA,"0.1.4"
"8416","646",2022-11-27 15:45:00,984,1006,22,136,TRUE,NA,"0.1.4"
"8417","646",2022-11-27 16:00:00,984,1006,22,136,TRUE,NA,"0.1.4"
"8418","646",2022-11-27 16:15:00,984,1006,22,136,TRUE,NA,"0.1.4"
"8419","646",2022-11-27 16:30:00,984,1006,22,136,TRUE,NA,"0.1.4"
"8420","646",2022-11-27 16:45:00,984,1006,22,136,TRUE,NA,"0.1.4"
"8421","646",2022-11-27 17:00:00,984,1006,22,136,TRUE,NA,"0.1.4"
"8422","646",2022-11-27 17:15:00,984,1006,22,136,TRUE,NA,"0.1.4"
"8423","646",2022-11-27 17:30:00,984,1006,22,136,TRUE,NA,"0.1.4"
"8424","646",2022-11-27 17:45:00,984,1006,22,136,TRUE,NA,"0.1.4"
"8425","646",2022-11-27 18:00:00,984,1006,22,136,TRUE,NA,"0.1.4"
"8426","646",2022-11-27 18:15:00,984,1006,22,136,TRUE,NA,"0.1.4"
"8427","646",2022-11-27 18:30:00,984,1006,22,136,TRUE,NA,"0.1.4"
"8428","646",2022-11-27 18:45:00,984,1006,22,136,TRUE,NA,"0.1.4"
"8429","646",2022-11-27 19:00:00,984,1006,22,136,TRUE,NA,"0.1.4"
"8430","646",2022-11-27 19:15:00,984,1006,22,136,TRUE,NA,"0.1.4"
"8431","646",2022-11-27 19:30:00,984,1006,22,136,TRUE,NA,"0.1.4"
"8432","646",2022-11-27 19:45:00,984,1006,22,136,TRUE,NA,"0.1.4"
"8433","646",2022-11-27 20:00:00,985,1006,21,136,TRUE,NA,"0.1.4"
"8434","646",2022-11-27 20:15:00,985,1006,21,136,TRUE,NA,"0.1.4"
"8435","646",2022-11-27 20:30:00,985,1006,21,136,TRUE,NA,"0.1.4"
"8436","646",2022-11-27 20:45:00,985,1006,21,136,TRUE,NA,"0.1.4"
"8437","646",2022-11-27 21:00:00,985,1006,21,136,TRUE,NA,"0.1.4"
"8438","646",2022-11-27 21:15:00,985,1006,21,136,TRUE,NA,"0.1.4"
"8439","646",2022-11-27 21:30:00,985,1006,21,136,TRUE,NA,"0.1.4"
"8440","646",2022-11-27 21:45:00,985,1006,21,136,TRUE,NA,"0.1.4"
"8441","646",2022-11-27 22:00:00,985,1006,21,136,TRUE,NA,"0.1.4"
"8442","646",2022-11-27 22:15:00,985,1006,21,136,TRUE,NA,"0.1.4"
"8443","646",2022-11-27 22:30:00,984,1006,22,136,TRUE,NA,"0.1.4"
"8444","646",2022-11-27 22:45:00,984,1006,22,136,TRUE,NA,"0.1.4"
"8445","646",2022-11-27 23:00:00,985,1006,21,136,TRUE,NA,"0.1.4"
"8446","646",2022-11-27 23:15:00,985,1006,21,136,TRUE,NA,"0.1.4"
"8447","646",2022-11-27 23:30:00,985,1006,21,136,TRUE,NA,"0.1.4"
"8448","646",2022-11-27 23:45:00,985,1006,21,136,FALSE,NA,"0.1.4"
"8449","646",2022-11-28,985,1006,21,136,FALSE,NA,"0.1.4"
"8450","646",2022-11-28 00:15:00,985,1006,21,136,FALSE,NA,"0.1.4"
"8451","646",2022-11-28 00:30:00,985,1006,21,136,FALSE,NA,"0.1.4"
"8452","646",2022-11-28 00:45:00,985,1006,21,136,FALSE,NA,"0.1.4"
"8453","646",2022-11-28 01:00:00,985,1006,21,136,TRUE,NA,"0.1.4"
"8454","646",2022-11-28 01:15:00,985,1006,21,136,TRUE,NA,"0.1.4"
"8455","646",2022-11-28 01:30:00,985,1006,21,136,TRUE,NA,"0.1.4"
"8456","646",2022-11-28 01:45:00,985,1006,21,136,TRUE,NA,"0.1.4"
"8457","646",2022-11-28 02:00:00,985,1006,21,136,TRUE,NA,"0.1.4"
"8458","646",2022-11-28 02:15:00,985,1006,21,136,TRUE,NA,"0.1.4"
"8459","646",2022-11-28 02:30:00,985,1006,21,136,TRUE,NA,"0.1.4"
"8460","646",2022-11-28 02:45:00,984,1006,22,136,TRUE,NA,"0.1.4"
"8461","646",2022-11-28 03:00:00,984,1006,22,136,TRUE,NA,"0.1.4"
"8462","646",2022-11-28 03:15:00,985,1006,21,136,TRUE,NA,"0.1.4"
"8463","646",2022-11-28 03:30:00,984,1006,22,136,TRUE,NA,"0.1.4"
"8464","646",2022-11-28 03:45:00,984,1006,22,136,TRUE,NA,"0.1.4"
"8465","646",2022-11-28 04:00:00,985,1006,21,136,TRUE,NA,"0.1.4"
"8466","646",2022-11-28 04:15:00,985,1006,21,136,TRUE,NA,"0.1.4"
"8467","646",2022-11-28 04:30:00,985,1006,21,136,TRUE,NA,"0.1.4"
"8468","646",2022-11-28 04:45:00,986,1006,20,136,TRUE,NA,"0.1.4"
"8469","646",2022-11-28 05:00:00,985,1006,21,136,TRUE,NA,"0.1.4"
"8470","646",2022-11-28 05:15:00,985,1006,21,136,TRUE,NA,"0.1.4"
"8471","646",2022-11-28 05:30:00,985,1006,21,136,TRUE,NA,"0.1.4"
"8472","646",2022-11-28 05:45:00,985,1006,21,136,TRUE,NA,"0.1.4"
"8473","646",2022-11-28 06:00:00,985,1006,21,136,TRUE,NA,"0.1.4"
"8474","646",2022-11-28 06:15:00,985,1006,21,136,TRUE,NA,"0.1.4"
"8475","646",2022-11-28 06:30:00,986,1006,20,136,TRUE,NA,"0.1.4"
"8476","646",2022-11-28 06:45:00,985,1006,21,136,TRUE,NA,"0.1.4"
"8477","646",2022-11-28 07:00:00,986,1006,20,136,TRUE,NA,"0.1.4"
"8478","646",2022-11-28 07:15:00,986,1006,20,136,TRUE,NA,"0.1.4"
"8479","646",2022-11-28 07:30:00,986,1006,20,136,TRUE,NA,"0.1.4"
"8480","646",2022-11-28 07:45:00,987,1006,19,136,TRUE,NA,"0.1.4"
"8481","646",2022-11-28 08:00:00,987,1006,19,136,TRUE,NA,"0.1.4"
"8482","646",2022-11-28 08:15:00,987,1006,19,136,TRUE,NA,"0.1.4"
"8483","646",2022-11-28 08:30:00,987,1006,19,136,TRUE,NA,"0.1.4"
"8484","646",2022-11-28 08:45:00,987,1006,19,136,TRUE,NA,"0.1.4"
"8485","646",2022-11-28 09:00:00,987,1006,19,136,TRUE,NA,"0.1.4"
"8486","646",2022-11-28 09:15:00,987,1006,19,136,TRUE,NA,"0.1.4"
"8487","646",2022-11-28 09:30:00,988,1006,18,136,TRUE,NA,"0.1.4"
"8488","646",2022-11-28 09:45:00,988,1006,18,136,TRUE,NA,"0.1.4"
"8489","646",2022-11-28 10:00:00,988,1006,18,136,TRUE,NA,"0.1.4"
"8490","646",2022-11-28 10:15:00,988,1006,18,136,TRUE,NA,"0.1.4"
"8491","646",2022-11-28 10:30:00,987,1006,19,136,TRUE,NA,"0.1.4"
"8492","646",2022-11-28 10:45:00,988,1006,18,136,TRUE,NA,"0.1.4"
"8493","646",2022-11-28 11:00:00,988,1006,18,136,TRUE,NA,"0.1.4"
"8494","646",2022-11-28 11:15:00,988,1006,18,136,TRUE,NA,"0.1.4"
"8495","646",2022-11-28 11:30:00,988,1006,18,136,TRUE,NA,"0.1.4"
"8496","646",2022-11-28 11:45:00,988,1006,18,136,TRUE,NA,"0.1.4"
"8497","646",2022-11-28 12:00:00,988,1006,18,136,TRUE,NA,"0.1.4"
"8498","646",2022-11-28 12:15:00,987,1006,19,136,TRUE,NA,"0.1.4"
"8499","646",2022-11-28 12:30:00,988,1006,18,136,TRUE,NA,"0.1.4"
"8500","646",2022-11-28 12:45:00,988,1006,18,136,TRUE,NA,"0.1.4"
"8501","646",2022-11-28 13:00:00,988,1006,18,136,TRUE,NA,"0.1.4"
"8502","646",2022-11-28 13:15:00,989,1006,17,136,TRUE,NA,"0.1.4"
"8503","646",2022-11-28 13:30:00,988,1006,18,136,TRUE,NA,"0.1.4"
"8504","646",2022-11-28 13:45:00,989,1006,17,136,TRUE,NA,"0.1.4"
"8505","646",2022-11-28 14:00:00,989,1006,17,136,TRUE,NA,"0.1.4"
"8506","646",2022-11-28 14:15:00,989,1006,17,136,TRUE,NA,"0.1.4"
"8507","646",2022-11-28 14:30:00,989,1006,17,136,TRUE,NA,"0.1.4"
"8508","646",2022-11-28 14:45:00,988,1006,18,136,TRUE,NA,"0.1.4"
"8509","646",2022-11-28 15:00:00,988,1006,18,136,TRUE,NA,"0.1.4"
"8510","646",2022-11-28 15:15:00,988,1006,18,136,TRUE,NA,"0.1.4"
"8511","646",2022-11-28 15:30:00,988,1006,18,136,TRUE,NA,"0.1.4"
"8512","646",2022-11-28 15:45:00,989,1006,17,136,TRUE,NA,"0.1.4"
"8513","646",2022-11-28 16:00:00,989,1006,17,136,TRUE,NA,"0.1.4"
"8514","646",2022-11-28 16:15:00,988,1006,18,136,TRUE,NA,"0.1.4"
"8515","646",2022-11-28 16:30:00,989,1006,17,136,TRUE,NA,"0.1.4"
"8516","646",2022-11-28 16:45:00,988,1006,18,136,TRUE,NA,"0.1.4"
"8517","646",2022-11-28 17:00:00,988,1006,18,136,TRUE,NA,"0.1.4"
"8518","646",2022-11-28 17:15:00,988,1006,18,136,TRUE,NA,"0.1.4"
"8519","646",2022-11-28 17:30:00,988,1006,18,136,TRUE,NA,"0.1.4"
"8520","646",2022-11-28 17:45:00,988,1006,18,136,TRUE,NA,"0.1.4"
"8521","646",2022-11-28 18:00:00,989,1006,17,136,TRUE,NA,"0.1.4"
"8522","646",2022-11-28 18:15:00,988,1006,18,136,TRUE,NA,"0.1.4"
"8523","646",2022-11-28 18:30:00,988,1006,18,136,TRUE,NA,"0.1.4"
"8524","646",2022-11-28 18:45:00,988,1006,18,136,TRUE,NA,"0.1.4"
"8525","646",2022-11-28 19:00:00,988,1006,18,136,TRUE,NA,"0.1.4"
"8526","646",2022-11-28 19:15:00,988,1006,18,136,TRUE,NA,"0.1.4"
"8527","646",2022-11-28 19:30:00,988,1006,18,136,TRUE,NA,"0.1.4"
"8528","646",2022-11-28 19:45:00,988,1006,18,136,TRUE,NA,"0.1.4"
"8529","646",2022-11-28 20:00:00,988,1006,18,136,TRUE,NA,"0.1.4"
"8530","646",2022-11-28 20:15:00,988,1006,18,136,TRUE,NA,"0.1.4"
"8531","646",2022-11-28 20:30:00,988,1006,18,136,TRUE,NA,"0.1.4"
"8532","646",2022-11-28 20:45:00,988,1006,18,136,TRUE,NA,"0.1.4"
"8533","646",2022-11-28 21:00:00,988,1006,18,136,TRUE,NA,"0.1.4"
"8534","646",2022-11-28 21:15:00,988,1006,18,136,TRUE,NA,"0.1.4"
"8535","646",2022-11-28 21:30:00,988,1006,18,136,TRUE,NA,"0.1.4"
"8536","646",2022-11-28 21:45:00,988,1006,18,136,TRUE,NA,"0.1.4"
"8537","646",2022-11-28 22:00:00,989,1006,17,136,TRUE,NA,"0.1.4"
"8538","646",2022-11-28 22:15:00,989,1006,17,136,TRUE,NA,"0.1.4"
"8539","646",2022-11-28 22:30:00,989,1006,17,136,TRUE,NA,"0.1.4"
"8540","646",2022-11-28 22:45:00,989,1006,17,136,TRUE,NA,"0.1.4"
"8541","646",2022-11-28 23:00:00,988,1006,18,136,TRUE,NA,"0.1.4"
"8542","646",2022-11-28 23:15:00,988,1006,18,136,TRUE,NA,"0.1.4"
"8543","646",2022-11-28 23:30:00,988,1006,18,136,TRUE,NA,"0.1.4"
"8544","646",2022-11-28 23:45:00,988,1006,18,136,TRUE,NA,"0.1.4"
"8545","646",2022-11-29,988,1006,18,136,TRUE,NA,"0.1.4"
"8546","646",2022-11-29 00:15:00,988,1006,18,136,TRUE,NA,"0.1.4"
"8547","646",2022-11-29 00:30:00,988,1006,18,136,TRUE,NA,"0.1.4"
"8548","646",2022-11-29 00:45:00,988,1006,18,136,TRUE,NA,"0.1.4"
"8549","646",2022-11-29 01:00:00,988,1006,18,136,TRUE,NA,"0.1.4"
"8550","646",2022-11-29 01:15:00,988,1006,18,136,TRUE,NA,"0.1.4"
"8551","646",2022-11-29 01:30:00,989,1006,17,136,TRUE,NA,"0.1.4"
"8552","646",2022-11-29 01:45:00,988,1006,18,136,TRUE,NA,"0.1.4"
"8553","646",2022-11-29 02:00:00,988,1006,18,136,TRUE,NA,"0.1.4"
"8554","646",2022-11-29 02:15:00,989,1006,17,136,TRUE,NA,"0.1.4"
"8555","646",2022-11-29 02:30:00,988,1006,18,136,TRUE,NA,"0.1.4"
"8556","646",2022-11-29 02:45:00,988,1006,18,136,TRUE,NA,"0.1.4"
"8557","646",2022-11-29 03:00:00,988,1006,18,136,TRUE,NA,"0.1.4"
"8558","646",2022-11-29 03:15:00,989,1006,17,136,TRUE,NA,"0.1.4"
"8559","646",2022-11-29 03:30:00,989,1006,17,136,TRUE,NA,"0.1.4"
"8560","646",2022-11-29 03:45:00,989,1006,17,136,TRUE,NA,"0.1.4"
"8561","646",2022-11-29 04:00:00,989,1006,17,136,TRUE,NA,"0.1.4"
"8562","646",2022-11-29 04:15:00,989,1006,17,136,TRUE,NA,"0.1.4"
"8563","646",2022-11-29 04:30:00,989,1006,17,136,TRUE,NA,"0.1.4"
"8564","646",2022-11-29 04:45:00,989,1006,17,136,TRUE,NA,"0.1.4"
"8565","646",2022-11-29 05:00:00,989,1006,17,136,TRUE,NA,"0.1.4"
"8566","646",2022-11-29 05:15:00,989,1006,17,136,TRUE,NA,"0.1.4"
"8567","646",2022-11-29 05:30:00,989,1006,17,136,TRUE,NA,"0.1.4"
"8568","646",2022-11-29 05:45:00,989,1006,17,136,TRUE,NA,"0.1.4"
"8569","646",2022-11-29 06:00:00,989,1006,17,136,TRUE,NA,"0.1.4"
"8570","646",2022-11-29 06:15:00,989,1006,17,136,TRUE,NA,"0.1.4"
"8571","646",2022-11-29 06:30:00,989,1006,17,136,TRUE,NA,"0.1.4"
"8572","646",2022-11-29 06:45:00,989,1006,17,136,TRUE,NA,"0.1.4"
"8573","646",2022-11-29 07:00:00,989,1006,17,136,TRUE,NA,"0.1.4"
"8574","646",2022-11-29 07:15:00,989,1006,17,136,TRUE,NA,"0.1.4"
"8575","646",2022-11-29 07:30:00,989,1006,17,136,TRUE,NA,"0.1.4"
"8576","646",2022-11-29 07:45:00,989,1006,17,136,TRUE,NA,"0.1.4"
"8577","646",2022-11-29 08:00:00,989,1006,17,136,TRUE,NA,"0.1.4"
"8578","646",2022-11-29 08:15:00,989,1006,17,136,TRUE,NA,"0.1.4"
"8579","646",2022-11-29 08:30:00,989,1006,17,136,TRUE,NA,"0.1.4"
"8580","646",2022-11-29 08:45:00,989,1006,17,136,TRUE,NA,"0.1.4"
"8581","646",2022-11-29 09:00:00,989,1006,17,136,TRUE,NA,"0.1.4"
"8582","646",2022-11-29 09:15:00,989,1006,17,136,TRUE,NA,"0.1.4"
"8583","646",2022-11-29 09:30:00,989,1006,17,136,TRUE,NA,"0.1.4"
"8584","646",2022-11-29 09:45:00,989,1006,17,136,TRUE,NA,"0.1.4"
"8585","646",2022-11-29 10:00:00,989,1006,17,136,TRUE,NA,"0.1.4"
"8586","646",2022-11-29 10:15:00,989,1006,17,136,TRUE,NA,"0.1.4"
"8587","646",2022-11-29 10:30:00,989,1006,17,136,TRUE,NA,"0.1.4"
"8588","646",2022-11-29 10:45:00,989,1006,17,136,TRUE,NA,"0.1.4"
"8589","646",2022-11-29 11:00:00,988,1006,18,136,TRUE,NA,"0.1.4"
"8590","646",2022-11-29 11:15:00,989,1006,17,136,TRUE,NA,"0.1.4"
"8591","646",2022-11-29 11:30:00,989,1006,17,136,TRUE,NA,"0.1.4"
"8592","646",2022-11-29 11:45:00,988,1006,18,136,TRUE,NA,"0.1.4"
"8593","646",2022-11-29 12:00:00,989,1006,17,136,TRUE,NA,"0.1.4"
"8594","646",2022-11-29 12:15:00,989,1006,17,136,TRUE,NA,"0.1.4"
"8595","646",2022-11-29 12:30:00,989,1006,17,136,TRUE,NA,"0.1.4"
"8596","646",2022-11-29 12:45:00,988,1006,18,136,TRUE,NA,"0.1.4"
"8597","646",2022-11-29 13:00:00,989,1006,17,136,TRUE,NA,"0.1.4"
"8598","646",2022-11-29 13:15:00,988,1006,18,136,TRUE,NA,"0.1.4"
"8599","646",2022-11-29 13:30:00,989,1006,17,136,TRUE,NA,"0.1.4"
"8600","646",2022-11-29 13:45:00,989,1006,17,136,TRUE,NA,"0.1.4"
"8601","646",2022-11-29 14:00:00,989,1006,17,136,TRUE,NA,"0.1.4"
"8602","646",2022-11-29 14:15:00,989,1006,17,136,TRUE,NA,"0.1.4"
"8603","646",2022-11-29 14:30:00,989,1006,17,136,TRUE,NA,"0.1.4"
"8604","646",2022-11-29 14:45:00,989,1006,17,136,TRUE,NA,"0.1.4"
"8605","646",2022-11-29 15:00:00,989,1006,17,136,TRUE,NA,"0.1.4"
"8606","646",2022-11-29 15:15:00,989,1006,17,136,TRUE,NA,"0.1.4"
"8607","646",2022-11-29 15:30:00,989,1006,17,136,TRUE,NA,"0.1.4"
"8608","646",2022-11-29 15:45:00,990,1006,16,136,TRUE,NA,"0.1.4"
"8609","646",2022-11-29 16:00:00,989,1006,17,136,TRUE,NA,"0.1.4"
"8610","646",2022-11-29 16:15:00,989,1006,17,136,TRUE,NA,"0.1.4"
"8611","646",2022-11-29 16:30:00,989,1006,17,136,TRUE,NA,"0.1.4"
"8612","646",2022-11-29 16:45:00,989,1006,17,136,TRUE,NA,"0.1.4"
"8613","646",2022-11-29 17:00:00,989,1006,17,136,TRUE,NA,"0.1.4"
"8614","646",2022-11-29 17:15:00,989,1006,17,136,TRUE,NA,"0.1.4"
"8615","646",2022-11-29 17:30:00,989,1006,17,136,TRUE,NA,"0.1.4"
"8616","646",2022-11-29 17:45:00,989,1006,17,136,TRUE,NA,"0.1.4"
"8617","646",2022-11-29 18:00:00,989,1006,17,136,TRUE,NA,"0.1.4"
"8618","646",2022-11-29 18:15:00,989,1006,17,136,TRUE,NA,"0.1.4"
"8619","646",2022-11-29 18:30:00,990,1006,16,136,TRUE,NA,"0.1.4"
"8620","646",2022-11-29 18:45:00,989,1006,17,136,TRUE,NA,"0.1.4"
"8621","646",2022-11-29 19:00:00,989,1006,17,136,TRUE,NA,"0.1.4"
"8622","646",2022-11-29 19:15:00,989,1006,17,136,TRUE,NA,"0.1.4"
"8623","646",2022-11-29 19:30:00,989,1006,17,136,TRUE,NA,"0.1.4"
"8624","646",2022-11-29 19:45:00,989,1006,17,136,TRUE,NA,"0.1.4"
"8625","646",2022-11-29 20:00:00,989,1006,17,136,TRUE,NA,"0.1.4"
"8626","646",2022-11-29 20:15:00,989,1006,17,136,TRUE,NA,"0.1.4"
"8627","646",2022-11-29 20:30:00,989,1006,17,136,TRUE,NA,"0.1.4"
"8628","646",2022-11-29 20:45:00,989,1006,17,136,TRUE,NA,"0.1.4"
"8629","646",2022-11-29 21:00:00,989,1006,17,136,TRUE,NA,"0.1.4"
"8630","646",2022-11-29 21:15:00,989,1006,17,136,TRUE,NA,"0.1.4"
"8631","646",2022-11-29 21:30:00,990,1006,16,136,TRUE,NA,"0.1.4"
"8632","646",2022-11-29 21:45:00,990,1006,16,136,TRUE,NA,"0.1.4"
"8633","646",2022-11-29 22:00:00,990,1006,16,136,TRUE,NA,"0.1.4"
"8634","646",2022-11-29 22:15:00,990,1006,16,136,TRUE,NA,"0.1.4"
"8635","646",2022-11-29 22:30:00,990,1006,16,136,TRUE,NA,"0.1.4"
"8636","646",2022-11-29 22:45:00,990,1006,16,136,TRUE,NA,"0.1.4"
"8637","646",2022-11-29 23:00:00,990,1006,16,136,TRUE,NA,"0.1.4"
"8638","646",2022-11-29 23:15:00,990,1006,16,136,TRUE,NA,"0.1.4"
"8639","646",2022-11-29 23:30:00,990,1006,16,136,TRUE,NA,"0.1.4"
"8640","646",2022-11-29 23:45:00,990,1006,16,136,TRUE,NA,"0.1.4"
"8641","646",2022-11-30,990,1006,16,136,TRUE,NA,"0.1.4"
"8642","646",2022-11-30 00:15:00,990,1006,16,136,TRUE,NA,"0.1.4"
"8643","646",2022-11-30 00:30:00,990,1006,16,136,TRUE,NA,"0.1.4"
"8644","646",2022-11-30 00:45:00,990,1006,16,136,TRUE,NA,"0.1.4"
"8645","646",2022-11-30 01:00:00,990,1006,16,136,TRUE,NA,"0.1.4"
"8646","646",2022-11-30 01:15:00,990,1006,16,136,TRUE,NA,"0.1.4"
"8647","646",2022-11-30 01:30:00,990,1006,16,136,TRUE,NA,"0.1.4"
"8648","646",2022-11-30 01:45:00,990,1006,16,136,TRUE,NA,"0.1.4"
"8649","646",2022-11-30 02:00:00,990,1006,16,136,TRUE,NA,"0.1.4"
"8650","646",2022-11-30 02:15:00,990,1006,16,136,TRUE,NA,"0.1.4"
"8651","646",2022-11-30 02:30:00,990,1006,16,136,TRUE,NA,"0.1.4"
"8652","646",2022-11-30 02:45:00,990,1006,16,136,TRUE,NA,"0.1.4"
"8653","646",2022-11-30 03:00:00,990,1006,16,136,TRUE,NA,"0.1.4"
"8654","646",2022-11-30 03:15:00,990,1006,16,136,TRUE,NA,"0.1.4"
"8655","646",2022-11-30 03:30:00,990,1006,16,136,TRUE,NA,"0.1.4"
"8656","646",2022-11-30 03:45:00,990,1006,16,136,TRUE,NA,"0.1.4"
"8657","646",2022-11-30 04:00:00,990,1006,16,136,TRUE,NA,"0.1.4"
"8658","646",2022-11-30 04:15:00,990,1006,16,136,TRUE,NA,"0.1.4"
"8659","646",2022-11-30 04:30:00,990,1006,16,136,TRUE,NA,"0.1.4"
"8660","646",2022-11-30 04:45:00,990,1006,16,136,TRUE,NA,"0.1.4"
"8661","646",2022-11-30 05:00:00,990,1006,16,136,TRUE,NA,"0.1.4"
"8662","646",2022-11-30 05:15:00,991,1006,15,136,TRUE,NA,"0.1.4"
"8663","646",2022-11-30 05:30:00,990,1006,16,136,TRUE,NA,"0.1.4"
"8664","646",2022-11-30 05:45:00,991,1006,15,136,TRUE,NA,"0.1.4"
"8665","646",2022-11-30 06:00:00,991,1006,15,136,TRUE,NA,"0.1.4"
"8666","646",2022-11-30 06:15:00,990,1006,16,136,TRUE,NA,"0.1.4"
"8667","646",2022-11-30 06:30:00,990,1006,16,136,TRUE,NA,"0.1.4"
"8668","646",2022-11-30 06:45:00,990,1006,16,136,TRUE,NA,"0.1.4"
"8669","646",2022-11-30 07:00:00,990,1006,16,136,TRUE,NA,"0.1.4"
"8670","646",2022-11-30 07:15:00,991,1006,15,136,TRUE,NA,"0.1.4"
"8671","646",2022-11-30 07:30:00,991,1006,15,136,TRUE,NA,"0.1.4"
"8672","646",2022-11-30 07:45:00,991,1006,15,136,TRUE,NA,"0.1.4"
"8673","646",2022-11-30 08:00:00,991,1006,15,136,TRUE,NA,"0.1.4"
"8674","646",2022-11-30 08:15:00,991,1006,15,136,TRUE,NA,"0.1.4"
"8675","646",2022-11-30 08:30:00,991,1006,15,136,TRUE,NA,"0.1.4"
"8676","646",2022-11-30 08:45:00,990,1006,16,136,TRUE,NA,"0.1.4"
"8677","646",2022-11-30 09:00:00,991,1006,15,136,TRUE,NA,"0.1.4"
"8678","646",2022-11-30 09:15:00,990,1006,16,136,TRUE,NA,"0.1.4"
"8679","646",2022-11-30 09:30:00,991,1006,15,136,TRUE,NA,"0.1.4"
"8680","646",2022-11-30 09:45:00,991,1006,15,136,TRUE,NA,"0.1.4"
"8681","646",2022-11-30 10:00:00,991,1006,15,136,TRUE,NA,"0.1.4"
"8682","646",2022-11-30 10:15:00,991,1006,15,136,TRUE,NA,"0.1.4"
"8683","646",2022-11-30 10:30:00,991,1006,15,136,TRUE,NA,"0.1.4"
"8684","646",2022-11-30 10:45:00,991,1006,15,136,TRUE,NA,"0.1.4"
"8685","646",2022-11-30 11:00:00,991,1006,15,136,TRUE,NA,"0.1.4"
"8686","646",2022-11-30 11:15:00,991,1006,15,136,TRUE,NA,"0.1.4"
"8687","646",2022-11-30 11:30:00,991,1006,15,136,TRUE,NA,"0.1.4"
"8688","646",2022-11-30 11:45:00,991,1006,15,136,TRUE,NA,"0.1.4"
"8689","646",2022-11-30 12:00:00,991,1006,15,136,TRUE,NA,"0.1.4"
"8690","646",2022-11-30 12:15:00,991,1006,15,136,TRUE,NA,"0.1.4"
"8691","646",2022-11-30 12:30:00,991,1006,15,136,TRUE,NA,"0.1.4"
"8692","646",2022-11-30 12:45:00,991,1006,15,136,TRUE,NA,"0.1.4"
"8693","646",2022-11-30 13:00:00,991,1006,15,136,TRUE,NA,"0.1.4"
"8694","646",2022-11-30 13:15:00,990,1006,16,136,TRUE,NA,"0.1.4"
"8695","646",2022-11-30 13:30:00,990,1006,16,136,TRUE,NA,"0.1.4"
"8696","646",2022-11-30 13:45:00,990,1006,16,136,TRUE,NA,"0.1.4"
"8697","646",2022-11-30 14:00:00,990,1006,16,136,TRUE,NA,"0.1.4"
"8698","646",2022-11-30 14:15:00,990,1006,16,136,TRUE,NA,"0.1.4"
"8699","646",2022-11-30 14:30:00,990,1006,16,136,TRUE,NA,"0.1.4"
"8700","646",2022-11-30 14:45:00,990,1006,16,136,TRUE,NA,"0.1.4"
"8701","646",2022-11-30 15:00:00,991,1006,15,136,TRUE,NA,"0.1.4"
"8702","646",2022-11-30 15:15:00,991,1006,15,136,TRUE,NA,"0.1.4"
"8703","646",2022-11-30 15:30:00,991,1006,15,136,TRUE,NA,"0.1.4"
"8704","646",2022-11-30 15:45:00,991,1006,15,136,TRUE,NA,"0.1.4"
"8705","646",2022-11-30 16:00:00,991,1006,15,136,TRUE,NA,"0.1.4"
"8706","646",2022-11-30 16:15:00,993,1006,13,136,TRUE,NA,"0.1.4"
"8707","646",2022-11-30 16:30:00,995,1006,11,136,TRUE,NA,"0.1.4"
"8708","646",2022-11-30 16:45:00,994,1006,12,136,TRUE,NA,"0.1.4"
"8709","646",2022-11-30 17:00:00,994,1006,12,136,TRUE,NA,"0.1.4"
"8710","646",2022-11-30 17:15:00,994,1006,12,136,TRUE,NA,"0.1.4"
"8711","646",2022-11-30 17:30:00,994,1006,12,136,TRUE,NA,"0.1.4"
"8712","646",2022-11-30 17:45:00,994,1006,12,136,TRUE,NA,"0.1.4"
"8713","646",2022-11-30 18:00:00,994,1006,12,136,TRUE,NA,"0.1.4"
"8714","646",2022-11-30 18:15:00,994,1006,12,136,TRUE,NA,"0.1.4"
"8715","646",2022-11-30 18:30:00,994,1006,12,136,TRUE,NA,"0.1.4"
"8716","646",2022-11-30 18:45:00,994,1006,12,136,TRUE,NA,"0.1.4"
"8717","646",2022-11-30 19:00:00,994,1006,12,136,TRUE,NA,"0.1.4"
"8718","646",2022-11-30 19:15:00,994,1006,12,136,TRUE,NA,"0.1.4"
"8719","646",2022-11-30 19:30:00,994,1006,12,136,TRUE,NA,"0.1.4"
"8720","646",2022-11-30 19:45:00,994,1006,12,136,TRUE,NA,"0.1.4"
"8721","646",2022-11-30 20:00:00,994,1006,12,136,TRUE,NA,"0.1.4"
"8722","646",2022-11-30 20:15:00,994,1006,12,136,TRUE,NA,"0.1.4"
"8723","646",2022-11-30 20:30:00,994,1006,12,136,TRUE,NA,"0.1.4"
"8724","646",2022-11-30 20:45:00,994,1006,12,136,TRUE,NA,"0.1.4"
"8725","646",2022-11-30 21:00:00,994,1006,12,136,TRUE,NA,"0.1.4"
"8726","646",2022-11-30 21:15:00,994,1006,12,136,TRUE,NA,"0.1.4"
"8727","646",2022-11-30 21:30:00,994,1006,12,136,TRUE,NA,"0.1.4"
"8728","646",2022-11-30 21:45:00,994,1006,12,136,TRUE,NA,"0.1.4"
"8729","646",2022-11-30 22:00:00,994,1006,12,136,TRUE,NA,"0.1.4"
"8730","646",2022-11-30 22:15:00,994,1006,12,136,TRUE,NA,"0.1.4"
"8731","646",2022-11-30 22:30:00,994,1006,12,136,TRUE,NA,"0.1.4"
"8732","646",2022-11-30 22:45:00,994,1006,12,136,TRUE,NA,"0.1.4"
"8733","646",2022-11-30 23:00:00,994,1006,12,136,TRUE,NA,"0.1.4"
"8734","646",2022-11-30 23:15:00,994,1006,12,136,TRUE,NA,"0.1.4"
"8735","646",2022-11-30 23:30:00,994,1006,12,136,TRUE,NA,"0.1.4"
"8736","646",2022-11-30 23:45:00,994,1006,12,136,TRUE,NA,"0.1.4"
"8737","646",2022-12-01,994,1006,12,136,TRUE,NA,"0.1.4"
"8738","646",2022-12-01 00:15:00,994,1006,12,136,TRUE,NA,"0.1.4"
"8739","646",2022-12-01 00:30:00,994,1006,12,136,TRUE,NA,"0.1.4"
"8740","646",2022-12-01 00:45:00,994,1006,12,136,TRUE,NA,"0.1.4"
"8741","646",2022-12-01 01:00:00,994,1006,12,136,TRUE,NA,"0.1.4"
"8742","646",2022-12-01 01:15:00,994,1006,12,136,TRUE,NA,"0.1.4"
"8743","646",2022-12-01 01:30:00,994,1006,12,136,TRUE,NA,"0.1.4"
"8744","646",2022-12-01 01:45:00,994,1006,12,136,TRUE,NA,"0.1.4"
"8745","646",2022-12-01 02:00:00,994,1006,12,136,TRUE,NA,"0.1.4"
"8746","646",2022-12-01 02:15:00,994,1006,12,136,TRUE,NA,"0.1.4"
"8747","646",2022-12-01 02:30:00,994,1006,12,136,TRUE,NA,"0.1.4"
"8748","646",2022-12-01 02:45:00,994,1006,12,136,TRUE,NA,"0.1.4"
"8749","646",2022-12-01 03:00:00,994,1006,12,136,TRUE,NA,"0.1.4"
"8750","646",2022-12-01 03:15:00,994,1006,12,136,TRUE,NA,"0.1.4"
"8751","646",2022-12-01 03:30:00,994,1006,12,136,TRUE,NA,"0.1.4"
"8752","646",2022-12-01 03:45:00,994,1006,12,136,TRUE,NA,"0.1.4"
"8753","646",2022-12-01 04:00:00,994,1006,12,136,TRUE,NA,"0.1.4"
"8754","646",2022-12-01 04:15:00,994,1006,12,136,TRUE,NA,"0.1.4"
"8755","646",2022-12-01 04:30:00,994,1006,12,136,TRUE,NA,"0.1.4"
"8756","646",2022-12-01 04:45:00,994,1006,12,136,TRUE,NA,"0.1.4"
"8757","646",2022-12-01 05:00:00,994,1006,12,136,TRUE,NA,"0.1.4"
"8758","646",2022-12-01 05:15:00,994,1006,12,136,TRUE,NA,"0.1.4"
"8759","646",2022-12-01 05:30:00,994,1006,12,136,TRUE,NA,"0.1.4"
"8760","646",2022-12-01 05:45:00,994,1006,12,136,TRUE,NA,"0.1.4"
"8761","646",2022-12-01 06:00:00,994,1006,12,136,TRUE,NA,"0.1.4"
"8762","646",2022-12-01 06:15:00,994,1006,12,136,TRUE,NA,"0.1.4"
"8763","646",2022-12-01 06:30:00,994,1006,12,136,TRUE,NA,"0.1.4"
"8764","646",2022-12-01 06:45:00,994,1006,12,136,TRUE,NA,"0.1.4"
"8765","646",2022-12-01 07:00:00,994,1006,12,136,TRUE,NA,"0.1.4"
"8766","646",2022-12-01 07:15:00,994,1006,12,136,TRUE,NA,"0.1.4"
"8767","646",2022-12-01 07:30:00,994,1006,12,136,TRUE,NA,"0.1.4"
"8768","646",2022-12-01 07:45:00,994,1006,12,136,TRUE,NA,"0.1.4"
"8769","646",2022-12-01 08:00:00,994,1006,12,136,TRUE,NA,"0.1.4"
"8770","646",2022-12-01 08:15:00,994,1006,12,136,TRUE,NA,"0.1.4"
"8771","646",2022-12-01 08:30:00,994,1006,12,136,TRUE,NA,"0.1.4"
"8772","646",2022-12-01 08:45:00,994,1006,12,136,TRUE,NA,"0.1.4"
"8773","646",2022-12-01 09:00:00,994,1006,12,136,TRUE,NA,"0.1.4"
"8774","646",2022-12-01 09:15:00,994,1006,12,136,TRUE,NA,"0.1.4"
"8775","646",2022-12-01 09:30:00,994,1006,12,136,TRUE,NA,"0.1.4"
"8776","646",2022-12-01 09:45:00,994,1006,12,136,TRUE,NA,"0.1.4"
"8777","646",2022-12-01 10:00:00,994,1006,12,136,TRUE,NA,"0.1.4"
"8778","646",2022-12-01 10:15:00,994,1006,12,136,TRUE,NA,"0.1.4"
"8779","646",2022-12-01 10:30:00,994,1006,12,136,TRUE,NA,"0.1.4"
"8780","646",2022-12-01 10:45:00,994,1006,12,136,TRUE,NA,"0.1.4"
"8781","646",2022-12-01 11:00:00,994,1006,12,136,TRUE,NA,"0.1.4"
"8782","646",2022-12-01 11:15:00,994,1006,12,136,TRUE,NA,"0.1.4"
"8783","646",2022-12-01 11:30:00,994,1006,12,136,TRUE,NA,"0.1.4"
"8784","646",2022-12-01 11:45:00,994,1006,12,136,TRUE,NA,"0.1.4"
"8785","646",2022-12-01 12:00:00,994,1006,12,136,TRUE,NA,"0.1.4"
"8786","646",2022-12-01 12:15:00,995,1006,11,136,TRUE,NA,"0.1.4"
"8787","646",2022-12-01 12:30:00,994,1006,12,136,TRUE,NA,"0.1.4"
"8788","646",2022-12-01 12:45:00,995,1006,11,136,TRUE,NA,"0.1.4"
"8789","646",2022-12-01 13:00:00,994,1006,12,136,TRUE,NA,"0.1.4"
"8790","646",2022-12-01 13:15:00,994,1006,12,136,TRUE,NA,"0.1.4"
"8791","646",2022-12-01 13:30:00,994,1006,12,136,TRUE,NA,"0.1.4"
"8792","646",2022-12-01 13:45:00,994,1006,12,136,TRUE,NA,"0.1.4"
"8793","646",2022-12-01 14:00:00,994,1006,12,136,TRUE,NA,"0.1.4"
"8794","646",2022-12-01 14:15:00,994,1006,12,136,TRUE,NA,"0.1.4"
"8795","646",2022-12-01 14:30:00,994,1006,12,136,TRUE,NA,"0.1.4"
"8796","646",2022-12-01 14:45:00,994,1006,12,136,TRUE,NA,"0.1.4"
"8797","646",2022-12-01 15:00:00,994,1006,12,136,TRUE,NA,"0.1.4"
"8798","646",2022-12-01 15:15:00,994,1006,12,136,TRUE,NA,"0.1.4"
"8799","646",2022-12-01 15:30:00,994,1006,12,136,TRUE,NA,"0.1.4"
"8800","646",2022-12-01 15:45:00,994,1006,12,136,TRUE,NA,"0.1.4"
"8801","646",2022-12-01 16:00:00,994,1006,12,136,TRUE,NA,"0.1.4"
"8802","646",2022-12-01 16:15:00,994,1006,12,136,TRUE,NA,"0.1.4"
"8803","646",2022-12-01 16:30:00,994,1006,12,136,TRUE,NA,"0.1.4"
"8804","646",2022-12-01 16:45:00,994,1006,12,136,TRUE,NA,"0.1.4"
"8805","646",2022-12-01 17:00:00,994,1006,12,136,TRUE,NA,"0.1.4"
"8806","646",2022-12-01 17:15:00,994,1006,12,136,TRUE,NA,"0.1.4"
"8807","646",2022-12-01 17:30:00,994,1006,12,136,TRUE,NA,"0.1.4"
"8808","646",2022-12-01 17:45:00,994,1006,12,136,TRUE,NA,"0.1.4"
"8809","646",2022-12-01 18:00:00,994,1006,12,136,TRUE,NA,"0.1.4"
"8810","646",2022-12-01 18:15:00,994,1006,12,136,TRUE,NA,"0.1.4"
"8811","646",2022-12-01 18:30:00,994,1006,12,136,TRUE,NA,"0.1.4"
"8812","646",2022-12-01 18:45:00,994,1006,12,136,TRUE,NA,"0.1.4"
"8813","646",2022-12-01 19:00:00,994,1006,12,136,TRUE,NA,"0.1.4"
"8814","646",2022-12-01 19:15:00,994,1006,12,136,TRUE,NA,"0.1.4"
"8815","646",2022-12-01 19:30:00,994,1006,12,136,TRUE,NA,"0.1.4"
"8816","646",2022-12-01 19:45:00,994,1006,12,136,TRUE,NA,"0.1.4"
"8817","646",2022-12-01 20:00:00,994,1006,12,136,TRUE,NA,"0.1.4"
"8818","646",2022-12-01 20:15:00,994,1006,12,136,TRUE,NA,"0.1.4"
"8819","646",2022-12-01 20:30:00,994,1006,12,136,TRUE,NA,"0.1.4"
"8820","646",2022-12-01 20:45:00,994,1006,12,136,TRUE,NA,"0.1.4"
"8821","646",2022-12-01 21:00:00,994,1006,12,136,TRUE,NA,"0.1.4"
"8822","646",2022-12-01 21:15:00,994,1006,12,136,TRUE,NA,"0.1.4"
"8823","646",2022-12-01 21:30:00,994,1006,12,136,TRUE,NA,"0.1.4"
"8824","646",2022-12-01 21:45:00,994,1006,12,136,TRUE,NA,"0.1.4"
"8825","646",2022-12-01 22:00:00,994,1006,12,136,TRUE,NA,"0.1.4"
"8826","646",2022-12-01 22:15:00,994,1006,12,136,TRUE,NA,"0.1.4"
"8827","646",2022-12-01 22:30:00,994,1006,12,136,TRUE,NA,"0.1.4"
"8828","646",2022-12-01 22:45:00,994,1006,12,136,TRUE,NA,"0.1.4"
"8829","646",2022-12-01 23:00:00,994,1006,12,136,TRUE,NA,"0.1.4"
"8830","646",2022-12-01 23:15:00,994,1006,12,136,TRUE,NA,"0.1.4"
"8831","646",2022-12-01 23:30:00,994,1006,12,136,TRUE,NA,"0.1.4"
"8832","646",2022-12-01 23:45:00,994,1006,12,136,TRUE,NA,"0.1.4"
"8833","646",2022-12-02,994,1006,12,136,TRUE,NA,"0.1.4"
"8834","646",2022-12-02 00:15:00,994,1006,12,136,TRUE,NA,"0.1.4"
"8835","646",2022-12-02 00:30:00,994,1006,12,136,TRUE,NA,"0.1.4"
"8836","646",2022-12-02 00:45:00,994,1006,12,136,TRUE,NA,"0.1.4"
"8837","646",2022-12-02 01:00:00,994,1006,12,136,TRUE,NA,"0.1.4"
"8838","646",2022-12-02 01:15:00,994,1006,12,136,TRUE,NA,"0.1.4"
"8839","646",2022-12-02 01:30:00,994,1006,12,136,TRUE,NA,"0.1.4"
"8840","646",2022-12-02 01:45:00,994,1006,12,136,TRUE,NA,"0.1.4"
"8841","646",2022-12-02 02:00:00,994,1006,12,136,TRUE,NA,"0.1.4"
"8842","646",2022-12-02 02:15:00,994,1006,12,136,TRUE,NA,"0.1.4"
"8843","646",2022-12-02 02:30:00,994,1006,12,136,TRUE,NA,"0.1.4"
"8844","646",2022-12-02 02:45:00,994,1006,12,136,TRUE,NA,"0.1.4"
"8845","646",2022-12-02 03:00:00,994,1006,12,136,TRUE,NA,"0.1.4"
"8846","646",2022-12-02 03:15:00,995,1006,11,136,TRUE,NA,"0.1.4"
"8847","646",2022-12-02 03:30:00,994,1006,12,136,TRUE,NA,"0.1.4"
"8848","646",2022-12-02 03:45:00,994,1006,12,136,TRUE,NA,"0.1.4"
"8849","646",2022-12-02 04:00:00,994,1006,12,136,TRUE,NA,"0.1.4"
"8850","646",2022-12-02 04:15:00,994,1006,12,136,TRUE,NA,"0.1.4"
"8851","646",2022-12-02 04:30:00,994,1006,12,136,TRUE,NA,"0.1.4"
"8852","646",2022-12-02 04:45:00,994,1006,12,136,TRUE,NA,"0.1.4"
"8853","646",2022-12-02 05:00:00,995,1006,11,136,TRUE,NA,"0.1.4"
"8854","646",2022-12-02 05:15:00,994,1006,12,136,TRUE,NA,"0.1.4"
"8855","646",2022-12-02 05:30:00,994,1006,12,136,TRUE,NA,"0.1.4"
"8856","646",2022-12-02 05:45:00,994,1006,12,136,TRUE,NA,"0.1.4"
"8857","646",2022-12-02 06:00:00,994,1006,12,136,TRUE,NA,"0.1.4"
"8858","646",2022-12-02 06:15:00,994,1006,12,136,TRUE,NA,"0.1.4"
"8859","646",2022-12-02 06:30:00,994,1006,12,136,TRUE,NA,"0.1.4"
"8860","646",2022-12-02 06:45:00,994,1006,12,136,TRUE,NA,"0.1.4"
"8861","646",2022-12-02 07:00:00,995,1006,11,136,TRUE,NA,"0.1.4"
"8862","646",2022-12-02 07:15:00,995,1006,11,136,TRUE,NA,"0.1.4"
"8863","646",2022-12-02 07:30:00,995,1006,11,136,TRUE,NA,"0.1.4"
"8864","646",2022-12-02 07:45:00,995,1006,11,136,TRUE,NA,"0.1.4"
"8865","646",2022-12-02 08:00:00,995,1006,11,136,TRUE,NA,"0.1.4"
"8866","646",2022-12-02 08:15:00,995,1006,11,136,TRUE,NA,"0.1.4"
"8867","646",2022-12-02 08:30:00,995,1006,11,136,TRUE,NA,"0.1.4"
"8868","646",2022-12-02 08:45:00,995,1006,11,136,TRUE,NA,"0.1.4"
"8869","646",2022-12-02 09:00:00,995,1006,11,136,TRUE,NA,"0.1.4"
"8870","646",2022-12-02 09:15:00,995,1006,11,136,TRUE,NA,"0.1.4"
"8871","646",2022-12-02 09:30:00,995,1006,11,136,TRUE,NA,"0.1.4"
"8872","646",2022-12-02 09:45:00,995,1006,11,136,TRUE,NA,"0.1.4"
"8873","646",2022-12-02 10:00:00,995,1006,11,136,TRUE,NA,"0.1.4"
"8874","646",2022-12-02 10:15:00,995,1006,11,136,TRUE,NA,"0.1.4"
"8875","646",2022-12-02 10:30:00,995,1006,11,136,TRUE,NA,"0.1.4"
"8876","646",2022-12-02 10:45:00,995,1006,11,136,TRUE,NA,"0.1.4"
"8877","646",2022-12-02 11:00:00,995,1006,11,136,TRUE,NA,"0.1.4"
"8878","646",2022-12-02 11:15:00,995,1006,11,136,TRUE,NA,"0.1.4"
"8879","646",2022-12-02 11:30:00,995,1006,11,136,TRUE,NA,"0.1.4"
"8880","646",2022-12-02 11:45:00,995,1006,11,136,TRUE,NA,"0.1.4"
"8881","646",2022-12-02 12:00:00,995,1006,11,136,TRUE,NA,"0.1.4"
"8882","646",2022-12-02 12:15:00,995,1006,11,136,TRUE,NA,"0.1.4"
"8883","646",2022-12-02 12:30:00,995,1006,11,136,TRUE,NA,"0.1.4"
"8884","646",2022-12-02 12:45:00,995,1006,11,136,TRUE,NA,"0.1.4"
"8885","646",2022-12-02 13:00:00,995,1006,11,136,TRUE,NA,"0.1.4"
"8886","646",2022-12-02 13:15:00,995,1006,11,136,TRUE,NA,"0.1.4"
"8887","646",2022-12-02 13:30:00,995,1006,11,136,TRUE,NA,"0.1.4"
"8888","646",2022-12-02 13:45:00,995,1006,11,136,TRUE,NA,"0.1.4"
"8889","646",2022-12-02 14:00:00,995,1006,11,136,TRUE,NA,"0.1.4"
"8890","646",2022-12-02 14:15:00,995,1006,11,136,TRUE,NA,"0.1.4"
"8891","646",2022-12-02 14:30:00,995,1006,11,136,TRUE,NA,"0.1.4"
"8892","646",2022-12-02 14:45:00,995,1006,11,136,TRUE,NA,"0.1.4"
"8893","646",2022-12-02 15:00:00,995,1006,11,136,TRUE,NA,"0.1.4"
"8894","646",2022-12-02 15:15:00,995,1006,11,136,TRUE,NA,"0.1.4"
"8895","646",2022-12-02 15:30:00,995,1006,11,136,TRUE,NA,"0.1.4"
"8896","646",2022-12-02 15:45:00,995,1006,11,136,TRUE,NA,"0.1.4"
"8897","646",2022-12-02 16:00:00,995,1006,11,136,TRUE,NA,"0.1.4"
"8898","646",2022-12-02 16:15:00,995,1006,11,136,TRUE,NA,"0.1.4"
"8899","646",2022-12-02 16:30:00,995,1006,11,136,TRUE,NA,"0.1.4"
"8900","646",2022-12-02 16:45:00,995,1006,11,136,TRUE,NA,"0.1.4"
"8901","646",2022-12-02 17:00:00,995,1006,11,136,TRUE,NA,"0.1.4"
"8902","646",2022-12-02 17:15:00,995,1006,11,136,TRUE,NA,"0.1.4"
"8903","646",2022-12-02 17:30:00,995,1006,11,136,TRUE,NA,"0.1.4"
"8904","646",2022-12-02 17:45:00,995,1006,11,136,TRUE,NA,"0.1.4"
"8905","646",2022-12-02 18:00:00,995,1006,11,136,TRUE,NA,"0.1.4"
"8906","646",2022-12-02 18:15:00,995,1006,11,136,TRUE,NA,"0.1.4"
"8907","646",2022-12-02 18:30:00,995,1006,11,136,TRUE,NA,"0.1.4"
"8908","646",2022-12-02 18:45:00,995,1006,11,136,TRUE,NA,"0.1.4"
"8909","646",2022-12-02 19:00:00,995,1006,11,136,TRUE,NA,"0.1.4"
"8910","646",2022-12-02 19:15:00,995,1006,11,136,TRUE,NA,"0.1.4"
"8911","646",2022-12-02 19:30:00,995,1006,11,136,TRUE,NA,"0.1.4"
"8912","646",2022-12-02 19:45:00,995,1006,11,136,TRUE,NA,"0.1.4"
"8913","646",2022-12-02 20:00:00,995,1006,11,136,TRUE,NA,"0.1.4"
"8914","646",2022-12-02 20:15:00,995,1006,11,136,TRUE,NA,"0.1.4"
"8915","646",2022-12-02 20:30:00,995,1006,11,136,TRUE,NA,"0.1.4"
"8916","646",2022-12-02 20:45:00,995,1006,11,136,TRUE,NA,"0.1.4"
"8917","646",2022-12-02 21:00:00,995,1006,11,136,TRUE,NA,"0.1.4"
"8918","646",2022-12-02 21:15:00,995,1006,11,136,TRUE,NA,"0.1.4"
"8919","646",2022-12-02 21:30:00,995,1006,11,136,TRUE,NA,"0.1.4"
"8920","646",2022-12-02 21:45:00,995,1006,11,136,TRUE,NA,"0.1.4"
"8921","646",2022-12-02 22:00:00,995,1006,11,136,TRUE,NA,"0.1.4"
"8922","646",2022-12-02 22:15:00,995,1006,11,136,TRUE,NA,"0.1.4"
"8923","646",2022-12-02 22:30:00,995,1006,11,136,TRUE,NA,"0.1.4"
"8924","646",2022-12-02 22:45:00,995,1006,11,136,TRUE,NA,"0.1.4"
"8925","646",2022-12-02 23:00:00,995,1006,11,136,TRUE,NA,"0.1.4"
"8926","646",2022-12-02 23:15:00,995,1006,11,136,TRUE,NA,"0.1.4"
"8927","646",2022-12-02 23:30:00,995,1006,11,136,TRUE,NA,"0.1.4"
"8928","646",2022-12-02 23:45:00,995,1006,11,136,TRUE,NA,"0.1.4"
"8929","646",2022-12-03,995,1006,11,136,TRUE,NA,"0.1.4"
"8930","646",2022-12-03 00:15:00,995,1006,11,136,TRUE,NA,"0.1.4"
"8931","646",2022-12-03 00:30:00,995,1006,11,136,TRUE,NA,"0.1.4"
"8932","646",2022-12-03 00:45:00,995,1006,11,136,TRUE,NA,"0.1.4"
"8933","646",2022-12-03 01:00:00,995,1006,11,136,TRUE,NA,"0.1.4"
"8934","646",2022-12-03 01:15:00,995,1006,11,136,TRUE,NA,"0.1.4"
"8935","646",2022-12-03 01:30:00,995,1006,11,136,TRUE,NA,"0.1.4"
"8936","646",2022-12-03 01:45:00,995,1006,11,136,TRUE,NA,"0.1.4"
"8937","646",2022-12-03 02:00:00,995,1006,11,136,TRUE,NA,"0.1.4"
"8938","646",2022-12-03 02:15:00,995,1006,11,136,TRUE,NA,"0.1.4"
"8939","646",2022-12-03 02:30:00,995,1006,11,136,TRUE,NA,"0.1.4"
"8940","646",2022-12-03 02:45:00,995,1006,11,136,TRUE,NA,"0.1.4"
"8941","646",2022-12-03 03:00:00,995,1006,11,136,TRUE,NA,"0.1.4"
"8942","646",2022-12-03 03:15:00,995,1006,11,136,TRUE,NA,"0.1.4"
"8943","646",2022-12-03 03:30:00,995,1006,11,136,TRUE,NA,"0.1.4"
"8944","646",2022-12-03 03:45:00,995,1006,11,136,TRUE,NA,"0.1.4"
"8945","646",2022-12-03 04:00:00,995,1006,11,136,TRUE,NA,"0.1.4"
"8946","646",2022-12-03 04:15:00,995,1006,11,136,TRUE,NA,"0.1.4"
"8947","646",2022-12-03 04:30:00,995,1006,11,136,TRUE,NA,"0.1.4"
"8948","646",2022-12-03 04:45:00,995,1006,11,136,TRUE,NA,"0.1.4"
"8949","646",2022-12-03 05:00:00,995,1006,11,136,TRUE,NA,"0.1.4"
"8950","646",2022-12-03 05:15:00,995,1006,11,136,TRUE,NA,"0.1.4"
"8951","646",2022-12-03 05:30:00,995,1006,11,136,TRUE,NA,"0.1.4"
"8952","646",2022-12-03 05:45:00,995,1006,11,136,TRUE,NA,"0.1.4"
"8953","646",2022-12-03 06:00:00,995,1006,11,136,TRUE,NA,"0.1.4"
"8954","646",2022-12-03 06:15:00,995,1006,11,136,TRUE,NA,"0.1.4"
"8955","646",2022-12-03 06:30:00,995,1006,11,136,TRUE,NA,"0.1.4"
"8956","646",2022-12-03 06:45:00,995,1006,11,136,TRUE,NA,"0.1.4"
"8957","646",2022-12-03 07:00:00,995,1006,11,136,TRUE,NA,"0.1.4"
"8958","646",2022-12-03 07:15:00,995,1006,11,136,TRUE,NA,"0.1.4"
"8959","646",2022-12-03 07:30:00,995,1006,11,136,TRUE,NA,"0.1.4"
"8960","646",2022-12-03 07:45:00,995,1006,11,136,TRUE,NA,"0.1.4"
"8961","646",2022-12-03 08:00:00,995,1006,11,136,TRUE,NA,"0.1.4"
"8962","646",2022-12-03 08:15:00,995,1006,11,136,TRUE,NA,"0.1.4"
"8963","646",2022-12-03 08:30:00,995,1006,11,136,TRUE,NA,"0.1.4"
"8964","646",2022-12-03 08:45:00,995,1006,11,136,TRUE,NA,"0.1.4"
"8965","646",2022-12-03 09:00:00,995,1006,11,136,TRUE,NA,"0.1.4"
"8966","646",2022-12-03 09:15:00,995,1006,11,136,TRUE,NA,"0.1.4"
"8967","646",2022-12-03 09:30:00,995,1006,11,136,TRUE,NA,"0.1.4"
"8968","646",2022-12-03 09:45:00,995,1006,11,136,TRUE,NA,"0.1.4"
"8969","646",2022-12-03 10:00:00,995,1006,11,136,TRUE,NA,"0.1.4"
"8970","646",2022-12-03 10:15:00,995,1006,11,136,TRUE,NA,"0.1.4"
"8971","646",2022-12-03 10:30:00,995,1006,11,136,TRUE,NA,"0.1.4"
"8972","646",2022-12-03 10:45:00,995,1006,11,136,TRUE,NA,"0.1.4"
"8973","646",2022-12-03 11:00:00,995,1006,11,136,TRUE,NA,"0.1.4"
"8974","646",2022-12-03 11:15:00,995,1006,11,136,TRUE,NA,"0.1.4"
"8975","646",2022-12-03 11:30:00,995,1006,11,136,TRUE,NA,"0.1.4"
"8976","646",2022-12-03 11:45:00,995,1006,11,136,TRUE,NA,"0.1.4"
"8977","646",2022-12-03 12:00:00,995,1006,11,136,TRUE,NA,"0.1.4"
"8978","646",2022-12-03 12:15:00,995,1006,11,136,TRUE,NA,"0.1.4"
"8979","646",2022-12-03 12:30:00,995,1006,11,136,TRUE,NA,"0.1.4"
"8980","646",2022-12-03 12:45:00,995,1006,11,136,TRUE,NA,"0.1.4"
"8981","646",2022-12-03 13:00:00,995,1006,11,136,TRUE,NA,"0.1.4"
"8982","646",2022-12-03 13:15:00,995,1006,11,136,TRUE,NA,"0.1.4"
"8983","646",2022-12-03 13:30:00,995,1006,11,136,TRUE,NA,"0.1.4"
"8984","646",2022-12-03 13:45:00,995,1006,11,136,TRUE,NA,"0.1.4"
"8985","646",2022-12-03 14:00:00,995,1006,11,136,TRUE,NA,"0.1.4"
"8986","646",2022-12-03 14:15:00,995,1006,11,136,TRUE,NA,"0.1.4"
"8987","646",2022-12-03 14:30:00,995,1006,11,136,TRUE,NA,"0.1.4"
"8988","646",2022-12-03 14:45:00,995,1006,11,136,TRUE,NA,"0.1.4"
"8989","646",2022-12-03 15:00:00,995,1006,11,136,TRUE,NA,"0.1.4"
"8990","646",2022-12-03 15:15:00,995,1006,11,136,TRUE,NA,"0.1.4"
"8991","646",2022-12-03 15:30:00,995,1006,11,136,TRUE,NA,"0.1.4"
"8992","646",2022-12-03 15:45:00,995,1006,11,136,TRUE,NA,"0.1.4"
"8993","646",2022-12-03 16:00:00,995,1006,11,136,TRUE,NA,"0.1.4"
"8994","646",2022-12-03 16:15:00,995,1006,11,136,TRUE,NA,"0.1.4"
"8995","646",2022-12-03 16:30:00,995,1006,11,136,TRUE,NA,"0.1.4"
"8996","646",2022-12-03 16:45:00,995,1006,11,136,TRUE,NA,"0.1.4"
"8997","646",2022-12-03 17:00:00,995,1006,11,136,TRUE,NA,"0.1.4"
"8998","646",2022-12-03 17:15:00,995,1006,11,136,TRUE,NA,"0.1.4"
"8999","646",2022-12-03 17:30:00,995,1006,11,136,TRUE,NA,"0.1.4"
"9000","646",2022-12-03 17:45:00,995,1006,11,136,TRUE,NA,"0.1.4"
"9001","646",2022-12-03 18:00:00,995,1006,11,136,TRUE,NA,"0.1.4"
"9002","646",2022-12-03 18:15:00,995,1006,11,136,TRUE,NA,"0.1.4"
"9003","646",2022-12-03 18:30:00,995,1006,11,136,TRUE,NA,"0.1.4"
"9004","646",2022-12-03 18:45:00,995,1006,11,136,TRUE,NA,"0.1.4"
"9005","646",2022-12-03 19:00:00,995,1006,11,136,TRUE,NA,"0.1.4"
"9006","646",2022-12-03 19:15:00,995,1006,11,136,TRUE,NA,"0.1.4"
"9007","646",2022-12-03 19:30:00,995,1006,11,136,TRUE,NA,"0.1.4"
"9008","646",2022-12-03 19:45:00,995,1006,11,136,TRUE,NA,"0.1.4"
"9009","646",2022-12-03 20:00:00,995,1006,11,136,TRUE,NA,"0.1.4"
"9010","646",2022-12-03 20:15:00,995,1006,11,136,TRUE,NA,"0.1.4"
"9011","646",2022-12-03 20:30:00,995,1006,11,136,TRUE,NA,"0.1.4"
"9012","646",2022-12-03 20:45:00,995,1006,11,136,TRUE,NA,"0.1.4"
"9013","646",2022-12-03 21:00:00,995,1006,11,136,TRUE,NA,"0.1.4"
"9014","646",2022-12-03 21:15:00,995,1006,11,136,TRUE,NA,"0.1.4"
"9015","646",2022-12-03 21:30:00,995,1006,11,136,TRUE,NA,"0.1.4"
"9016","646",2022-12-03 21:45:00,995,1006,11,136,TRUE,NA,"0.1.4"
"9017","646",2022-12-03 22:00:00,995,1006,11,136,TRUE,NA,"0.1.4"
"9018","646",2022-12-03 22:15:00,995,1006,11,136,TRUE,NA,"0.1.4"
"9019","646",2022-12-03 22:30:00,995,1006,11,136,TRUE,NA,"0.1.4"
"9020","646",2022-12-03 22:45:00,995,1006,11,136,TRUE,NA,"0.1.4"
"9021","646",2022-12-03 23:00:00,995,1006,11,136,TRUE,NA,"0.1.4"
"9022","646",2022-12-03 23:15:00,995,1006,11,136,TRUE,NA,"0.1.4"
"9023","646",2022-12-03 23:30:00,995,1006,11,136,TRUE,NA,"0.1.4"
"9024","646",2022-12-03 23:45:00,995,1006,11,136,TRUE,NA,"0.1.4"
"9025","646",2022-12-04,996,1006,10,136,TRUE,NA,"0.1.4"
"9026","646",2022-12-04 00:15:00,996,1006,10,136,TRUE,NA,"0.1.4"
"9027","646",2022-12-04 00:30:00,996,1006,10,136,TRUE,NA,"0.1.4"
"9028","646",2022-12-04 00:45:00,996,1006,10,136,TRUE,NA,"0.1.4"
"9029","646",2022-12-04 01:00:00,996,1006,10,136,TRUE,NA,"0.1.4"
"9030","646",2022-12-04 01:15:00,996,1006,10,136,TRUE,NA,"0.1.4"
"9031","646",2022-12-04 01:30:00,996,1006,10,136,TRUE,NA,"0.1.4"
"9032","646",2022-12-04 01:45:00,996,1006,10,136,TRUE,NA,"0.1.4"
"9033","646",2022-12-04 02:00:00,996,1006,10,136,TRUE,NA,"0.1.4"
"9034","646",2022-12-04 02:15:00,996,1006,10,136,TRUE,NA,"0.1.4"
"9035","646",2022-12-04 02:30:00,996,1006,10,136,TRUE,NA,"0.1.4"
"9036","646",2022-12-04 02:45:00,996,1006,10,136,TRUE,NA,"0.1.4"
"9037","646",2022-12-04 03:00:00,996,1006,10,136,TRUE,NA,"0.1.4"
"9038","646",2022-12-04 03:15:00,996,1006,10,136,TRUE,NA,"0.1.4"
"9039","646",2022-12-04 03:30:00,996,1006,10,136,TRUE,NA,"0.1.4"
"9040","646",2022-12-04 03:45:00,996,1006,10,136,TRUE,NA,"0.1.4"
"9041","646",2022-12-04 04:00:00,996,1006,10,136,TRUE,NA,"0.1.4"
"9042","646",2022-12-04 04:15:00,996,1006,10,136,TRUE,NA,"0.1.4"
"9043","646",2022-12-04 04:30:00,996,1006,10,136,TRUE,NA,"0.1.4"
"9044","646",2022-12-04 04:45:00,996,1006,10,136,TRUE,NA,"0.1.4"
"9045","646",2022-12-04 05:00:00,996,1006,10,136,TRUE,NA,"0.1.4"
"9046","646",2022-12-04 05:15:00,996,1006,10,136,TRUE,NA,"0.1.4"
"9047","646",2022-12-04 05:30:00,996,1006,10,136,TRUE,NA,"0.1.4"
"9048","646",2022-12-04 05:45:00,996,1006,10,136,TRUE,NA,"0.1.4"
"9049","646",2022-12-04 06:00:00,996,1006,10,136,TRUE,NA,"0.1.4"
"9050","646",2022-12-04 06:15:00,996,1006,10,136,TRUE,NA,"0.1.4"
"9051","646",2022-12-04 06:30:00,996,1006,10,136,TRUE,NA,"0.1.4"
"9052","646",2022-12-04 06:45:00,996,1006,10,136,TRUE,NA,"0.1.4"
"9053","646",2022-12-04 07:00:00,996,1006,10,136,TRUE,NA,"0.1.4"
"9054","646",2022-12-04 07:15:00,996,1006,10,136,TRUE,NA,"0.1.4"
"9055","646",2022-12-04 07:30:00,996,1006,10,136,TRUE,NA,"0.1.4"
"9056","646",2022-12-04 07:45:00,996,1006,10,136,TRUE,NA,"0.1.4"
"9057","646",2022-12-04 08:00:00,996,1006,10,136,TRUE,NA,"0.1.4"
"9058","646",2022-12-04 08:15:00,996,1006,10,136,TRUE,NA,"0.1.4"
"9059","646",2022-12-04 08:30:00,996,1006,10,136,TRUE,NA,"0.1.4"
"9060","646",2022-12-04 08:45:00,997,1006,9,136,TRUE,NA,"0.1.4"
"9061","646",2022-12-04 09:00:00,996,1006,10,136,TRUE,NA,"0.1.4"
"9062","646",2022-12-04 09:15:00,996,1006,10,136,TRUE,NA,"0.1.4"
"9063","646",2022-12-04 09:30:00,997,1006,9,136,TRUE,NA,"0.1.4"
"9064","646",2022-12-04 09:45:00,997,1006,9,136,TRUE,NA,"0.1.4"
"9065","646",2022-12-04 10:00:00,997,1006,9,136,TRUE,NA,"0.1.4"
"9066","646",2022-12-04 10:15:00,997,1006,9,136,TRUE,NA,"0.1.4"
"9067","646",2022-12-04 10:30:00,997,1006,9,136,TRUE,NA,"0.1.4"
"9068","646",2022-12-04 10:45:00,997,1006,9,136,TRUE,NA,"0.1.4"
"9069","646",2022-12-04 11:00:00,997,1006,9,136,TRUE,NA,"0.1.4"
"9070","646",2022-12-04 11:15:00,997,1006,9,136,TRUE,NA,"0.1.4"
"9071","646",2022-12-04 11:30:00,997,1006,9,136,TRUE,NA,"0.1.4"
"9072","646",2022-12-04 11:45:00,997,1006,9,136,TRUE,NA,"0.1.4"
"9073","646",2022-12-04 12:00:00,997,1006,9,136,TRUE,NA,"0.1.4"
"9074","646",2022-12-04 12:15:00,997,1006,9,136,TRUE,NA,"0.1.4"
"9075","646",2022-12-04 12:30:00,997,1006,9,136,TRUE,NA,"0.1.4"
"9076","646",2022-12-04 12:45:00,997,1006,9,136,TRUE,NA,"0.1.4"
"9077","646",2022-12-04 13:00:00,997,1006,9,136,TRUE,NA,"0.1.4"
"9078","646",2022-12-04 13:15:00,997,1006,9,136,TRUE,NA,"0.1.4"
"9079","646",2022-12-04 13:30:00,997,1006,9,136,TRUE,NA,"0.1.4"
"9080","646",2022-12-04 13:45:00,997,1006,9,136,TRUE,NA,"0.1.4"
"9081","646",2022-12-04 14:00:00,997,1006,9,136,TRUE,NA,"0.1.4"
"9082","646",2022-12-04 14:15:00,996,1006,10,136,TRUE,NA,"0.1.4"
"9083","646",2022-12-04 14:30:00,997,1006,9,136,TRUE,NA,"0.1.4"
"9084","646",2022-12-04 14:45:00,996,1006,10,136,TRUE,NA,"0.1.4"
"9085","646",2022-12-04 15:00:00,996,1006,10,136,TRUE,NA,"0.1.4"
"9086","646",2022-12-04 15:15:00,996,1006,10,136,TRUE,NA,"0.1.4"
"9087","646",2022-12-04 15:30:00,996,1006,10,136,TRUE,NA,"0.1.4"
"9088","646",2022-12-04 15:45:00,997,1006,9,136,TRUE,NA,"0.1.4"
"9089","646",2022-12-04 16:00:00,997,1006,9,136,TRUE,NA,"0.1.4"
"9090","646",2022-12-04 16:15:00,996,1006,10,136,TRUE,NA,"0.1.4"
"9091","646",2022-12-04 16:30:00,997,1006,9,136,TRUE,NA,"0.1.4"
"9092","646",2022-12-04 16:45:00,996,1006,10,136,TRUE,NA,"0.1.4"
"9093","646",2022-12-04 17:00:00,996,1006,10,136,TRUE,NA,"0.1.4"
"9094","646",2022-12-04 17:15:00,996,1006,10,136,TRUE,NA,"0.1.4"
"9095","646",2022-12-04 17:30:00,996,1006,10,136,TRUE,NA,"0.1.4"
"9096","646",2022-12-04 17:45:00,996,1006,10,136,TRUE,NA,"0.1.4"
"9097","646",2022-12-04 18:00:00,996,1006,10,136,TRUE,NA,"0.1.4"
"9098","646",2022-12-04 18:15:00,996,1006,10,136,TRUE,NA,"0.1.4"
"9099","646",2022-12-04 18:30:00,997,1006,9,136,TRUE,NA,"0.1.4"
"9100","646",2022-12-04 18:45:00,996,1006,10,136,TRUE,NA,"0.1.4"
"9101","646",2022-12-04 19:00:00,997,1006,9,136,TRUE,NA,"0.1.4"
"9102","646",2022-12-04 19:15:00,997,1006,9,136,TRUE,NA,"0.1.4"
"9103","646",2022-12-04 19:30:00,997,1006,9,136,TRUE,NA,"0.1.4"
"9104","646",2022-12-04 19:45:00,997,1006,9,136,TRUE,NA,"0.1.4"
"9105","646",2022-12-04 20:00:00,997,1006,9,136,TRUE,NA,"0.1.4"
"9106","646",2022-12-04 20:15:00,997,1006,9,136,TRUE,NA,"0.1.4"
"9107","646",2022-12-04 20:30:00,997,1006,9,136,TRUE,NA,"0.1.4"
"9108","646",2022-12-04 20:45:00,997,1006,9,136,TRUE,NA,"0.1.4"
"9109","646",2022-12-04 21:00:00,997,1006,9,136,TRUE,NA,"0.1.4"
"9110","646",2022-12-04 21:15:00,997,1006,9,136,TRUE,NA,"0.1.4"
"9111","646",2022-12-04 21:30:00,996,1006,10,136,TRUE,NA,"0.1.4"
"9112","646",2022-12-04 21:45:00,997,1006,9,136,TRUE,NA,"0.1.4"
"9113","646",2022-12-04 22:00:00,997,1006,9,136,TRUE,NA,"0.1.4"
"9114","646",2022-12-04 22:15:00,997,1006,9,136,TRUE,NA,"0.1.4"
"9115","646",2022-12-04 22:30:00,997,1006,9,136,TRUE,NA,"0.1.4"
"9116","646",2022-12-04 22:45:00,997,1006,9,136,TRUE,NA,"0.1.4"
"9117","646",2022-12-04 23:00:00,997,1006,9,136,TRUE,NA,"0.1.4"
"9118","646",2022-12-04 23:15:00,997,1006,9,136,TRUE,NA,"0.1.4"
"9119","646",2022-12-04 23:30:00,997,1006,9,136,TRUE,NA,"0.1.4"
"9120","646",2022-12-04 23:45:00,997,1006,9,136,TRUE,NA,"0.1.4"
"9121","646",2022-12-05,997,1006,9,136,TRUE,NA,"0.1.4"
"9122","646",2022-12-05 00:15:00,997,1006,9,136,TRUE,NA,"0.1.4"
"9123","646",2022-12-05 00:30:00,997,1006,9,136,TRUE,NA,"0.1.4"
"9124","646",2022-12-05 00:45:00,997,1006,9,136,TRUE,NA,"0.1.4"
"9125","646",2022-12-05 01:00:00,997,1006,9,136,TRUE,NA,"0.1.4"
"9126","646",2022-12-05 01:15:00,997,1006,9,136,TRUE,NA,"0.1.4"
"9127","646",2022-12-05 01:30:00,997,1006,9,136,TRUE,NA,"0.1.4"
"9128","646",2022-12-05 01:45:00,997,1006,9,136,TRUE,NA,"0.1.4"
"9129","646",2022-12-05 02:00:00,997,1006,9,136,TRUE,NA,"0.1.4"
"9130","646",2022-12-05 02:15:00,996,1006,10,136,TRUE,NA,"0.1.4"
"9131","646",2022-12-05 02:30:00,996,1006,10,136,TRUE,NA,"0.1.4"
"9132","646",2022-12-05 02:45:00,996,1006,10,136,TRUE,NA,"0.1.4"
"9133","646",2022-12-05 03:00:00,996,1006,10,136,TRUE,NA,"0.1.4"
"9134","646",2022-12-05 03:15:00,997,1006,9,136,TRUE,NA,"0.1.4"
"9135","646",2022-12-05 03:30:00,997,1006,9,136,TRUE,NA,"0.1.4"
"9136","646",2022-12-05 03:45:00,996,1006,10,136,TRUE,NA,"0.1.4"
"9137","646",2022-12-05 04:00:00,996,1006,10,136,TRUE,NA,"0.1.4"
"9138","646",2022-12-05 04:15:00,996,1006,10,136,TRUE,NA,"0.1.4"
"9139","646",2022-12-05 04:30:00,996,1006,10,136,TRUE,NA,"0.1.4"
"9140","646",2022-12-05 04:45:00,996,1006,10,136,TRUE,NA,"0.1.4"
"9141","646",2022-12-05 05:00:00,997,1006,9,136,TRUE,NA,"0.1.4"
"9142","646",2022-12-05 05:15:00,997,1006,9,136,TRUE,NA,"0.1.4"
"9143","646",2022-12-05 05:30:00,997,1006,9,136,TRUE,NA,"0.1.4"
"9144","646",2022-12-05 05:45:00,997,1006,9,136,TRUE,NA,"0.1.4"
"9145","646",2022-12-05 06:00:00,997,1006,9,136,TRUE,NA,"0.1.4"
"9146","646",2022-12-05 06:15:00,997,1006,9,136,TRUE,NA,"0.1.4"
"9147","646",2022-12-05 06:30:00,997,1006,9,136,TRUE,NA,"0.1.4"
"9148","646",2022-12-05 06:45:00,997,1006,9,136,TRUE,NA,"0.1.4"
"9149","646",2022-12-05 07:00:00,997,1006,9,136,TRUE,NA,"0.1.4"
"9150","646",2022-12-05 07:15:00,997,1006,9,136,TRUE,NA,"0.1.4"
"9151","646",2022-12-05 07:30:00,997,1006,9,136,TRUE,NA,"0.1.4"
"9152","646",2022-12-05 07:45:00,996,1006,10,136,TRUE,NA,"0.1.4"
"9153","646",2022-12-05 08:00:00,997,1006,9,136,TRUE,NA,"0.1.4"
"9154","646",2022-12-05 08:15:00,996,1006,10,136,TRUE,NA,"0.1.4"
"9155","646",2022-12-05 08:30:00,997,1006,9,136,TRUE,NA,"0.1.4"
"9156","646",2022-12-05 08:45:00,996,1006,10,136,TRUE,NA,"0.1.4"
"9157","646",2022-12-05 09:00:00,996,1006,10,136,TRUE,NA,"0.1.4"
"9158","646",2022-12-05 09:15:00,997,1006,9,136,TRUE,NA,"0.1.4"
"9159","646",2022-12-05 09:30:00,996,1006,10,136,TRUE,NA,"0.1.4"
"9160","646",2022-12-05 09:45:00,997,1006,9,136,TRUE,NA,"0.1.4"
"9161","646",2022-12-05 10:00:00,996,1006,10,136,TRUE,NA,"0.1.4"
"9162","646",2022-12-05 10:15:00,997,1006,9,136,TRUE,NA,"0.1.4"
"9163","646",2022-12-05 10:30:00,997,1006,9,136,TRUE,NA,"0.1.4"
"9164","646",2022-12-05 10:45:00,997,1006,9,136,TRUE,NA,"0.1.4"
"9165","646",2022-12-05 11:00:00,997,1006,9,136,TRUE,NA,"0.1.4"
"9166","646",2022-12-05 11:15:00,997,1006,9,136,TRUE,NA,"0.1.4"
"9167","646",2022-12-05 11:30:00,996,1006,10,136,TRUE,NA,"0.1.4"
"9168","646",2022-12-05 11:45:00,997,1006,9,136,TRUE,NA,"0.1.4"
"9169","646",2022-12-05 12:00:00,997,1006,9,136,TRUE,NA,"0.1.4"
"9170","646",2022-12-05 12:15:00,997,1006,9,136,TRUE,NA,"0.1.4"
"9171","646",2022-12-05 12:30:00,997,1006,9,136,TRUE,NA,"0.1.4"
"9172","646",2022-12-05 12:45:00,996,1006,10,136,TRUE,NA,"0.1.4"
"9173","646",2022-12-05 13:00:00,997,1006,9,136,TRUE,NA,"0.1.4"
"9174","646",2022-12-05 13:15:00,996,1006,10,136,TRUE,NA,"0.1.4"
"9175","646",2022-12-05 13:30:00,996,1006,10,136,TRUE,NA,"0.1.4"
"9176","646",2022-12-05 13:45:00,996,1006,10,136,TRUE,NA,"0.1.4"
"9177","646",2022-12-05 14:00:00,996,1006,10,136,TRUE,NA,"0.1.4"
"9178","646",2022-12-05 14:15:00,996,1006,10,136,TRUE,NA,"0.1.4"
"9179","646",2022-12-05 14:30:00,996,1006,10,136,TRUE,NA,"0.1.4"
"9180","646",2022-12-05 14:45:00,997,1006,9,136,TRUE,NA,"0.1.4"
"9181","646",2022-12-05 15:00:00,997,1006,9,136,TRUE,NA,"0.1.4"
"9182","646",2022-12-05 15:15:00,997,1006,9,136,TRUE,NA,"0.1.4"
"9183","646",2022-12-05 15:30:00,997,1006,9,136,TRUE,NA,"0.1.4"
"9184","646",2022-12-05 15:45:00,996,1006,10,136,TRUE,NA,"0.1.4"
"9185","646",2022-12-05 16:00:00,997,1006,9,136,TRUE,NA,"0.1.4"
"9186","646",2022-12-05 16:15:00,996,1006,10,136,TRUE,NA,"0.1.4"
"9187","646",2022-12-05 16:30:00,996,1006,10,136,TRUE,NA,"0.1.4"
"9188","646",2022-12-05 16:45:00,997,1006,9,136,TRUE,NA,"0.1.4"
"9189","646",2022-12-05 17:00:00,997,1006,9,136,TRUE,NA,"0.1.4"
"9190","646",2022-12-05 17:15:00,996,1006,10,136,TRUE,NA,"0.1.4"
"9191","646",2022-12-05 17:30:00,996,1006,10,136,TRUE,NA,"0.1.4"
"9192","646",2022-12-05 17:45:00,996,1006,10,136,TRUE,NA,"0.1.4"
"9193","646",2022-12-05 18:00:00,996,1006,10,136,TRUE,NA,"0.1.4"
"9194","646",2022-12-05 18:15:00,996,1006,10,136,TRUE,NA,"0.1.4"
"9195","646",2022-12-05 18:30:00,996,1006,10,136,TRUE,NA,"0.1.4"
"9196","646",2022-12-05 18:45:00,996,1006,10,136,TRUE,NA,"0.1.4"
"9197","646",2022-12-05 19:00:00,996,1006,10,136,TRUE,NA,"0.1.4"
"9198","646",2022-12-05 19:15:00,996,1006,10,136,TRUE,NA,"0.1.4"
"9199","646",2022-12-05 19:30:00,996,1006,10,136,TRUE,NA,"0.1.4"
"9200","646",2022-12-05 19:45:00,996,1006,10,136,TRUE,NA,"0.1.4"
"9201","646",2022-12-05 20:00:00,996,1006,10,136,TRUE,NA,"0.1.4"
"9202","646",2022-12-05 20:15:00,996,1006,10,136,TRUE,NA,"0.1.4"
"9203","646",2022-12-05 20:30:00,998,1006,8,136,TRUE,NA,"0.1.4"
"9204","646",2022-12-05 20:45:00,998,1006,8,136,TRUE,NA,"0.1.4"
"9205","646",2022-12-05 21:00:00,997,1006,9,136,TRUE,NA,"0.1.4"
"9206","646",2022-12-05 21:15:00,997,1006,9,136,TRUE,NA,"0.1.4"
"9207","646",2022-12-05 21:30:00,998,1006,8,136,TRUE,NA,"0.1.4"
"9208","646",2022-12-05 21:45:00,998,1006,8,136,TRUE,NA,"0.1.4"
"9209","646",2022-12-05 22:00:00,997,1006,9,136,TRUE,NA,"0.1.4"
"9210","646",2022-12-05 22:15:00,997,1006,9,136,TRUE,NA,"0.1.4"
"9211","646",2022-12-05 22:30:00,997,1006,9,136,TRUE,NA,"0.1.4"
"9212","646",2022-12-05 22:45:00,997,1006,9,136,TRUE,NA,"0.1.4"
"9213","646",2022-12-05 23:00:00,997,1006,9,136,TRUE,NA,"0.1.4"
"9214","646",2022-12-05 23:15:00,997,1006,9,136,TRUE,NA,"0.1.4"
"9215","646",2022-12-05 23:30:00,997,1006,9,136,TRUE,NA,"0.1.4"
"9216","646",2022-12-05 23:45:00,997,1006,9,136,TRUE,NA,"0.1.4"
"9217","646",2022-12-06,997,1006,9,136,TRUE,NA,"0.1.4"
"9218","646",2022-12-06 00:15:00,997,1006,9,136,TRUE,NA,"0.1.4"
"9219","646",2022-12-06 00:30:00,997,1006,9,136,TRUE,NA,"0.1.4"
"9220","646",2022-12-06 00:45:00,997,1006,9,136,TRUE,NA,"0.1.4"
"9221","646",2022-12-06 01:00:00,997,1006,9,136,TRUE,NA,"0.1.4"
"9222","646",2022-12-06 01:15:00,997,1006,9,136,TRUE,NA,"0.1.4"
"9223","646",2022-12-06 01:30:00,997,1006,9,136,TRUE,NA,"0.1.4"
"9224","646",2022-12-06 01:45:00,997,1006,9,136,TRUE,NA,"0.1.4"
"9225","646",2022-12-06 02:00:00,997,1006,9,136,TRUE,NA,"0.1.4"
"9226","646",2022-12-06 02:15:00,997,1006,9,136,TRUE,NA,"0.1.4"
"9227","646",2022-12-06 02:30:00,997,1006,9,136,TRUE,NA,"0.1.4"
"9228","646",2022-12-06 02:45:00,997,1006,9,136,TRUE,NA,"0.1.4"
"9229","646",2022-12-06 03:00:00,997,1006,9,136,TRUE,NA,"0.1.4"
"9230","646",2022-12-06 03:15:00,997,1006,9,136,TRUE,NA,"0.1.4"
"9231","646",2022-12-06 03:30:00,997,1006,9,136,TRUE,NA,"0.1.4"
"9232","646",2022-12-06 03:45:00,997,1006,9,136,TRUE,NA,"0.1.4"
"9233","646",2022-12-06 04:00:00,997,1006,9,136,TRUE,NA,"0.1.4"
"9234","646",2022-12-06 04:15:00,997,1006,9,136,TRUE,NA,"0.1.4"
"9235","646",2022-12-06 04:30:00,997,1006,9,136,TRUE,NA,"0.1.4"
"9236","646",2022-12-06 04:45:00,997,1006,9,136,TRUE,NA,"0.1.4"
"9237","646",2022-12-06 05:00:00,997,1006,9,136,TRUE,NA,"0.1.4"
"9238","646",2022-12-06 05:15:00,997,1006,9,136,TRUE,NA,"0.1.4"
"9239","646",2022-12-06 05:30:00,997,1006,9,136,TRUE,NA,"0.1.4"
"9240","646",2022-12-06 05:45:00,997,1006,9,136,TRUE,NA,"0.1.4"
"9241","646",2022-12-06 06:00:00,997,1006,9,136,TRUE,NA,"0.1.4"
"9242","646",2022-12-06 06:15:00,997,1006,9,136,TRUE,NA,"0.1.4"
"9243","646",2022-12-06 06:30:00,997,1006,9,136,TRUE,NA,"0.1.4"
"9244","646",2022-12-06 06:45:00,997,1006,9,136,TRUE,NA,"0.1.4"
"9245","646",2022-12-06 07:00:00,997,1006,9,136,TRUE,NA,"0.1.4"
"9246","646",2022-12-06 07:15:00,997,1006,9,136,TRUE,NA,"0.1.4"
"9247","646",2022-12-06 07:30:00,997,1006,9,136,TRUE,NA,"0.1.4"
"9248","646",2022-12-06 07:45:00,997,1006,9,136,TRUE,NA,"0.1.4"
"9249","646",2022-12-06 08:00:00,997,1006,9,136,TRUE,NA,"0.1.4"
"9250","646",2022-12-06 08:15:00,997,1006,9,136,TRUE,NA,"0.1.4"
"9251","646",2022-12-06 08:30:00,997,1006,9,136,TRUE,NA,"0.1.4"
"9252","646",2022-12-06 08:45:00,997,1006,9,136,TRUE,NA,"0.1.4"
"9253","646",2022-12-06 09:00:00,997,1006,9,136,TRUE,NA,"0.1.4"
"9254","646",2022-12-06 09:15:00,997,1006,9,136,TRUE,NA,"0.1.4"
"9255","646",2022-12-06 09:30:00,997,1006,9,136,TRUE,NA,"0.1.4"
"9256","646",2022-12-06 09:45:00,997,1006,9,136,TRUE,NA,"0.1.4"
"9257","646",2022-12-06 10:00:00,997,1006,9,136,TRUE,NA,"0.1.4"
"9258","646",2022-12-06 10:15:00,997,1006,9,136,TRUE,NA,"0.1.4"
"9259","646",2022-12-06 10:30:00,997,1006,9,136,TRUE,NA,"0.1.4"
"9260","646",2022-12-06 10:45:00,997,1006,9,136,TRUE,NA,"0.1.4"
"9261","646",2022-12-06 11:00:00,997,1006,9,136,TRUE,NA,"0.1.4"
"9262","646",2022-12-06 11:15:00,997,1006,9,136,TRUE,NA,"0.1.4"
"9263","646",2022-12-06 11:30:00,997,1006,9,136,TRUE,NA,"0.1.4"
"9264","646",2022-12-06 11:45:00,997,1006,9,136,TRUE,NA,"0.1.4"
"9265","646",2022-12-06 12:00:00,997,1006,9,136,TRUE,NA,"0.1.4"
"9266","646",2022-12-06 12:15:00,997,1006,9,136,TRUE,NA,"0.1.4"
"9267","646",2022-12-06 12:30:00,997,1006,9,136,TRUE,NA,"0.1.4"
"9268","646",2022-12-06 12:45:00,997,1006,9,136,TRUE,NA,"0.1.4"
"9269","646",2022-12-06 13:00:00,997,1006,9,136,TRUE,NA,"0.1.4"
"9270","646",2022-12-06 13:15:00,997,1006,9,136,TRUE,NA,"0.1.4"
"9271","646",2022-12-06 13:30:00,997,1006,9,136,TRUE,NA,"0.1.4"
"9272","646",2022-12-06 13:45:00,997,1006,9,136,TRUE,NA,"0.1.4"
"9273","646",2022-12-06 14:00:00,997,1006,9,136,TRUE,NA,"0.1.4"
"9274","646",2022-12-06 14:15:00,997,1006,9,136,TRUE,NA,"0.1.4"
"9275","646",2022-12-06 14:30:00,997,1006,9,136,TRUE,NA,"0.1.4"
"9276","646",2022-12-06 14:45:00,997,1006,9,136,TRUE,NA,"0.1.4"
"9277","646",2022-12-06 15:00:00,997,1006,9,136,TRUE,NA,"0.1.4"
"9278","646",2022-12-06 15:15:00,997,1006,9,136,TRUE,NA,"0.1.4"
"9279","646",2022-12-06 15:30:00,997,1006,9,136,TRUE,NA,"0.1.4"
"9280","646",2022-12-06 15:45:00,997,1006,9,136,TRUE,NA,"0.1.4"
"9281","646",2022-12-06 16:00:00,997,1006,9,136,TRUE,NA,"0.1.4"
"9282","646",2022-12-06 16:15:00,997,1006,9,136,TRUE,NA,"0.1.4"
"9283","646",2022-12-06 16:30:00,997,1006,9,136,TRUE,NA,"0.1.4"
"9284","646",2022-12-06 16:45:00,997,1006,9,136,TRUE,NA,"0.1.4"
"9285","646",2022-12-06 17:00:00,997,1006,9,136,TRUE,NA,"0.1.4"
"9286","646",2022-12-06 17:15:00,997,1006,9,136,TRUE,NA,"0.1.4"
"9287","646",2022-12-06 17:30:00,997,1006,9,136,TRUE,NA,"0.1.4"
"9288","646",2022-12-06 17:45:00,997,1006,9,136,TRUE,NA,"0.1.4"
"9289","646",2022-12-06 18:00:00,997,1006,9,136,TRUE,NA,"0.1.4"
"9290","646",2022-12-06 18:15:00,997,1006,9,136,TRUE,NA,"0.1.4"
"9291","646",2022-12-06 18:30:00,997,1006,9,136,TRUE,NA,"0.1.4"
"9292","646",2022-12-06 18:45:00,997,1006,9,136,TRUE,NA,"0.1.4"
"9293","646",2022-12-06 19:00:00,997,1006,9,136,TRUE,NA,"0.1.4"
"9294","646",2022-12-06 19:15:00,997,1006,9,136,TRUE,NA,"0.1.4"
"9295","646",2022-12-06 19:30:00,997,1006,9,136,TRUE,NA,"0.1.4"
"9296","646",2022-12-06 19:45:00,997,1006,9,136,TRUE,NA,"0.1.4"
"9297","646",2022-12-06 20:00:00,997,1006,9,136,TRUE,NA,"0.1.4"
"9298","646",2022-12-06 20:15:00,997,1006,9,136,TRUE,NA,"0.1.4"
"9299","646",2022-12-06 20:30:00,997,1006,9,136,TRUE,NA,"0.1.4"
"9300","646",2022-12-06 20:45:00,997,1006,9,136,TRUE,NA,"0.1.4"
"9301","646",2022-12-06 21:00:00,997,1006,9,136,TRUE,NA,"0.1.4"
"9302","646",2022-12-06 21:15:00,997,1006,9,136,TRUE,NA,"0.1.4"
"9303","646",2022-12-06 21:30:00,997,1006,9,136,TRUE,NA,"0.1.4"
"9304","646",2022-12-06 21:45:00,997,1006,9,136,TRUE,NA,"0.1.4"
"9305","646",2022-12-06 22:00:00,997,1006,9,136,TRUE,NA,"0.1.4"
"9306","646",2022-12-06 22:15:00,997,1006,9,136,TRUE,NA,"0.1.4"
"9307","646",2022-12-06 22:30:00,997,1006,9,136,TRUE,NA,"0.1.4"
"9308","646",2022-12-06 22:45:00,997,1006,9,136,TRUE,NA,"0.1.4"
"9309","646",2022-12-06 23:00:00,997,1006,9,136,TRUE,NA,"0.1.4"
"9310","646",2022-12-06 23:15:00,997,1006,9,136,TRUE,NA,"0.1.4"
"9311","646",2022-12-06 23:30:00,997,1006,9,136,TRUE,NA,"0.1.4"
"9312","646",2022-12-06 23:45:00,997,1006,9,136,TRUE,NA,"0.1.4"
"9313","646",2022-12-07,997,1006,9,136,TRUE,NA,"0.1.4"
"9314","646",2022-12-07 00:15:00,997,1006,9,136,TRUE,NA,"0.1.4"
"9315","646",2022-12-07 00:30:00,997,1006,9,136,TRUE,NA,"0.1.4"
"9316","646",2022-12-07 00:45:00,997,1006,9,136,TRUE,NA,"0.1.4"
"9317","646",2022-12-07 01:00:00,997,1006,9,136,TRUE,NA,"0.1.4"
"9318","646",2022-12-07 01:15:00,997,1006,9,136,TRUE,NA,"0.1.4"
"9319","646",2022-12-07 01:30:00,997,1006,9,136,TRUE,NA,"0.1.4"
"9320","646",2022-12-07 01:45:00,997,1006,9,136,TRUE,NA,"0.1.4"
"9321","646",2022-12-07 02:00:00,997,1006,9,136,TRUE,NA,"0.1.4"
"9322","646",2022-12-07 02:15:00,997,1006,9,136,TRUE,NA,"0.1.4"
"9323","646",2022-12-07 02:30:00,997,1006,9,136,TRUE,NA,"0.1.4"
"9324","646",2022-12-07 02:45:00,997,1006,9,136,TRUE,NA,"0.1.4"
"9325","646",2022-12-07 03:00:00,997,1006,9,136,TRUE,NA,"0.1.4"
"9326","646",2022-12-07 03:15:00,997,1006,9,136,TRUE,NA,"0.1.4"
"9327","646",2022-12-07 03:30:00,997,1006,9,136,TRUE,NA,"0.1.4"
"9328","646",2022-12-07 03:45:00,997,1006,9,136,TRUE,NA,"0.1.4"
"9329","646",2022-12-07 04:00:00,997,1006,9,136,TRUE,NA,"0.1.4"
"9330","646",2022-12-07 04:15:00,997,1006,9,136,TRUE,NA,"0.1.4"
"9331","646",2022-12-07 04:30:00,997,1006,9,136,TRUE,NA,"0.1.4"
"9332","646",2022-12-07 04:45:00,997,1006,9,136,TRUE,NA,"0.1.4"
"9333","646",2022-12-07 05:00:00,997,1006,9,136,TRUE,NA,"0.1.4"
"9334","646",2022-12-07 05:15:00,997,1006,9,136,TRUE,NA,"0.1.4"
"9335","646",2022-12-07 05:30:00,997,1006,9,136,TRUE,NA,"0.1.4"
"9336","646",2022-12-07 05:45:00,997,1006,9,136,TRUE,NA,"0.1.4"
"9337","646",2022-12-07 06:00:00,997,1006,9,136,TRUE,NA,"0.1.4"
"9338","646",2022-12-07 06:15:00,997,1006,9,136,TRUE,NA,"0.1.4"
"9339","646",2022-12-07 06:30:00,997,1006,9,136,TRUE,NA,"0.1.4"
"9340","646",2022-12-07 06:45:00,997,1006,9,136,TRUE,NA,"0.1.4"
"9341","646",2022-12-07 07:00:00,997,1006,9,136,TRUE,NA,"0.1.4"
"9342","646",2022-12-07 07:15:00,997,1006,9,136,TRUE,NA,"0.1.4"
"9343","646",2022-12-07 07:30:00,997,1006,9,136,TRUE,NA,"0.1.4"
"9344","646",2022-12-07 07:45:00,997,1006,9,136,TRUE,NA,"0.1.4"
"9345","646",2022-12-07 08:00:00,997,1006,9,136,TRUE,NA,"0.1.4"
"9346","646",2022-12-07 08:15:00,997,1006,9,136,TRUE,NA,"0.1.4"
"9347","646",2022-12-07 08:30:00,997,1006,9,136,TRUE,NA,"0.1.4"
"9348","646",2022-12-07 08:45:00,997,1006,9,136,TRUE,NA,"0.1.4"
"9349","646",2022-12-07 09:00:00,998,1006,8,136,TRUE,NA,"0.1.4"
"9350","646",2022-12-07 09:15:00,997,1006,9,136,TRUE,NA,"0.1.4"
"9351","646",2022-12-07 09:30:00,997,1006,9,136,TRUE,NA,"0.1.4"
"9352","646",2022-12-07 09:45:00,998,1006,8,136,TRUE,NA,"0.1.4"
"9353","646",2022-12-07 10:00:00,997,1006,9,136,TRUE,NA,"0.1.4"
"9354","646",2022-12-07 10:15:00,997,1006,9,136,TRUE,NA,"0.1.4"
"9355","646",2022-12-07 10:30:00,997,1006,9,136,TRUE,NA,"0.1.4"
"9356","646",2022-12-07 10:45:00,997,1006,9,136,TRUE,NA,"0.1.4"
"9357","646",2022-12-07 11:00:00,997,1006,9,136,TRUE,NA,"0.1.4"
"9358","646",2022-12-07 11:15:00,997,1006,9,136,TRUE,NA,"0.1.4"
"9359","646",2022-12-07 11:30:00,998,1006,8,136,TRUE,NA,"0.1.4"
"9360","646",2022-12-07 11:45:00,997,1006,9,136,TRUE,NA,"0.1.4"
"9361","646",2022-12-07 12:00:00,998,1006,8,136,TRUE,NA,"0.1.4"
"9362","646",2022-12-07 12:15:00,998,1006,8,136,TRUE,NA,"0.1.4"
"9363","646",2022-12-07 12:30:00,998,1006,8,136,TRUE,NA,"0.1.4"
"9364","646",2022-12-07 12:45:00,998,1006,8,136,TRUE,NA,"0.1.4"
"9365","646",2022-12-07 13:00:00,998,1006,8,136,TRUE,NA,"0.1.4"
"9366","646",2022-12-07 13:15:00,998,1006,8,136,TRUE,NA,"0.1.4"
"9367","646",2022-12-07 13:30:00,998,1006,8,136,TRUE,NA,"0.1.4"
"9368","646",2022-12-07 13:45:00,998,1006,8,136,TRUE,NA,"0.1.4"
"9369","646",2022-12-07 14:00:00,998,1006,8,136,TRUE,NA,"0.1.4"
"9370","646",2022-12-07 14:15:00,998,1006,8,136,TRUE,NA,"0.1.4"
"9371","646",2022-12-07 14:30:00,998,1006,8,136,TRUE,NA,"0.1.4"
"9372","646",2022-12-07 14:45:00,998,1006,8,136,TRUE,NA,"0.1.4"
"9373","646",2022-12-07 15:00:00,998,1006,8,136,TRUE,NA,"0.1.4"
"9374","646",2022-12-07 15:15:00,998,1006,8,136,TRUE,NA,"0.1.4"
"9375","646",2022-12-07 15:30:00,998,1006,8,136,TRUE,NA,"0.1.4"
"9376","646",2022-12-07 15:45:00,998,1006,8,136,TRUE,NA,"0.1.4"
"9377","646",2022-12-07 16:00:00,998,1006,8,136,TRUE,NA,"0.1.4"
"9378","646",2022-12-07 16:15:00,998,1006,8,136,TRUE,NA,"0.1.4"
"9379","646",2022-12-07 16:30:00,998,1006,8,136,TRUE,NA,"0.1.4"
"9380","646",2022-12-07 16:45:00,998,1006,8,136,TRUE,NA,"0.1.4"
"9381","646",2022-12-07 17:00:00,998,1006,8,136,TRUE,NA,"0.1.4"
"9382","646",2022-12-07 17:15:00,998,1006,8,136,TRUE,NA,"0.1.4"
"9383","646",2022-12-07 17:30:00,998,1006,8,136,TRUE,NA,"0.1.4"
"9384","646",2022-12-07 17:45:00,998,1006,8,136,TRUE,NA,"0.1.4"
"9385","646",2022-12-07 18:00:00,998,1006,8,136,TRUE,NA,"0.1.4"
"9386","646",2022-12-07 18:15:00,998,1006,8,136,TRUE,NA,"0.1.4"
"9387","646",2022-12-07 18:30:00,998,1006,8,136,TRUE,NA,"0.1.4"
"9388","646",2022-12-07 18:45:00,998,1006,8,136,TRUE,NA,"0.1.4"
"9389","646",2022-12-07 19:00:00,998,1006,8,136,TRUE,NA,"0.1.4"
"9390","646",2022-12-07 19:15:00,998,1006,8,136,TRUE,NA,"0.1.4"
"9391","646",2022-12-07 19:30:00,998,1006,8,136,TRUE,NA,"0.1.4"
"9392","646",2022-12-07 19:45:00,998,1006,8,136,TRUE,NA,"0.1.4"
"9393","646",2022-12-07 20:00:00,998,1006,8,136,TRUE,NA,"0.1.4"
"9394","646",2022-12-07 20:15:00,998,1006,8,136,TRUE,NA,"0.1.4"
"9395","646",2022-12-07 20:30:00,998,1006,8,136,TRUE,NA,"0.1.4"
"9396","646",2022-12-07 20:45:00,998,1006,8,136,TRUE,NA,"0.1.4"
"9397","646",2022-12-07 21:00:00,998,1006,8,136,TRUE,NA,"0.1.4"
"9398","646",2022-12-07 21:15:00,998,1006,8,136,TRUE,NA,"0.1.4"
"9399","646",2022-12-07 21:30:00,998,1006,8,136,TRUE,NA,"0.1.4"
"9400","646",2022-12-07 21:45:00,998,1006,8,136,TRUE,NA,"0.1.4"
"9401","646",2022-12-07 22:00:00,998,1006,8,136,TRUE,NA,"0.1.4"
"9402","646",2022-12-07 22:15:00,998,1006,8,136,TRUE,NA,"0.1.4"
"9403","646",2022-12-07 22:30:00,998,1006,8,136,TRUE,NA,"0.1.4"
"9404","646",2022-12-07 22:45:00,998,1006,8,136,TRUE,NA,"0.1.4"
"9405","646",2022-12-07 23:00:00,998,1006,8,136,TRUE,NA,"0.1.4"
"9406","646",2022-12-07 23:15:00,998,1006,8,136,TRUE,NA,"0.1.4"
"9407","646",2022-12-07 23:30:00,998,1006,8,136,TRUE,NA,"0.1.4"
"9408","646",2022-12-07 23:45:00,998,1006,8,136,TRUE,NA,"0.1.4"
"9409","646",2022-12-08,998,1006,8,136,TRUE,NA,"0.1.4"
"9410","646",2022-12-08 00:15:00,998,1006,8,136,TRUE,NA,"0.1.4"
"9411","646",2022-12-08 00:30:00,998,1006,8,136,TRUE,NA,"0.1.4"
"9412","646",2022-12-08 00:45:00,998,1006,8,136,TRUE,NA,"0.1.4"
"9413","646",2022-12-08 01:00:00,998,1006,8,136,TRUE,NA,"0.1.4"
"9414","646",2022-12-08 01:15:00,998,1006,8,136,TRUE,NA,"0.1.4"
"9415","646",2022-12-08 01:30:00,998,1006,8,136,TRUE,NA,"0.1.4"
"9416","646",2022-12-08 01:45:00,998,1006,8,136,TRUE,NA,"0.1.4"
"9417","646",2022-12-08 02:00:00,998,1006,8,136,TRUE,NA,"0.1.4"
"9418","646",2022-12-08 02:15:00,998,1006,8,136,TRUE,NA,"0.1.4"
"9419","646",2022-12-08 02:30:00,998,1006,8,136,TRUE,NA,"0.1.4"
"9420","646",2022-12-08 02:45:00,998,1006,8,136,TRUE,NA,"0.1.4"
"9421","646",2022-12-08 03:00:00,998,1006,8,136,TRUE,NA,"0.1.4"
"9422","646",2022-12-08 03:15:00,998,1006,8,136,TRUE,NA,"0.1.4"
"9423","646",2022-12-08 03:30:00,998,1006,8,136,TRUE,NA,"0.1.4"
"9424","646",2022-12-08 03:45:00,998,1006,8,136,TRUE,NA,"0.1.4"
"9425","646",2022-12-08 04:00:00,998,1006,8,136,TRUE,NA,"0.1.4"
"9426","646",2022-12-08 04:15:00,998,1006,8,136,TRUE,NA,"0.1.4"
"9427","646",2022-12-08 04:30:00,998,1006,8,136,TRUE,NA,"0.1.4"
"9428","646",2022-12-08 04:45:00,998,1006,8,136,TRUE,NA,"0.1.4"
"9429","646",2022-12-08 05:00:00,998,1006,8,136,TRUE,NA,"0.1.4"
"9430","646",2022-12-08 05:15:00,998,1006,8,136,TRUE,NA,"0.1.4"
"9431","646",2022-12-08 05:30:00,998,1006,8,136,TRUE,NA,"0.1.4"
"9432","646",2022-12-08 05:45:00,998,1006,8,136,TRUE,NA,"0.1.4"
"9433","646",2022-12-08 06:00:00,998,1006,8,136,TRUE,NA,"0.1.4"
"9434","646",2022-12-08 06:15:00,998,1006,8,136,TRUE,NA,"0.1.4"
"9435","646",2022-12-08 06:30:00,998,1006,8,136,TRUE,NA,"0.1.4"
"9436","646",2022-12-08 06:45:00,998,1006,8,136,TRUE,NA,"0.1.4"
"9437","646",2022-12-08 07:00:00,998,1006,8,136,TRUE,NA,"0.1.4"
"9438","646",2022-12-08 07:15:00,998,1006,8,136,TRUE,NA,"0.1.4"
"9439","646",2022-12-08 07:30:00,998,1006,8,136,TRUE,NA,"0.1.4"
"9440","646",2022-12-08 07:45:00,998,1006,8,136,TRUE,NA,"0.1.4"
"9441","646",2022-12-08 08:00:00,998,1006,8,136,TRUE,NA,"0.1.4"
"9442","646",2022-12-08 08:15:00,998,1006,8,136,TRUE,NA,"0.1.4"
"9443","646",2022-12-08 08:30:00,998,1006,8,136,TRUE,NA,"0.1.4"
"9444","646",2022-12-08 08:45:00,998,1006,8,136,TRUE,NA,"0.1.4"
"9445","646",2022-12-08 09:00:00,998,1006,8,136,TRUE,NA,"0.1.4"
"9446","646",2022-12-08 09:15:00,998,1006,8,136,TRUE,NA,"0.1.4"
"9447","646",2022-12-08 09:30:00,998,1006,8,136,TRUE,NA,"0.1.4"
"9448","646",2022-12-08 09:45:00,998,1006,8,136,TRUE,NA,"0.1.4"
"9449","646",2022-12-08 10:00:00,998,1006,8,136,TRUE,NA,"0.1.4"
"9450","646",2022-12-08 10:15:00,998,1006,8,136,TRUE,NA,"0.1.4"
"9451","646",2022-12-08 10:30:00,998,1006,8,136,TRUE,NA,"0.1.4"
"9452","646",2022-12-08 10:45:00,998,1006,8,136,TRUE,NA,"0.1.4"
"9453","646",2022-12-08 11:00:00,998,1006,8,136,TRUE,NA,"0.1.4"
"9454","646",2022-12-08 11:15:00,998,1006,8,136,TRUE,NA,"0.1.4"
"9455","646",2022-12-08 11:30:00,998,1006,8,136,TRUE,NA,"0.1.4"
"9456","646",2022-12-08 11:45:00,998,1006,8,136,TRUE,NA,"0.1.4"
"9457","646",2022-12-08 12:00:00,998,1006,8,136,TRUE,NA,"0.1.4"
"9458","646",2022-12-08 12:15:00,998,1006,8,136,TRUE,NA,"0.1.4"
"9459","646",2022-12-08 12:30:00,998,1006,8,136,TRUE,NA,"0.1.4"
"9460","646",2022-12-08 12:45:00,998,1006,8,136,TRUE,NA,"0.1.4"
"9461","646",2022-12-08 13:00:00,998,1006,8,136,TRUE,NA,"0.1.4"
"9462","646",2022-12-08 13:15:00,998,1006,8,136,TRUE,NA,"0.1.4"
"9463","646",2022-12-08 13:30:00,998,1006,8,136,TRUE,NA,"0.1.4"
"9464","646",2022-12-08 13:45:00,998,1006,8,136,TRUE,NA,"0.1.4"
"9465","646",2022-12-08 14:00:00,998,1006,8,136,TRUE,NA,"0.1.4"
"9466","646",2022-12-08 14:15:00,998,1006,8,136,TRUE,NA,"0.1.4"
"9467","646",2022-12-08 14:30:00,998,1006,8,136,TRUE,NA,"0.1.4"
"9468","646",2022-12-08 14:45:00,998,1006,8,136,TRUE,NA,"0.1.4"
"9469","646",2022-12-08 15:00:00,998,1006,8,136,TRUE,NA,"0.1.4"
"9470","646",2022-12-08 15:15:00,998,1006,8,136,TRUE,NA,"0.1.4"
"9471","646",2022-12-08 15:30:00,998,1006,8,136,TRUE,NA,"0.1.4"
"9472","646",2022-12-08 15:45:00,998,1006,8,136,TRUE,NA,"0.1.4"
"9473","646",2022-12-08 16:00:00,998,1006,8,136,TRUE,NA,"0.1.4"
"9474","646",2022-12-08 16:15:00,998,1006,8,136,TRUE,NA,"0.1.4"
"9475","646",2022-12-08 16:30:00,998,1006,8,136,TRUE,NA,"0.1.4"
"9476","646",2022-12-08 16:45:00,998,1006,8,136,TRUE,NA,"0.1.4"
"9477","646",2022-12-08 17:00:00,998,1006,8,136,TRUE,NA,"0.1.4"
"9478","646",2022-12-08 17:15:00,998,1006,8,136,TRUE,NA,"0.1.4"
"9479","646",2022-12-08 17:30:00,998,1006,8,136,TRUE,NA,"0.1.4"
"9480","646",2022-12-08 17:45:00,998,1006,8,136,TRUE,NA,"0.1.4"
"9481","646",2022-12-08 18:00:00,998,1006,8,136,TRUE,NA,"0.1.4"
"9482","646",2022-12-08 18:15:00,998,1006,8,136,TRUE,NA,"0.1.4"
"9483","646",2022-12-08 18:30:00,998,1006,8,136,TRUE,NA,"0.1.4"
"9484","646",2022-12-08 18:45:00,998,1006,8,136,TRUE,NA,"0.1.4"
"9485","646",2022-12-08 19:00:00,998,1006,8,136,TRUE,NA,"0.1.4"
"9486","646",2022-12-08 19:15:00,998,1006,8,136,TRUE,NA,"0.1.4"
"9487","646",2022-12-08 19:30:00,998,1006,8,136,TRUE,NA,"0.1.4"
"9488","646",2022-12-08 19:45:00,998,1006,8,136,TRUE,NA,"0.1.4"
"9489","646",2022-12-08 20:00:00,998,1006,8,136,TRUE,NA,"0.1.4"
"9490","646",2022-12-08 20:15:00,998,1006,8,136,TRUE,NA,"0.1.4"
"9491","646",2022-12-08 20:30:00,998,1006,8,136,TRUE,NA,"0.1.4"
"9492","646",2022-12-08 20:45:00,998,1006,8,136,TRUE,NA,"0.1.4"
"9493","646",2022-12-08 21:00:00,998,1006,8,136,TRUE,NA,"0.1.4"
"9494","646",2022-12-08 21:15:00,998,1006,8,136,TRUE,NA,"0.1.4"
"9495","646",2022-12-08 21:30:00,998,1006,8,136,TRUE,NA,"0.1.4"
"9496","646",2022-12-08 21:45:00,998,1006,8,136,TRUE,NA,"0.1.4"
"9497","646",2022-12-08 22:00:00,998,1006,8,136,TRUE,NA,"0.1.4"
"9498","646",2022-12-08 22:15:00,998,1006,8,136,TRUE,NA,"0.1.4"
"9499","646",2022-12-08 22:30:00,998,1006,8,136,TRUE,NA,"0.1.4"
"9500","646",2022-12-08 22:45:00,998,1006,8,136,TRUE,NA,"0.1.4"
"9501","646",2022-12-08 23:00:00,998,1006,8,136,TRUE,NA,"0.1.4"
"9502","646",2022-12-08 23:15:00,998,1006,8,136,TRUE,NA,"0.1.4"
"9503","646",2022-12-08 23:30:00,998,1006,8,136,TRUE,NA,"0.1.4"
"9504","646",2022-12-08 23:45:00,998,1006,8,136,TRUE,NA,"0.1.4"
"9505","646",2022-12-09,998,1006,8,136,TRUE,NA,"0.1.4"
"9506","646",2022-12-09 00:15:00,998,1006,8,136,TRUE,NA,"0.1.4"
"9507","646",2022-12-09 00:30:00,998,1006,8,136,TRUE,NA,"0.1.4"
"9508","646",2022-12-09 00:45:00,998,1006,8,136,TRUE,NA,"0.1.4"
"9509","646",2022-12-09 01:00:00,998,1006,8,136,TRUE,NA,"0.1.4"
"9510","646",2022-12-09 01:15:00,998,1006,8,136,TRUE,NA,"0.1.4"
"9511","646",2022-12-09 01:30:00,998,1006,8,136,TRUE,NA,"0.1.4"
"9512","646",2022-12-09 01:45:00,998,1006,8,136,TRUE,NA,"0.1.4"
"9513","646",2022-12-09 02:00:00,998,1006,8,136,TRUE,NA,"0.1.4"
"9514","646",2022-12-09 02:15:00,998,1006,8,136,TRUE,NA,"0.1.4"
"9515","646",2022-12-09 02:30:00,998,1006,8,136,TRUE,NA,"0.1.4"
"9516","646",2022-12-09 02:45:00,998,1006,8,136,TRUE,NA,"0.1.4"
"9517","646",2022-12-09 03:00:00,998,1006,8,136,TRUE,NA,"0.1.4"
"9518","646",2022-12-09 03:15:00,998,1006,8,136,TRUE,NA,"0.1.4"
"9519","646",2022-12-09 03:30:00,998,1006,8,136,TRUE,NA,"0.1.4"
"9520","646",2022-12-09 03:45:00,998,1006,8,136,TRUE,NA,"0.1.4"
"9521","646",2022-12-09 04:00:00,998,1006,8,136,TRUE,NA,"0.1.4"
"9522","646",2022-12-09 04:15:00,998,1006,8,136,TRUE,NA,"0.1.4"
"9523","646",2022-12-09 04:30:00,998,1006,8,136,TRUE,NA,"0.1.4"
"9524","646",2022-12-09 04:45:00,998,1006,8,136,TRUE,NA,"0.1.4"
"9525","646",2022-12-09 05:00:00,998,1006,8,136,TRUE,NA,"0.1.4"
"9526","646",2022-12-09 05:15:00,998,1006,8,136,TRUE,NA,"0.1.4"
"9527","646",2022-12-09 05:30:00,998,1006,8,136,TRUE,NA,"0.1.4"
"9528","646",2022-12-09 05:45:00,998,1006,8,136,TRUE,NA,"0.1.4"
"9529","646",2022-12-09 06:00:00,998,1006,8,136,TRUE,NA,"0.1.4"
"9530","646",2022-12-09 06:15:00,998,1006,8,136,TRUE,NA,"0.1.4"
"9531","646",2022-12-09 06:30:00,998,1006,8,136,TRUE,NA,"0.1.4"
"9532","646",2022-12-09 06:45:00,998,1006,8,136,TRUE,NA,"0.1.4"
"9533","646",2022-12-09 07:00:00,998,1006,8,136,TRUE,NA,"0.1.4"
"9534","646",2022-12-09 07:15:00,998,1006,8,136,TRUE,NA,"0.1.4"
"9535","646",2022-12-09 07:30:00,998,1006,8,136,TRUE,NA,"0.1.4"
"9536","646",2022-12-09 07:45:00,998,1006,8,136,TRUE,NA,"0.1.4"
"9537","646",2022-12-09 08:00:00,998,1006,8,136,TRUE,NA,"0.1.4"
"9538","646",2022-12-09 08:15:00,998,1006,8,136,TRUE,NA,"0.1.4"
"9539","646",2022-12-09 08:30:00,998,1006,8,136,TRUE,NA,"0.1.4"
"9540","646",2022-12-09 08:45:00,998,1006,8,136,TRUE,NA,"0.1.4"
"9541","646",2022-12-09 09:00:00,998,1006,8,136,TRUE,NA,"0.1.4"
"9542","646",2022-12-09 09:15:00,998,1006,8,136,TRUE,NA,"0.1.4"
"9543","646",2022-12-09 09:30:00,998,1006,8,136,TRUE,NA,"0.1.4"
"9544","646",2022-12-09 09:45:00,998,1006,8,136,TRUE,NA,"0.1.4"
"9545","646",2022-12-09 10:00:00,998,1006,8,136,TRUE,NA,"0.1.4"
"9546","646",2022-12-09 10:15:00,998,1006,8,136,TRUE,NA,"0.1.4"
"9547","646",2022-12-09 10:30:00,998,1006,8,136,TRUE,NA,"0.1.4"
"9548","646",2022-12-09 10:45:00,998,1006,8,136,TRUE,NA,"0.1.4"
"9549","646",2022-12-09 11:00:00,998,1006,8,136,TRUE,NA,"0.1.4"
"9550","646",2022-12-09 11:15:00,998,1006,8,136,TRUE,NA,"0.1.4"
"9551","646",2022-12-09 11:30:00,998,1006,8,136,TRUE,NA,"0.1.4"
"9552","646",2022-12-09 11:45:00,998,1006,8,136,TRUE,NA,"0.1.4"
"9553","646",2022-12-09 12:00:00,998,1006,8,136,TRUE,NA,"0.1.4"
"9554","646",2022-12-09 12:15:00,998,1006,8,136,TRUE,NA,"0.1.4"
"9555","646",2022-12-09 12:30:00,998,1006,8,136,TRUE,NA,"0.1.4"
"9556","646",2022-12-09 12:45:00,998,1006,8,136,TRUE,NA,"0.1.4"
"9557","646",2022-12-09 13:00:00,998,1006,8,136,TRUE,NA,"0.1.4"
"9558","646",2022-12-09 13:15:00,998,1006,8,136,TRUE,NA,"0.1.4"
"9559","646",2022-12-09 13:30:00,998,1006,8,136,TRUE,NA,"0.1.4"
"9560","646",2022-12-09 13:45:00,998,1006,8,136,TRUE,NA,"0.1.4"
"9561","646",2022-12-09 14:00:00,998,1006,8,136,TRUE,NA,"0.1.4"
"9562","646",2022-12-09 14:15:00,998,1006,8,136,TRUE,NA,"0.1.4"
"9563","646",2022-12-09 14:30:00,998,1006,8,136,TRUE,NA,"0.1.4"
"9564","646",2022-12-09 14:45:00,998,1006,8,136,TRUE,NA,"0.1.4"
"9565","646",2022-12-09 15:00:00,998,1006,8,136,TRUE,NA,"0.1.4"
"9566","646",2022-12-09 15:15:00,998,1006,8,136,TRUE,NA,"0.1.4"
"9567","646",2022-12-09 15:30:00,998,1006,8,136,TRUE,NA,"0.1.4"
"9568","646",2022-12-09 15:45:00,998,1006,8,136,TRUE,NA,"0.1.4"
"9569","646",2022-12-09 16:00:00,998,1006,8,136,TRUE,NA,"0.1.4"
"9570","646",2022-12-09 16:15:00,998,1006,8,136,TRUE,NA,"0.1.4"
"9571","646",2022-12-09 16:30:00,998,1006,8,136,TRUE,NA,"0.1.4"
"9572","646",2022-12-09 16:45:00,998,1006,8,136,TRUE,NA,"0.1.4"
"9573","646",2022-12-09 17:00:00,998,1006,8,136,TRUE,NA,"0.1.4"
"9574","646",2022-12-09 17:15:00,998,1006,8,136,TRUE,NA,"0.1.4"
"9575","646",2022-12-09 17:30:00,998,1006,8,136,TRUE,NA,"0.1.4"
"9576","646",2022-12-09 17:45:00,998,1006,8,136,TRUE,NA,"0.1.4"
"9577","646",2022-12-09 18:00:00,998,1006,8,136,TRUE,NA,"0.1.4"
"9578","646",2022-12-09 18:15:00,998,1006,8,136,TRUE,NA,"0.1.4"
"9579","646",2022-12-09 18:30:00,998,1006,8,136,TRUE,NA,"0.1.4"
"9580","646",2022-12-09 18:45:00,998,1006,8,136,TRUE,NA,"0.1.4"
"9581","646",2022-12-09 19:00:00,998,1006,8,136,TRUE,NA,"0.1.4"
"9582","646",2022-12-09 19:15:00,998,1006,8,136,TRUE,NA,"0.1.4"
"9583","646",2022-12-09 19:30:00,998,1006,8,136,TRUE,NA,"0.1.4"
"9584","646",2022-12-09 19:45:00,998,1006,8,136,TRUE,NA,"0.1.4"
"9585","646",2022-12-09 20:00:00,998,1006,8,136,TRUE,NA,"0.1.4"
"9586","646",2022-12-09 20:15:00,998,1006,8,136,TRUE,NA,"0.1.4"
"9587","646",2022-12-09 20:30:00,998,1006,8,136,TRUE,NA,"0.1.4"
"9588","646",2022-12-09 20:45:00,998,1006,8,136,TRUE,NA,"0.1.4"
"9589","646",2022-12-09 21:00:00,998,1006,8,136,TRUE,NA,"0.1.4"
"9590","646",2022-12-09 21:15:00,998,1006,8,136,TRUE,NA,"0.1.4"
"9591","646",2022-12-09 21:30:00,998,1006,8,136,TRUE,NA,"0.1.4"
"9592","646",2022-12-09 21:45:00,998,1006,8,136,TRUE,NA,"0.1.4"
"9593","646",2022-12-09 22:00:00,998,1006,8,136,TRUE,NA,"0.1.4"
"9594","646",2022-12-09 22:15:00,998,1006,8,136,TRUE,NA,"0.1.4"
"9595","646",2022-12-09 22:30:00,998,1006,8,136,TRUE,NA,"0.1.4"
"9596","646",2022-12-09 22:45:00,998,1006,8,136,TRUE,NA,"0.1.4"
"9597","646",2022-12-09 23:00:00,998,1006,8,136,TRUE,NA,"0.1.4"
"9598","646",2022-12-09 23:15:00,998,1006,8,136,TRUE,NA,"0.1.4"
"9599","646",2022-12-09 23:30:00,998,1006,8,136,TRUE,NA,"0.1.4"
"9600","646",2022-12-09 23:45:00,998,1006,8,136,TRUE,NA,"0.1.4"
"9601","646",2022-12-10,998,1006,8,136,TRUE,NA,"0.1.4"
"9602","646",2022-12-10 00:15:00,998,1006,8,136,TRUE,NA,"0.1.4"
"9603","646",2022-12-10 00:30:00,998,1006,8,136,TRUE,NA,"0.1.4"
"9604","646",2022-12-10 00:45:00,998,1006,8,136,TRUE,NA,"0.1.4"
"9605","646",2022-12-10 01:00:00,998,1006,8,136,TRUE,NA,"0.1.4"
"9606","646",2022-12-10 01:15:00,998,1006,8,136,TRUE,NA,"0.1.4"
"9607","646",2022-12-10 01:30:00,998,1006,8,136,TRUE,NA,"0.1.4"
"9608","646",2022-12-10 01:45:00,998,1006,8,136,TRUE,NA,"0.1.4"
"9609","646",2022-12-10 02:00:00,998,1006,8,136,TRUE,NA,"0.1.4"
"9610","646",2022-12-10 02:15:00,998,1006,8,136,TRUE,NA,"0.1.4"
"9611","646",2022-12-10 02:30:00,998,1006,8,136,TRUE,NA,"0.1.4"
"9612","646",2022-12-10 02:45:00,998,1006,8,136,TRUE,NA,"0.1.4"
"9613","646",2022-12-10 03:00:00,998,1006,8,136,TRUE,NA,"0.1.4"
"9614","646",2022-12-10 03:15:00,998,1006,8,136,TRUE,NA,"0.1.4"
"9615","646",2022-12-10 03:30:00,998,1006,8,136,TRUE,NA,"0.1.4"
"9616","646",2022-12-10 03:45:00,998,1006,8,136,TRUE,NA,"0.1.4"
"9617","646",2022-12-10 04:00:00,998,1006,8,136,TRUE,NA,"0.1.4"
"9618","646",2022-12-10 04:15:00,998,1006,8,136,TRUE,NA,"0.1.4"
"9619","646",2022-12-10 04:30:00,998,1006,8,136,TRUE,NA,"0.1.4"
"9620","646",2022-12-10 04:45:00,998,1006,8,136,TRUE,NA,"0.1.4"
"9621","646",2022-12-10 05:00:00,998,1006,8,136,TRUE,NA,"0.1.4"
"9622","646",2022-12-10 05:15:00,998,1006,8,136,TRUE,NA,"0.1.4"
"9623","646",2022-12-10 05:30:00,998,1006,8,136,TRUE,NA,"0.1.4"
"9624","646",2022-12-10 05:45:00,998,1006,8,136,TRUE,NA,"0.1.4"
"9625","646",2022-12-10 06:00:00,998,1006,8,136,TRUE,NA,"0.1.4"
"9626","646",2022-12-10 06:15:00,998,1006,8,136,TRUE,NA,"0.1.4"
"9627","646",2022-12-10 06:30:00,998,1006,8,136,TRUE,NA,"0.1.4"
"9628","646",2022-12-10 06:45:00,998,1006,8,136,TRUE,NA,"0.1.4"
"9629","646",2022-12-10 07:00:00,998,1006,8,136,TRUE,NA,"0.1.4"
"9630","646",2022-12-10 07:15:00,998,1006,8,136,TRUE,NA,"0.1.4"
"9631","646",2022-12-10 07:30:00,998,1006,8,136,TRUE,NA,"0.1.4"
"9632","646",2022-12-10 07:45:00,998,1006,8,136,TRUE,NA,"0.1.4"
"9633","646",2022-12-10 08:00:00,998,1006,8,136,TRUE,NA,"0.1.4"
"9634","646",2022-12-10 08:15:00,998,1006,8,136,TRUE,NA,"0.1.4"
"9635","646",2022-12-10 08:30:00,998,1006,8,136,TRUE,NA,"0.1.4"
"9636","646",2022-12-10 08:45:00,998,1006,8,136,TRUE,NA,"0.1.4"
"9637","646",2022-12-10 09:00:00,998,1006,8,136,TRUE,NA,"0.1.4"
"9638","646",2022-12-10 09:15:00,998,1006,8,136,TRUE,NA,"0.1.4"
"9639","646",2022-12-10 09:30:00,998,1006,8,136,TRUE,NA,"0.1.4"
"9640","646",2022-12-10 09:45:00,998,1006,8,136,TRUE,NA,"0.1.4"
"9641","646",2022-12-10 10:00:00,998,1006,8,136,TRUE,NA,"0.1.4"
"9642","646",2022-12-10 10:15:00,998,1006,8,136,TRUE,NA,"0.1.4"
"9643","646",2022-12-10 10:30:00,998,1006,8,136,TRUE,NA,"0.1.4"
"9644","646",2022-12-10 10:45:00,998,1006,8,136,TRUE,NA,"0.1.4"
"9645","646",2022-12-10 11:00:00,998,1006,8,136,TRUE,NA,"0.1.4"
"9646","646",2022-12-10 11:15:00,998,1006,8,136,TRUE,NA,"0.1.4"
"9647","646",2022-12-10 11:30:00,998,1006,8,136,TRUE,NA,"0.1.4"
"9648","646",2022-12-10 11:45:00,998,1006,8,136,TRUE,NA,"0.1.4"
"9649","646",2022-12-10 12:00:00,998,1006,8,136,TRUE,NA,"0.1.4"
"9650","646",2022-12-10 12:15:00,998,1006,8,136,TRUE,NA,"0.1.4"
"9651","646",2022-12-10 12:30:00,998,1006,8,136,TRUE,NA,"0.1.4"
"9652","646",2022-12-10 12:45:00,998,1006,8,136,TRUE,NA,"0.1.4"
"9653","646",2022-12-10 13:00:00,998,1006,8,136,TRUE,NA,"0.1.4"
"9654","646",2022-12-10 13:15:00,998,1006,8,136,TRUE,NA,"0.1.4"
"9655","646",2022-12-10 13:30:00,998,1006,8,136,TRUE,NA,"0.1.4"
"9656","646",2022-12-10 13:45:00,998,1006,8,136,TRUE,NA,"0.1.4"
"9657","646",2022-12-10 14:00:00,998,1006,8,136,TRUE,NA,"0.1.4"
"9658","646",2022-12-10 14:15:00,998,1006,8,136,TRUE,NA,"0.1.4"
"9659","646",2022-12-10 14:30:00,998,1006,8,136,TRUE,NA,"0.1.4"
"9660","646",2022-12-10 14:45:00,998,1006,8,136,TRUE,NA,"0.1.4"
"9661","646",2022-12-10 15:00:00,998,1006,8,136,TRUE,NA,"0.1.4"
"9662","646",2022-12-10 15:15:00,998,1006,8,136,TRUE,NA,"0.1.4"
"9663","646",2022-12-10 15:30:00,998,1006,8,136,TRUE,NA,"0.1.4"
"9664","646",2022-12-10 15:45:00,998,1006,8,136,TRUE,NA,"0.1.4"
"9665","646",2022-12-10 16:00:00,998,1006,8,136,TRUE,NA,"0.1.4"
"9666","646",2022-12-10 16:15:00,998,1006,8,136,TRUE,NA,"0.1.4"
"9667","646",2022-12-10 16:30:00,998,1006,8,136,TRUE,NA,"0.1.4"
"9668","646",2022-12-10 16:45:00,998,1006,8,136,TRUE,NA,"0.1.4"
"9669","646",2022-12-10 17:00:00,998,1006,8,136,TRUE,NA,"0.1.4"
"9670","646",2022-12-10 17:15:00,998,1006,8,136,TRUE,NA,"0.1.4"
"9671","646",2022-12-10 17:30:00,998,1006,8,136,TRUE,NA,"0.1.4"
"9672","646",2022-12-10 17:45:00,998,1006,8,136,TRUE,NA,"0.1.4"
"9673","646",2022-12-10 18:00:00,998,1006,8,136,TRUE,NA,"0.1.4"
"9674","646",2022-12-10 18:15:00,998,1006,8,136,TRUE,NA,"0.1.4"
"9675","646",2022-12-10 18:30:00,998,1006,8,136,TRUE,NA,"0.1.4"
"9676","646",2022-12-10 18:45:00,998,1006,8,136,TRUE,NA,"0.1.4"
"9677","646",2022-12-10 19:00:00,998,1006,8,136,TRUE,NA,"0.1.4"
"9678","646",2022-12-10 19:15:00,998,1006,8,136,TRUE,NA,"0.1.4"
"9679","646",2022-12-10 19:30:00,998,1006,8,136,TRUE,NA,"0.1.4"
"9680","646",2022-12-10 19:45:00,998,1006,8,136,TRUE,NA,"0.1.4"
"9681","646",2022-12-10 20:00:00,998,1006,8,136,TRUE,NA,"0.1.4"
"9682","646",2022-12-10 20:15:00,998,1006,8,136,TRUE,NA,"0.1.4"
"9683","646",2022-12-10 20:30:00,998,1006,8,136,TRUE,NA,"0.1.4"
"9684","646",2022-12-10 20:45:00,998,1006,8,136,TRUE,NA,"0.1.4"
"9685","646",2022-12-10 21:00:00,998,1006,8,136,TRUE,NA,"0.1.4"
"9686","646",2022-12-10 21:15:00,998,1006,8,136,TRUE,NA,"0.1.4"
"9687","646",2022-12-10 21:30:00,998,1006,8,136,TRUE,NA,"0.1.4"
"9688","646",2022-12-10 21:45:00,998,1006,8,136,TRUE,NA,"0.1.4"
"9689","646",2022-12-10 22:00:00,998,1006,8,136,TRUE,NA,"0.1.4"
"9690","646",2022-12-10 22:15:00,998,1006,8,136,TRUE,NA,"0.1.4"
"9691","646",2022-12-10 22:30:00,998,1006,8,136,TRUE,NA,"0.1.4"
"9692","646",2022-12-10 22:45:00,998,1006,8,136,TRUE,NA,"0.1.4"
"9693","646",2022-12-10 23:00:00,998,1006,8,136,TRUE,NA,"0.1.4"
"9694","646",2022-12-10 23:15:00,998,1006,8,136,TRUE,NA,"0.1.4"
"9695","646",2022-12-10 23:30:00,998,1006,8,136,TRUE,NA,"0.1.4"
"9696","646",2022-12-10 23:45:00,998,1006,8,136,TRUE,NA,"0.1.4"
"9697","646",2022-12-11,998,1006,8,136,TRUE,NA,"0.1.4"
"9698","646",2022-12-11 00:15:00,998,1006,8,136,TRUE,NA,"0.1.4"
"9699","646",2022-12-11 00:30:00,998,1006,8,136,TRUE,NA,"0.1.4"
"9700","646",2022-12-11 00:45:00,998,1006,8,136,TRUE,NA,"0.1.4"
"9701","646",2022-12-11 01:00:00,998,1006,8,136,TRUE,NA,"0.1.4"
"9702","646",2022-12-11 01:15:00,998,1006,8,136,TRUE,NA,"0.1.4"
"9703","646",2022-12-11 01:30:00,998,1006,8,136,TRUE,NA,"0.1.4"
"9704","646",2022-12-11 01:45:00,998,1006,8,136,TRUE,NA,"0.1.4"
"9705","646",2022-12-11 02:00:00,998,1006,8,136,TRUE,NA,"0.1.4"
"9706","646",2022-12-11 02:15:00,998,1006,8,136,TRUE,NA,"0.1.4"
"9707","646",2022-12-11 02:30:00,998,1006,8,136,TRUE,NA,"0.1.4"
"9708","646",2022-12-11 02:45:00,998,1006,8,136,TRUE,NA,"0.1.4"
"9709","646",2022-12-11 03:00:00,998,1006,8,136,TRUE,NA,"0.1.4"
"9710","646",2022-12-11 03:15:00,998,1006,8,136,TRUE,NA,"0.1.4"
"9711","646",2022-12-11 03:30:00,998,1006,8,136,TRUE,NA,"0.1.4"
"9712","646",2022-12-11 03:45:00,998,1006,8,136,TRUE,NA,"0.1.4"
"9713","646",2022-12-11 04:00:00,998,1006,8,136,TRUE,NA,"0.1.4"
"9714","646",2022-12-11 04:15:00,998,1006,8,136,TRUE,NA,"0.1.4"
"9715","646",2022-12-11 04:30:00,998,1006,8,136,TRUE,NA,"0.1.4"
"9716","646",2022-12-11 04:45:00,998,1006,8,136,TRUE,NA,"0.1.4"
"9717","646",2022-12-11 05:00:00,998,1006,8,136,TRUE,NA,"0.1.4"
"9718","646",2022-12-11 05:15:00,998,1006,8,136,TRUE,NA,"0.1.4"
"9719","646",2022-12-11 05:30:00,998,1006,8,136,TRUE,NA,"0.1.4"
"9720","646",2022-12-11 05:45:00,998,1006,8,136,TRUE,NA,"0.1.4"
"9721","646",2022-12-11 06:00:00,998,1006,8,136,TRUE,NA,"0.1.4"
"9722","646",2022-12-11 06:15:00,998,1006,8,136,TRUE,NA,"0.1.4"
"9723","646",2022-12-11 06:30:00,998,1006,8,136,TRUE,NA,"0.1.4"
"9724","646",2022-12-11 06:45:00,998,1006,8,136,TRUE,NA,"0.1.4"
"9725","646",2022-12-11 07:00:00,998,1006,8,136,TRUE,NA,"0.1.4"
"9726","646",2022-12-11 07:15:00,998,1006,8,136,TRUE,NA,"0.1.4"
"9727","646",2022-12-11 07:30:00,998,1006,8,136,TRUE,NA,"0.1.4"
"9728","646",2022-12-11 07:45:00,998,1006,8,136,TRUE,NA,"0.1.4"
"9729","646",2022-12-11 08:00:00,998,1006,8,136,TRUE,NA,"0.1.4"
"9730","646",2022-12-11 08:15:00,998,1006,8,136,TRUE,NA,"0.1.4"
"9731","646",2022-12-11 08:30:00,998,1006,8,136,TRUE,NA,"0.1.4"
"9732","646",2022-12-11 08:45:00,998,1006,8,136,TRUE,NA,"0.1.4"
"9733","646",2022-12-11 09:00:00,998,1006,8,136,TRUE,NA,"0.1.4"
"9734","646",2022-12-11 09:15:00,998,1006,8,136,TRUE,NA,"0.1.4"
"9735","646",2022-12-11 09:30:00,998,1006,8,136,TRUE,NA,"0.1.4"
"9736","646",2022-12-11 09:45:00,998,1006,8,136,TRUE,NA,"0.1.4"
"9737","646",2022-12-11 10:00:00,998,1006,8,136,TRUE,NA,"0.1.4"
"9738","646",2022-12-11 10:15:00,998,1006,8,136,TRUE,NA,"0.1.4"
"9739","646",2022-12-11 10:30:00,998,1006,8,136,TRUE,NA,"0.1.4"
"9740","646",2022-12-11 10:45:00,998,1006,8,136,TRUE,NA,"0.1.4"
"9741","646",2022-12-11 11:00:00,998,1006,8,136,TRUE,NA,"0.1.4"
"9742","646",2022-12-11 11:15:00,998,1006,8,136,TRUE,NA,"0.1.4"
"9743","646",2022-12-11 11:30:00,998,1006,8,136,TRUE,NA,"0.1.4"
"9744","646",2022-12-11 11:45:00,998,1006,8,136,TRUE,NA,"0.1.4"
"9745","646",2022-12-11 12:00:00,998,1006,8,136,TRUE,NA,"0.1.4"
"9746","646",2022-12-11 12:15:00,998,1006,8,136,TRUE,NA,"0.1.4"
"9747","646",2022-12-11 12:30:00,998,1006,8,136,TRUE,NA,"0.1.4"
"9748","646",2022-12-11 12:45:00,998,1006,8,136,TRUE,NA,"0.1.4"
"9749","646",2022-12-11 13:00:00,998,1006,8,136,TRUE,NA,"0.1.4"
"9750","646",2022-12-11 13:15:00,998,1006,8,136,TRUE,NA,"0.1.4"
"9751","646",2022-12-11 13:30:00,998,1006,8,136,TRUE,NA,"0.1.4"
"9752","646",2022-12-11 13:45:00,998,1006,8,136,TRUE,NA,"0.1.4"
"9753","646",2022-12-11 14:00:00,998,1006,8,136,TRUE,NA,"0.1.4"
"9754","646",2022-12-11 14:15:00,998,1006,8,136,TRUE,NA,"0.1.4"
"9755","646",2022-12-11 14:30:00,998,1006,8,136,TRUE,NA,"0.1.4"
"9756","646",2022-12-11 14:45:00,998,1006,8,136,TRUE,NA,"0.1.4"
"9757","646",2022-12-11 15:00:00,998,1006,8,136,TRUE,NA,"0.1.4"
"9758","646",2022-12-11 15:15:00,998,1006,8,136,TRUE,NA,"0.1.4"
"9759","646",2022-12-11 15:30:00,998,1006,8,136,TRUE,NA,"0.1.4"
"9760","646",2022-12-11 15:45:00,998,1006,8,136,TRUE,NA,"0.1.4"
"9761","646",2022-12-11 16:00:00,998,1006,8,136,TRUE,NA,"0.1.4"
"9762","646",2022-12-11 16:15:00,998,1006,8,136,TRUE,NA,"0.1.4"
"9763","646",2022-12-11 16:30:00,998,1006,8,136,TRUE,NA,"0.1.4"
"9764","646",2022-12-11 16:45:00,998,1006,8,136,TRUE,NA,"0.1.4"
"9765","646",2022-12-11 17:00:00,998,1006,8,136,TRUE,NA,"0.1.4"
"9766","646",2022-12-11 17:15:00,998,1006,8,136,TRUE,NA,"0.1.4"
"9767","646",2022-12-11 17:30:00,998,1006,8,136,TRUE,NA,"0.1.4"
"9768","646",2022-12-11 17:45:00,998,1006,8,136,TRUE,NA,"0.1.4"
"9769","646",2022-12-11 18:00:00,998,1006,8,136,TRUE,NA,"0.1.4"
"9770","646",2022-12-11 18:15:00,998,1006,8,136,TRUE,NA,"0.1.4"
"9771","646",2022-12-11 18:30:00,998,1006,8,136,TRUE,NA,"0.1.4"
"9772","646",2022-12-11 18:45:00,998,1006,8,136,TRUE,NA,"0.1.4"
"9773","646",2022-12-11 19:00:00,998,1006,8,136,TRUE,NA,"0.1.4"
"9774","646",2022-12-11 19:15:00,998,1006,8,136,TRUE,NA,"0.1.4"
"9775","646",2022-12-11 19:30:00,998,1006,8,136,TRUE,NA,"0.1.4"
"9776","646",2022-12-11 19:45:00,998,1006,8,136,TRUE,NA,"0.1.4"
"9777","646",2022-12-11 20:00:00,998,1006,8,136,TRUE,NA,"0.1.4"
"9778","646",2022-12-11 20:15:00,998,1006,8,136,TRUE,NA,"0.1.4"
"9779","646",2022-12-11 20:30:00,998,1006,8,136,TRUE,NA,"0.1.4"
"9780","646",2022-12-11 20:45:00,998,1006,8,136,TRUE,NA,"0.1.4"
"9781","646",2022-12-11 21:00:00,998,1006,8,136,TRUE,NA,"0.1.4"
"9782","646",2022-12-11 21:15:00,998,1006,8,136,TRUE,NA,"0.1.4"
"9783","646",2022-12-11 21:30:00,998,1006,8,136,TRUE,NA,"0.1.4"
"9784","646",2022-12-11 21:45:00,998,1006,8,136,TRUE,NA,"0.1.4"
"9785","646",2022-12-11 22:00:00,998,1006,8,136,TRUE,NA,"0.1.4"
"9786","646",2022-12-11 22:15:00,998,1006,8,136,TRUE,NA,"0.1.4"
"9787","646",2022-12-11 22:30:00,998,1006,8,136,TRUE,NA,"0.1.4"
"9788","646",2022-12-11 22:45:00,998,1006,8,136,TRUE,NA,"0.1.4"
"9789","646",2022-12-11 23:00:00,998,1006,8,136,TRUE,NA,"0.1.4"
"9790","646",2022-12-11 23:15:00,998,1006,8,136,TRUE,NA,"0.1.4"
"9791","646",2022-12-11 23:30:00,998,1006,8,136,TRUE,NA,"0.1.4"
"9792","646",2022-12-11 23:45:00,998,1006,8,136,TRUE,NA,"0.1.4"
"9793","646",2022-12-12,998,1006,8,136,TRUE,NA,"0.1.4"
"9794","646",2022-12-12 00:15:00,998,1006,8,136,TRUE,NA,"0.1.4"
"9795","646",2022-12-12 00:30:00,998,1006,8,136,TRUE,NA,"0.1.4"
"9796","646",2022-12-12 00:45:00,998,1006,8,136,TRUE,NA,"0.1.4"
"9797","646",2022-12-12 01:00:00,998,1006,8,136,TRUE,NA,"0.1.4"
"9798","646",2022-12-12 01:15:00,998,1006,8,136,TRUE,NA,"0.1.4"
"9799","646",2022-12-12 01:30:00,998,1006,8,136,TRUE,NA,"0.1.4"
"9800","646",2022-12-12 01:45:00,998,1006,8,136,TRUE,NA,"0.1.4"
"9801","646",2022-12-12 02:00:00,998,1006,8,136,TRUE,NA,"0.1.4"
"9802","646",2022-12-12 02:15:00,998,1006,8,136,TRUE,NA,"0.1.4"
"9803","646",2022-12-12 02:30:00,998,1006,8,136,TRUE,NA,"0.1.4"
"9804","646",2022-12-12 02:45:00,998,1006,8,136,TRUE,NA,"0.1.4"
"9805","646",2022-12-12 03:00:00,998,1006,8,136,TRUE,NA,"0.1.4"
"9806","646",2022-12-12 03:15:00,998,1006,8,136,TRUE,NA,"0.1.4"
"9807","646",2022-12-12 03:30:00,998,1006,8,136,TRUE,NA,"0.1.4"
"9808","646",2022-12-12 03:45:00,998,1006,8,136,TRUE,NA,"0.1.4"
"9809","646",2022-12-12 04:00:00,998,1006,8,136,TRUE,NA,"0.1.4"
"9810","646",2022-12-12 04:15:00,998,1006,8,136,TRUE,NA,"0.1.4"
"9811","646",2022-12-12 04:30:00,998,1006,8,136,TRUE,NA,"0.1.4"
"9812","646",2022-12-12 04:45:00,998,1006,8,136,TRUE,NA,"0.1.4"
"9813","646",2022-12-12 05:00:00,998,1006,8,136,TRUE,NA,"0.1.4"
"9814","646",2022-12-12 05:15:00,998,1006,8,136,TRUE,NA,"0.1.4"
"9815","646",2022-12-12 05:30:00,998,1006,8,136,TRUE,NA,"0.1.4"
"9816","646",2022-12-12 05:45:00,998,1006,8,136,TRUE,NA,"0.1.4"
"9817","646",2022-12-12 06:00:00,998,1006,8,136,TRUE,NA,"0.1.4"
"9818","646",2022-12-12 06:15:00,998,1006,8,136,TRUE,NA,"0.1.4"
"9819","646",2022-12-12 06:30:00,998,1006,8,136,TRUE,NA,"0.1.4"
"9820","646",2022-12-12 06:45:00,998,1006,8,136,TRUE,NA,"0.1.4"
"9821","646",2022-12-12 07:00:00,998,1006,8,136,TRUE,NA,"0.1.4"
"9822","646",2022-12-12 07:15:00,998,1006,8,136,TRUE,NA,"0.1.4"
"9823","646",2022-12-12 07:30:00,998,1006,8,136,TRUE,NA,"0.1.4"
"9824","646",2022-12-12 07:45:00,998,1006,8,136,TRUE,NA,"0.1.4"
"9825","646",2022-12-12 08:00:00,998,1006,8,136,TRUE,NA,"0.1.4"
"9826","646",2022-12-12 08:15:00,998,1006,8,136,TRUE,NA,"0.1.4"
"9827","646",2022-12-12 08:30:00,998,1006,8,136,TRUE,NA,"0.1.4"
"9828","646",2022-12-12 08:45:00,998,1006,8,136,TRUE,NA,"0.1.4"
"9829","646",2022-12-12 09:00:00,998,1006,8,136,TRUE,NA,"0.1.4"
"9830","646",2022-12-12 09:15:00,998,1006,8,136,TRUE,NA,"0.1.4"
"9831","646",2022-12-12 09:30:00,998,1006,8,136,TRUE,NA,"0.1.4"
"9832","646",2022-12-12 09:45:00,998,1006,8,136,TRUE,NA,"0.1.4"
"9833","646",2022-12-12 10:00:00,998,1006,8,136,TRUE,NA,"0.1.4"
"9834","646",2022-12-12 10:15:00,998,1006,8,136,TRUE,NA,"0.1.4"
"9835","646",2022-12-12 10:30:00,998,1006,8,136,TRUE,NA,"0.1.4"
"9836","646",2022-12-12 10:45:00,998,1006,8,136,TRUE,NA,"0.1.4"
"9837","646",2022-12-12 11:00:00,998,1006,8,136,TRUE,NA,"0.1.4"
"9838","646",2022-12-12 11:15:00,998,1006,8,136,TRUE,NA,"0.1.4"
"9839","646",2022-12-12 11:30:00,998,1006,8,136,TRUE,NA,"0.1.4"
"9840","646",2022-12-12 11:45:00,998,1006,8,136,TRUE,NA,"0.1.4"
"9841","646",2022-12-12 12:00:00,998,1006,8,136,TRUE,NA,"0.1.4"
"9842","646",2022-12-12 12:15:00,998,1006,8,136,TRUE,NA,"0.1.4"
"9843","646",2022-12-12 12:30:00,998,1006,8,136,TRUE,NA,"0.1.4"
"9844","646",2022-12-12 12:45:00,998,1006,8,136,TRUE,NA,"0.1.4"
"9845","646",2022-12-12 13:00:00,998,1006,8,136,TRUE,NA,"0.1.4"
"9846","646",2022-12-12 13:15:00,998,1006,8,136,TRUE,NA,"0.1.4"
"9847","646",2022-12-12 13:30:00,998,1006,8,136,TRUE,NA,"0.1.4"
"9848","646",2022-12-12 13:45:00,998,1006,8,136,TRUE,NA,"0.1.4"
"9849","646",2022-12-12 14:00:00,998,1006,8,136,TRUE,NA,"0.1.4"
"9850","646",2022-12-12 14:15:00,998,1006,8,136,TRUE,NA,"0.1.4"
"9851","646",2022-12-12 14:30:00,998,1006,8,136,TRUE,NA,"0.1.4"
"9852","646",2022-12-12 14:45:00,998,1006,8,136,TRUE,NA,"0.1.4"
"9853","646",2022-12-12 15:00:00,998,1006,8,136,TRUE,NA,"0.1.4"
"9854","646",2022-12-12 15:15:00,998,1006,8,136,TRUE,NA,"0.1.4"
"9855","646",2022-12-12 15:30:00,998,1006,8,136,TRUE,NA,"0.1.4"
"9856","646",2022-12-12 15:45:00,998,1006,8,136,TRUE,NA,"0.1.4"
"9857","646",2022-12-12 16:00:00,998,1006,8,136,TRUE,NA,"0.1.4"
"9858","646",2022-12-12 16:15:00,998,1006,8,136,TRUE,NA,"0.1.4"
"9859","646",2022-12-12 16:30:00,998,1006,8,136,TRUE,NA,"0.1.4"
"9860","646",2022-12-12 16:45:00,998,1006,8,136,TRUE,NA,"0.1.4"
"9861","646",2022-12-12 17:00:00,998,1006,8,136,TRUE,NA,"0.1.4"
"9862","646",2022-12-12 17:15:00,998,1006,8,136,TRUE,NA,"0.1.4"
"9863","646",2022-12-12 17:30:00,998,1006,8,136,TRUE,NA,"0.1.4"
"9864","646",2022-12-12 17:45:00,998,1006,8,136,TRUE,NA,"0.1.4"
"9865","646",2022-12-12 18:00:00,998,1006,8,136,TRUE,NA,"0.1.4"
"9866","646",2022-12-12 18:15:00,998,1006,8,136,TRUE,NA,"0.1.4"
"9867","646",2022-12-12 18:30:00,998,1006,8,136,TRUE,NA,"0.1.4"
"9868","646",2022-12-12 18:45:00,998,1006,8,136,TRUE,NA,"0.1.4"
"9869","646",2022-12-12 19:00:00,998,1006,8,136,TRUE,NA,"0.1.4"
"9870","646",2022-12-12 19:15:00,998,1006,8,136,TRUE,NA,"0.1.4"
"9871","646",2022-12-12 19:30:00,998,1006,8,136,TRUE,NA,"0.1.4"
"9872","646",2022-12-12 19:45:00,998,1006,8,136,TRUE,NA,"0.1.4"
"9873","646",2022-12-12 20:00:00,998,1006,8,136,TRUE,NA,"0.1.4"
"9874","646",2022-12-12 20:15:00,998,1006,8,136,TRUE,NA,"0.1.4"
"9875","646",2022-12-12 20:30:00,998,1006,8,136,TRUE,NA,"0.1.4"
"9876","646",2022-12-12 20:45:00,998,1006,8,136,TRUE,NA,"0.1.4"
"9877","646",2022-12-12 21:00:00,998,1006,8,136,TRUE,NA,"0.1.4"
"9878","646",2022-12-12 21:15:00,998,1006,8,136,TRUE,NA,"0.1.4"
"9879","646",2022-12-12 21:30:00,998,1006,8,136,TRUE,NA,"0.1.4"
"9880","646",2022-12-12 21:45:00,998,1006,8,136,TRUE,NA,"0.1.4"
"9881","646",2022-12-12 22:00:00,998,1006,8,136,TRUE,NA,"0.1.4"
"9882","646",2022-12-12 22:15:00,998,1006,8,136,TRUE,NA,"0.1.4"
"9883","646",2022-12-12 22:30:00,998,1006,8,136,TRUE,NA,"0.1.4"
"9884","646",2022-12-12 22:45:00,998,1006,8,136,TRUE,NA,"0.1.4"
"9885","646",2022-12-12 23:00:00,998,1006,8,136,TRUE,NA,"0.1.4"
"9886","646",2022-12-12 23:15:00,998,1006,8,136,TRUE,NA,"0.1.4"
"9887","646",2022-12-12 23:30:00,998,1006,8,136,TRUE,NA,"0.1.4"
"9888","646",2022-12-12 23:45:00,998,1006,8,136,TRUE,NA,"0.1.4"
"9889","646",2022-12-13,998,1006,8,136,TRUE,NA,"0.1.4"
"9890","646",2022-12-13 00:15:00,998,1006,8,136,TRUE,NA,"0.1.4"
"9891","646",2022-12-13 00:30:00,998,1006,8,136,TRUE,NA,"0.1.4"
"9892","646",2022-12-13 00:45:00,998,1006,8,136,TRUE,NA,"0.1.4"
"9893","646",2022-12-13 01:00:00,998,1006,8,136,TRUE,NA,"0.1.4"
"9894","646",2022-12-13 01:15:00,998,1006,8,136,TRUE,NA,"0.1.4"
"9895","646",2022-12-13 01:30:00,998,1006,8,136,TRUE,NA,"0.1.4"
"9896","646",2022-12-13 01:45:00,998,1006,8,136,TRUE,NA,"0.1.4"
"9897","646",2022-12-13 02:00:00,998,1006,8,136,TRUE,NA,"0.1.4"
"9898","646",2022-12-13 02:15:00,998,1006,8,136,TRUE,NA,"0.1.4"
"9899","646",2022-12-13 02:30:00,998,1006,8,136,TRUE,NA,"0.1.4"
"9900","646",2022-12-13 02:45:00,998,1006,8,136,TRUE,NA,"0.1.4"
"9901","646",2022-12-13 03:00:00,998,1006,8,136,TRUE,NA,"0.1.4"
"9902","646",2022-12-13 03:15:00,998,1006,8,136,TRUE,NA,"0.1.4"
"9903","646",2022-12-13 03:30:00,998,1006,8,136,TRUE,NA,"0.1.4"
"9904","646",2022-12-13 03:45:00,998,1006,8,136,TRUE,NA,"0.1.4"
"9905","646",2022-12-13 04:00:00,998,1006,8,136,TRUE,NA,"0.1.4"
"9906","646",2022-12-13 04:15:00,998,1006,8,136,TRUE,NA,"0.1.4"
"9907","646",2022-12-13 04:30:00,998,1006,8,136,TRUE,NA,"0.1.4"
"9908","646",2022-12-13 04:45:00,998,1006,8,136,TRUE,NA,"0.1.4"
"9909","646",2022-12-13 05:00:00,998,1006,8,136,TRUE,NA,"0.1.4"
"9910","646",2022-12-13 05:15:00,998,1006,8,136,TRUE,NA,"0.1.4"
"9911","646",2022-12-13 05:30:00,998,1006,8,136,TRUE,NA,"0.1.4"
"9912","646",2022-12-13 05:45:00,998,1006,8,136,TRUE,NA,"0.1.4"
"9913","646",2022-12-13 06:00:00,998,1006,8,136,TRUE,NA,"0.1.4"
"9914","646",2022-12-13 06:15:00,998,1006,8,136,TRUE,NA,"0.1.4"
"9915","646",2022-12-13 06:30:00,998,1006,8,136,TRUE,NA,"0.1.4"
"9916","646",2022-12-13 06:45:00,998,1006,8,136,TRUE,NA,"0.1.4"
"9917","646",2022-12-13 07:00:00,998,1006,8,136,TRUE,NA,"0.1.4"
"9918","646",2022-12-13 07:15:00,998,1006,8,136,TRUE,NA,"0.1.4"
"9919","646",2022-12-13 07:30:00,998,1006,8,136,TRUE,NA,"0.1.4"
"9920","646",2022-12-13 07:45:00,998,1006,8,136,TRUE,NA,"0.1.4"
"9921","646",2022-12-13 08:00:00,998,1006,8,136,TRUE,NA,"0.1.4"
"9922","646",2022-12-13 08:15:00,998,1006,8,136,TRUE,NA,"0.1.4"
"9923","646",2022-12-13 08:30:00,998,1006,8,136,TRUE,NA,"0.1.4"
"9924","646",2022-12-13 08:45:00,998,1006,8,136,TRUE,NA,"0.1.4"
"9925","646",2022-12-13 09:00:00,998,1006,8,136,TRUE,NA,"0.1.4"
"9926","646",2022-12-13 09:15:00,998,1006,8,136,TRUE,NA,"0.1.4"
"9927","646",2022-12-13 09:30:00,998,1006,8,136,TRUE,NA,"0.1.4"
"9928","646",2022-12-13 09:45:00,998,1006,8,136,TRUE,NA,"0.1.4"
"9929","646",2022-12-13 10:00:00,998,1006,8,136,TRUE,NA,"0.1.4"
"9930","646",2022-12-13 10:15:00,998,1006,8,136,TRUE,NA,"0.1.4"
"9931","646",2022-12-13 10:30:00,998,1006,8,136,TRUE,NA,"0.1.4"
"9932","646",2022-12-13 10:45:00,998,1006,8,136,TRUE,NA,"0.1.4"
"9933","646",2022-12-13 11:00:00,998,1006,8,136,TRUE,NA,"0.1.4"
"9934","646",2022-12-13 11:15:00,998,1006,8,136,TRUE,NA,"0.1.4"
"9935","646",2022-12-13 11:30:00,998,1006,8,136,TRUE,NA,"0.1.4"
"9936","646",2022-12-13 11:45:00,998,1006,8,136,TRUE,NA,"0.1.4"
"9937","646",2022-12-13 12:00:00,998,1006,8,136,TRUE,NA,"0.1.4"
"9938","646",2022-12-13 12:15:00,998,1006,8,136,TRUE,NA,"0.1.4"
"9939","646",2022-12-13 12:30:00,998,1006,8,136,TRUE,NA,"0.1.4"
"9940","646",2022-12-13 12:45:00,998,1006,8,136,TRUE,NA,"0.1.4"
"9941","646",2022-12-13 13:00:00,998,1006,8,136,TRUE,NA,"0.1.4"
"9942","646",2022-12-13 13:15:00,998,1006,8,136,TRUE,NA,"0.1.4"
"9943","646",2022-12-13 13:30:00,998,1006,8,136,TRUE,NA,"0.1.4"
"9944","646",2022-12-13 13:45:00,998,1006,8,136,TRUE,NA,"0.1.4"
"9945","646",2022-12-13 14:00:00,998,1006,8,136,TRUE,NA,"0.1.4"
"9946","646",2022-12-13 14:15:00,998,1006,8,136,TRUE,NA,"0.1.4"
"9947","646",2022-12-13 14:30:00,998,1006,8,136,TRUE,NA,"0.1.4"
"9948","646",2022-12-13 14:45:00,998,1006,8,136,TRUE,NA,"0.1.4"
"9949","646",2022-12-13 15:00:00,998,1006,8,136,TRUE,NA,"0.1.4"
"9950","646",2022-12-13 15:15:00,998,1006,8,136,TRUE,NA,"0.1.4"
"9951","646",2022-12-13 15:30:00,998,1006,8,136,TRUE,NA,"0.1.4"
"9952","646",2022-12-13 15:45:00,998,1006,8,136,TRUE,NA,"0.1.4"
"9953","646",2022-12-13 16:00:00,998,1006,8,136,TRUE,NA,"0.1.4"
"9954","646",2022-12-13 16:15:00,998,1006,8,136,TRUE,NA,"0.1.4"
"9955","646",2022-12-13 16:30:00,998,1006,8,136,TRUE,NA,"0.1.4"
"9956","646",2022-12-13 16:45:00,998,1006,8,136,TRUE,NA,"0.1.4"
"9957","646",2022-12-13 17:00:00,998,1006,8,136,TRUE,NA,"0.1.4"
"9958","646",2022-12-13 17:15:00,998,1006,8,136,TRUE,NA,"0.1.4"
"9959","646",2022-12-13 17:30:00,998,1006,8,136,TRUE,NA,"0.1.4"
"9960","646",2022-12-13 17:45:00,998,1006,8,136,TRUE,NA,"0.1.4"
"9961","646",2022-12-13 18:00:00,998,1006,8,136,TRUE,NA,"0.1.4"
"9962","646",2022-12-13 18:15:00,998,1006,8,136,TRUE,NA,"0.1.4"
"9963","646",2022-12-13 18:30:00,998,1006,8,136,TRUE,NA,"0.1.4"
"9964","646",2022-12-13 18:45:00,998,1006,8,136,TRUE,NA,"0.1.4"
"9965","646",2022-12-13 19:00:00,998,1006,8,136,TRUE,NA,"0.1.4"
"9966","646",2022-12-13 19:15:00,998,1006,8,136,TRUE,NA,"0.1.4"
"9967","646",2022-12-13 19:30:00,998,1006,8,136,TRUE,NA,"0.1.4"
"9968","646",2022-12-13 19:45:00,998,1006,8,136,TRUE,NA,"0.1.4"
"9969","646",2022-12-13 20:00:00,998,1006,8,136,TRUE,NA,"0.1.4"
"9970","646",2022-12-13 20:15:00,998,1006,8,136,TRUE,NA,"0.1.4"
"9971","646",2022-12-13 20:30:00,998,1006,8,136,TRUE,NA,"0.1.4"
"9972","646",2022-12-13 20:45:00,998,1006,8,136,TRUE,NA,"0.1.4"
"9973","646",2022-12-13 21:00:00,998,1006,8,136,TRUE,NA,"0.1.4"
"9974","646",2022-12-13 21:15:00,998,1006,8,136,TRUE,NA,"0.1.4"
"9975","646",2022-12-13 21:30:00,998,1006,8,136,TRUE,NA,"0.1.4"
"9976","646",2022-12-13 21:45:00,998,1006,8,136,TRUE,NA,"0.1.4"
"9977","646",2022-12-13 22:00:00,998,1006,8,136,TRUE,NA,"0.1.4"
"9978","646",2022-12-13 22:15:00,998,1006,8,136,TRUE,NA,"0.1.4"
"9979","646",2022-12-13 22:30:00,998,1006,8,136,TRUE,NA,"0.1.4"
"9980","646",2022-12-13 22:45:00,998,1006,8,136,TRUE,NA,"0.1.4"
"9981","646",2022-12-13 23:00:00,998,1006,8,136,TRUE,NA,"0.1.4"
"9982","646",2022-12-13 23:15:00,998,1006,8,136,TRUE,NA,"0.1.4"
"9983","646",2022-12-13 23:30:00,998,1006,8,136,TRUE,NA,"0.1.4"
"9984","646",2022-12-13 23:45:00,998,1006,8,136,TRUE,NA,"0.1.4"
"9985","646",2022-12-14,998,1006,8,136,TRUE,NA,"0.1.4"
"9986","646",2022-12-14 00:15:00,998,1006,8,136,TRUE,NA,"0.1.4"
"9987","646",2022-12-14 00:30:00,998,1006,8,136,TRUE,NA,"0.1.4"
"9988","646",2022-12-14 00:45:00,998,1006,8,136,TRUE,NA,"0.1.4"
"9989","646",2022-12-14 01:00:00,998,1006,8,136,TRUE,NA,"0.1.4"
"9990","646",2022-12-14 01:15:00,998,1006,8,136,TRUE,NA,"0.1.4"
"9991","646",2022-12-14 01:30:00,998,1006,8,136,TRUE,NA,"0.1.4"
"9992","646",2022-12-14 01:45:00,998,1006,8,136,TRUE,NA,"0.1.4"
"9993","646",2022-12-14 02:00:00,998,1006,8,136,TRUE,NA,"0.1.4"
"9994","646",2022-12-14 02:15:00,998,1006,8,136,TRUE,NA,"0.1.4"
"9995","646",2022-12-14 02:30:00,998,1006,8,136,TRUE,NA,"0.1.4"
"9996","646",2022-12-14 02:45:00,998,1006,8,136,TRUE,NA,"0.1.4"
"9997","646",2022-12-14 03:00:00,998,1006,8,136,TRUE,NA,"0.1.4"
"9998","646",2022-12-14 03:15:00,998,1006,8,136,TRUE,NA,"0.1.4"
"9999","646",2022-12-14 03:30:00,998,1006,8,136,TRUE,NA,"0.1.4"
"10000","646",2022-12-14 03:45:00,998,1006,8,136,TRUE,NA,"0.1.4"
"10001","646",2022-12-14 04:00:00,998,1006,8,136,TRUE,NA,"0.1.4"
"10002","646",2022-12-14 04:15:00,998,1006,8,136,TRUE,NA,"0.1.4"
"10003","646",2022-12-14 04:30:00,998,1006,8,136,TRUE,NA,"0.1.4"
"10004","646",2022-12-14 04:45:00,998,1006,8,136,TRUE,NA,"0.1.4"
"10005","646",2022-12-14 05:00:00,998,1006,8,136,TRUE,NA,"0.1.4"
"10006","646",2022-12-14 05:15:00,998,1006,8,136,TRUE,NA,"0.1.4"
"10007","646",2022-12-14 05:30:00,998,1006,8,136,TRUE,NA,"0.1.4"
"10008","646",2022-12-14 05:45:00,998,1006,8,136,TRUE,NA,"0.1.4"
"10009","646",2022-12-14 06:00:00,998,1006,8,136,TRUE,NA,"0.1.4"
"10010","646",2022-12-14 06:15:00,998,1006,8,136,TRUE,NA,"0.1.4"
"10011","646",2022-12-14 06:30:00,998,1006,8,136,TRUE,NA,"0.1.4"
"10012","646",2022-12-14 06:45:00,998,1006,8,136,TRUE,NA,"0.1.4"
"10013","646",2022-12-14 07:00:00,998,1006,8,136,TRUE,NA,"0.1.4"
"10014","646",2022-12-14 07:15:00,998,1006,8,136,TRUE,NA,"0.1.4"
"10015","646",2022-12-14 07:30:00,998,1006,8,136,TRUE,NA,"0.1.4"
"10016","646",2022-12-14 07:45:00,998,1006,8,136,TRUE,NA,"0.1.4"
"10017","646",2022-12-14 08:00:00,998,1006,8,136,TRUE,NA,"0.1.4"
"10018","646",2022-12-14 08:15:00,998,1006,8,136,TRUE,NA,"0.1.4"
"10019","646",2022-12-14 08:30:00,998,1006,8,136,TRUE,NA,"0.1.4"
"10020","646",2022-12-14 08:45:00,998,1006,8,136,TRUE,NA,"0.1.4"
"10021","646",2022-12-14 09:00:00,998,1006,8,136,TRUE,NA,"0.1.4"
"10022","646",2022-12-14 09:15:00,998,1006,8,136,TRUE,NA,"0.1.4"
"10023","646",2022-12-14 09:30:00,998,1006,8,136,TRUE,NA,"0.1.4"
"10024","646",2022-12-14 09:45:00,998,1006,8,136,TRUE,NA,"0.1.4"
"10025","646",2022-12-14 10:00:00,998,1006,8,136,TRUE,NA,"0.1.4"
"10026","646",2022-12-14 10:15:00,998,1006,8,136,TRUE,NA,"0.1.4"
"10027","646",2022-12-14 10:30:00,998,1006,8,136,TRUE,NA,"0.1.4"
"10028","646",2022-12-14 10:45:00,998,1006,8,136,TRUE,NA,"0.1.4"
"10029","646",2022-12-14 11:00:00,998,1006,8,136,TRUE,NA,"0.1.4"
"10030","646",2022-12-14 11:15:00,998,1006,8,136,TRUE,NA,"0.1.4"
"10031","646",2022-12-14 11:30:00,998,1006,8,136,TRUE,NA,"0.1.4"
"10032","646",2022-12-14 11:45:00,998,1006,8,136,TRUE,NA,"0.1.4"
"10033","646",2022-12-14 12:00:00,998,1006,8,136,TRUE,NA,"0.1.4"
"10034","646",2022-12-14 12:15:00,998,1006,8,136,TRUE,NA,"0.1.4"
"10035","646",2022-12-14 12:30:00,998,1006,8,136,TRUE,NA,"0.1.4"
"10036","646",2022-12-14 12:45:00,998,1006,8,136,TRUE,NA,"0.1.4"
"10037","646",2022-12-14 13:00:00,998,1006,8,136,TRUE,NA,"0.1.4"
"10038","646",2022-12-14 13:15:00,998,1006,8,136,TRUE,NA,"0.1.4"
"10039","646",2022-12-14 13:30:00,998,1006,8,136,TRUE,NA,"0.1.4"
"10040","646",2022-12-14 13:45:00,998,1006,8,136,TRUE,NA,"0.1.4"
"10041","646",2022-12-14 14:00:00,998,1006,8,136,TRUE,NA,"0.1.4"
"10042","646",2022-12-14 14:15:00,998,1006,8,136,TRUE,NA,"0.1.4"
"10043","646",2022-12-14 14:30:00,998,1006,8,136,TRUE,NA,"0.1.4"
"10044","646",2022-12-14 14:45:00,998,1006,8,136,TRUE,NA,"0.1.4"
"10045","646",2022-12-14 15:00:00,998,1006,8,136,TRUE,NA,"0.1.4"
"10046","646",2022-12-14 15:15:00,998,1006,8,136,TRUE,NA,"0.1.4"
"10047","646",2022-12-14 15:30:00,998,1006,8,136,TRUE,NA,"0.1.4"
"10048","646",2022-12-14 15:45:00,998,1006,8,136,TRUE,NA,"0.1.4"
"10049","646",2022-12-14 16:00:00,998,1006,8,136,TRUE,NA,"0.1.4"
"10050","646",2022-12-14 16:15:00,998,1006,8,136,TRUE,NA,"0.1.4"
"10051","646",2022-12-14 16:30:00,998,1006,8,136,TRUE,NA,"0.1.4"
"10052","646",2022-12-14 16:45:00,998,1006,8,136,TRUE,NA,"0.1.4"
"10053","646",2022-12-14 17:00:00,998,1006,8,136,TRUE,NA,"0.1.4"
"10054","646",2022-12-14 17:15:00,998,1006,8,136,TRUE,NA,"0.1.4"
"10055","646",2022-12-14 17:30:00,998,1006,8,136,TRUE,NA,"0.1.4"
"10056","646",2022-12-14 17:45:00,998,1006,8,136,TRUE,NA,"0.1.4"
"10057","646",2022-12-14 18:00:00,998,1006,8,136,TRUE,NA,"0.1.4"
"10058","646",2022-12-14 18:15:00,998,1006,8,136,TRUE,NA,"0.1.4"
"10059","646",2022-12-14 18:30:00,998,1006,8,136,TRUE,NA,"0.1.4"
"10060","646",2022-12-14 18:45:00,998,1006,8,136,TRUE,NA,"0.1.4"
"10061","646",2022-12-14 19:00:00,998,1006,8,136,TRUE,NA,"0.1.4"
"10062","646",2022-12-14 19:15:00,998,1006,8,136,TRUE,NA,"0.1.4"
"10063","646",2022-12-14 19:30:00,998,1006,8,136,TRUE,NA,"0.1.4"
"10064","646",2022-12-14 19:45:00,998,1006,8,136,TRUE,NA,"0.1.4"
"10065","646",2022-12-14 20:00:00,998,1006,8,136,TRUE,NA,"0.1.4"
"10066","646",2022-12-14 20:15:00,998,1006,8,136,TRUE,NA,"0.1.4"
"10067","646",2022-12-14 20:30:00,998,1006,8,136,TRUE,NA,"0.1.4"
"10068","646",2022-12-14 20:45:00,998,1006,8,136,TRUE,NA,"0.1.4"
"10069","646",2022-12-14 21:00:00,998,1006,8,136,TRUE,NA,"0.1.4"
"10070","646",2022-12-14 21:15:00,998,1006,8,136,TRUE,NA,"0.1.4"
"10071","646",2022-12-14 21:30:00,998,1006,8,136,TRUE,NA,"0.1.4"
"10072","646",2022-12-14 21:45:00,998,1006,8,136,TRUE,NA,"0.1.4"
"10073","646",2022-12-14 22:00:00,998,1006,8,136,TRUE,NA,"0.1.4"
"10074","646",2022-12-14 22:15:00,998,1006,8,136,TRUE,NA,"0.1.4"
"10075","646",2022-12-14 22:30:00,998,1006,8,136,TRUE,NA,"0.1.4"
"10076","646",2022-12-14 22:45:00,998,1006,8,136,TRUE,NA,"0.1.4"
"10077","646",2022-12-14 23:00:00,998,1006,8,136,TRUE,NA,"0.1.4"
"10078","646",2022-12-14 23:15:00,998,1006,8,136,TRUE,NA,"0.1.4"
"10079","646",2022-12-14 23:30:00,998,1006,8,136,TRUE,NA,"0.1.4"
"10080","646",2022-12-14 23:45:00,998,1006,8,136,TRUE,NA,"0.1.4"
"10081","646",2022-12-15,998,1006,8,136,TRUE,NA,"0.1.4"
"10082","646",2022-12-15 00:15:00,998,1006,8,136,TRUE,NA,"0.1.4"
"10083","646",2022-12-15 00:30:00,998,1006,8,136,TRUE,NA,"0.1.4"
"10084","646",2022-12-15 00:45:00,998,1006,8,136,TRUE,NA,"0.1.4"
"10085","646",2022-12-15 01:00:00,998,1006,8,136,TRUE,NA,"0.1.4"
"10086","646",2022-12-15 01:15:00,998,1006,8,136,TRUE,NA,"0.1.4"
"10087","646",2022-12-15 01:30:00,998,1006,8,136,TRUE,NA,"0.1.4"
"10088","646",2022-12-15 01:45:00,998,1006,8,136,TRUE,NA,"0.1.4"
"10089","646",2022-12-15 02:00:00,998,1006,8,136,TRUE,NA,"0.1.4"
"10090","646",2022-12-15 02:15:00,998,1006,8,136,TRUE,NA,"0.1.4"
"10091","646",2022-12-15 02:30:00,998,1006,8,136,TRUE,NA,"0.1.4"
"10092","646",2022-12-15 02:45:00,998,1006,8,136,TRUE,NA,"0.1.4"
"10093","646",2022-12-15 03:00:00,998,1006,8,136,TRUE,NA,"0.1.4"
"10094","646",2022-12-15 03:15:00,998,1006,8,136,TRUE,NA,"0.1.4"
"10095","646",2022-12-15 03:30:00,998,1006,8,136,TRUE,NA,"0.1.4"
"10096","646",2022-12-15 03:45:00,998,1006,8,136,TRUE,NA,"0.1.4"
"10097","646",2022-12-15 04:00:00,998,1006,8,136,TRUE,NA,"0.1.4"
"10098","646",2022-12-15 04:15:00,998,1006,8,136,TRUE,NA,"0.1.4"
"10099","646",2022-12-15 04:30:00,998,1006,8,136,TRUE,NA,"0.1.4"
"10100","646",2022-12-15 04:45:00,998,1006,8,136,TRUE,NA,"0.1.4"
"10101","646",2022-12-15 05:00:00,998,1006,8,136,TRUE,NA,"0.1.4"
"10102","646",2022-12-15 05:15:00,998,1006,8,136,TRUE,NA,"0.1.4"
"10103","646",2022-12-15 05:30:00,998,1006,8,136,TRUE,NA,"0.1.4"
"10104","646",2022-12-15 05:45:00,998,1006,8,136,TRUE,NA,"0.1.4"
"10105","646",2022-12-15 06:00:00,998,1006,8,136,TRUE,NA,"0.1.4"
"10106","646",2022-12-15 06:15:00,998,1006,8,136,TRUE,NA,"0.1.4"
"10107","646",2022-12-15 06:30:00,998,1006,8,136,TRUE,NA,"0.1.4"
"10108","646",2022-12-15 06:45:00,998,1006,8,136,TRUE,NA,"0.1.4"
"10109","646",2022-12-15 07:00:00,998,1006,8,136,TRUE,NA,"0.1.4"
"10110","646",2022-12-15 07:15:00,998,1006,8,136,TRUE,NA,"0.1.4"
"10111","646",2022-12-15 07:30:00,998,1006,8,136,TRUE,NA,"0.1.4"
"10112","646",2022-12-15 07:45:00,998,1006,8,136,TRUE,NA,"0.1.4"
"10113","646",2022-12-15 08:00:00,998,1006,8,136,TRUE,NA,"0.1.4"
"10114","646",2022-12-15 08:15:00,998,1006,8,136,TRUE,NA,"0.1.4"
"10115","646",2022-12-15 08:30:00,998,1006,8,136,TRUE,NA,"0.1.4"
"10116","646",2022-12-15 08:45:00,998,1006,8,136,TRUE,NA,"0.1.4"
"10117","646",2022-12-15 09:00:00,998,1006,8,136,TRUE,NA,"0.1.4"
"10118","646",2022-12-15 09:15:00,998,1006,8,136,TRUE,NA,"0.1.4"
"10119","646",2022-12-15 09:30:00,997,1006,9,136,TRUE,NA,"0.1.4"
"10120","646",2022-12-15 09:45:00,997,1006,9,136,TRUE,NA,"0.1.4"
"10121","646",2022-12-15 10:00:00,997,1006,9,136,TRUE,NA,"0.1.4"
"10122","646",2022-12-15 10:15:00,997,1006,9,136,TRUE,NA,"0.1.4"
"10123","646",2022-12-15 10:30:00,997,1006,9,136,TRUE,NA,"0.1.4"
"10124","646",2022-12-15 10:45:00,997,1006,9,136,TRUE,NA,"0.1.4"
"10125","646",2022-12-15 11:00:00,998,1006,8,136,TRUE,NA,"0.1.4"
"10126","646",2022-12-15 11:15:00,998,1006,8,136,TRUE,NA,"0.1.4"
"10127","646",2022-12-15 11:30:00,998,1006,8,136,TRUE,NA,"0.1.4"
"10128","646",2022-12-15 11:45:00,998,1006,8,136,TRUE,NA,"0.1.4"
"10129","646",2022-12-15 12:00:00,998,1006,8,136,TRUE,NA,"0.1.4"
"10130","646",2022-12-15 12:15:00,998,1006,8,136,TRUE,NA,"0.1.4"
"10131","646",2022-12-15 12:30:00,999,1006,7,136,TRUE,NA,"0.1.4"
"10132","646",2022-12-15 12:45:00,998,1006,8,136,TRUE,NA,"0.1.4"
"10133","646",2022-12-15 13:00:00,998,1006,8,136,TRUE,NA,"0.1.4"
"10134","646",2022-12-15 13:15:00,998,1006,8,136,TRUE,NA,"0.1.4"
"10135","646",2022-12-15 13:30:00,998,1006,8,136,TRUE,NA,"0.1.4"
"10136","646",2022-12-15 13:45:00,998,1006,8,136,TRUE,NA,"0.1.4"
"10137","646",2022-12-15 14:00:00,998,1006,8,136,TRUE,NA,"0.1.4"
"10138","646",2022-12-15 14:15:00,997,1006,9,136,TRUE,NA,"0.1.4"
"10139","646",2022-12-15 14:30:00,998,1006,8,136,TRUE,NA,"0.1.4"
"10140","646",2022-12-15 14:45:00,997,1006,9,136,TRUE,NA,"0.1.4"
"10141","646",2022-12-15 15:00:00,998,1006,8,136,TRUE,NA,"0.1.4"
"10142","646",2022-12-15 15:15:00,998,1006,8,136,TRUE,NA,"0.1.4"
"10143","646",2022-12-15 15:30:00,998,1006,8,136,TRUE,NA,"0.1.4"
"10144","646",2022-12-15 15:45:00,998,1006,8,136,TRUE,NA,"0.1.4"
"10145","646",2022-12-15 16:00:00,998,1006,8,136,TRUE,NA,"0.1.4"
"10146","646",2022-12-15 16:15:00,998,1006,8,136,TRUE,NA,"0.1.4"
"10147","646",2022-12-15 16:30:00,998,1006,8,136,TRUE,NA,"0.1.4"
"10148","646",2022-12-15 16:45:00,998,1006,8,136,TRUE,NA,"0.1.4"
"10149","646",2022-12-15 17:00:00,998,1006,8,136,TRUE,NA,"0.1.4"
"10150","646",2022-12-15 17:15:00,998,1006,8,136,TRUE,NA,"0.1.4"
"10151","646",2022-12-15 17:30:00,998,1006,8,136,TRUE,NA,"0.1.4"
"10152","646",2022-12-15 17:45:00,998,1006,8,136,TRUE,NA,"0.1.4"
"10153","646",2022-12-15 18:00:00,998,1006,8,136,TRUE,NA,"0.1.4"
"10154","646",2022-12-15 18:15:00,998,1006,8,136,TRUE,NA,"0.1.4"
"10155","646",2022-12-15 18:30:00,998,1006,8,136,TRUE,NA,"0.1.4"
"10156","646",2022-12-15 18:45:00,998,1006,8,136,TRUE,NA,"0.1.4"
"10157","646",2022-12-15 19:00:00,998,1006,8,136,TRUE,NA,"0.1.4"
"10158","646",2022-12-15 19:15:00,998,1006,8,136,TRUE,NA,"0.1.4"
"10159","646",2022-12-15 19:30:00,998,1006,8,136,TRUE,NA,"0.1.4"
"10160","646",2022-12-15 19:45:00,998,1006,8,136,TRUE,NA,"0.1.4"
"10161","646",2022-12-15 20:00:00,998,1006,8,136,TRUE,NA,"0.1.4"
"10162","646",2022-12-15 20:15:00,998,1006,8,136,TRUE,NA,"0.1.4"
"10163","646",2022-12-15 20:30:00,998,1006,8,136,TRUE,NA,"0.1.4"
"10164","646",2022-12-15 20:45:00,998,1006,8,136,TRUE,NA,"0.1.4"
"10165","646",2022-12-15 21:00:00,998,1006,8,136,TRUE,NA,"0.1.4"
"10166","646",2022-12-15 21:15:00,998,1006,8,136,TRUE,NA,"0.1.4"
"10167","646",2022-12-15 21:30:00,998,1006,8,136,TRUE,NA,"0.1.4"
"10168","646",2022-12-15 21:45:00,998,1006,8,136,TRUE,NA,"0.1.4"
"10169","646",2022-12-15 22:00:00,998,1006,8,136,TRUE,NA,"0.1.4"
"10170","646",2022-12-15 22:15:00,998,1006,8,136,TRUE,NA,"0.1.4"
"10171","646",2022-12-15 22:30:00,998,1006,8,136,TRUE,NA,"0.1.4"
"10172","646",2022-12-15 22:45:00,998,1006,8,136,TRUE,NA,"0.1.4"
"10173","646",2022-12-15 23:00:00,998,1006,8,136,TRUE,NA,"0.1.4"
"10174","646",2022-12-15 23:15:00,998,1006,8,136,TRUE,NA,"0.1.4"
"10175","646",2022-12-15 23:30:00,998,1006,8,136,TRUE,NA,"0.1.4"
"10176","646",2022-12-15 23:45:00,998,1006,8,136,TRUE,NA,"0.1.4"
"10177","646",2022-12-16,998,1006,8,136,TRUE,NA,"0.1.4"
"10178","646",2022-12-16 00:15:00,998,1006,8,136,TRUE,NA,"0.1.4"
"10179","646",2022-12-16 00:30:00,998,1006,8,136,TRUE,NA,"0.1.4"
"10180","646",2022-12-16 00:45:00,998,1006,8,136,TRUE,NA,"0.1.4"
"10181","646",2022-12-16 01:00:00,998,1006,8,136,TRUE,NA,"0.1.4"
"10182","646",2022-12-16 01:15:00,998,1006,8,136,TRUE,NA,"0.1.4"
"10183","646",2022-12-16 01:30:00,998,1006,8,136,TRUE,NA,"0.1.4"
"10184","646",2022-12-16 01:45:00,998,1006,8,136,TRUE,NA,"0.1.4"
"10185","646",2022-12-16 02:00:00,998,1006,8,136,TRUE,NA,"0.1.4"
"10186","646",2022-12-16 02:15:00,998,1006,8,136,TRUE,NA,"0.1.4"
"10187","646",2022-12-16 02:30:00,998,1006,8,136,TRUE,NA,"0.1.4"
"10188","646",2022-12-16 02:45:00,998,1006,8,136,TRUE,NA,"0.1.4"
"10189","646",2022-12-16 03:00:00,998,1006,8,136,TRUE,NA,"0.1.4"
"10190","646",2022-12-16 03:15:00,998,1006,8,136,TRUE,NA,"0.1.4"
"10191","646",2022-12-16 03:30:00,998,1006,8,136,TRUE,NA,"0.1.4"
"10192","646",2022-12-16 03:45:00,998,1006,8,136,TRUE,NA,"0.1.4"
"10193","646",2022-12-16 04:00:00,998,1006,8,136,TRUE,NA,"0.1.4"
"10194","646",2022-12-16 04:15:00,998,1006,8,136,TRUE,NA,"0.1.4"
"10195","646",2022-12-16 04:30:00,999,1006,7,136,TRUE,NA,"0.1.4"
"10196","646",2022-12-16 04:45:00,998,1006,8,136,TRUE,NA,"0.1.4"
"10197","646",2022-12-16 05:00:00,998,1006,8,136,TRUE,NA,"0.1.4"
"10198","646",2022-12-16 05:15:00,998,1006,8,136,TRUE,NA,"0.1.4"
"10199","646",2022-12-16 05:30:00,998,1006,8,136,TRUE,NA,"0.1.4"
"10200","646",2022-12-16 05:45:00,999,1006,7,136,TRUE,NA,"0.1.4"
"10201","646",2022-12-16 06:00:00,999,1006,7,136,TRUE,NA,"0.1.4"
"10202","646",2022-12-16 06:15:00,998,1006,8,136,TRUE,NA,"0.1.4"
"10203","646",2022-12-16 06:30:00,998,1006,8,136,TRUE,NA,"0.1.4"
"10204","646",2022-12-16 06:45:00,998,1006,8,136,TRUE,NA,"0.1.4"
"10205","646",2022-12-16 07:00:00,998,1006,8,136,TRUE,NA,"0.1.4"
"10206","646",2022-12-16 07:15:00,998,1006,8,136,TRUE,NA,"0.1.4"
"10207","646",2022-12-16 07:30:00,998,1006,8,136,TRUE,NA,"0.1.4"
"10208","646",2022-12-16 07:45:00,998,1006,8,136,TRUE,NA,"0.1.4"
"10209","646",2022-12-16 08:00:00,998,1006,8,136,TRUE,NA,"0.1.4"
"10210","646",2022-12-16 08:15:00,998,1006,8,136,TRUE,NA,"0.1.4"
"10211","646",2022-12-16 08:30:00,998,1006,8,136,TRUE,NA,"0.1.4"
"10212","646",2022-12-16 08:45:00,998,1006,8,136,TRUE,NA,"0.1.4"
"10213","646",2022-12-16 09:00:00,998,1006,8,136,TRUE,NA,"0.1.4"
"10214","646",2022-12-16 09:15:00,998,1006,8,136,TRUE,NA,"0.1.4"
"10215","646",2022-12-16 09:30:00,998,1006,8,136,TRUE,NA,"0.1.4"
"10216","646",2022-12-16 09:45:00,998,1006,8,136,TRUE,NA,"0.1.4"
"10217","646",2022-12-16 10:00:00,998,1006,8,136,TRUE,NA,"0.1.4"
"10218","646",2022-12-16 10:15:00,998,1006,8,136,TRUE,NA,"0.1.4"
"10219","646",2022-12-16 10:30:00,999,1006,7,136,TRUE,NA,"0.1.4"
"10220","646",2022-12-16 10:45:00,999,1006,7,136,TRUE,NA,"0.1.4"
"10221","646",2022-12-16 11:00:00,999,1006,7,136,TRUE,NA,"0.1.4"
"10222","646",2022-12-16 11:15:00,999,1006,7,136,TRUE,NA,"0.1.4"
"10223","646",2022-12-16 11:30:00,999,1006,7,136,TRUE,NA,"0.1.4"
"10224","646",2022-12-16 11:45:00,998,1006,8,136,TRUE,NA,"0.1.4"
"10225","646",2022-12-16 12:00:00,999,1006,7,136,TRUE,NA,"0.1.4"
"10226","646",2022-12-16 12:15:00,998,1006,8,136,TRUE,NA,"0.1.4"
"10227","646",2022-12-16 12:30:00,998,1006,8,136,TRUE,NA,"0.1.4"
"10228","646",2022-12-16 12:45:00,998,1006,8,136,TRUE,NA,"0.1.4"
"10229","646",2022-12-16 13:00:00,998,1006,8,136,TRUE,NA,"0.1.4"
"10230","646",2022-12-16 13:15:00,998,1006,8,136,TRUE,NA,"0.1.4"
"10231","646",2022-12-16 13:30:00,998,1006,8,136,TRUE,NA,"0.1.4"
"10232","646",2022-12-16 13:45:00,998,1006,8,136,TRUE,NA,"0.1.4"
"10233","646",2022-12-16 14:00:00,998,1006,8,136,TRUE,NA,"0.1.4"
"10234","646",2022-12-16 14:15:00,998,1006,8,136,TRUE,NA,"0.1.4"
"10235","646",2022-12-16 14:30:00,998,1006,8,136,TRUE,NA,"0.1.4"
"10236","646",2022-12-16 14:45:00,998,1006,8,136,TRUE,NA,"0.1.4"
"10237","646",2022-12-16 15:00:00,999,1006,7,136,TRUE,NA,"0.1.4"
"10238","646",2022-12-16 15:15:00,998,1006,8,136,TRUE,NA,"0.1.4"
"10239","646",2022-12-16 15:30:00,998,1006,8,136,TRUE,NA,"0.1.4"
"10240","646",2022-12-16 15:45:00,998,1006,8,136,TRUE,NA,"0.1.4"
"10241","646",2022-12-16 16:00:00,998,1006,8,136,TRUE,NA,"0.1.4"
"10242","646",2022-12-16 16:15:00,998,1006,8,136,TRUE,NA,"0.1.4"
"10243","646",2022-12-16 16:30:00,999,1006,7,136,TRUE,NA,"0.1.4"
"10244","646",2022-12-16 16:45:00,999,1006,7,136,TRUE,NA,"0.1.4"
"10245","646",2022-12-16 17:00:00,999,1006,7,136,TRUE,NA,"0.1.4"
"10246","646",2022-12-16 17:15:00,999,1006,7,136,TRUE,NA,"0.1.4"
"10247","646",2022-12-16 17:30:00,999,1006,7,136,TRUE,NA,"0.1.4"
"10248","646",2022-12-16 17:45:00,999,1006,7,136,TRUE,NA,"0.1.4"
"10249","646",2022-12-16 18:00:00,999,1006,7,136,TRUE,NA,"0.1.4"
"10250","646",2022-12-16 18:15:00,999,1006,7,136,TRUE,NA,"0.1.4"
"10251","646",2022-12-16 18:30:00,999,1006,7,136,TRUE,NA,"0.1.4"
"10252","646",2022-12-16 18:45:00,999,1006,7,136,TRUE,NA,"0.1.4"
"10253","646",2022-12-16 19:00:00,999,1006,7,136,TRUE,NA,"0.1.4"
"10254","646",2022-12-16 19:15:00,999,1006,7,136,TRUE,NA,"0.1.4"
"10255","646",2022-12-16 19:30:00,999,1006,7,136,TRUE,NA,"0.1.4"
"10256","646",2022-12-16 19:45:00,999,1006,7,136,TRUE,NA,"0.1.4"
"10257","646",2022-12-16 20:00:00,999,1006,7,136,TRUE,NA,"0.1.4"
"10258","646",2022-12-16 20:15:00,999,1006,7,136,TRUE,NA,"0.1.4"
"10259","646",2022-12-16 20:30:00,999,1006,7,136,TRUE,NA,"0.1.4"
"10260","646",2022-12-16 20:45:00,999,1006,7,136,TRUE,NA,"0.1.4"
"10261","646",2022-12-16 21:00:00,999,1006,7,136,TRUE,NA,"0.1.4"
"10262","646",2022-12-16 21:15:00,999,1006,7,136,TRUE,NA,"0.1.4"
"10263","646",2022-12-16 21:30:00,999,1006,7,136,TRUE,NA,"0.1.4"
"10264","646",2022-12-16 21:45:00,999,1006,7,136,TRUE,NA,"0.1.4"
"10265","646",2022-12-16 22:00:00,999,1006,7,136,TRUE,NA,"0.1.4"
"10266","646",2022-12-16 22:15:00,999,1006,7,136,TRUE,NA,"0.1.4"
"10267","646",2022-12-16 22:30:00,999,1006,7,136,TRUE,NA,"0.1.4"
"10268","646",2022-12-16 22:45:00,999,1006,7,136,TRUE,NA,"0.1.4"
"10269","646",2022-12-16 23:00:00,999,1006,7,136,TRUE,NA,"0.1.4"
"10270","646",2022-12-16 23:15:00,999,1006,7,136,TRUE,NA,"0.1.4"
"10271","646",2022-12-16 23:30:00,999,1006,7,136,TRUE,NA,"0.1.4"
"10272","646",2022-12-16 23:45:00,999,1006,7,136,TRUE,NA,"0.1.4"
"10273","646",2022-12-17,999,1006,7,136,TRUE,NA,"0.1.4"
"10274","646",2022-12-17 00:15:00,999,1006,7,136,TRUE,NA,"0.1.4"
"10275","646",2022-12-17 00:30:00,999,1006,7,136,TRUE,NA,"0.1.4"
"10276","646",2022-12-17 00:45:00,999,1006,7,136,TRUE,NA,"0.1.4"
"10277","646",2022-12-17 01:00:00,999,1006,7,136,TRUE,NA,"0.1.4"
"10278","646",2022-12-17 01:15:00,999,1006,7,136,TRUE,NA,"0.1.4"
"10279","646",2022-12-17 01:30:00,999,1006,7,136,TRUE,NA,"0.1.4"
"10280","646",2022-12-17 01:45:00,999,1006,7,136,TRUE,NA,"0.1.4"
"10281","646",2022-12-17 02:00:00,999,1006,7,136,TRUE,NA,"0.1.4"
"10282","646",2022-12-17 02:15:00,999,1006,7,136,TRUE,NA,"0.1.4"
"10283","646",2022-12-17 02:30:00,999,1006,7,136,TRUE,NA,"0.1.4"
"10284","646",2022-12-17 02:45:00,999,1006,7,136,TRUE,NA,"0.1.4"
"10285","646",2022-12-17 03:00:00,999,1006,7,136,TRUE,NA,"0.1.4"
"10286","646",2022-12-17 03:15:00,999,1006,7,136,TRUE,NA,"0.1.4"
"10287","646",2022-12-17 03:30:00,999,1006,7,136,TRUE,NA,"0.1.4"
"10288","646",2022-12-17 03:45:00,999,1006,7,136,TRUE,NA,"0.1.4"
"10289","646",2022-12-17 04:00:00,999,1006,7,136,TRUE,NA,"0.1.4"
"10290","646",2022-12-17 04:15:00,999,1006,7,136,TRUE,NA,"0.1.4"
"10291","646",2022-12-17 04:30:00,999,1006,7,136,TRUE,NA,"0.1.4"
"10292","646",2022-12-17 04:45:00,999,1006,7,136,TRUE,NA,"0.1.4"
"10293","646",2022-12-17 05:00:00,999,1006,7,136,TRUE,NA,"0.1.4"
"10294","646",2022-12-17 05:15:00,999,1006,7,136,TRUE,NA,"0.1.4"
"10295","646",2022-12-17 05:30:00,999,1006,7,136,TRUE,NA,"0.1.4"
"10296","646",2022-12-17 05:45:00,999,1006,7,136,TRUE,NA,"0.1.4"
"10297","646",2022-12-17 06:00:00,999,1006,7,136,TRUE,NA,"0.1.4"
"10298","646",2022-12-17 06:15:00,999,1006,7,136,TRUE,NA,"0.1.4"
"10299","646",2022-12-17 06:30:00,999,1006,7,136,TRUE,NA,"0.1.4"
"10300","646",2022-12-17 06:45:00,999,1006,7,136,TRUE,NA,"0.1.4"
"10301","646",2022-12-17 07:00:00,999,1006,7,136,TRUE,NA,"0.1.4"
"10302","646",2022-12-17 07:15:00,999,1006,7,136,TRUE,NA,"0.1.4"
"10303","646",2022-12-17 07:30:00,1000,1006,6,136,TRUE,NA,"0.1.4"
"10304","646",2022-12-17 07:45:00,1000,1006,6,136,TRUE,NA,"0.1.4"
"10305","646",2022-12-17 08:00:00,1000,1006,6,136,TRUE,NA,"0.1.4"
"10306","646",2022-12-17 08:15:00,999,1006,7,136,TRUE,NA,"0.1.4"
"10307","646",2022-12-17 08:30:00,1000,1006,6,136,TRUE,NA,"0.1.4"
"10308","646",2022-12-17 08:45:00,1000,1006,6,136,TRUE,NA,"0.1.4"
"10309","646",2022-12-17 09:00:00,1000,1006,6,136,TRUE,NA,"0.1.4"
"10310","646",2022-12-17 09:15:00,999,1006,7,136,TRUE,NA,"0.1.4"
"10311","646",2022-12-17 09:30:00,1000,1006,6,136,TRUE,NA,"0.1.4"
"10312","646",2022-12-17 09:45:00,1000,1006,6,136,TRUE,NA,"0.1.4"
"10313","646",2022-12-17 10:00:00,999,1006,7,136,TRUE,NA,"0.1.4"
"10314","646",2022-12-17 10:15:00,999,1006,7,136,TRUE,NA,"0.1.4"
"10315","646",2022-12-17 10:30:00,999,1006,7,136,TRUE,NA,"0.1.4"
"10316","646",2022-12-17 10:45:00,999,1006,7,136,TRUE,NA,"0.1.4"
"10317","646",2022-12-17 11:00:00,999,1006,7,136,TRUE,NA,"0.1.4"
"10318","646",2022-12-17 11:15:00,999,1006,7,136,TRUE,NA,"0.1.4"
"10319","646",2022-12-17 11:30:00,999,1006,7,136,TRUE,NA,"0.1.4"
"10320","646",2022-12-17 11:45:00,999,1006,7,136,TRUE,NA,"0.1.4"
"10321","646",2022-12-17 12:00:00,999,1006,7,136,TRUE,NA,"0.1.4"
"10322","646",2022-12-17 12:15:00,999,1006,7,136,TRUE,NA,"0.1.4"
"10323","646",2022-12-17 12:30:00,1000,1006,6,136,TRUE,NA,"0.1.4"
"10324","646",2022-12-17 12:45:00,1000,1006,6,136,TRUE,NA,"0.1.4"
"10325","646",2022-12-17 13:00:00,999,1006,7,136,TRUE,NA,"0.1.4"
"10326","646",2022-12-17 13:15:00,999,1006,7,136,TRUE,NA,"0.1.4"
"10327","646",2022-12-17 13:30:00,999,1006,7,136,TRUE,NA,"0.1.4"
"10328","646",2022-12-17 13:45:00,999,1006,7,136,TRUE,NA,"0.1.4"
"10329","646",2022-12-17 14:00:00,999,1006,7,136,TRUE,NA,"0.1.4"
"10330","646",2022-12-17 14:15:00,999,1006,7,136,TRUE,NA,"0.1.4"
"10331","646",2022-12-17 14:30:00,999,1006,7,136,TRUE,NA,"0.1.4"
"10332","646",2022-12-17 14:45:00,999,1006,7,136,TRUE,NA,"0.1.4"
"10333","646",2022-12-17 15:00:00,999,1006,7,136,TRUE,NA,"0.1.4"
"10334","646",2022-12-17 15:15:00,1000,1006,6,136,TRUE,NA,"0.1.4"
"10335","646",2022-12-17 15:30:00,999,1006,7,136,TRUE,NA,"0.1.4"
"10336","646",2022-12-17 15:45:00,1000,1006,6,136,TRUE,NA,"0.1.4"
"10337","646",2022-12-17 16:00:00,1000,1006,6,136,TRUE,NA,"0.1.4"
"10338","646",2022-12-17 16:15:00,1000,1006,6,136,TRUE,NA,"0.1.4"
"10339","646",2022-12-17 16:30:00,1000,1006,6,136,TRUE,NA,"0.1.4"
"10340","646",2022-12-17 16:45:00,1000,1006,6,136,TRUE,NA,"0.1.4"
"10341","646",2022-12-17 17:00:00,1000,1006,6,136,TRUE,NA,"0.1.4"
"10342","646",2022-12-17 17:15:00,1000,1006,6,136,TRUE,NA,"0.1.4"
"10343","646",2022-12-17 17:30:00,1000,1006,6,136,TRUE,NA,"0.1.4"
"10344","646",2022-12-17 17:45:00,1000,1006,6,136,TRUE,NA,"0.1.4"
"10345","646",2022-12-17 18:00:00,1000,1006,6,136,TRUE,NA,"0.1.4"
"10346","646",2022-12-17 18:15:00,1000,1006,6,136,TRUE,NA,"0.1.4"
"10347","646",2022-12-17 18:30:00,1000,1006,6,136,TRUE,NA,"0.1.4"
"10348","646",2022-12-17 18:45:00,1000,1006,6,136,TRUE,NA,"0.1.4"
"10349","646",2022-12-17 19:00:00,1000,1006,6,136,TRUE,NA,"0.1.4"
"10350","646",2022-12-17 19:15:00,1000,1006,6,136,TRUE,NA,"0.1.4"
"10351","646",2022-12-17 19:30:00,1000,1006,6,136,TRUE,NA,"0.1.4"
"10352","646",2022-12-17 19:45:00,1000,1006,6,136,TRUE,NA,"0.1.4"
"10353","646",2022-12-17 20:00:00,1000,1006,6,136,TRUE,NA,"0.1.4"
"10354","646",2022-12-17 20:15:00,1000,1006,6,136,TRUE,NA,"0.1.4"
"10355","646",2022-12-17 20:30:00,1000,1006,6,136,TRUE,NA,"0.1.4"
"10356","646",2022-12-17 20:45:00,1000,1006,6,136,TRUE,NA,"0.1.4"
"10357","646",2022-12-17 21:00:00,1000,1006,6,136,TRUE,NA,"0.1.4"
"10358","646",2022-12-17 21:15:00,1000,1006,6,136,TRUE,NA,"0.1.4"
"10359","646",2022-12-17 21:30:00,1000,1006,6,136,TRUE,NA,"0.1.4"
"10360","646",2022-12-17 21:45:00,1000,1006,6,136,TRUE,NA,"0.1.4"
"10361","646",2022-12-17 22:00:00,1000,1006,6,136,TRUE,NA,"0.1.4"
"10362","646",2022-12-17 22:15:00,1000,1006,6,136,TRUE,NA,"0.1.4"
"10363","646",2022-12-17 22:30:00,1000,1006,6,136,TRUE,NA,"0.1.4"
"10364","646",2022-12-17 22:45:00,1000,1006,6,136,TRUE,NA,"0.1.4"
"10365","646",2022-12-17 23:00:00,1000,1006,6,136,TRUE,NA,"0.1.4"
"10366","646",2022-12-17 23:15:00,1000,1006,6,136,TRUE,NA,"0.1.4"
"10367","646",2022-12-17 23:30:00,1000,1006,6,136,TRUE,NA,"0.1.4"
"10368","646",2022-12-17 23:45:00,1000,1006,6,136,TRUE,NA,"0.1.4"
"10369","646",2022-12-18,1000,1006,6,136,TRUE,NA,"0.1.4"
"10370","646",2022-12-18 00:15:00,1000,1006,6,136,TRUE,NA,"0.1.4"
"10371","646",2022-12-18 00:30:00,1000,1006,6,136,TRUE,NA,"0.1.4"
"10372","646",2022-12-18 00:45:00,1000,1006,6,136,TRUE,NA,"0.1.4"
"10373","646",2022-12-18 01:00:00,1000,1006,6,136,TRUE,NA,"0.1.4"
"10374","646",2022-12-18 01:15:00,1000,1006,6,136,TRUE,NA,"0.1.4"
"10375","646",2022-12-18 01:30:00,1000,1006,6,136,TRUE,NA,"0.1.4"
"10376","646",2022-12-18 01:45:00,1000,1006,6,136,TRUE,NA,"0.1.4"
"10377","646",2022-12-18 02:00:00,1000,1006,6,136,TRUE,NA,"0.1.4"
"10378","646",2022-12-18 02:15:00,1000,1006,6,136,TRUE,NA,"0.1.4"
"10379","646",2022-12-18 02:30:00,1000,1006,6,136,TRUE,NA,"0.1.4"
"10380","646",2022-12-18 02:45:00,1000,1006,6,136,TRUE,NA,"0.1.4"
"10381","646",2022-12-18 03:00:00,1000,1006,6,136,TRUE,NA,"0.1.4"
"10382","646",2022-12-18 03:15:00,1000,1006,6,136,TRUE,NA,"0.1.4"
"10383","646",2022-12-18 03:30:00,1000,1006,6,136,TRUE,NA,"0.1.4"
"10384","646",2022-12-18 03:45:00,1000,1006,6,136,TRUE,NA,"0.1.4"
"10385","646",2022-12-18 04:00:00,1000,1006,6,136,TRUE,NA,"0.1.4"
"10386","646",2022-12-18 04:15:00,1000,1006,6,136,TRUE,NA,"0.1.4"
"10387","646",2022-12-18 04:30:00,1000,1006,6,136,TRUE,NA,"0.1.4"
"10388","646",2022-12-18 04:45:00,1000,1006,6,136,TRUE,NA,"0.1.4"
"10389","646",2022-12-18 05:00:00,1000,1006,6,136,TRUE,NA,"0.1.4"
"10390","646",2022-12-18 05:15:00,1000,1006,6,136,TRUE,NA,"0.1.4"
"10391","646",2022-12-18 05:30:00,1000,1006,6,136,TRUE,NA,"0.1.4"
"10392","646",2022-12-18 05:45:00,1000,1006,6,136,TRUE,NA,"0.1.4"
"10393","646",2022-12-18 06:00:00,1000,1006,6,136,TRUE,NA,"0.1.4"
"10394","646",2022-12-18 06:15:00,1000,1006,6,136,TRUE,NA,"0.1.4"
"10395","646",2022-12-18 06:30:00,1000,1006,6,136,TRUE,NA,"0.1.4"
"10396","646",2022-12-18 06:45:00,1000,1006,6,136,TRUE,NA,"0.1.4"
"10397","646",2022-12-18 07:00:00,1000,1006,6,136,TRUE,NA,"0.1.4"
"10398","646",2022-12-18 07:15:00,1000,1006,6,136,TRUE,NA,"0.1.4"
"10399","646",2022-12-18 07:30:00,1000,1006,6,136,TRUE,NA,"0.1.4"
"10400","646",2022-12-18 07:45:00,1000,1006,6,136,TRUE,NA,"0.1.4"
"10401","646",2022-12-18 08:00:00,1000,1006,6,136,TRUE,NA,"0.1.4"
"10402","646",2022-12-18 08:15:00,1000,1006,6,136,TRUE,NA,"0.1.4"
"10403","646",2022-12-18 08:30:00,1000,1006,6,136,TRUE,NA,"0.1.4"
"10404","646",2022-12-18 08:45:00,1000,1006,6,136,TRUE,NA,"0.1.4"
"10405","646",2022-12-18 09:00:00,999,1006,7,136,TRUE,NA,"0.1.4"
"10406","646",2022-12-18 09:15:00,999,1006,7,136,TRUE,NA,"0.1.4"
"10407","646",2022-12-18 09:30:00,999,1006,7,136,TRUE,NA,"0.1.4"
"10408","646",2022-12-18 09:45:00,1000,1006,6,136,TRUE,NA,"0.1.4"
"10409","646",2022-12-18 10:00:00,1000,1006,6,136,TRUE,NA,"0.1.4"
"10410","646",2022-12-18 10:15:00,1000,1006,6,136,TRUE,NA,"0.1.4"
"10411","646",2022-12-18 10:30:00,1000,1006,6,136,TRUE,NA,"0.1.4"
"10412","646",2022-12-18 10:45:00,1000,1006,6,136,TRUE,NA,"0.1.4"
"10413","646",2022-12-18 11:00:00,1000,1006,6,136,TRUE,NA,"0.1.4"
"10414","646",2022-12-18 11:15:00,1000,1006,6,136,TRUE,NA,"0.1.4"
"10415","646",2022-12-18 11:30:00,1000,1006,6,136,TRUE,NA,"0.1.4"
"10416","646",2022-12-18 11:45:00,1000,1006,6,136,TRUE,NA,"0.1.4"
"10417","646",2022-12-18 12:00:00,1000,1006,6,136,TRUE,NA,"0.1.4"
"10418","646",2022-12-18 12:15:00,1000,1006,6,136,TRUE,NA,"0.1.4"
"10419","646",2022-12-18 12:30:00,1000,1006,6,136,TRUE,NA,"0.1.4"
"10420","646",2022-12-18 12:45:00,1000,1006,6,136,TRUE,NA,"0.1.4"
"10421","646",2022-12-18 13:00:00,1000,1006,6,136,TRUE,NA,"0.1.4"
"10422","646",2022-12-18 13:15:00,1000,1006,6,136,TRUE,NA,"0.1.4"
"10423","646",2022-12-18 13:30:00,1000,1006,6,136,TRUE,NA,"0.1.4"
"10424","646",2022-12-18 13:45:00,1000,1006,6,136,TRUE,NA,"0.1.4"
"10425","646",2022-12-18 14:00:00,1000,1006,6,136,TRUE,NA,"0.1.4"
"10426","646",2022-12-18 14:15:00,1000,1006,6,136,TRUE,NA,"0.1.4"
"10427","646",2022-12-18 14:30:00,1000,1006,6,136,TRUE,NA,"0.1.4"
"10428","646",2022-12-18 14:45:00,1000,1006,6,136,TRUE,NA,"0.1.4"
"10429","646",2022-12-18 15:00:00,1000,1006,6,136,TRUE,NA,"0.1.4"
"10430","646",2022-12-18 15:15:00,1000,1006,6,136,TRUE,NA,"0.1.4"
"10431","646",2022-12-18 15:30:00,1000,1006,6,136,TRUE,NA,"0.1.4"
"10432","646",2022-12-18 15:45:00,1000,1006,6,136,TRUE,NA,"0.1.4"
"10433","646",2022-12-18 16:00:00,1000,1006,6,136,TRUE,NA,"0.1.4"
"10434","646",2022-12-18 16:15:00,1000,1006,6,136,TRUE,NA,"0.1.4"
"10435","646",2022-12-18 16:30:00,1000,1006,6,136,TRUE,NA,"0.1.4"
"10436","646",2022-12-18 16:45:00,1000,1006,6,136,TRUE,NA,"0.1.4"
"10437","646",2022-12-18 17:00:00,1000,1006,6,136,TRUE,NA,"0.1.4"
"10438","646",2022-12-18 17:15:00,1000,1006,6,136,TRUE,NA,"0.1.4"
"10439","646",2022-12-18 17:30:00,1000,1006,6,136,TRUE,NA,"0.1.4"
"10440","646",2022-12-18 17:45:00,1000,1006,6,136,TRUE,NA,"0.1.4"
"10441","646",2022-12-18 18:00:00,1000,1006,6,136,TRUE,NA,"0.1.4"
"10442","646",2022-12-18 18:15:00,1000,1006,6,136,TRUE,NA,"0.1.4"
"10443","646",2022-12-18 18:30:00,1000,1006,6,136,TRUE,NA,"0.1.4"
"10444","646",2022-12-18 18:45:00,1000,1006,6,136,TRUE,NA,"0.1.4"
"10445","646",2022-12-18 19:00:00,1000,1006,6,136,TRUE,NA,"0.1.4"
"10446","646",2022-12-18 19:15:00,1000,1006,6,136,TRUE,NA,"0.1.4"
"10447","646",2022-12-18 19:30:00,1000,1006,6,136,TRUE,NA,"0.1.4"
"10448","646",2022-12-18 19:45:00,1000,1006,6,136,TRUE,NA,"0.1.4"
"10449","646",2022-12-18 20:00:00,1000,1006,6,136,TRUE,NA,"0.1.4"
"10450","646",2022-12-18 20:15:00,1000,1006,6,136,TRUE,NA,"0.1.4"
"10451","646",2022-12-18 20:30:00,1000,1006,6,136,TRUE,NA,"0.1.4"
"10452","646",2022-12-18 20:45:00,1000,1006,6,136,TRUE,NA,"0.1.4"
"10453","646",2022-12-18 21:00:00,1000,1006,6,136,TRUE,NA,"0.1.4"
"10454","646",2022-12-18 21:15:00,1000,1006,6,136,TRUE,NA,"0.1.4"
"10455","646",2022-12-18 21:30:00,1000,1006,6,136,TRUE,NA,"0.1.4"
"10456","646",2022-12-18 21:45:00,1000,1006,6,136,TRUE,NA,"0.1.4"
"10457","646",2022-12-18 22:00:00,1000,1006,6,136,TRUE,NA,"0.1.4"
"10458","646",2022-12-18 22:15:00,1000,1006,6,136,TRUE,NA,"0.1.4"
"10459","646",2022-12-18 22:30:00,1000,1006,6,136,TRUE,NA,"0.1.4"
"10460","646",2022-12-18 22:45:00,1000,1006,6,136,TRUE,NA,"0.1.4"
"10461","646",2022-12-18 23:00:00,1000,1006,6,136,TRUE,NA,"0.1.4"
"10462","646",2022-12-18 23:15:00,1000,1006,6,136,TRUE,NA,"0.1.4"
"10463","646",2022-12-18 23:30:00,1000,1006,6,136,TRUE,NA,"0.1.4"
"10464","646",2022-12-18 23:45:00,1000,1006,6,136,TRUE,NA,"0.1.4"
"10465","646",2022-12-19,1000,1006,6,136,TRUE,NA,"0.1.4"
"10466","646",2022-12-19 00:15:00,1000,1006,6,136,TRUE,NA,"0.1.4"
"10467","646",2022-12-19 00:30:00,1000,1006,6,136,TRUE,NA,"0.1.4"
"10468","646",2022-12-19 00:45:00,1000,1006,6,136,TRUE,NA,"0.1.4"
"10469","646",2022-12-19 01:00:00,1000,1006,6,136,TRUE,NA,"0.1.4"
"10470","646",2022-12-19 01:15:00,1000,1006,6,136,TRUE,NA,"0.1.4"
"10471","646",2022-12-19 01:30:00,1000,1006,6,136,TRUE,NA,"0.1.4"
"10472","646",2022-12-19 01:45:00,1000,1006,6,136,TRUE,NA,"0.1.4"
"10473","646",2022-12-19 02:00:00,1000,1006,6,136,TRUE,NA,"0.1.4"
"10474","646",2022-12-19 02:15:00,1000,1006,6,136,TRUE,NA,"0.1.4"
"10475","646",2022-12-19 02:30:00,1000,1006,6,136,TRUE,NA,"0.1.4"
"10476","646",2022-12-19 02:45:00,1000,1006,6,136,TRUE,NA,"0.1.4"
"10477","646",2022-12-19 03:00:00,1000,1006,6,136,TRUE,NA,"0.1.4"
"10478","646",2022-12-19 03:15:00,1000,1006,6,136,TRUE,NA,"0.1.4"
"10479","646",2022-12-19 03:30:00,1000,1006,6,136,TRUE,NA,"0.1.4"
"10480","646",2022-12-19 03:45:00,1000,1006,6,136,TRUE,NA,"0.1.4"
"10481","646",2022-12-19 04:00:00,1000,1006,6,136,TRUE,NA,"0.1.4"
"10482","646",2022-12-19 04:15:00,1000,1006,6,136,TRUE,NA,"0.1.4"
"10483","646",2022-12-19 04:30:00,1000,1006,6,136,TRUE,NA,"0.1.4"
"10484","646",2022-12-19 04:45:00,1000,1006,6,136,TRUE,NA,"0.1.4"
"10485","646",2022-12-19 05:00:00,1000,1006,6,136,TRUE,NA,"0.1.4"
"10486","646",2022-12-19 05:15:00,1000,1006,6,136,TRUE,NA,"0.1.4"
"10487","646",2022-12-19 05:30:00,1000,1006,6,136,TRUE,NA,"0.1.4"
"10488","646",2022-12-19 05:45:00,1000,1006,6,136,TRUE,NA,"0.1.4"
"10489","646",2022-12-19 06:00:00,1000,1006,6,136,TRUE,NA,"0.1.4"
"10490","646",2022-12-19 06:15:00,1000,1006,6,136,TRUE,NA,"0.1.4"
"10491","646",2022-12-19 06:30:00,1000,1006,6,136,TRUE,NA,"0.1.4"
"10492","646",2022-12-19 06:45:00,1000,1006,6,136,TRUE,NA,"0.1.4"
"10493","646",2022-12-19 07:00:00,1000,1006,6,136,TRUE,NA,"0.1.4"
"10494","646",2022-12-19 07:15:00,1000,1006,6,136,TRUE,NA,"0.1.4"
"10495","646",2022-12-19 07:30:00,1000,1006,6,136,TRUE,NA,"0.1.4"
"10496","646",2022-12-19 07:45:00,1000,1006,6,136,TRUE,NA,"0.1.4"
"10497","646",2022-12-19 08:00:00,1000,1006,6,136,TRUE,NA,"0.1.4"
"10498","646",2022-12-19 08:15:00,1000,1006,6,136,TRUE,NA,"0.1.4"
"10499","646",2022-12-19 08:30:00,1000,1006,6,136,TRUE,NA,"0.1.4"
"10500","646",2022-12-19 08:45:00,1000,1006,6,136,TRUE,NA,"0.1.4"
"10501","646",2022-12-19 09:00:00,1000,1006,6,136,TRUE,NA,"0.1.4"
"10502","646",2022-12-19 09:15:00,1000,1006,6,136,TRUE,NA,"0.1.4"
"10503","646",2022-12-19 09:30:00,1000,1006,6,136,TRUE,NA,"0.1.4"
"10504","646",2022-12-19 09:45:00,1000,1006,6,136,TRUE,NA,"0.1.4"
"10505","646",2022-12-19 10:00:00,1000,1006,6,136,TRUE,NA,"0.1.4"
"10506","646",2022-12-19 10:15:00,1000,1006,6,136,TRUE,NA,"0.1.4"
"10507","646",2022-12-19 10:30:00,1000,1006,6,136,TRUE,NA,"0.1.4"
"10508","646",2022-12-19 10:45:00,1000,1006,6,136,TRUE,NA,"0.1.4"
"10509","646",2022-12-19 11:00:00,1000,1006,6,136,TRUE,NA,"0.1.4"
"10510","646",2022-12-19 11:15:00,1000,1006,6,136,TRUE,NA,"0.1.4"
"10511","646",2022-12-19 11:30:00,1000,1006,6,136,TRUE,NA,"0.1.4"
"10512","646",2022-12-19 11:45:00,1000,1006,6,136,TRUE,NA,"0.1.4"
"10513","646",2022-12-19 12:00:00,1000,1006,6,136,TRUE,NA,"0.1.4"
"10514","646",2022-12-19 12:15:00,1000,1006,6,136,TRUE,NA,"0.1.4"
"10515","646",2022-12-19 12:30:00,1000,1006,6,136,TRUE,NA,"0.1.4"
"10516","646",2022-12-19 12:45:00,1000,1006,6,136,TRUE,NA,"0.1.4"
"10517","646",2022-12-19 13:00:00,1000,1006,6,136,TRUE,NA,"0.1.4"
"10518","646",2022-12-19 13:15:00,1000,1006,6,136,TRUE,NA,"0.1.4"
"10519","646",2022-12-19 13:30:00,1000,1006,6,136,TRUE,NA,"0.1.4"
"10520","646",2022-12-19 13:45:00,1000,1006,6,136,TRUE,NA,"0.1.4"
"10521","646",2022-12-19 14:00:00,1000,1006,6,136,TRUE,NA,"0.1.4"
"10522","646",2022-12-19 14:15:00,1000,1006,6,136,TRUE,NA,"0.1.4"
"10523","646",2022-12-19 14:30:00,1000,1006,6,136,TRUE,NA,"0.1.4"
"10524","646",2022-12-19 14:45:00,1000,1006,6,136,TRUE,NA,"0.1.4"
"10525","646",2022-12-19 15:00:00,1000,1006,6,136,TRUE,NA,"0.1.4"
"10526","646",2022-12-19 15:15:00,1000,1006,6,136,TRUE,NA,"0.1.4"
"10527","646",2022-12-19 15:30:00,1000,1006,6,136,TRUE,NA,"0.1.4"
"10528","646",2022-12-19 15:45:00,1000,1006,6,136,TRUE,NA,"0.1.4"
"10529","646",2022-12-19 16:00:00,1000,1006,6,136,TRUE,NA,"0.1.4"
"10530","646",2022-12-19 16:15:00,1000,1006,6,136,TRUE,NA,"0.1.4"
"10531","646",2022-12-19 16:30:00,1000,1006,6,136,TRUE,NA,"0.1.4"
"10532","646",2022-12-19 16:45:00,1000,1006,6,136,TRUE,NA,"0.1.4"
"10533","646",2022-12-19 17:00:00,1000,1006,6,136,TRUE,NA,"0.1.4"
"10534","646",2022-12-19 17:15:00,1000,1006,6,136,TRUE,NA,"0.1.4"
"10535","646",2022-12-19 17:30:00,1000,1006,6,136,TRUE,NA,"0.1.4"
"10536","646",2022-12-19 17:45:00,1000,1006,6,136,TRUE,NA,"0.1.4"
"10537","646",2022-12-19 18:00:00,1000,1006,6,136,TRUE,NA,"0.1.4"
"10538","646",2022-12-19 18:15:00,1000,1006,6,136,TRUE,NA,"0.1.4"
"10539","646",2022-12-19 18:30:00,1000,1006,6,136,TRUE,NA,"0.1.4"
"10540","646",2022-12-19 18:45:00,1000,1006,6,136,TRUE,NA,"0.1.4"
"10541","646",2022-12-19 19:00:00,1000,1006,6,136,TRUE,NA,"0.1.4"
"10542","646",2022-12-19 19:15:00,1000,1006,6,136,TRUE,NA,"0.1.4"
"10543","646",2022-12-19 19:30:00,1000,1006,6,136,TRUE,NA,"0.1.4"
"10544","646",2022-12-19 19:45:00,1000,1006,6,136,TRUE,NA,"0.1.4"
"10545","646",2022-12-19 20:00:00,1000,1006,6,136,TRUE,NA,"0.1.4"
"10546","646",2022-12-19 20:15:00,1000,1006,6,136,TRUE,NA,"0.1.4"
"10547","646",2022-12-19 20:30:00,1000,1006,6,136,TRUE,NA,"0.1.4"
"10548","646",2022-12-19 20:45:00,1000,1006,6,136,TRUE,NA,"0.1.4"
"10549","646",2022-12-19 21:00:00,1000,1006,6,136,TRUE,NA,"0.1.4"
"10550","646",2022-12-19 21:15:00,1000,1006,6,136,TRUE,NA,"0.1.4"
"10551","646",2022-12-19 21:30:00,1000,1006,6,136,TRUE,NA,"0.1.4"
"10552","646",2022-12-19 21:45:00,1000,1006,6,136,TRUE,NA,"0.1.4"
"10553","646",2022-12-19 22:00:00,1000,1006,6,136,TRUE,NA,"0.1.4"
"10554","646",2022-12-19 22:15:00,1000,1006,6,136,TRUE,NA,"0.1.4"
"10555","646",2022-12-19 22:30:00,1000,1006,6,136,TRUE,NA,"0.1.4"
"10556","646",2022-12-19 22:45:00,1000,1006,6,136,TRUE,NA,"0.1.4"
"10557","646",2022-12-19 23:00:00,1000,1006,6,136,TRUE,NA,"0.1.4"
"10558","646",2022-12-19 23:15:00,1000,1006,6,136,TRUE,NA,"0.1.4"
"10559","646",2022-12-19 23:30:00,1000,1006,6,136,TRUE,NA,"0.1.4"
"10560","646",2022-12-19 23:45:00,1000,1006,6,136,TRUE,NA,"0.1.4"
"10561","646",2022-12-20,1000,1006,6,136,TRUE,NA,"0.1.4"
"10562","646",2022-12-20 00:15:00,1000,1006,6,136,TRUE,NA,"0.1.4"
"10563","646",2022-12-20 00:30:00,1000,1006,6,136,TRUE,NA,"0.1.4"
"10564","646",2022-12-20 00:45:00,1000,1006,6,136,TRUE,NA,"0.1.4"
"10565","646",2022-12-20 01:00:00,1000,1006,6,136,TRUE,NA,"0.1.4"
"10566","646",2022-12-20 01:15:00,1000,1006,6,136,TRUE,NA,"0.1.4"
"10567","646",2022-12-20 01:30:00,1000,1006,6,136,TRUE,NA,"0.1.4"
"10568","646",2022-12-20 01:45:00,1000,1006,6,136,TRUE,NA,"0.1.4"
"10569","646",2022-12-20 02:00:00,1000,1006,6,136,TRUE,NA,"0.1.4"
"10570","646",2022-12-20 02:15:00,1000,1006,6,136,TRUE,NA,"0.1.4"
"10571","646",2022-12-20 02:30:00,1000,1006,6,136,TRUE,NA,"0.1.4"
"10572","646",2022-12-20 02:45:00,1000,1006,6,136,TRUE,NA,"0.1.4"
"10573","646",2022-12-20 03:00:00,1000,1006,6,136,TRUE,NA,"0.1.4"
"10574","646",2022-12-20 03:15:00,1000,1006,6,136,TRUE,NA,"0.1.4"
"10575","646",2022-12-20 03:30:00,1000,1006,6,136,TRUE,NA,"0.1.4"
"10576","646",2022-12-20 03:45:00,1000,1006,6,136,TRUE,NA,"0.1.4"
"10577","646",2022-12-20 04:00:00,1000,1006,6,136,TRUE,NA,"0.1.4"
"10578","646",2022-12-20 04:15:00,1000,1006,6,136,TRUE,NA,"0.1.4"
"10579","646",2022-12-20 04:30:00,1000,1006,6,136,TRUE,NA,"0.1.4"
"10580","646",2022-12-20 04:45:00,1000,1006,6,136,TRUE,NA,"0.1.4"
"10581","646",2022-12-20 05:00:00,1000,1006,6,136,TRUE,NA,"0.1.4"
"10582","646",2022-12-20 05:15:00,1000,1006,6,136,TRUE,NA,"0.1.4"
"10583","646",2022-12-20 05:30:00,1000,1006,6,136,TRUE,NA,"0.1.4"
"10584","646",2022-12-20 05:45:00,1000,1006,6,136,TRUE,NA,"0.1.4"
"10585","646",2022-12-20 06:00:00,1000,1006,6,136,TRUE,NA,"0.1.4"
"10586","646",2022-12-20 06:15:00,1000,1006,6,136,TRUE,NA,"0.1.4"
"10587","646",2022-12-20 06:30:00,1000,1006,6,136,TRUE,NA,"0.1.4"
"10588","646",2022-12-20 06:45:00,1000,1006,6,136,TRUE,NA,"0.1.4"
"10589","646",2022-12-20 07:00:00,1000,1006,6,136,TRUE,NA,"0.1.4"
"10590","646",2022-12-20 07:15:00,1000,1006,6,136,TRUE,NA,"0.1.4"
"10591","646",2022-12-20 07:30:00,1000,1006,6,136,TRUE,NA,"0.1.4"
"10592","646",2022-12-20 07:45:00,1000,1006,6,136,TRUE,NA,"0.1.4"
"10593","646",2022-12-20 08:00:00,1000,1006,6,136,TRUE,NA,"0.1.4"
"10594","646",2022-12-20 08:15:00,1000,1006,6,136,TRUE,NA,"0.1.4"
"10595","646",2022-12-20 08:30:00,1000,1006,6,136,TRUE,NA,"0.1.4"
"10596","646",2022-12-20 08:45:00,1000,1006,6,136,TRUE,NA,"0.1.4"
"10597","646",2022-12-20 09:00:00,1000,1006,6,136,TRUE,NA,"0.1.4"
"10598","646",2022-12-20 09:15:00,1000,1006,6,136,TRUE,NA,"0.1.4"
"10599","646",2022-12-20 09:30:00,1000,1006,6,136,TRUE,NA,"0.1.4"
"10600","646",2022-12-20 09:45:00,1000,1006,6,136,TRUE,NA,"0.1.4"
"10601","646",2022-12-20 10:00:00,1000,1006,6,136,TRUE,NA,"0.1.4"
"10602","646",2022-12-20 10:15:00,1000,1006,6,136,TRUE,NA,"0.1.4"
"10603","646",2022-12-20 10:30:00,1000,1006,6,136,TRUE,NA,"0.1.4"
"10604","646",2022-12-20 10:45:00,1000,1006,6,136,TRUE,NA,"0.1.4"
"10605","646",2022-12-20 11:00:00,1000,1006,6,136,TRUE,NA,"0.1.4"
"10606","646",2022-12-20 11:15:00,1000,1006,6,136,TRUE,NA,"0.1.4"
"10607","646",2022-12-20 11:30:00,1000,1006,6,136,TRUE,NA,"0.1.4"
"10608","646",2022-12-20 11:45:00,1000,1006,6,136,TRUE,NA,"0.1.4"
"10609","646",2022-12-20 12:00:00,1000,1006,6,136,TRUE,NA,"0.1.4"
"10610","646",2022-12-20 12:15:00,1000,1006,6,136,TRUE,NA,"0.1.4"
"10611","646",2022-12-20 12:30:00,1000,1006,6,136,TRUE,NA,"0.1.4"
"10612","646",2022-12-20 12:45:00,1000,1006,6,136,TRUE,NA,"0.1.4"
"10613","646",2022-12-20 13:00:00,1000,1006,6,136,TRUE,NA,"0.1.4"
"10614","646",2022-12-20 13:15:00,1000,1006,6,136,TRUE,NA,"0.1.4"
"10615","646",2022-12-20 13:30:00,1000,1006,6,136,TRUE,NA,"0.1.4"
"10616","646",2022-12-20 13:45:00,1000,1006,6,136,TRUE,NA,"0.1.4"
"10617","646",2022-12-20 14:00:00,1000,1006,6,136,TRUE,NA,"0.1.4"
"10618","646",2022-12-20 14:15:00,1000,1006,6,136,TRUE,NA,"0.1.4"
"10619","646",2022-12-20 14:30:00,1000,1006,6,136,TRUE,NA,"0.1.4"
"10620","646",2022-12-20 14:45:00,1000,1006,6,136,TRUE,NA,"0.1.4"
"10621","646",2022-12-20 15:00:00,1000,1006,6,136,TRUE,NA,"0.1.4"
"10622","646",2022-12-20 15:15:00,1000,1006,6,136,TRUE,NA,"0.1.4"
"10623","646",2022-12-20 15:30:00,1000,1006,6,136,TRUE,NA,"0.1.4"
"10624","646",2022-12-20 15:45:00,1000,1006,6,136,TRUE,NA,"0.1.4"
"10625","646",2022-12-20 16:00:00,1000,1006,6,136,TRUE,NA,"0.1.4"
"10626","646",2022-12-20 16:15:00,1000,1006,6,136,TRUE,NA,"0.1.4"
"10627","646",2022-12-20 16:30:00,1000,1006,6,136,TRUE,NA,"0.1.4"
"10628","646",2022-12-20 16:45:00,1000,1006,6,136,TRUE,NA,"0.1.4"
"10629","646",2022-12-20 17:00:00,1000,1006,6,136,TRUE,NA,"0.1.4"
"10630","646",2022-12-20 17:15:00,1000,1006,6,136,TRUE,NA,"0.1.4"
"10631","646",2022-12-20 17:30:00,1000,1006,6,136,TRUE,NA,"0.1.4"
"10632","646",2022-12-20 17:45:00,1000,1006,6,136,TRUE,NA,"0.1.4"
"10633","646",2022-12-20 18:00:00,1000,1006,6,136,TRUE,NA,"0.1.4"
"10634","646",2022-12-20 18:15:00,1000,1006,6,136,TRUE,NA,"0.1.4"
"10635","646",2022-12-20 18:30:00,1000,1006,6,136,TRUE,NA,"0.1.4"
"10636","646",2022-12-20 18:45:00,1000,1006,6,136,TRUE,NA,"0.1.4"
"10637","646",2022-12-20 19:00:00,1000,1006,6,136,TRUE,NA,"0.1.4"
"10638","646",2022-12-20 19:15:00,1000,1006,6,136,TRUE,NA,"0.1.4"
"10639","646",2022-12-20 19:30:00,1000,1006,6,136,TRUE,NA,"0.1.4"
"10640","646",2022-12-20 19:45:00,1000,1006,6,136,TRUE,NA,"0.1.4"
"10641","646",2022-12-20 20:00:00,1000,1006,6,136,TRUE,NA,"0.1.4"
"10642","646",2022-12-20 20:15:00,1000,1006,6,136,TRUE,NA,"0.1.4"
"10643","646",2022-12-20 20:30:00,1000,1006,6,136,TRUE,NA,"0.1.4"
"10644","646",2022-12-20 20:45:00,1000,1006,6,136,TRUE,NA,"0.1.4"
"10645","646",2022-12-20 21:00:00,1000,1006,6,136,TRUE,NA,"0.1.4"
"10646","646",2022-12-20 21:15:00,1000,1006,6,136,TRUE,NA,"0.1.4"
"10647","646",2022-12-20 21:30:00,1000,1006,6,136,TRUE,NA,"0.1.4"
"10648","646",2022-12-20 21:45:00,1000,1006,6,136,TRUE,NA,"0.1.4"
"10649","646",2022-12-20 22:00:00,1000,1006,6,136,TRUE,NA,"0.1.4"
"10650","646",2022-12-20 22:15:00,1000,1006,6,136,TRUE,NA,"0.1.4"
"10651","646",2022-12-20 22:30:00,1000,1006,6,136,TRUE,NA,"0.1.4"
"10652","646",2022-12-20 22:45:00,1000,1006,6,136,TRUE,NA,"0.1.4"
"10653","646",2022-12-20 23:00:00,1000,1006,6,136,TRUE,NA,"0.1.4"
"10654","646",2022-12-20 23:15:00,1000,1006,6,136,TRUE,NA,"0.1.4"
"10655","646",2022-12-20 23:30:00,1000,1006,6,136,TRUE,NA,"0.1.4"
"10656","646",2022-12-20 23:45:00,1000,1006,6,136,TRUE,NA,"0.1.4"
"10657","646",2022-12-21,1000,1006,6,136,TRUE,NA,"0.1.4"
"10658","646",2022-12-21 00:15:00,1000,1006,6,136,TRUE,NA,"0.1.4"
"10659","646",2022-12-21 00:30:00,1000,1006,6,136,TRUE,NA,"0.1.4"
"10660","646",2022-12-21 00:45:00,1000,1006,6,136,TRUE,NA,"0.1.4"
"10661","646",2022-12-21 01:00:00,1000,1006,6,136,TRUE,NA,"0.1.4"
"10662","646",2022-12-21 01:15:00,1000,1006,6,136,TRUE,NA,"0.1.4"
"10663","646",2022-12-21 01:30:00,1000,1006,6,136,TRUE,NA,"0.1.4"
"10664","646",2022-12-21 01:45:00,1000,1006,6,136,TRUE,NA,"0.1.4"
"10665","646",2022-12-21 02:00:00,1000,1006,6,136,TRUE,NA,"0.1.4"
"10666","646",2022-12-21 02:15:00,1000,1006,6,136,TRUE,NA,"0.1.4"
"10667","646",2022-12-21 02:30:00,1000,1006,6,136,TRUE,NA,"0.1.4"
"10668","646",2022-12-21 02:45:00,1000,1006,6,136,TRUE,NA,"0.1.4"
"10669","646",2022-12-21 03:00:00,1000,1006,6,136,TRUE,NA,"0.1.4"
"10670","646",2022-12-21 03:15:00,1000,1006,6,136,TRUE,NA,"0.1.4"
"10671","646",2022-12-21 03:30:00,1000,1006,6,136,TRUE,NA,"0.1.4"
"10672","646",2022-12-21 03:45:00,1000,1006,6,136,TRUE,NA,"0.1.4"
"10673","646",2022-12-21 04:00:00,1000,1006,6,136,TRUE,NA,"0.1.4"
"10674","646",2022-12-21 04:15:00,1000,1006,6,136,TRUE,NA,"0.1.4"
"10675","646",2022-12-21 04:30:00,1000,1006,6,136,TRUE,NA,"0.1.4"
"10676","646",2022-12-21 04:45:00,1000,1006,6,136,TRUE,NA,"0.1.4"
"10677","646",2022-12-21 05:00:00,1000,1006,6,136,TRUE,NA,"0.1.4"
"10678","646",2022-12-21 05:15:00,1000,1006,6,136,TRUE,NA,"0.1.4"
"10679","646",2022-12-21 05:30:00,1000,1006,6,136,TRUE,NA,"0.1.4"
"10680","646",2022-12-21 05:45:00,1000,1006,6,136,TRUE,NA,"0.1.4"
"10681","646",2022-12-21 06:00:00,1000,1006,6,136,TRUE,NA,"0.1.4"
"10682","646",2022-12-21 06:15:00,1000,1006,6,136,TRUE,NA,"0.1.4"
"10683","646",2022-12-21 06:30:00,1000,1006,6,136,TRUE,NA,"0.1.4"
"10684","646",2022-12-21 06:45:00,1000,1006,6,136,TRUE,NA,"0.1.4"
"10685","646",2022-12-21 07:00:00,1000,1006,6,136,TRUE,NA,"0.1.4"
"10686","646",2022-12-21 07:15:00,1000,1006,6,136,TRUE,NA,"0.1.4"
"10687","646",2022-12-21 07:30:00,1000,1006,6,136,TRUE,NA,"0.1.4"
"10688","646",2022-12-21 07:45:00,1000,1006,6,136,TRUE,NA,"0.1.4"
"10689","646",2022-12-21 08:00:00,1000,1006,6,136,TRUE,NA,"0.1.4"
"10690","646",2022-12-21 08:15:00,1000,1006,6,136,TRUE,NA,"0.1.4"
"10691","646",2022-12-21 08:30:00,1000,1006,6,136,TRUE,NA,"0.1.4"
"10692","646",2022-12-21 08:45:00,1000,1006,6,136,TRUE,NA,"0.1.4"
"10693","646",2022-12-21 09:00:00,1000,1006,6,136,TRUE,NA,"0.1.4"
"10694","646",2022-12-21 09:15:00,1000,1006,6,136,TRUE,NA,"0.1.4"
"10695","646",2022-12-21 09:30:00,1000,1006,6,136,TRUE,NA,"0.1.4"
"10696","646",2022-12-21 09:45:00,1000,1006,6,136,TRUE,NA,"0.1.4"
"10697","646",2022-12-21 10:00:00,1000,1006,6,136,TRUE,NA,"0.1.4"
"10698","646",2022-12-21 10:15:00,1000,1006,6,136,TRUE,NA,"0.1.4"
"10699","646",2022-12-21 10:30:00,1000,1006,6,136,TRUE,NA,"0.1.4"
"10700","646",2022-12-21 10:45:00,1000,1006,6,136,TRUE,NA,"0.1.4"
"10701","646",2022-12-21 11:00:00,1000,1006,6,136,TRUE,NA,"0.1.4"
"10702","646",2022-12-21 11:15:00,1000,1006,6,136,TRUE,NA,"0.1.4"
"10703","646",2022-12-21 11:30:00,1000,1006,6,136,TRUE,NA,"0.1.4"
"10704","646",2022-12-21 11:45:00,1000,1006,6,136,TRUE,NA,"0.1.4"
"10705","646",2022-12-21 12:00:00,1000,1006,6,136,TRUE,NA,"0.1.4"
"10706","646",2022-12-21 12:15:00,1000,1006,6,136,TRUE,NA,"0.1.4"
"10707","646",2022-12-21 12:30:00,1000,1006,6,136,TRUE,NA,"0.1.4"
"10708","646",2022-12-21 12:45:00,1000,1006,6,136,TRUE,NA,"0.1.4"
"10709","646",2022-12-21 13:00:00,1000,1006,6,136,TRUE,NA,"0.1.4"
"10710","646",2022-12-21 13:15:00,1000,1006,6,136,TRUE,NA,"0.1.4"
"10711","646",2022-12-21 13:30:00,1000,1006,6,136,TRUE,NA,"0.1.4"
"10712","646",2022-12-21 13:45:00,1000,1006,6,136,TRUE,NA,"0.1.4"
"10713","646",2022-12-21 14:00:00,1000,1006,6,136,TRUE,NA,"0.1.4"
"10714","646",2022-12-21 14:15:00,1000,1006,6,136,TRUE,NA,"0.1.4"
"10715","646",2022-12-21 14:30:00,1000,1006,6,136,TRUE,NA,"0.1.4"
"10716","646",2022-12-21 14:45:00,1000,1006,6,136,TRUE,NA,"0.1.4"
"10717","646",2022-12-21 15:00:00,1000,1006,6,136,TRUE,NA,"0.1.4"
"10718","646",2022-12-21 15:15:00,1000,1006,6,136,TRUE,NA,"0.1.4"
"10719","646",2022-12-21 15:30:00,1000,1006,6,136,TRUE,NA,"0.1.4"
"10720","646",2022-12-21 15:45:00,1000,1006,6,136,TRUE,NA,"0.1.4"
"10721","646",2022-12-21 16:00:00,1000,1006,6,136,TRUE,NA,"0.1.4"
"10722","646",2022-12-21 16:15:00,1000,1006,6,136,TRUE,NA,"0.1.4"
"10723","646",2022-12-21 16:30:00,1000,1006,6,136,TRUE,NA,"0.1.4"
"10724","646",2022-12-21 16:45:00,1000,1006,6,136,TRUE,NA,"0.1.4"
"10725","646",2022-12-21 17:00:00,1000,1006,6,136,TRUE,NA,"0.1.4"
"10726","646",2022-12-21 17:15:00,1000,1006,6,136,TRUE,NA,"0.1.4"
"10727","646",2022-12-21 17:30:00,1000,1006,6,136,TRUE,NA,"0.1.4"
"10728","646",2022-12-21 17:45:00,1000,1006,6,136,TRUE,NA,"0.1.4"
"10729","646",2022-12-21 18:00:00,1000,1006,6,136,TRUE,NA,"0.1.4"
"10730","646",2022-12-21 18:15:00,1000,1006,6,136,TRUE,NA,"0.1.4"
"10731","646",2022-12-21 18:30:00,1000,1006,6,136,TRUE,NA,"0.1.4"
"10732","646",2022-12-21 18:45:00,1000,1006,6,136,TRUE,NA,"0.1.4"
"10733","646",2022-12-21 19:00:00,1000,1006,6,136,TRUE,NA,"0.1.4"
"10734","646",2022-12-21 19:15:00,1000,1006,6,136,TRUE,NA,"0.1.4"
"10735","646",2022-12-21 19:30:00,1000,1006,6,136,TRUE,NA,"0.1.4"
"10736","646",2022-12-21 19:45:00,1000,1006,6,136,TRUE,NA,"0.1.4"
"10737","646",2022-12-21 20:00:00,1000,1006,6,136,TRUE,NA,"0.1.4"
"10738","646",2022-12-21 20:15:00,1000,1006,6,136,TRUE,NA,"0.1.4"
"10739","646",2022-12-21 20:30:00,1000,1006,6,136,TRUE,NA,"0.1.4"
"10740","646",2022-12-21 20:45:00,1000,1006,6,136,TRUE,NA,"0.1.4"
"10741","646",2022-12-21 21:00:00,1000,1006,6,136,TRUE,NA,"0.1.4"
"10742","646",2022-12-21 21:15:00,1000,1006,6,136,TRUE,NA,"0.1.4"
"10743","646",2022-12-21 21:30:00,1000,1006,6,136,TRUE,NA,"0.1.4"
"10744","646",2022-12-21 21:45:00,1000,1006,6,136,TRUE,NA,"0.1.4"
"10745","646",2022-12-21 22:00:00,1000,1006,6,136,TRUE,NA,"0.1.4"
"10746","646",2022-12-21 22:15:00,1000,1006,6,136,TRUE,NA,"0.1.4"
"10747","646",2022-12-21 22:30:00,1000,1006,6,136,TRUE,NA,"0.1.4"
"10748","646",2022-12-21 22:45:00,1000,1006,6,136,TRUE,NA,"0.1.4"
"10749","646",2022-12-21 23:00:00,1000,1006,6,136,TRUE,NA,"0.1.4"
"10750","646",2022-12-21 23:15:00,1000,1006,6,136,TRUE,NA,"0.1.4"
"10751","646",2022-12-21 23:30:00,1000,1006,6,136,TRUE,NA,"0.1.4"
"10752","646",2022-12-21 23:45:00,1000,1006,6,136,TRUE,NA,"0.1.4"
"10753","646",2022-12-22,1000,1006,6,136,TRUE,NA,"0.1.4"
"10754","646",2022-12-22 00:15:00,1000,1006,6,136,TRUE,NA,"0.1.4"
"10755","646",2022-12-22 00:30:00,1000,1006,6,136,TRUE,NA,"0.1.4"
"10756","646",2022-12-22 00:45:00,1000,1006,6,136,TRUE,NA,"0.1.4"
"10757","646",2022-12-22 01:00:00,1000,1006,6,136,TRUE,NA,"0.1.4"
"10758","646",2022-12-22 01:15:00,1000,1006,6,136,TRUE,NA,"0.1.4"
"10759","646",2022-12-22 01:30:00,1000,1006,6,136,TRUE,NA,"0.1.4"
"10760","646",2022-12-22 01:45:00,1000,1006,6,136,TRUE,NA,"0.1.4"
"10761","646",2022-12-22 02:00:00,1000,1006,6,136,TRUE,NA,"0.1.4"
"10762","646",2022-12-22 02:15:00,1000,1006,6,136,TRUE,NA,"0.1.4"
"10763","646",2022-12-22 02:30:00,1000,1006,6,136,TRUE,NA,"0.1.4"
"10764","646",2022-12-22 02:45:00,1000,1006,6,136,TRUE,NA,"0.1.4"
"10765","646",2022-12-22 03:00:00,1000,1006,6,136,TRUE,NA,"0.1.4"
"10766","646",2022-12-22 03:15:00,1000,1006,6,136,TRUE,NA,"0.1.4"
"10767","646",2022-12-22 03:30:00,1000,1006,6,136,TRUE,NA,"0.1.4"
"10768","646",2022-12-22 03:45:00,1000,1006,6,136,TRUE,NA,"0.1.4"
"10769","646",2022-12-22 04:00:00,1000,1006,6,136,TRUE,NA,"0.1.4"
"10770","646",2022-12-22 04:15:00,1000,1006,6,136,TRUE,NA,"0.1.4"
"10771","646",2022-12-22 04:30:00,1000,1006,6,136,TRUE,NA,"0.1.4"
"10772","646",2022-12-22 04:45:00,1000,1006,6,136,TRUE,NA,"0.1.4"
"10773","646",2022-12-22 05:00:00,1000,1006,6,136,TRUE,NA,"0.1.4"
"10774","646",2022-12-22 05:15:00,1000,1006,6,136,TRUE,NA,"0.1.4"
"10775","646",2022-12-22 05:30:00,1000,1006,6,136,TRUE,NA,"0.1.4"
"10776","646",2022-12-22 05:45:00,1000,1006,6,136,TRUE,NA,"0.1.4"
"10777","646",2022-12-22 06:00:00,1000,1006,6,136,TRUE,NA,"0.1.4"
"10778","646",2022-12-22 06:15:00,1000,1006,6,136,TRUE,NA,"0.1.4"
"10779","646",2022-12-22 06:30:00,1000,1006,6,136,TRUE,NA,"0.1.4"
"10780","646",2022-12-22 06:45:00,1000,1006,6,136,TRUE,NA,"0.1.4"
"10781","646",2022-12-22 07:00:00,1000,1006,6,136,TRUE,NA,"0.1.4"
"10782","646",2022-12-22 07:15:00,1000,1006,6,136,TRUE,NA,"0.1.4"
"10783","646",2022-12-22 07:30:00,1000,1006,6,136,TRUE,NA,"0.1.4"
"10784","646",2022-12-22 07:45:00,1000,1006,6,136,TRUE,NA,"0.1.4"
"10785","646",2022-12-22 08:00:00,1000,1006,6,136,TRUE,NA,"0.1.4"
"10786","646",2022-12-22 08:15:00,1000,1006,6,136,TRUE,NA,"0.1.4"
"10787","646",2022-12-22 08:30:00,1000,1006,6,136,TRUE,NA,"0.1.4"
"10788","646",2022-12-22 08:45:00,1000,1006,6,136,TRUE,NA,"0.1.4"
"10789","646",2022-12-22 09:00:00,1000,1006,6,136,TRUE,NA,"0.1.4"
"10790","646",2022-12-22 09:15:00,1000,1006,6,136,TRUE,NA,"0.1.4"
"10791","646",2022-12-22 09:30:00,1000,1006,6,136,TRUE,NA,"0.1.4"
"10792","646",2022-12-22 09:45:00,1000,1006,6,136,TRUE,NA,"0.1.4"
"10793","646",2022-12-22 10:00:00,1000,1006,6,136,TRUE,NA,"0.1.4"
"10794","646",2022-12-22 10:15:00,1000,1006,6,136,TRUE,NA,"0.1.4"
"10795","646",2022-12-22 10:30:00,1000,1006,6,136,TRUE,NA,"0.1.4"
"10796","646",2022-12-22 10:45:00,1000,1006,6,136,TRUE,NA,"0.1.4"
"10797","646",2022-12-22 11:00:00,1000,1006,6,136,TRUE,NA,"0.1.4"
"10798","646",2022-12-22 11:15:00,1000,1006,6,136,TRUE,NA,"0.1.4"
"10799","646",2022-12-22 11:30:00,1000,1006,6,136,TRUE,NA,"0.1.4"
"10800","646",2022-12-22 11:45:00,1000,1006,6,136,TRUE,NA,"0.1.4"
"10801","646",2022-12-22 12:00:00,1000,1006,6,136,TRUE,NA,"0.1.4"
"10802","646",2022-12-22 12:15:00,1000,1006,6,136,TRUE,NA,"0.1.4"
"10803","646",2022-12-22 12:30:00,1000,1006,6,136,TRUE,NA,"0.1.4"
"10804","646",2022-12-22 12:45:00,999,1006,7,136,TRUE,NA,"0.1.4"
"10805","646",2022-12-22 13:00:00,999,1006,7,136,TRUE,NA,"0.1.4"
"10806","646",2022-12-22 13:15:00,999,1006,7,136,TRUE,NA,"0.1.4"
"10807","646",2022-12-22 13:30:00,1000,1006,6,136,TRUE,NA,"0.1.4"
"10808","646",2022-12-22 13:45:00,1000,1006,6,136,TRUE,NA,"0.1.4"
"10809","646",2022-12-22 14:00:00,1000,1006,6,136,TRUE,NA,"0.1.4"
"10810","646",2022-12-22 14:15:00,999,1006,7,136,TRUE,NA,"0.1.4"
"10811","646",2022-12-22 14:30:00,999,1006,7,136,TRUE,NA,"0.1.4"
"10812","646",2022-12-22 14:45:00,1000,1006,6,136,TRUE,NA,"0.1.4"
"10813","646",2022-12-22 15:00:00,1000,1006,6,136,TRUE,NA,"0.1.4"
"10814","646",2022-12-22 15:15:00,1000,1006,6,136,TRUE,NA,"0.1.4"
"10815","646",2022-12-22 15:30:00,1000,1006,6,136,TRUE,NA,"0.1.4"
"10816","646",2022-12-22 15:45:00,1000,1006,6,136,TRUE,NA,"0.1.4"
"10817","646",2022-12-22 16:00:00,1000,1006,6,136,TRUE,NA,"0.1.4"
"10818","646",2022-12-22 16:15:00,1000,1006,6,136,TRUE,NA,"0.1.4"
"10819","646",2022-12-22 16:30:00,1000,1006,6,136,TRUE,NA,"0.1.4"
"10820","646",2022-12-22 16:45:00,1000,1006,6,136,TRUE,NA,"0.1.4"
"10821","646",2022-12-22 17:00:00,1000,1006,6,136,TRUE,NA,"0.1.4"
"10822","646",2022-12-22 17:15:00,1000,1006,6,136,TRUE,NA,"0.1.4"
"10823","646",2022-12-22 17:30:00,1000,1006,6,136,TRUE,NA,"0.1.4"
"10824","646",2022-12-22 17:45:00,1000,1006,6,136,TRUE,NA,"0.1.4"
"10825","646",2022-12-22 18:00:00,1000,1006,6,136,TRUE,NA,"0.1.4"
"10826","646",2022-12-22 18:15:00,1000,1006,6,136,TRUE,NA,"0.1.4"
"10827","646",2022-12-22 18:30:00,1000,1006,6,136,TRUE,NA,"0.1.4"
"10828","646",2022-12-22 18:45:00,1000,1006,6,136,TRUE,NA,"0.1.4"
"10829","646",2022-12-22 19:00:00,1000,1006,6,136,TRUE,NA,"0.1.4"
"10830","646",2022-12-22 19:15:00,1000,1006,6,136,TRUE,NA,"0.1.4"
"10831","646",2022-12-22 19:30:00,1000,1006,6,136,TRUE,NA,"0.1.4"
"10832","646",2022-12-22 19:45:00,1000,1006,6,136,TRUE,NA,"0.1.4"
"10833","646",2022-12-22 20:00:00,1000,1006,6,136,TRUE,NA,"0.1.4"
"10834","646",2022-12-22 20:15:00,1000,1006,6,136,TRUE,NA,"0.1.4"
"10835","646",2022-12-22 20:30:00,1000,1006,6,136,TRUE,NA,"0.1.4"
"10836","646",2022-12-22 20:45:00,1000,1006,6,136,TRUE,NA,"0.1.4"
"10837","646",2022-12-22 21:00:00,1000,1006,6,136,TRUE,NA,"0.1.4"
"10838","646",2022-12-22 21:15:00,1000,1006,6,136,TRUE,NA,"0.1.4"
"10839","646",2022-12-22 21:30:00,1000,1006,6,136,TRUE,NA,"0.1.4"
"10840","646",2022-12-22 21:45:00,1000,1006,6,136,TRUE,NA,"0.1.4"
"10841","646",2022-12-22 22:00:00,1000,1006,6,136,TRUE,NA,"0.1.4"
"10842","646",2022-12-22 22:15:00,1000,1006,6,136,TRUE,NA,"0.1.4"
"10843","646",2022-12-22 22:30:00,1000,1006,6,136,TRUE,NA,"0.1.4"
"10844","646",2022-12-22 22:45:00,1000,1006,6,136,TRUE,NA,"0.1.4"
"10845","646",2022-12-22 23:00:00,1000,1006,6,136,TRUE,NA,"0.1.4"
"10846","646",2022-12-22 23:15:00,1000,1006,6,136,TRUE,NA,"0.1.4"
"10847","646",2022-12-22 23:30:00,1000,1006,6,136,TRUE,NA,"0.1.4"
"10848","646",2022-12-22 23:45:00,1000,1006,6,136,TRUE,NA,"0.1.4"
"10849","646",2022-12-23,1000,1006,6,136,TRUE,NA,"0.1.4"
"10850","646",2022-12-23 00:15:00,1000,1006,6,136,TRUE,NA,"0.1.4"
"10851","646",2022-12-23 00:30:00,1000,1006,6,136,TRUE,NA,"0.1.4"
"10852","646",2022-12-23 00:45:00,1000,1006,6,136,TRUE,NA,"0.1.4"
"10853","646",2022-12-23 01:00:00,1000,1006,6,136,TRUE,NA,"0.1.4"
"10854","646",2022-12-23 01:15:00,1000,1006,6,136,TRUE,NA,"0.1.4"
"10855","646",2022-12-23 01:30:00,1000,1006,6,136,TRUE,NA,"0.1.4"
"10856","646",2022-12-23 01:45:00,1000,1006,6,136,TRUE,NA,"0.1.4"
"10857","646",2022-12-23 02:00:00,1000,1006,6,136,TRUE,NA,"0.1.4"
"10858","646",2022-12-23 02:15:00,1000,1006,6,136,TRUE,NA,"0.1.4"
"10859","646",2022-12-23 02:30:00,1000,1006,6,136,TRUE,NA,"0.1.4"
"10860","646",2022-12-23 02:45:00,1000,1006,6,136,TRUE,NA,"0.1.4"
"10861","646",2022-12-23 03:00:00,1000,1006,6,136,TRUE,NA,"0.1.4"
"10862","646",2022-12-23 03:15:00,1000,1006,6,136,TRUE,NA,"0.1.4"
"10863","646",2022-12-23 03:30:00,1000,1006,6,136,TRUE,NA,"0.1.4"
"10864","646",2022-12-23 03:45:00,1000,1006,6,136,TRUE,NA,"0.1.4"
"10865","646",2022-12-23 04:00:00,1000,1006,6,136,TRUE,NA,"0.1.4"
"10866","646",2022-12-23 04:15:00,1000,1006,6,136,TRUE,NA,"0.1.4"
"10867","646",2022-12-23 04:30:00,1000,1006,6,136,TRUE,NA,"0.1.4"
"10868","646",2022-12-23 04:45:00,1000,1006,6,136,TRUE,NA,"0.1.4"
"10869","646",2022-12-23 05:00:00,1000,1006,6,136,TRUE,NA,"0.1.4"
"10870","646",2022-12-23 05:15:00,1000,1006,6,136,TRUE,NA,"0.1.4"
"10871","646",2022-12-23 05:30:00,1000,1006,6,136,TRUE,NA,"0.1.4"
"10872","646",2022-12-23 05:45:00,1000,1006,6,136,TRUE,NA,"0.1.4"
"10873","646",2022-12-23 06:00:00,1000,1006,6,136,TRUE,NA,"0.1.4"
"10874","646",2022-12-23 06:15:00,1000,1006,6,136,TRUE,NA,"0.1.4"
"10875","646",2022-12-23 06:30:00,1000,1006,6,136,TRUE,NA,"0.1.4"
"10876","646",2022-12-23 06:45:00,1000,1006,6,136,TRUE,NA,"0.1.4"
"10877","646",2022-12-23 07:00:00,1000,1006,6,136,TRUE,NA,"0.1.4"
"10878","646",2022-12-23 07:15:00,1000,1006,6,136,TRUE,NA,"0.1.4"
"10879","646",2022-12-23 07:30:00,1000,1006,6,136,TRUE,NA,"0.1.4"
"10880","646",2022-12-23 07:45:00,1000,1006,6,136,TRUE,NA,"0.1.4"
"10881","646",2022-12-23 08:00:00,1000,1006,6,136,TRUE,NA,"0.1.4"
"10882","646",2022-12-23 08:15:00,1000,1006,6,136,TRUE,NA,"0.1.4"
"10883","646",2022-12-23 08:30:00,1000,1006,6,136,TRUE,NA,"0.1.4"
"10884","646",2022-12-23 08:45:00,1000,1006,6,136,TRUE,NA,"0.1.4"
"10885","646",2022-12-23 09:00:00,1000,1006,6,136,TRUE,NA,"0.1.4"
"10886","646",2022-12-23 09:15:00,1000,1006,6,136,TRUE,NA,"0.1.4"
"10887","646",2022-12-23 09:30:00,1000,1006,6,136,TRUE,NA,"0.1.4"
"10888","646",2022-12-23 09:45:00,1000,1006,6,136,TRUE,NA,"0.1.4"
"10889","646",2022-12-23 10:00:00,1000,1006,6,136,TRUE,NA,"0.1.4"
"10890","646",2022-12-23 10:15:00,1000,1006,6,136,TRUE,NA,"0.1.4"
"10891","646",2022-12-23 10:30:00,1000,1006,6,136,TRUE,NA,"0.1.4"
"10892","646",2022-12-23 10:45:00,1000,1006,6,136,TRUE,NA,"0.1.4"
"10893","646",2022-12-23 11:00:00,1000,1006,6,136,TRUE,NA,"0.1.4"
"10894","646",2022-12-23 11:15:00,1000,1006,6,136,TRUE,NA,"0.1.4"
"10895","646",2022-12-23 11:30:00,1000,1006,6,136,TRUE,NA,"0.1.4"
"10896","646",2022-12-23 11:45:00,1000,1006,6,136,TRUE,NA,"0.1.4"
"10897","646",2022-12-23 12:00:00,1000,1006,6,136,TRUE,NA,"0.1.4"
"10898","646",2022-12-23 12:15:00,1000,1006,6,136,TRUE,NA,"0.1.4"
"10899","646",2022-12-23 12:30:00,1000,1006,6,136,TRUE,NA,"0.1.4"
"10900","646",2022-12-23 12:45:00,1000,1006,6,136,TRUE,NA,"0.1.4"
"10901","646",2022-12-23 13:00:00,1000,1006,6,136,TRUE,NA,"0.1.4"
"10902","646",2022-12-23 13:15:00,1000,1006,6,136,TRUE,NA,"0.1.4"
"10903","646",2022-12-23 13:30:00,1000,1006,6,136,TRUE,NA,"0.1.4"
"10904","646",2022-12-23 13:45:00,1000,1006,6,136,TRUE,NA,"0.1.4"
"10905","646",2022-12-23 14:00:00,1000,1006,6,136,TRUE,NA,"0.1.4"
"10906","646",2022-12-23 14:15:00,1000,1006,6,136,TRUE,NA,"0.1.4"
"10907","646",2022-12-23 14:30:00,1000,1006,6,136,TRUE,NA,"0.1.4"
"10908","646",2022-12-23 14:45:00,1000,1006,6,136,TRUE,NA,"0.1.4"
"10909","646",2022-12-23 15:00:00,1000,1006,6,136,TRUE,NA,"0.1.4"
"10910","646",2022-12-23 15:15:00,1000,1006,6,136,TRUE,NA,"0.1.4"
"10911","646",2022-12-23 15:30:00,1000,1006,6,136,TRUE,NA,"0.1.4"
"10912","646",2022-12-23 15:45:00,1000,1006,6,136,TRUE,NA,"0.1.4"
"10913","646",2022-12-23 16:00:00,1000,1006,6,136,TRUE,NA,"0.1.4"
"10914","646",2022-12-23 16:15:00,1000,1006,6,136,TRUE,NA,"0.1.4"
"10915","646",2022-12-23 16:30:00,1000,1006,6,136,TRUE,NA,"0.1.4"
"10916","646",2022-12-23 16:45:00,1000,1006,6,136,TRUE,NA,"0.1.4"
"10917","646",2022-12-23 17:00:00,1000,1006,6,136,TRUE,NA,"0.1.4"
"10918","646",2022-12-23 17:15:00,1000,1006,6,136,TRUE,NA,"0.1.4"
"10919","646",2022-12-23 17:30:00,1000,1006,6,136,TRUE,NA,"0.1.4"
"10920","646",2022-12-23 17:45:00,1000,1006,6,136,TRUE,NA,"0.1.4"
"10921","646",2022-12-23 18:00:00,1000,1006,6,136,TRUE,NA,"0.1.4"
"10922","646",2022-12-23 18:15:00,1000,1006,6,136,TRUE,NA,"0.1.4"
"10923","646",2022-12-23 18:30:00,1000,1006,6,136,TRUE,NA,"0.1.4"
"10924","646",2022-12-23 18:45:00,1000,1006,6,136,TRUE,NA,"0.1.4"
"10925","646",2022-12-23 19:00:00,1000,1006,6,136,TRUE,NA,"0.1.4"
"10926","646",2022-12-23 19:15:00,1000,1006,6,136,TRUE,NA,"0.1.4"
"10927","646",2022-12-23 19:30:00,1000,1006,6,136,TRUE,NA,"0.1.4"
"10928","646",2022-12-23 19:45:00,1000,1006,6,136,TRUE,NA,"0.1.4"
"10929","646",2022-12-23 20:00:00,1000,1006,6,136,TRUE,NA,"0.1.4"
"10930","646",2022-12-23 20:15:00,1000,1006,6,136,TRUE,NA,"0.1.4"
"10931","646",2022-12-23 20:30:00,1000,1006,6,136,TRUE,NA,"0.1.4"
"10932","646",2022-12-23 20:45:00,1000,1006,6,136,TRUE,NA,"0.1.4"
"10933","646",2022-12-23 21:00:00,1000,1006,6,136,TRUE,NA,"0.1.4"
"10934","646",2022-12-23 21:15:00,1000,1006,6,136,TRUE,NA,"0.1.4"
"10935","646",2022-12-23 21:30:00,1000,1006,6,136,TRUE,NA,"0.1.4"
"10936","646",2022-12-23 21:45:00,1000,1006,6,136,TRUE,NA,"0.1.4"
"10937","646",2022-12-23 22:00:00,1000,1006,6,136,TRUE,NA,"0.1.4"
"10938","646",2022-12-23 22:15:00,1000,1006,6,136,TRUE,NA,"0.1.4"
"10939","646",2022-12-23 22:30:00,1000,1006,6,136,TRUE,NA,"0.1.4"
"10940","646",2022-12-23 22:45:00,1000,1006,6,136,TRUE,NA,"0.1.4"
"10941","646",2022-12-23 23:00:00,1000,1006,6,136,TRUE,NA,"0.1.4"
"10942","646",2022-12-23 23:15:00,1000,1006,6,136,TRUE,NA,"0.1.4"
"10943","646",2022-12-23 23:30:00,1000,1006,6,136,TRUE,NA,"0.1.4"
"10944","646",2022-12-23 23:45:00,1000,1006,6,136,TRUE,NA,"0.1.4"
"10945","646",2022-12-24,1000,1006,6,136,TRUE,NA,"0.1.4"
"10946","646",2022-12-24 00:15:00,1000,1006,6,136,TRUE,NA,"0.1.4"
"10947","646",2022-12-24 00:30:00,1000,1006,6,136,TRUE,NA,"0.1.4"
"10948","646",2022-12-24 00:45:00,1000,1006,6,136,TRUE,NA,"0.1.4"
"10949","646",2022-12-24 01:00:00,1000,1006,6,136,TRUE,NA,"0.1.4"
"10950","646",2022-12-24 01:15:00,1000,1006,6,136,TRUE,NA,"0.1.4"
"10951","646",2022-12-24 01:30:00,1000,1006,6,136,TRUE,NA,"0.1.4"
"10952","646",2022-12-24 01:45:00,1000,1006,6,136,TRUE,NA,"0.1.4"
"10953","646",2022-12-24 02:00:00,1000,1006,6,136,TRUE,NA,"0.1.4"
"10954","646",2022-12-24 02:15:00,1000,1006,6,136,TRUE,NA,"0.1.4"
"10955","646",2022-12-24 02:30:00,1000,1006,6,136,TRUE,NA,"0.1.4"
"10956","646",2022-12-24 02:45:00,1000,1006,6,136,TRUE,NA,"0.1.4"
"10957","646",2022-12-24 03:00:00,1000,1006,6,136,TRUE,NA,"0.1.4"
"10958","646",2022-12-24 03:15:00,1000,1006,6,136,TRUE,NA,"0.1.4"
"10959","646",2022-12-24 03:30:00,1000,1006,6,136,TRUE,NA,"0.1.4"
"10960","646",2022-12-24 03:45:00,1000,1006,6,136,TRUE,NA,"0.1.4"
"10961","646",2022-12-24 04:00:00,1000,1006,6,136,TRUE,NA,"0.1.4"
"10962","646",2022-12-24 04:15:00,1000,1006,6,136,TRUE,NA,"0.1.4"
"10963","646",2022-12-24 04:30:00,1000,1006,6,136,TRUE,NA,"0.1.4"
"10964","646",2022-12-24 04:45:00,1000,1006,6,136,TRUE,NA,"0.1.4"
"10965","646",2022-12-24 05:00:00,1000,1006,6,136,TRUE,NA,"0.1.4"
"10966","646",2022-12-24 05:15:00,1000,1006,6,136,TRUE,NA,"0.1.4"
"10967","646",2022-12-24 05:30:00,1000,1006,6,136,TRUE,NA,"0.1.4"
"10968","646",2022-12-24 05:45:00,1000,1006,6,136,TRUE,NA,"0.1.4"
"10969","646",2022-12-24 06:00:00,1000,1006,6,136,TRUE,NA,"0.1.4"
"10970","646",2022-12-24 06:15:00,1000,1006,6,136,TRUE,NA,"0.1.4"
"10971","646",2022-12-24 06:30:00,1000,1006,6,136,TRUE,NA,"0.1.4"
"10972","646",2022-12-24 06:45:00,1000,1006,6,136,TRUE,NA,"0.1.4"
"10973","646",2022-12-24 07:00:00,1000,1006,6,136,TRUE,NA,"0.1.4"
"10974","646",2022-12-24 07:15:00,1000,1006,6,136,TRUE,NA,"0.1.4"
"10975","646",2022-12-24 07:30:00,1000,1006,6,136,TRUE,NA,"0.1.4"
"10976","646",2022-12-24 07:45:00,1000,1006,6,136,TRUE,NA,"0.1.4"
"10977","646",2022-12-24 08:00:00,1000,1006,6,136,TRUE,NA,"0.1.4"
"10978","646",2022-12-24 08:15:00,1000,1006,6,136,TRUE,NA,"0.1.4"
"10979","646",2022-12-24 08:30:00,1000,1006,6,136,TRUE,NA,"0.1.4"
"10980","646",2022-12-24 08:45:00,1000,1006,6,136,TRUE,NA,"0.1.4"
"10981","646",2022-12-24 09:00:00,1000,1006,6,136,TRUE,NA,"0.1.4"
"10982","646",2022-12-24 09:15:00,1000,1006,6,136,TRUE,NA,"0.1.4"
"10983","646",2022-12-24 09:30:00,1000,1006,6,136,TRUE,NA,"0.1.4"
"10984","646",2022-12-24 09:45:00,1000,1006,6,136,TRUE,NA,"0.1.4"
"10985","646",2022-12-24 10:00:00,1000,1006,6,136,TRUE,NA,"0.1.4"
"10986","646",2022-12-24 10:15:00,1000,1006,6,136,TRUE,NA,"0.1.4"
"10987","646",2022-12-24 10:30:00,1000,1006,6,136,TRUE,NA,"0.1.4"
"10988","646",2022-12-24 10:45:00,1000,1006,6,136,TRUE,NA,"0.1.4"
"10989","646",2022-12-24 11:00:00,1000,1006,6,136,TRUE,NA,"0.1.4"
"10990","646",2022-12-24 11:15:00,1000,1006,6,136,TRUE,NA,"0.1.4"
"10991","646",2022-12-24 11:30:00,1000,1006,6,136,TRUE,NA,"0.1.4"
"10992","646",2022-12-24 11:45:00,1000,1006,6,136,TRUE,NA,"0.1.4"
"10993","646",2022-12-24 12:00:00,1000,1006,6,136,TRUE,NA,"0.1.4"
"10994","646",2022-12-24 12:15:00,1000,1006,6,136,TRUE,NA,"0.1.4"
"10995","646",2022-12-24 12:30:00,1000,1006,6,136,TRUE,NA,"0.1.4"
"10996","646",2022-12-24 12:45:00,1000,1006,6,136,TRUE,NA,"0.1.4"
"10997","646",2022-12-24 13:00:00,1000,1006,6,136,TRUE,NA,"0.1.4"
"10998","646",2022-12-24 13:15:00,1000,1006,6,136,TRUE,NA,"0.1.4"
"10999","646",2022-12-24 13:30:00,1000,1006,6,136,TRUE,NA,"0.1.4"
"11000","646",2022-12-24 13:45:00,1000,1006,6,136,TRUE,NA,"0.1.4"
"11001","646",2022-12-24 14:00:00,1000,1006,6,136,TRUE,NA,"0.1.4"
"11002","646",2022-12-24 14:15:00,1000,1006,6,136,TRUE,NA,"0.1.4"
"11003","646",2022-12-24 14:30:00,1000,1006,6,136,TRUE,NA,"0.1.4"
"11004","646",2022-12-24 14:45:00,1000,1006,6,136,TRUE,NA,"0.1.4"
"11005","646",2022-12-24 15:00:00,1000,1006,6,136,TRUE,NA,"0.1.4"
"11006","646",2022-12-24 15:15:00,1000,1006,6,136,TRUE,NA,"0.1.4"
"11007","646",2022-12-24 15:30:00,1000,1006,6,136,TRUE,NA,"0.1.4"
"11008","646",2022-12-24 15:45:00,1000,1006,6,136,TRUE,NA,"0.1.4"
"11009","646",2022-12-24 16:00:00,1000,1006,6,136,TRUE,NA,"0.1.4"
"11010","646",2022-12-24 16:15:00,1000,1006,6,136,TRUE,NA,"0.1.4"
"11011","646",2022-12-24 16:30:00,1000,1006,6,136,TRUE,NA,"0.1.4"
"11012","646",2022-12-24 16:45:00,1000,1006,6,136,TRUE,NA,"0.1.4"
"11013","646",2022-12-24 17:00:00,1000,1006,6,136,TRUE,NA,"0.1.4"
"11014","646",2022-12-24 17:15:00,1000,1006,6,136,TRUE,NA,"0.1.4"
"11015","646",2022-12-24 17:30:00,1000,1006,6,136,TRUE,NA,"0.1.4"
"11016","646",2022-12-24 17:45:00,1000,1006,6,136,TRUE,NA,"0.1.4"
"11017","646",2022-12-24 18:00:00,1000,1006,6,136,TRUE,NA,"0.1.4"
"11018","646",2022-12-24 18:15:00,1000,1006,6,136,TRUE,NA,"0.1.4"
"11019","646",2022-12-24 18:30:00,1000,1006,6,136,TRUE,NA,"0.1.4"
"11020","646",2022-12-24 18:45:00,1000,1006,6,136,TRUE,NA,"0.1.4"
"11021","646",2022-12-24 19:00:00,1000,1006,6,136,TRUE,NA,"0.1.4"
"11022","646",2022-12-24 19:15:00,1000,1006,6,136,TRUE,NA,"0.1.4"
"11023","646",2022-12-24 19:30:00,1000,1006,6,136,TRUE,NA,"0.1.4"
"11024","646",2022-12-24 19:45:00,1000,1006,6,136,TRUE,NA,"0.1.4"
"11025","646",2022-12-24 20:00:00,1000,1006,6,136,TRUE,NA,"0.1.4"
"11026","646",2022-12-24 20:15:00,1000,1006,6,136,TRUE,NA,"0.1.4"
"11027","646",2022-12-24 20:30:00,1000,1006,6,136,TRUE,NA,"0.1.4"
"11028","646",2022-12-24 20:45:00,1000,1006,6,136,TRUE,NA,"0.1.4"
"11029","646",2022-12-24 21:00:00,1000,1006,6,136,TRUE,NA,"0.1.4"
"11030","646",2022-12-24 21:15:00,1000,1006,6,136,TRUE,NA,"0.1.4"
"11031","646",2022-12-24 21:30:00,1000,1006,6,136,TRUE,NA,"0.1.4"
"11032","646",2022-12-24 21:45:00,1000,1006,6,136,TRUE,NA,"0.1.4"
"11033","646",2022-12-24 22:00:00,1000,1006,6,136,TRUE,NA,"0.1.4"
"11034","646",2022-12-24 22:15:00,1000,1006,6,136,TRUE,NA,"0.1.4"
"11035","646",2022-12-24 22:30:00,1000,1006,6,136,TRUE,NA,"0.1.4"
"11036","646",2022-12-24 22:45:00,1000,1006,6,136,TRUE,NA,"0.1.4"
"11037","646",2022-12-24 23:00:00,1000,1006,6,136,TRUE,NA,"0.1.4"
"11038","646",2022-12-24 23:15:00,1000,1006,6,136,TRUE,NA,"0.1.4"
"11039","646",2022-12-24 23:30:00,1000,1006,6,136,TRUE,NA,"0.1.4"
"11040","646",2022-12-24 23:45:00,1000,1006,6,136,TRUE,NA,"0.1.4"
"11041","646",2022-12-25,1000,1006,6,136,TRUE,NA,"0.1.4"
"11042","646",2022-12-25 00:15:00,1000,1006,6,136,TRUE,NA,"0.1.4"
"11043","646",2022-12-25 00:30:00,1000,1006,6,136,TRUE,NA,"0.1.4"
"11044","646",2022-12-25 00:45:00,1000,1006,6,136,TRUE,NA,"0.1.4"
"11045","646",2022-12-25 01:00:00,1000,1006,6,136,TRUE,NA,"0.1.4"
"11046","646",2022-12-25 01:15:00,1000,1006,6,136,TRUE,NA,"0.1.4"
"11047","646",2022-12-25 01:30:00,1000,1006,6,136,TRUE,NA,"0.1.4"
"11048","646",2022-12-25 01:45:00,1000,1006,6,136,TRUE,NA,"0.1.4"
"11049","646",2022-12-25 02:00:00,1000,1006,6,136,TRUE,NA,"0.1.4"
"11050","646",2022-12-25 02:15:00,1000,1006,6,136,TRUE,NA,"0.1.4"
"11051","646",2022-12-25 02:30:00,1000,1006,6,136,TRUE,NA,"0.1.4"
"11052","646",2022-12-25 02:45:00,1000,1006,6,136,TRUE,NA,"0.1.4"
"11053","646",2022-12-25 03:00:00,1000,1006,6,136,TRUE,NA,"0.1.4"
"11054","646",2022-12-25 03:15:00,1000,1006,6,136,TRUE,NA,"0.1.4"
"11055","646",2022-12-25 03:30:00,1000,1006,6,136,TRUE,NA,"0.1.4"
"11056","646",2022-12-25 03:45:00,1000,1006,6,136,TRUE,NA,"0.1.4"
"11057","646",2022-12-25 04:00:00,1000,1006,6,136,TRUE,NA,"0.1.4"
"11058","646",2022-12-25 04:15:00,1000,1006,6,136,TRUE,NA,"0.1.4"
"11059","646",2022-12-25 04:30:00,1000,1006,6,136,TRUE,NA,"0.1.4"
"11060","646",2022-12-25 04:45:00,1000,1006,6,136,TRUE,NA,"0.1.4"
"11061","646",2022-12-25 05:00:00,1000,1006,6,136,TRUE,NA,"0.1.4"
"11062","646",2022-12-25 05:15:00,1000,1006,6,136,TRUE,NA,"0.1.4"
"11063","646",2022-12-25 05:30:00,1000,1006,6,136,TRUE,NA,"0.1.4"
"11064","646",2022-12-25 05:45:00,1000,1006,6,136,TRUE,NA,"0.1.4"
"11065","646",2022-12-25 06:00:00,1000,1006,6,136,TRUE,NA,"0.1.4"
"11066","646",2022-12-25 06:15:00,1000,1006,6,136,TRUE,NA,"0.1.4"
"11067","646",2022-12-25 06:30:00,1000,1006,6,136,TRUE,NA,"0.1.4"
"11068","646",2022-12-25 06:45:00,1000,1006,6,136,TRUE,NA,"0.1.4"
"11069","646",2022-12-25 07:00:00,1000,1006,6,136,TRUE,NA,"0.1.4"
"11070","646",2022-12-25 07:15:00,1000,1006,6,136,TRUE,NA,"0.1.4"
"11071","646",2022-12-25 07:30:00,1000,1006,6,136,TRUE,NA,"0.1.4"
"11072","646",2022-12-25 07:45:00,1000,1006,6,136,TRUE,NA,"0.1.4"
"11073","646",2022-12-25 08:00:00,1000,1006,6,136,TRUE,NA,"0.1.4"
"11074","646",2022-12-25 08:15:00,1000,1006,6,136,TRUE,NA,"0.1.4"
"11075","646",2022-12-25 08:30:00,1000,1006,6,136,TRUE,NA,"0.1.4"
"11076","646",2022-12-25 08:45:00,1000,1006,6,136,TRUE,NA,"0.1.4"
"11077","646",2022-12-25 09:00:00,1000,1006,6,136,TRUE,NA,"0.1.4"
"11078","646",2022-12-25 09:15:00,1000,1006,6,136,TRUE,NA,"0.1.4"
"11079","646",2022-12-25 09:30:00,1000,1006,6,136,TRUE,NA,"0.1.4"
"11080","646",2022-12-25 09:45:00,1000,1006,6,136,TRUE,NA,"0.1.4"
"11081","646",2022-12-25 10:00:00,1000,1006,6,136,TRUE,NA,"0.1.4"
"11082","646",2022-12-25 10:15:00,1000,1006,6,136,TRUE,NA,"0.1.4"
"11083","646",2022-12-25 10:30:00,1000,1006,6,136,TRUE,NA,"0.1.4"
"11084","646",2022-12-25 10:45:00,1000,1006,6,136,TRUE,NA,"0.1.4"
"11085","646",2022-12-25 11:00:00,1000,1006,6,136,TRUE,NA,"0.1.4"
"11086","646",2022-12-25 11:15:00,1000,1006,6,136,TRUE,NA,"0.1.4"
"11087","646",2022-12-25 11:30:00,1000,1006,6,136,TRUE,NA,"0.1.4"
"11088","646",2022-12-25 11:45:00,1000,1006,6,136,TRUE,NA,"0.1.4"
"11089","646",2022-12-25 12:00:00,1000,1006,6,136,TRUE,NA,"0.1.4"
"11090","646",2022-12-25 12:15:00,1000,1006,6,136,TRUE,NA,"0.1.4"
"11091","646",2022-12-25 12:30:00,1000,1006,6,136,TRUE,NA,"0.1.4"
"11092","646",2022-12-25 12:45:00,1000,1006,6,136,TRUE,NA,"0.1.4"
"11093","646",2022-12-25 13:00:00,1000,1006,6,136,TRUE,NA,"0.1.4"
"11094","646",2022-12-25 13:15:00,1000,1006,6,136,TRUE,NA,"0.1.4"
"11095","646",2022-12-25 13:30:00,1000,1006,6,136,TRUE,NA,"0.1.4"
"11096","646",2022-12-25 13:45:00,1000,1006,6,136,TRUE,NA,"0.1.4"
"11097","646",2022-12-25 14:00:00,1000,1006,6,136,TRUE,NA,"0.1.4"
"11098","646",2022-12-25 14:15:00,1000,1006,6,136,TRUE,NA,"0.1.4"
"11099","646",2022-12-25 14:30:00,1000,1006,6,136,TRUE,NA,"0.1.4"
"11100","646",2022-12-25 14:45:00,1000,1006,6,136,TRUE,NA,"0.1.4"
"11101","646",2022-12-25 15:00:00,1000,1006,6,136,TRUE,NA,"0.1.4"
"11102","646",2022-12-25 15:15:00,1000,1006,6,136,TRUE,NA,"0.1.4"
"11103","646",2022-12-25 15:30:00,1000,1006,6,136,TRUE,NA,"0.1.4"
"11104","646",2022-12-25 15:45:00,1000,1006,6,136,TRUE,NA,"0.1.4"
"11105","646",2022-12-25 16:00:00,1000,1006,6,136,TRUE,NA,"0.1.4"
"11106","646",2022-12-25 16:15:00,1000,1006,6,136,TRUE,NA,"0.1.4"
"11107","646",2022-12-25 16:30:00,1000,1006,6,136,TRUE,NA,"0.1.4"
"11108","646",2022-12-25 16:45:00,1000,1006,6,136,TRUE,NA,"0.1.4"
"11109","646",2022-12-25 17:00:00,1000,1006,6,136,TRUE,NA,"0.1.4"
"11110","646",2022-12-25 17:15:00,1000,1006,6,136,TRUE,NA,"0.1.4"
"11111","646",2022-12-25 17:30:00,1000,1006,6,136,TRUE,NA,"0.1.4"
"11112","646",2022-12-25 17:45:00,1000,1006,6,136,TRUE,NA,"0.1.4"
"11113","646",2022-12-25 18:00:00,1000,1006,6,136,TRUE,NA,"0.1.4"
"11114","646",2022-12-25 18:15:00,1000,1006,6,136,TRUE,NA,"0.1.4"
"11115","646",2022-12-25 18:30:00,1000,1006,6,136,TRUE,NA,"0.1.4"
"11116","646",2022-12-25 18:45:00,1000,1006,6,136,TRUE,NA,"0.1.4"
"11117","646",2022-12-25 19:00:00,1000,1006,6,136,TRUE,NA,"0.1.4"
"11118","646",2022-12-25 19:15:00,1000,1006,6,136,TRUE,NA,"0.1.4"
"11119","646",2022-12-25 19:30:00,1000,1006,6,136,TRUE,NA,"0.1.4"
"11120","646",2022-12-25 19:45:00,1000,1006,6,136,TRUE,NA,"0.1.4"
"11121","646",2022-12-25 20:00:00,1000,1006,6,136,TRUE,NA,"0.1.4"
"11122","646",2022-12-25 20:15:00,1000,1006,6,136,TRUE,NA,"0.1.4"
"11123","646",2022-12-25 20:30:00,1000,1006,6,136,TRUE,NA,"0.1.4"
"11124","646",2022-12-25 20:45:00,1000,1006,6,136,TRUE,NA,"0.1.4"
"11125","646",2022-12-25 21:00:00,1000,1006,6,136,TRUE,NA,"0.1.4"
"11126","646",2022-12-25 21:15:00,1000,1006,6,136,TRUE,NA,"0.1.4"
"11127","646",2022-12-25 21:30:00,1000,1006,6,136,TRUE,NA,"0.1.4"
"11128","646",2022-12-25 21:45:00,1000,1006,6,136,TRUE,NA,"0.1.4"
"11129","646",2022-12-25 22:00:00,1000,1006,6,136,TRUE,NA,"0.1.4"
"11130","646",2022-12-25 22:15:00,1000,1006,6,136,TRUE,NA,"0.1.4"
"11131","646",2022-12-25 22:30:00,1000,1006,6,136,TRUE,NA,"0.1.4"
"11132","646",2022-12-25 22:45:00,1000,1006,6,136,TRUE,NA,"0.1.4"
"11133","646",2022-12-25 23:00:00,1000,1006,6,136,TRUE,NA,"0.1.4"
"11134","646",2022-12-25 23:15:00,1000,1006,6,136,TRUE,NA,"0.1.4"
"11135","646",2022-12-25 23:30:00,1000,1006,6,136,TRUE,NA,"0.1.4"
"11136","646",2022-12-25 23:45:00,1000,1006,6,136,TRUE,NA,"0.1.4"
"11137","646",2022-12-26,1000,1006,6,136,TRUE,NA,"0.1.4"
"11138","646",2022-12-26 00:15:00,1000,1006,6,136,TRUE,NA,"0.1.4"
"11139","646",2022-12-26 00:30:00,1000,1006,6,136,TRUE,NA,"0.1.4"
"11140","646",2022-12-26 00:45:00,1000,1006,6,136,TRUE,NA,"0.1.4"
"11141","646",2022-12-26 01:00:00,1000,1006,6,136,TRUE,NA,"0.1.4"
"11142","646",2022-12-26 01:15:00,1000,1006,6,136,TRUE,NA,"0.1.4"
"11143","646",2022-12-26 01:30:00,1000,1006,6,136,TRUE,NA,"0.1.4"
"11144","646",2022-12-26 01:45:00,1000,1006,6,136,TRUE,NA,"0.1.4"
"11145","646",2022-12-26 02:00:00,1000,1006,6,136,TRUE,NA,"0.1.4"
"11146","646",2022-12-26 02:15:00,1000,1006,6,136,TRUE,NA,"0.1.4"
"11147","646",2022-12-26 02:30:00,1000,1006,6,136,TRUE,NA,"0.1.4"
"11148","646",2022-12-26 02:45:00,1000,1006,6,136,TRUE,NA,"0.1.4"
"11149","646",2022-12-26 03:00:00,1000,1006,6,136,TRUE,NA,"0.1.4"
"11150","646",2022-12-26 03:15:00,1000,1006,6,136,TRUE,NA,"0.1.4"
"11151","646",2022-12-26 03:30:00,1000,1006,6,136,TRUE,NA,"0.1.4"
"11152","646",2022-12-26 03:45:00,1000,1006,6,136,TRUE,NA,"0.1.4"
"11153","646",2022-12-26 04:00:00,1000,1006,6,136,TRUE,NA,"0.1.4"
"11154","646",2022-12-26 04:15:00,1000,1006,6,136,TRUE,NA,"0.1.4"
"11155","646",2022-12-26 04:30:00,1000,1006,6,136,TRUE,NA,"0.1.4"
"11156","646",2022-12-26 04:45:00,1000,1006,6,136,TRUE,NA,"0.1.4"
"11157","646",2022-12-26 05:00:00,1000,1006,6,136,TRUE,NA,"0.1.4"
"11158","646",2022-12-26 05:15:00,1000,1006,6,136,TRUE,NA,"0.1.4"
"11159","646",2022-12-26 05:30:00,1000,1006,6,136,TRUE,NA,"0.1.4"
"11160","646",2022-12-26 05:45:00,1000,1006,6,136,TRUE,NA,"0.1.4"
"11161","646",2022-12-26 06:00:00,1000,1006,6,136,TRUE,NA,"0.1.4"
"11162","646",2022-12-26 06:15:00,1000,1006,6,136,TRUE,NA,"0.1.4"
"11163","646",2022-12-26 06:30:00,1000,1006,6,136,TRUE,NA,"0.1.4"
"11164","646",2022-12-26 06:45:00,1000,1006,6,136,TRUE,NA,"0.1.4"
"11165","646",2022-12-26 07:00:00,1000,1006,6,136,TRUE,NA,"0.1.4"
"11166","646",2022-12-26 07:15:00,1000,1006,6,136,TRUE,NA,"0.1.4"
"11167","646",2022-12-26 07:30:00,1000,1006,6,136,TRUE,NA,"0.1.4"
"11168","646",2022-12-26 07:45:00,1000,1006,6,136,TRUE,NA,"0.1.4"
"11169","646",2022-12-26 08:00:00,1000,1006,6,136,TRUE,NA,"0.1.4"
"11170","646",2022-12-26 08:15:00,1000,1006,6,136,TRUE,NA,"0.1.4"
"11171","646",2022-12-26 08:30:00,1000,1006,6,136,TRUE,NA,"0.1.4"
"11172","646",2022-12-26 08:45:00,1000,1006,6,136,TRUE,NA,"0.1.4"
"11173","646",2022-12-26 09:00:00,1000,1006,6,136,TRUE,NA,"0.1.4"
"11174","646",2022-12-26 09:15:00,1000,1006,6,136,TRUE,NA,"0.1.4"
"11175","646",2022-12-26 09:30:00,1000,1006,6,136,TRUE,NA,"0.1.4"
"11176","646",2022-12-26 09:45:00,1000,1006,6,136,TRUE,NA,"0.1.4"
"11177","646",2022-12-26 10:00:00,1000,1006,6,136,TRUE,NA,"0.1.4"
"11178","646",2022-12-26 10:15:00,1000,1006,6,136,TRUE,NA,"0.1.4"
"11179","646",2022-12-26 10:30:00,1000,1006,6,136,TRUE,NA,"0.1.4"
"11180","646",2022-12-26 10:45:00,1000,1006,6,136,TRUE,NA,"0.1.4"
"11181","646",2022-12-26 11:00:00,1000,1006,6,136,TRUE,NA,"0.1.4"
"11182","646",2022-12-26 11:15:00,1000,1006,6,136,TRUE,NA,"0.1.4"
"11183","646",2022-12-26 11:30:00,1000,1006,6,136,TRUE,NA,"0.1.4"
"11184","646",2022-12-26 11:45:00,1000,1006,6,136,TRUE,NA,"0.1.4"
"11185","646",2022-12-26 12:00:00,1000,1006,6,136,TRUE,NA,"0.1.4"
"11186","646",2022-12-26 12:15:00,1000,1006,6,136,TRUE,NA,"0.1.4"
"11187","646",2022-12-26 12:30:00,1000,1006,6,136,TRUE,NA,"0.1.4"
"11188","646",2022-12-26 12:45:00,1000,1006,6,136,TRUE,NA,"0.1.4"
"11189","646",2022-12-26 13:00:00,1000,1006,6,136,TRUE,NA,"0.1.4"
"11190","646",2022-12-26 13:15:00,1000,1006,6,136,TRUE,NA,"0.1.4"
"11191","646",2022-12-26 13:30:00,1000,1006,6,136,TRUE,NA,"0.1.4"
"11192","646",2022-12-26 13:45:00,1000,1006,6,136,TRUE,NA,"0.1.4"
"11193","646",2022-12-26 14:00:00,1000,1006,6,136,TRUE,NA,"0.1.4"
"11194","646",2022-12-26 14:15:00,1000,1006,6,136,TRUE,NA,"0.1.4"
"11195","646",2022-12-26 14:30:00,1000,1006,6,136,TRUE,NA,"0.1.4"
"11196","646",2022-12-26 14:45:00,1000,1006,6,136,TRUE,NA,"0.1.4"
"11197","646",2022-12-26 15:00:00,1000,1006,6,136,TRUE,NA,"0.1.4"
"11198","646",2022-12-26 15:15:00,1000,1006,6,136,TRUE,NA,"0.1.4"
"11199","646",2022-12-26 15:30:00,1000,1006,6,136,TRUE,NA,"0.1.4"
"11200","646",2022-12-26 15:45:00,1000,1006,6,136,TRUE,NA,"0.1.4"
"11201","646",2022-12-26 16:00:00,1000,1006,6,136,TRUE,NA,"0.1.4"
"11202","646",2022-12-26 16:15:00,1000,1006,6,136,TRUE,NA,"0.1.4"
"11203","646",2022-12-26 16:30:00,1000,1006,6,136,TRUE,NA,"0.1.4"
"11204","646",2022-12-26 16:45:00,1000,1006,6,136,TRUE,NA,"0.1.4"
"11205","646",2022-12-26 17:00:00,1000,1006,6,136,TRUE,NA,"0.1.4"
"11206","646",2022-12-26 17:15:00,1000,1006,6,136,TRUE,NA,"0.1.4"
"11207","646",2022-12-26 17:30:00,1000,1006,6,136,TRUE,NA,"0.1.4"
"11208","646",2022-12-26 17:45:00,1000,1006,6,136,TRUE,NA,"0.1.4"
"11209","646",2022-12-26 18:00:00,1000,1006,6,136,TRUE,NA,"0.1.4"
"11210","646",2022-12-26 18:15:00,1000,1006,6,136,TRUE,NA,"0.1.4"
"11211","646",2022-12-26 18:30:00,1000,1006,6,136,TRUE,NA,"0.1.4"
"11212","646",2022-12-26 18:45:00,1000,1006,6,136,TRUE,NA,"0.1.4"
"11213","646",2022-12-26 19:00:00,1000,1006,6,136,TRUE,NA,"0.1.4"
"11214","646",2022-12-26 19:15:00,1000,1006,6,136,TRUE,NA,"0.1.4"
"11215","646",2022-12-26 19:30:00,1000,1006,6,136,TRUE,NA,"0.1.4"
"11216","646",2022-12-26 19:45:00,1000,1006,6,136,TRUE,NA,"0.1.4"
"11217","646",2022-12-26 20:00:00,1000,1006,6,136,TRUE,NA,"0.1.4"
"11218","646",2022-12-26 20:15:00,1000,1006,6,136,TRUE,NA,"0.1.4"
"11219","646",2022-12-26 20:30:00,1000,1006,6,136,TRUE,NA,"0.1.4"
"11220","646",2022-12-26 20:45:00,1000,1006,6,136,TRUE,NA,"0.1.4"
"11221","646",2022-12-26 21:00:00,1000,1006,6,136,TRUE,NA,"0.1.4"
"11222","646",2022-12-26 21:15:00,1000,1006,6,136,TRUE,NA,"0.1.4"
"11223","646",2022-12-26 21:30:00,1000,1006,6,136,TRUE,NA,"0.1.4"
"11224","646",2022-12-26 21:45:00,1000,1006,6,136,TRUE,NA,"0.1.4"
"11225","646",2022-12-26 22:00:00,1000,1006,6,136,TRUE,NA,"0.1.4"
"11226","646",2022-12-26 22:15:00,1000,1006,6,136,TRUE,NA,"0.1.4"
"11227","646",2022-12-26 22:30:00,1000,1006,6,136,TRUE,NA,"0.1.4"
"11228","646",2022-12-26 22:45:00,1000,1006,6,136,TRUE,NA,"0.1.4"
"11229","646",2022-12-26 23:00:00,1000,1006,6,136,TRUE,NA,"0.1.4"
"11230","646",2022-12-26 23:15:00,1000,1006,6,136,TRUE,NA,"0.1.4"
"11231","646",2022-12-26 23:30:00,1000,1006,6,136,TRUE,NA,"0.1.4"
"11232","646",2022-12-26 23:45:00,1000,1006,6,136,TRUE,NA,"0.1.4"
"11233","646",2022-12-27,1000,1006,6,136,TRUE,NA,"0.1.4"
"11234","646",2022-12-27 00:15:00,1000,1006,6,136,TRUE,NA,"0.1.4"
"11235","646",2022-12-27 00:30:00,1000,1006,6,136,TRUE,NA,"0.1.4"
"11236","646",2022-12-27 00:45:00,1000,1006,6,136,TRUE,NA,"0.1.4"
"11237","646",2022-12-27 01:00:00,1000,1006,6,136,TRUE,NA,"0.1.4"
"11238","646",2022-12-27 01:15:00,1000,1006,6,136,TRUE,NA,"0.1.4"
"11239","646",2022-12-27 01:30:00,1000,1006,6,136,TRUE,NA,"0.1.4"
"11240","646",2022-12-27 01:45:00,1000,1006,6,136,TRUE,NA,"0.1.4"
"11241","646",2022-12-27 02:00:00,1000,1006,6,136,TRUE,NA,"0.1.4"
"11242","646",2022-12-27 02:15:00,1000,1006,6,136,TRUE,NA,"0.1.4"
"11243","646",2022-12-27 02:30:00,1000,1006,6,136,TRUE,NA,"0.1.4"
"11244","646",2022-12-27 02:45:00,1000,1006,6,136,TRUE,NA,"0.1.4"
"11245","646",2022-12-27 03:00:00,1000,1006,6,136,TRUE,NA,"0.1.4"
"11246","646",2022-12-27 03:15:00,1000,1006,6,136,TRUE,NA,"0.1.4"
"11247","646",2022-12-27 03:30:00,1000,1006,6,136,TRUE,NA,"0.1.4"
"11248","646",2022-12-27 03:45:00,1000,1006,6,136,TRUE,NA,"0.1.4"
"11249","646",2022-12-27 04:00:00,1000,1006,6,136,TRUE,NA,"0.1.4"
"11250","646",2022-12-27 04:15:00,1000,1006,6,136,TRUE,NA,"0.1.4"
"11251","646",2022-12-27 04:30:00,1000,1006,6,136,TRUE,NA,"0.1.4"
"11252","646",2022-12-27 04:45:00,1000,1006,6,136,TRUE,NA,"0.1.4"
"11253","646",2022-12-27 05:00:00,1000,1006,6,136,TRUE,NA,"0.1.4"
"11254","646",2022-12-27 05:15:00,1000,1006,6,136,TRUE,NA,"0.1.4"
"11255","646",2022-12-27 05:30:00,1000,1006,6,136,TRUE,NA,"0.1.4"
"11256","646",2022-12-27 05:45:00,1000,1006,6,136,TRUE,NA,"0.1.4"
"11257","646",2022-12-27 06:00:00,1000,1006,6,136,TRUE,NA,"0.1.4"
"11258","646",2022-12-27 06:15:00,1000,1006,6,136,TRUE,NA,"0.1.4"
"11259","646",2022-12-27 06:30:00,1000,1006,6,136,TRUE,NA,"0.1.4"
"11260","646",2022-12-27 06:45:00,1000,1006,6,136,TRUE,NA,"0.1.4"
"11261","646",2022-12-27 07:00:00,1000,1006,6,136,TRUE,NA,"0.1.4"
"11262","646",2022-12-27 07:15:00,1000,1006,6,136,TRUE,NA,"0.1.4"
"11263","646",2022-12-27 07:30:00,1000,1006,6,136,TRUE,NA,"0.1.4"
"11264","646",2022-12-27 07:45:00,1000,1006,6,136,TRUE,NA,"0.1.4"
"11265","646",2022-12-27 08:00:00,1000,1006,6,136,TRUE,NA,"0.1.4"
"11266","646",2022-12-27 08:15:00,1000,1006,6,136,FALSE,NA,"0.1.4"
"11267","646",2022-12-27 08:30:00,1000,1006,6,136,FALSE,NA,"0.1.4"
"11268","646",2022-12-27 08:45:00,1000,1006,6,136,FALSE,NA,"0.1.4"
"11269","646",2022-12-27 09:00:00,1000,1006,6,136,FALSE,NA,"0.1.4"
"11270","646",2022-12-27 09:15:00,1000,1006,6,136,FALSE,NA,"0.1.4"
"11271","646",2022-12-27 09:30:00,1000,1006,6,136,FALSE,NA,"0.1.4"
"11272","646",2022-12-27 09:45:00,1000,1006,6,136,FALSE,NA,"0.1.4"
"11273","646",2022-12-27 10:00:00,1000,1006,6,136,FALSE,NA,"0.1.4"
"11274","646",2022-12-27 10:15:00,1000,1006,6,136,FALSE,NA,"0.1.4"
"11275","646",2022-12-27 10:30:00,1000,1006,6,136,FALSE,NA,"0.1.4"
"11276","646",2022-12-27 10:45:00,1000,1006,6,136,FALSE,NA,"0.1.4"
"11277","646",2022-12-27 11:00:00,1000,1006,6,136,FALSE,NA,"0.1.4"
"11278","646",2022-12-27 11:15:00,1000,1006,6,136,FALSE,NA,"0.1.4"
"11279","646",2022-12-27 11:30:00,1000,1006,6,136,FALSE,NA,"0.1.4"
"11280","646",2022-12-27 11:45:00,1000,1006,6,136,FALSE,NA,"0.1.4"
"11281","646",2022-12-27 12:00:00,1000,1006,6,136,FALSE,NA,"0.1.4"
"11282","646",2022-12-27 12:15:00,1000,1006,6,136,FALSE,NA,"0.1.4"
"11283","646",2022-12-27 12:30:00,1000,1006,6,136,FALSE,NA,"0.1.4"
"11284","646",2022-12-27 12:45:00,1000,1006,6,136,FALSE,NA,"0.1.4"
"11285","646",2022-12-27 13:00:00,1000,1006,6,136,FALSE,NA,"0.1.4"
"11286","646",2022-12-27 13:15:00,1000,1006,6,136,FALSE,NA,"0.1.4"
"11287","646",2022-12-27 13:30:00,1000,1006,6,136,FALSE,NA,"0.1.4"
"11288","646",2022-12-27 13:45:00,1000,1006,6,136,FALSE,NA,"0.1.4"
"11289","646",2022-12-27 14:00:00,1000,1006,6,136,FALSE,NA,"0.1.4"
"11290","646",2022-12-27 14:15:00,1000,1006,6,136,FALSE,NA,"0.1.4"
"11291","646",2022-12-27 14:30:00,1000,1006,6,136,FALSE,NA,"0.1.4"
"11292","646",2022-12-27 14:45:00,1000,1006,6,136,FALSE,NA,"0.1.4"
"11293","646",2022-12-27 15:00:00,1000,1006,6,136,FALSE,NA,"0.1.4"
"11294","646",2022-12-27 15:15:00,1000,1006,6,136,FALSE,NA,"0.1.4"
"11295","646",2022-12-27 15:30:00,1000,1006,6,136,FALSE,NA,"0.1.4"
"11296","646",2022-12-27 15:45:00,1000,1006,6,136,FALSE,NA,"0.1.4"
"11297","646",2022-12-27 16:00:00,1000,1006,6,136,FALSE,NA,"0.1.4"
"11298","646",2022-12-27 16:15:00,1000,1006,6,136,FALSE,NA,"0.1.4"
"11299","646",2022-12-27 16:30:00,1000,1006,6,136,FALSE,NA,"0.1.4"
"11300","646",2022-12-27 16:45:00,1000,1006,6,136,FALSE,NA,"0.1.4"
"11301","646",2022-12-27 17:00:00,1000,1006,6,136,FALSE,NA,"0.1.4"
"11302","646",2022-12-27 17:15:00,1000,1006,6,136,FALSE,NA,"0.1.4"
"11303","646",2022-12-27 17:30:00,1000,1006,6,136,FALSE,NA,"0.1.4"
"11304","646",2022-12-27 17:45:00,1000,1006,6,136,FALSE,NA,"0.1.4"
"11305","646",2022-12-27 18:00:00,1000,1006,6,136,FALSE,NA,"0.1.4"
"11306","646",2022-12-27 18:15:00,1000,1006,6,136,FALSE,NA,"0.1.4"
"11307","646",2022-12-27 18:30:00,1000,1006,6,136,FALSE,NA,"0.1.4"
"11308","646",2022-12-27 18:45:00,1000,1006,6,136,FALSE,NA,"0.1.4"
"11309","646",2022-12-27 19:00:00,1000,1006,6,136,FALSE,NA,"0.1.4"
"11310","646",2022-12-27 19:15:00,1000,1006,6,136,FALSE,NA,"0.1.4"
"11311","646",2022-12-27 19:30:00,999,1006,7,136,FALSE,NA,"0.1.4"
"11312","646",2022-12-27 19:45:00,1000,1006,6,136,FALSE,NA,"0.1.4"
"11313","646",2022-12-27 20:00:00,1000,1006,6,136,FALSE,NA,"0.1.4"
"11314","646",2022-12-27 20:15:00,999,1006,7,136,FALSE,NA,"0.1.4"
"11315","646",2022-12-27 20:30:00,999,1006,7,136,FALSE,NA,"0.1.4"
"11316","646",2022-12-27 20:45:00,999,1006,7,136,FALSE,NA,"0.1.4"
"11317","646",2022-12-27 21:00:00,1000,1006,6,136,FALSE,NA,"0.1.4"
"11318","646",2022-12-27 21:15:00,1000,1006,6,136,FALSE,NA,"0.1.4"
"11319","646",2022-12-27 21:30:00,1000,1006,6,136,TRUE,NA,"0.1.4"
"11320","646",2022-12-27 21:45:00,1000,1006,6,136,TRUE,NA,"0.1.4"
"11321","646",2022-12-27 22:00:00,1000,1006,6,136,TRUE,NA,"0.1.4"
"11322","646",2022-12-27 22:15:00,1000,1006,6,136,TRUE,NA,"0.1.4"
"11323","646",2022-12-27 22:30:00,1000,1006,6,136,TRUE,NA,"0.1.4"
"11324","646",2022-12-27 22:45:00,1000,1006,6,136,TRUE,NA,"0.1.4"
"11325","646",2022-12-27 23:00:00,1000,1006,6,136,TRUE,NA,"0.1.4"
"11326","646",2022-12-27 23:15:00,1000,1006,6,136,TRUE,NA,"0.1.4"
"11327","646",2022-12-27 23:30:00,1000,1006,6,136,TRUE,NA,"0.1.4"
"11328","646",2022-12-27 23:45:00,1000,1006,6,136,TRUE,NA,"0.1.4"
"11329","646",2022-12-28,1000,1006,6,136,TRUE,NA,"0.1.4"
"11330","646",2022-12-28 00:15:00,1000,1006,6,136,TRUE,NA,"0.1.4"
"11331","646",2022-12-28 00:30:00,1000,1006,6,136,TRUE,NA,"0.1.4"
"11332","646",2022-12-28 00:45:00,1000,1006,6,136,TRUE,NA,"0.1.4"
"11333","646",2022-12-28 01:00:00,1000,1006,6,136,TRUE,NA,"0.1.4"
"11334","646",2022-12-28 01:15:00,1000,1006,6,136,TRUE,NA,"0.1.4"
"11335","646",2022-12-28 01:30:00,1000,1006,6,136,TRUE,NA,"0.1.4"
"11336","646",2022-12-28 01:45:00,1000,1006,6,136,TRUE,NA,"0.1.4"
"11337","646",2022-12-28 02:00:00,1000,1006,6,136,TRUE,NA,"0.1.4"
"11338","646",2022-12-28 02:15:00,1000,1006,6,136,TRUE,NA,"0.1.4"
"11339","646",2022-12-28 02:30:00,1000,1006,6,136,TRUE,NA,"0.1.4"
"11340","646",2022-12-28 02:45:00,1000,1006,6,136,TRUE,NA,"0.1.4"
"11341","646",2022-12-28 03:00:00,1000,1006,6,136,TRUE,NA,"0.1.4"
"11342","646",2022-12-28 03:15:00,1000,1006,6,136,TRUE,NA,"0.1.4"
"11343","646",2022-12-28 03:30:00,1000,1006,6,136,TRUE,NA,"0.1.4"
"11344","646",2022-12-28 03:45:00,1000,1006,6,136,TRUE,NA,"0.1.4"
"11345","646",2022-12-28 04:00:00,1000,1006,6,136,TRUE,NA,"0.1.4"
"11346","646",2022-12-28 04:15:00,1000,1006,6,136,TRUE,NA,"0.1.4"
"11347","646",2022-12-28 04:30:00,1000,1006,6,136,TRUE,NA,"0.1.4"
"11348","646",2022-12-28 04:45:00,1000,1006,6,136,TRUE,NA,"0.1.4"
"11349","646",2022-12-28 05:00:00,1000,1006,6,136,TRUE,NA,"0.1.4"
"11350","646",2022-12-28 05:15:00,1000,1006,6,136,TRUE,NA,"0.1.4"
"11351","646",2022-12-28 05:30:00,1000,1006,6,136,TRUE,NA,"0.1.4"
"11352","646",2022-12-28 05:45:00,1000,1006,6,136,TRUE,NA,"0.1.4"
"11353","646",2022-12-28 06:00:00,1000,1006,6,136,TRUE,NA,"0.1.4"
"11354","646",2022-12-28 06:15:00,1000,1006,6,136,TRUE,NA,"0.1.4"
"11355","646",2022-12-28 06:30:00,1000,1006,6,136,TRUE,NA,"0.1.4"
"11356","646",2022-12-28 06:45:00,1000,1006,6,136,TRUE,NA,"0.1.4"
"11357","646",2022-12-28 07:00:00,1000,1006,6,136,TRUE,NA,"0.1.4"
"11358","646",2022-12-28 07:15:00,1000,1006,6,136,TRUE,NA,"0.1.4"
"11359","646",2022-12-28 07:30:00,1000,1006,6,136,TRUE,NA,"0.1.4"
"11360","646",2022-12-28 07:45:00,1000,1006,6,136,TRUE,NA,"0.1.4"
"11361","646",2022-12-28 08:00:00,1000,1006,6,136,TRUE,NA,"0.1.4"
"11362","646",2022-12-28 08:15:00,1000,1006,6,136,TRUE,NA,"0.1.4"
"11363","646",2022-12-28 08:30:00,1000,1006,6,136,TRUE,NA,"0.1.4"
"11364","646",2022-12-28 08:45:00,1000,1006,6,136,TRUE,NA,"0.1.4"
"11365","646",2022-12-28 09:00:00,1000,1006,6,136,TRUE,NA,"0.1.4"
"11366","646",2022-12-28 09:15:00,1000,1006,6,136,TRUE,NA,"0.1.4"
"11367","646",2022-12-28 09:30:00,1000,1006,6,136,TRUE,NA,"0.1.4"
"11368","646",2022-12-28 09:45:00,1000,1006,6,136,TRUE,NA,"0.1.4"
"11369","646",2022-12-28 10:00:00,1000,1006,6,136,TRUE,NA,"0.1.4"
"11370","646",2022-12-28 10:15:00,1000,1006,6,136,TRUE,NA,"0.1.4"
"11371","646",2022-12-28 10:30:00,1000,1006,6,136,TRUE,NA,"0.1.4"
"11372","646",2022-12-28 10:45:00,1000,1006,6,136,TRUE,NA,"0.1.4"
"11373","646",2022-12-28 11:00:00,1000,1006,6,136,TRUE,NA,"0.1.4"
"11374","646",2022-12-28 11:15:00,1000,1006,6,136,TRUE,NA,"0.1.4"
"11375","646",2022-12-28 11:30:00,1000,1006,6,136,TRUE,NA,"0.1.4"
"11376","646",2022-12-28 11:45:00,1000,1006,6,136,TRUE,NA,"0.1.4"
"11377","646",2022-12-28 12:00:00,1000,1006,6,136,TRUE,NA,"0.1.4"
"11378","646",2022-12-28 12:15:00,1000,1006,6,136,TRUE,NA,"0.1.4"
"11379","646",2022-12-28 12:30:00,1000,1006,6,136,TRUE,NA,"0.1.4"
"11380","646",2022-12-28 12:45:00,1000,1006,6,136,TRUE,NA,"0.1.4"
"11381","646",2022-12-28 13:00:00,1000,1006,6,136,TRUE,NA,"0.1.4"
"11382","646",2022-12-28 13:15:00,1000,1006,6,136,TRUE,NA,"0.1.4"
"11383","646",2022-12-28 13:30:00,1000,1006,6,136,TRUE,NA,"0.1.4"
"11384","646",2022-12-28 13:45:00,1000,1006,6,136,TRUE,NA,"0.1.4"
"11385","646",2022-12-28 14:00:00,1000,1006,6,136,TRUE,NA,"0.1.4"
"11386","646",2022-12-28 14:15:00,1000,1006,6,136,TRUE,NA,"0.1.4"
"11387","646",2022-12-28 14:30:00,1000,1006,6,136,TRUE,NA,"0.1.4"
"11388","646",2022-12-28 14:45:00,1000,1006,6,136,TRUE,NA,"0.1.4"
"11389","646",2022-12-28 15:00:00,1000,1006,6,136,TRUE,NA,"0.1.4"
"11390","646",2022-12-28 15:15:00,1000,1006,6,136,TRUE,NA,"0.1.4"
"11391","646",2022-12-28 15:30:00,1000,1006,6,136,TRUE,NA,"0.1.4"
"11392","646",2022-12-28 15:45:00,1000,1006,6,136,TRUE,NA,"0.1.4"
"11393","646",2022-12-28 16:00:00,1000,1006,6,136,TRUE,NA,"0.1.4"
"11394","646",2022-12-28 16:15:00,1000,1006,6,136,TRUE,NA,"0.1.4"
"11395","646",2022-12-28 16:30:00,1000,1006,6,136,TRUE,NA,"0.1.4"
"11396","646",2022-12-28 16:45:00,1000,1006,6,136,TRUE,NA,"0.1.4"
"11397","646",2022-12-28 17:00:00,1000,1006,6,136,TRUE,NA,"0.1.4"
"11398","646",2022-12-28 17:15:00,1000,1006,6,136,TRUE,NA,"0.1.4"
"11399","646",2022-12-28 17:30:00,1000,1006,6,136,TRUE,NA,"0.1.4"
"11400","646",2022-12-28 17:45:00,1000,1006,6,136,TRUE,NA,"0.1.4"
"11401","646",2022-12-28 18:00:00,1000,1006,6,136,TRUE,NA,"0.1.4"
"11402","646",2022-12-28 18:15:00,1000,1006,6,136,TRUE,NA,"0.1.4"
"11403","646",2022-12-28 18:30:00,1000,1006,6,136,TRUE,NA,"0.1.4"
"11404","646",2022-12-28 18:45:00,1000,1006,6,136,TRUE,NA,"0.1.4"
"11405","646",2022-12-28 19:00:00,1000,1006,6,136,TRUE,NA,"0.1.4"
"11406","646",2022-12-28 19:15:00,1000,1006,6,136,TRUE,NA,"0.1.4"
"11407","646",2022-12-28 19:30:00,1000,1006,6,136,TRUE,NA,"0.1.4"
"11408","646",2022-12-28 19:45:00,1000,1006,6,136,TRUE,NA,"0.1.4"
"11409","646",2022-12-28 20:00:00,1000,1006,6,136,TRUE,NA,"0.1.4"
"11410","646",2022-12-28 20:15:00,1000,1006,6,136,TRUE,NA,"0.1.4"
"11411","646",2022-12-28 20:30:00,1000,1006,6,136,TRUE,NA,"0.1.4"
"11412","646",2022-12-28 20:45:00,1000,1006,6,136,TRUE,NA,"0.1.4"
"11413","646",2022-12-28 21:00:00,1000,1006,6,136,TRUE,NA,"0.1.4"
"11414","646",2022-12-28 21:15:00,1000,1006,6,136,TRUE,NA,"0.1.4"
"11415","646",2022-12-28 21:30:00,1000,1006,6,136,TRUE,NA,"0.1.4"
"11416","646",2022-12-28 21:45:00,1000,1006,6,136,TRUE,NA,"0.1.4"
"11417","646",2022-12-28 22:00:00,1000,1006,6,136,TRUE,NA,"0.1.4"
"11418","646",2022-12-28 22:15:00,1000,1006,6,136,TRUE,NA,"0.1.4"
"11419","646",2022-12-28 22:30:00,1000,1006,6,136,TRUE,NA,"0.1.4"
"11420","646",2022-12-28 22:45:00,1000,1006,6,136,TRUE,NA,"0.1.4"
"11421","646",2022-12-28 23:00:00,1000,1006,6,136,TRUE,NA,"0.1.4"
"11422","646",2022-12-28 23:15:00,1000,1006,6,136,TRUE,NA,"0.1.4"
"11423","646",2022-12-28 23:30:00,1000,1006,6,136,TRUE,NA,"0.1.4"
"11424","646",2022-12-28 23:45:00,1000,1006,6,136,TRUE,NA,"0.1.4"
"11425","646",2022-12-29,1000,1006,6,136,TRUE,NA,"0.1.4"
"11426","646",2022-12-29 00:15:00,1000,1006,6,136,TRUE,NA,"0.1.4"
"11427","646",2022-12-29 00:30:00,1000,1006,6,136,TRUE,NA,"0.1.4"
"11428","646",2022-12-29 00:45:00,1000,1006,6,136,TRUE,NA,"0.1.4"
"11429","646",2022-12-29 01:00:00,1000,1006,6,136,TRUE,NA,"0.1.4"
"11430","646",2022-12-29 01:15:00,1000,1006,6,136,TRUE,NA,"0.1.4"
"11431","646",2022-12-29 01:30:00,1000,1006,6,136,TRUE,NA,"0.1.4"
"11432","646",2022-12-29 01:45:00,1000,1006,6,136,TRUE,NA,"0.1.4"
"11433","646",2022-12-29 02:00:00,1000,1006,6,136,TRUE,NA,"0.1.4"
"11434","646",2022-12-29 02:15:00,1000,1006,6,136,TRUE,NA,"0.1.4"
"11435","646",2022-12-29 02:30:00,1000,1006,6,136,TRUE,NA,"0.1.4"
"11436","646",2022-12-29 02:45:00,1000,1006,6,136,TRUE,NA,"0.1.4"
"11437","646",2022-12-29 03:00:00,1000,1006,6,136,TRUE,NA,"0.1.4"
"11438","646",2022-12-29 03:15:00,1000,1006,6,136,TRUE,NA,"0.1.4"
"11439","646",2022-12-29 03:30:00,1000,1006,6,136,TRUE,NA,"0.1.4"
"11440","646",2022-12-29 03:45:00,1000,1006,6,136,TRUE,NA,"0.1.4"
"11441","646",2022-12-29 04:00:00,1000,1006,6,136,TRUE,NA,"0.1.4"
"11442","646",2022-12-29 04:15:00,1000,1006,6,136,TRUE,NA,"0.1.4"
"11443","646",2022-12-29 04:30:00,1000,1006,6,136,TRUE,NA,"0.1.4"
"11444","646",2022-12-29 04:45:00,1000,1006,6,136,TRUE,NA,"0.1.4"
"11445","646",2022-12-29 05:00:00,1000,1006,6,136,TRUE,NA,"0.1.4"
"11446","646",2022-12-29 05:15:00,1000,1006,6,136,TRUE,NA,"0.1.4"
"11447","646",2022-12-29 05:30:00,1000,1006,6,136,TRUE,NA,"0.1.4"
"11448","646",2022-12-29 05:45:00,1000,1006,6,136,TRUE,NA,"0.1.4"
"11449","646",2022-12-29 06:00:00,1000,1006,6,136,TRUE,NA,"0.1.4"
"11450","646",2022-12-29 06:15:00,1000,1006,6,136,TRUE,NA,"0.1.4"
"11451","646",2022-12-29 06:30:00,1000,1006,6,136,TRUE,NA,"0.1.4"
"11452","646",2022-12-29 06:45:00,1000,1006,6,136,TRUE,NA,"0.1.4"
"11453","646",2022-12-29 07:00:00,1000,1006,6,136,TRUE,NA,"0.1.4"
"11454","646",2022-12-29 07:15:00,1000,1006,6,136,TRUE,NA,"0.1.4"
"11455","646",2022-12-29 07:30:00,1000,1006,6,136,TRUE,NA,"0.1.4"
"11456","646",2022-12-29 07:45:00,1000,1006,6,136,TRUE,NA,"0.1.4"
"11457","646",2022-12-29 08:00:00,1000,1006,6,136,TRUE,NA,"0.1.4"
"11458","646",2022-12-29 08:15:00,1000,1006,6,136,TRUE,NA,"0.1.4"
"11459","646",2022-12-29 08:30:00,1000,1006,6,136,TRUE,NA,"0.1.4"
"11460","646",2022-12-29 08:45:00,1000,1006,6,136,TRUE,NA,"0.1.4"
"11461","646",2022-12-29 09:00:00,1000,1006,6,136,TRUE,NA,"0.1.4"
"11462","646",2022-12-29 09:15:00,1000,1006,6,136,TRUE,NA,"0.1.4"
"11463","646",2022-12-29 09:30:00,1000,1006,6,136,TRUE,NA,"0.1.4"
"11464","646",2022-12-29 09:45:00,1000,1006,6,136,TRUE,NA,"0.1.4"
"11465","646",2022-12-29 10:00:00,1000,1006,6,136,TRUE,NA,"0.1.4"
"11466","646",2022-12-29 10:15:00,1000,1006,6,136,TRUE,NA,"0.1.4"
"11467","646",2022-12-29 10:30:00,1000,1006,6,136,TRUE,NA,"0.1.4"
"11468","646",2022-12-29 10:45:00,1000,1006,6,136,TRUE,NA,"0.1.4"
"11469","646",2022-12-29 11:00:00,1000,1006,6,136,TRUE,NA,"0.1.4"
"11470","646",2022-12-29 11:15:00,1000,1006,6,136,TRUE,NA,"0.1.4"
"11471","646",2022-12-29 11:30:00,1000,1006,6,136,TRUE,NA,"0.1.4"
"11472","646",2022-12-29 11:45:00,1000,1006,6,136,TRUE,NA,"0.1.4"
"11473","646",2022-12-29 12:00:00,1000,1006,6,136,TRUE,NA,"0.1.4"
"11474","646",2022-12-29 12:15:00,1000,1006,6,136,TRUE,NA,"0.1.4"
"11475","646",2022-12-29 12:30:00,1000,1006,6,136,TRUE,NA,"0.1.4"
"11476","646",2022-12-29 12:45:00,1000,1006,6,136,TRUE,NA,"0.1.4"
"11477","646",2022-12-29 13:00:00,1000,1006,6,136,TRUE,NA,"0.1.4"
"11478","646",2022-12-29 13:15:00,1000,1006,6,136,TRUE,NA,"0.1.4"
"11479","646",2022-12-29 13:30:00,1000,1006,6,136,TRUE,NA,"0.1.4"
"11480","646",2022-12-29 13:45:00,1000,1006,6,136,TRUE,NA,"0.1.4"
"11481","646",2022-12-29 14:00:00,1000,1006,6,136,TRUE,NA,"0.1.4"
"11482","646",2022-12-29 14:15:00,1000,1006,6,136,TRUE,NA,"0.1.4"
"11483","646",2022-12-29 14:30:00,1000,1006,6,136,TRUE,NA,"0.1.4"
"11484","646",2022-12-29 14:45:00,1000,1006,6,136,TRUE,NA,"0.1.4"
"11485","646",2022-12-29 15:00:00,1000,1006,6,136,TRUE,NA,"0.1.4"
"11486","646",2022-12-29 15:15:00,1000,1006,6,136,TRUE,NA,"0.1.4"
"11487","646",2022-12-29 15:30:00,1000,1006,6,136,TRUE,NA,"0.1.4"
"11488","646",2022-12-29 15:45:00,1000,1006,6,136,TRUE,NA,"0.1.4"
"11489","646",2022-12-29 16:00:00,1000,1006,6,136,TRUE,NA,"0.1.4"
"11490","646",2022-12-29 16:15:00,1000,1006,6,136,TRUE,NA,"0.1.4"
"11491","646",2022-12-29 16:30:00,1000,1006,6,136,TRUE,NA,"0.1.4"
"11492","646",2022-12-29 16:45:00,1000,1006,6,136,TRUE,NA,"0.1.4"
"11493","646",2022-12-29 17:00:00,1000,1006,6,136,TRUE,NA,"0.1.4"
"11494","646",2022-12-29 17:15:00,1000,1006,6,136,TRUE,NA,"0.1.4"
"11495","646",2022-12-29 17:30:00,1000,1006,6,136,TRUE,NA,"0.1.4"
"11496","646",2022-12-29 17:45:00,1000,1006,6,136,TRUE,NA,"0.1.4"
"11497","646",2022-12-29 18:00:00,1000,1006,6,136,TRUE,NA,"0.1.4"
"11498","646",2022-12-29 18:15:00,1000,1006,6,136,TRUE,NA,"0.1.4"
"11499","646",2022-12-29 18:30:00,1000,1006,6,136,TRUE,NA,"0.1.4"
"11500","646",2022-12-29 18:45:00,1000,1006,6,136,TRUE,NA,"0.1.4"
"11501","646",2022-12-29 19:00:00,1000,1006,6,136,TRUE,NA,"0.1.4"
"11502","646",2022-12-29 19:15:00,1000,1006,6,136,TRUE,NA,"0.1.4"
"11503","646",2022-12-29 19:30:00,1000,1006,6,136,TRUE,NA,"0.1.4"
"11504","646",2022-12-29 19:45:00,1000,1006,6,136,TRUE,NA,"0.1.4"
"11505","646",2022-12-29 20:00:00,1000,1006,6,136,TRUE,NA,"0.1.4"
"11506","646",2022-12-29 20:15:00,1000,1006,6,136,TRUE,NA,"0.1.4"
"11507","646",2022-12-29 20:30:00,1000,1006,6,136,TRUE,NA,"0.1.4"
"11508","646",2022-12-29 20:45:00,1000,1006,6,136,TRUE,NA,"0.1.4"
"11509","646",2022-12-29 21:00:00,1000,1006,6,136,TRUE,NA,"0.1.4"
"11510","646",2022-12-29 21:15:00,1000,1006,6,136,TRUE,NA,"0.1.4"
"11511","646",2022-12-29 21:30:00,1000,1006,6,136,TRUE,NA,"0.1.4"
"11512","646",2022-12-29 21:45:00,1000,1006,6,136,TRUE,NA,"0.1.4"
"11513","646",2022-12-29 22:00:00,1000,1006,6,136,TRUE,NA,"0.1.4"
"11514","646",2022-12-29 22:15:00,1000,1006,6,136,TRUE,NA,"0.1.4"
"11515","646",2022-12-29 22:30:00,1000,1006,6,136,TRUE,NA,"0.1.4"
"11516","646",2022-12-29 22:45:00,1000,1006,6,136,TRUE,NA,"0.1.4"
"11517","646",2022-12-29 23:00:00,1000,1006,6,136,TRUE,NA,"0.1.4"
"11518","646",2022-12-29 23:15:00,1000,1006,6,136,TRUE,NA,"0.1.4"
"11519","646",2022-12-29 23:30:00,1000,1006,6,136,TRUE,NA,"0.1.4"
"11520","646",2022-12-29 23:45:00,1000,1006,6,136,TRUE,NA,"0.1.4"
"11521","646",2022-12-30,1000,1006,6,136,TRUE,NA,"0.1.4"
"11522","646",2022-12-30 00:15:00,1000,1006,6,136,TRUE,NA,"0.1.4"
"11523","646",2022-12-30 00:30:00,1000,1006,6,136,TRUE,NA,"0.1.4"
"11524","646",2022-12-30 00:45:00,1000,1006,6,136,TRUE,NA,"0.1.4"
"11525","646",2022-12-30 01:00:00,1000,1006,6,136,TRUE,NA,"0.1.4"
"11526","646",2022-12-30 01:15:00,1000,1006,6,136,TRUE,NA,"0.1.4"
"11527","646",2022-12-30 01:30:00,1000,1006,6,136,TRUE,NA,"0.1.4"
"11528","646",2022-12-30 01:45:00,1000,1006,6,136,TRUE,NA,"0.1.4"
"11529","646",2022-12-30 02:00:00,1000,1006,6,136,TRUE,NA,"0.1.4"
"11530","646",2022-12-30 02:15:00,1000,1006,6,136,TRUE,NA,"0.1.4"
"11531","646",2022-12-30 02:30:00,1000,1006,6,136,TRUE,NA,"0.1.4"
"11532","646",2022-12-30 02:45:00,1000,1006,6,136,TRUE,NA,"0.1.4"
"11533","646",2022-12-30 03:00:00,1000,1006,6,136,TRUE,NA,"0.1.4"
"11534","646",2022-12-30 03:15:00,1000,1006,6,136,TRUE,NA,"0.1.4"
"11535","646",2022-12-30 03:30:00,1000,1006,6,136,TRUE,NA,"0.1.4"
"11536","646",2022-12-30 03:45:00,1000,1006,6,136,TRUE,NA,"0.1.4"
"11537","646",2022-12-30 04:00:00,1000,1006,6,136,TRUE,NA,"0.1.4"
"11538","646",2022-12-30 04:15:00,1000,1006,6,136,TRUE,NA,"0.1.4"
"11539","646",2022-12-30 04:30:00,1000,1006,6,136,TRUE,NA,"0.1.4"
"11540","646",2022-12-30 04:45:00,1000,1006,6,136,TRUE,NA,"0.1.4"
"11541","646",2022-12-30 05:00:00,1000,1006,6,136,TRUE,NA,"0.1.4"
"11542","646",2022-12-30 05:15:00,1000,1006,6,136,TRUE,NA,"0.1.4"
"11543","646",2022-12-30 05:30:00,1000,1006,6,136,TRUE,NA,"0.1.4"
"11544","646",2022-12-30 05:45:00,1000,1006,6,136,TRUE,NA,"0.1.4"
"11545","646",2022-12-30 06:00:00,1000,1006,6,136,TRUE,NA,"0.1.4"
"11546","646",2022-12-30 06:15:00,1000,1006,6,136,TRUE,NA,"0.1.4"
"11547","646",2022-12-30 06:30:00,1000,1006,6,136,TRUE,NA,"0.1.4"
"11548","646",2022-12-30 06:45:00,1000,1006,6,136,TRUE,NA,"0.1.4"
"11549","646",2022-12-30 07:00:00,1000,1006,6,136,TRUE,NA,"0.1.4"
"11550","646",2022-12-30 07:15:00,1000,1006,6,136,TRUE,NA,"0.1.4"
"11551","646",2022-12-30 07:30:00,1000,1006,6,136,TRUE,NA,"0.1.4"
"11552","646",2022-12-30 07:45:00,1000,1006,6,136,TRUE,NA,"0.1.4"
"11553","646",2022-12-30 08:00:00,1000,1006,6,136,TRUE,NA,"0.1.4"
"11554","646",2022-12-30 08:15:00,1000,1006,6,136,TRUE,NA,"0.1.4"
"11555","646",2022-12-30 08:30:00,1000,1006,6,136,TRUE,NA,"0.1.4"
"11556","646",2022-12-30 08:45:00,1000,1006,6,136,TRUE,NA,"0.1.4"
"11557","646",2022-12-30 09:00:00,1000,1006,6,136,TRUE,NA,"0.1.4"
"11558","646",2022-12-30 09:15:00,1000,1006,6,136,TRUE,NA,"0.1.4"
"11559","646",2022-12-30 09:30:00,1000,1006,6,136,TRUE,NA,"0.1.4"
"11560","646",2022-12-30 09:45:00,1000,1006,6,136,TRUE,NA,"0.1.4"
"11561","646",2022-12-30 10:00:00,1000,1006,6,136,TRUE,NA,"0.1.4"
"11562","646",2022-12-30 10:15:00,1000,1006,6,136,TRUE,NA,"0.1.4"
"11563","646",2022-12-30 10:30:00,1000,1006,6,136,TRUE,NA,"0.1.4"
"11564","646",2022-12-30 10:45:00,1000,1006,6,136,TRUE,NA,"0.1.4"
"11565","646",2022-12-30 11:00:00,1000,1006,6,136,TRUE,NA,"0.1.4"
"11566","646",2022-12-30 11:15:00,1000,1006,6,136,TRUE,NA,"0.1.4"
"11567","646",2022-12-30 11:30:00,1000,1006,6,136,TRUE,NA,"0.1.4"
"11568","646",2022-12-30 11:45:00,1000,1006,6,136,TRUE,NA,"0.1.4"
"11569","646",2022-12-30 12:00:00,1000,1006,6,136,TRUE,NA,"0.1.4"
"11570","646",2022-12-30 12:15:00,1000,1006,6,136,TRUE,NA,"0.1.4"
"11571","646",2022-12-30 12:30:00,1000,1006,6,136,TRUE,NA,"0.1.4"
"11572","646",2022-12-30 12:45:00,1000,1006,6,136,TRUE,NA,"0.1.4"
"11573","646",2022-12-30 13:00:00,1000,1006,6,136,TRUE,NA,"0.1.4"
"11574","646",2022-12-30 13:15:00,1000,1006,6,136,TRUE,NA,"0.1.4"
"11575","646",2022-12-30 13:30:00,1000,1006,6,136,TRUE,NA,"0.1.4"
"11576","646",2022-12-30 13:45:00,1000,1006,6,136,TRUE,NA,"0.1.4"
"11577","646",2022-12-30 14:00:00,1000,1006,6,136,TRUE,NA,"0.1.4"
"11578","646",2022-12-30 14:15:00,1000,1006,6,136,TRUE,NA,"0.1.4"
"11579","646",2022-12-30 14:30:00,1000,1006,6,136,TRUE,NA,"0.1.4"
"11580","646",2022-12-30 14:45:00,1000,1006,6,136,TRUE,NA,"0.1.4"
"11581","646",2022-12-30 15:00:00,1000,1006,6,136,TRUE,NA,"0.1.4"
"11582","646",2022-12-30 15:15:00,1000,1006,6,136,TRUE,NA,"0.1.4"
"11583","646",2022-12-30 15:30:00,1000,1006,6,136,TRUE,NA,"0.1.4"
"11584","646",2022-12-30 15:45:00,1000,1006,6,136,TRUE,NA,"0.1.4"
"11585","646",2022-12-30 16:00:00,1000,1006,6,136,TRUE,NA,"0.1.4"
"11586","646",2022-12-30 16:15:00,1000,1006,6,136,TRUE,NA,"0.1.4"
"11587","646",2022-12-30 16:30:00,1000,1006,6,136,TRUE,NA,"0.1.4"
"11588","646",2022-12-30 16:45:00,1000,1006,6,136,TRUE,NA,"0.1.4"
"11589","646",2022-12-30 17:00:00,1000,1006,6,136,TRUE,NA,"0.1.4"
"11590","646",2022-12-30 17:15:00,1000,1006,6,136,TRUE,NA,"0.1.4"
"11591","646",2022-12-30 17:30:00,1000,1006,6,136,TRUE,NA,"0.1.4"
"11592","646",2022-12-30 17:45:00,1000,1006,6,136,TRUE,NA,"0.1.4"
"11593","646",2022-12-30 18:00:00,1000,1006,6,136,TRUE,NA,"0.1.4"
"11594","646",2022-12-30 18:15:00,1000,1006,6,136,TRUE,NA,"0.1.4"
"11595","646",2022-12-30 18:30:00,1000,1006,6,136,TRUE,NA,"0.1.4"
"11596","646",2022-12-30 18:45:00,1000,1006,6,136,TRUE,NA,"0.1.4"
"11597","646",2022-12-30 19:00:00,1000,1006,6,136,TRUE,NA,"0.1.4"
"11598","646",2022-12-30 19:15:00,1000,1006,6,136,TRUE,NA,"0.1.4"
"11599","646",2022-12-30 19:30:00,1000,1006,6,136,TRUE,NA,"0.1.4"
"11600","646",2022-12-30 19:45:00,1000,1006,6,136,TRUE,NA,"0.1.4"
"11601","646",2022-12-30 20:00:00,1000,1006,6,136,TRUE,NA,"0.1.4"
"11602","646",2022-12-30 20:15:00,1000,1006,6,136,TRUE,NA,"0.1.4"
"11603","646",2022-12-30 20:30:00,1000,1006,6,136,TRUE,NA,"0.1.4"
"11604","646",2022-12-30 20:45:00,1000,1006,6,136,TRUE,NA,"0.1.4"
"11605","646",2022-12-30 21:00:00,1000,1006,6,136,TRUE,NA,"0.1.4"
"11606","646",2022-12-30 21:15:00,1000,1006,6,136,TRUE,NA,"0.1.4"
"11607","646",2022-12-30 21:30:00,1000,1006,6,136,TRUE,NA,"0.1.4"
"11608","646",2022-12-30 21:45:00,1000,1006,6,136,TRUE,NA,"0.1.4"
"11609","646",2022-12-30 22:00:00,1000,1006,6,136,TRUE,NA,"0.1.4"
"11610","646",2022-12-30 22:15:00,1000,1006,6,136,TRUE,NA,"0.1.4"
"11611","646",2022-12-30 22:30:00,1000,1006,6,136,TRUE,NA,"0.1.4"
"11612","646",2022-12-30 22:45:00,1000,1006,6,136,TRUE,NA,"0.1.4"
"11613","646",2022-12-30 23:00:00,1000,1006,6,136,TRUE,NA,"0.1.4"
"11614","646",2022-12-30 23:15:00,1000,1006,6,136,TRUE,NA,"0.1.4"
"11615","646",2022-12-30 23:30:00,1000,1006,6,136,TRUE,NA,"0.1.4"
"11616","646",2022-12-30 23:45:00,1000,1006,6,136,TRUE,NA,"0.1.4"
"11617","646",2022-12-31,1000,1006,6,136,TRUE,NA,"0.1.4"
"11618","646",2022-12-31 00:15:00,1000,1006,6,136,TRUE,NA,"0.1.4"
"11619","646",2022-12-31 00:30:00,1000,1006,6,136,TRUE,NA,"0.1.4"
"11620","646",2022-12-31 00:45:00,1000,1006,6,136,TRUE,NA,"0.1.4"
"11621","646",2022-12-31 01:00:00,1000,1006,6,136,TRUE,NA,"0.1.4"
"11622","646",2022-12-31 01:15:00,1000,1006,6,136,TRUE,NA,"0.1.4"
"11623","646",2022-12-31 01:30:00,1000,1006,6,136,TRUE,NA,"0.1.4"
"11624","646",2022-12-31 01:45:00,1000,1006,6,136,TRUE,NA,"0.1.4"
"11625","646",2022-12-31 02:00:00,1000,1006,6,136,TRUE,NA,"0.1.4"
"11626","646",2022-12-31 02:15:00,1000,1006,6,136,TRUE,NA,"0.1.4"
"11627","646",2022-12-31 02:30:00,1000,1006,6,136,TRUE,NA,"0.1.4"
"11628","646",2022-12-31 02:45:00,1000,1006,6,136,TRUE,NA,"0.1.4"
"11629","646",2022-12-31 03:00:00,1000,1006,6,136,TRUE,NA,"0.1.4"
"11630","646",2022-12-31 03:15:00,1000,1006,6,136,TRUE,NA,"0.1.4"
"11631","646",2022-12-31 03:30:00,1000,1006,6,136,TRUE,NA,"0.1.4"
"11632","646",2022-12-31 03:45:00,1000,1006,6,136,TRUE,NA,"0.1.4"
"11633","646",2022-12-31 04:00:00,1000,1006,6,136,TRUE,NA,"0.1.4"
"11634","646",2022-12-31 04:15:00,1000,1006,6,136,TRUE,NA,"0.1.4"
"11635","646",2022-12-31 04:30:00,1000,1006,6,136,TRUE,NA,"0.1.4"
"11636","646",2022-12-31 04:45:00,1000,1006,6,136,TRUE,NA,"0.1.4"
"11637","646",2022-12-31 05:00:00,1000,1006,6,136,TRUE,NA,"0.1.4"
"11638","646",2022-12-31 05:15:00,1000,1006,6,136,TRUE,NA,"0.1.4"
"11639","646",2022-12-31 05:30:00,1000,1006,6,136,TRUE,NA,"0.1.4"
"11640","646",2022-12-31 05:45:00,1000,1006,6,136,TRUE,NA,"0.1.4"
"11641","646",2022-12-31 06:00:00,1000,1006,6,136,TRUE,NA,"0.1.4"
"11642","646",2022-12-31 06:15:00,1000,1006,6,136,TRUE,NA,"0.1.4"
"11643","646",2022-12-31 06:30:00,1000,1006,6,136,TRUE,NA,"0.1.4"
"11644","646",2022-12-31 06:45:00,1000,1006,6,136,TRUE,NA,"0.1.4"
"11645","646",2022-12-31 07:00:00,1000,1006,6,136,TRUE,NA,"0.1.4"
"11646","646",2022-12-31 07:15:00,1000,1006,6,136,TRUE,NA,"0.1.4"
"11647","646",2022-12-31 07:30:00,1000,1006,6,136,TRUE,NA,"0.1.4"
"11648","646",2022-12-31 07:45:00,1000,1006,6,136,TRUE,NA,"0.1.4"
"11649","646",2022-12-31 08:00:00,1000,1006,6,136,TRUE,NA,"0.1.4"
"11650","646",2022-12-31 08:15:00,1000,1006,6,136,TRUE,NA,"0.1.4"
"11651","646",2022-12-31 08:30:00,1000,1006,6,136,TRUE,NA,"0.1.4"
"11652","646",2022-12-31 08:45:00,1000,1006,6,136,TRUE,NA,"0.1.4"
"11653","646",2022-12-31 09:00:00,1000,1006,6,136,TRUE,NA,"0.1.4"
"11654","646",2022-12-31 09:15:00,1000,1006,6,136,TRUE,NA,"0.1.4"
"11655","646",2022-12-31 09:30:00,1000,1006,6,136,TRUE,NA,"0.1.4"
"11656","646",2022-12-31 09:45:00,1000,1006,6,136,TRUE,NA,"0.1.4"
"11657","646",2022-12-31 10:00:00,1000,1006,6,136,TRUE,NA,"0.1.4"
"11658","646",2022-12-31 10:15:00,1000,1006,6,136,TRUE,NA,"0.1.4"
"11659","646",2022-12-31 10:30:00,1000,1006,6,136,TRUE,NA,"0.1.4"
"11660","646",2022-12-31 10:45:00,1000,1006,6,136,TRUE,NA,"0.1.4"
"11661","646",2022-12-31 11:00:00,1000,1006,6,136,TRUE,NA,"0.1.4"
"11662","646",2022-12-31 11:15:00,1000,1006,6,136,TRUE,NA,"0.1.4"
"11663","646",2022-12-31 11:30:00,1000,1006,6,136,TRUE,NA,"0.1.4"
"11664","646",2022-12-31 11:45:00,1000,1006,6,136,TRUE,NA,"0.1.4"
"11665","646",2022-12-31 12:00:00,1000,1006,6,136,TRUE,NA,"0.1.4"
"11666","646",2022-12-31 12:15:00,1000,1006,6,136,TRUE,NA,"0.1.4"
"11667","646",2022-12-31 12:30:00,1000,1006,6,136,TRUE,NA,"0.1.4"
"11668","646",2022-12-31 12:45:00,1000,1006,6,136,TRUE,NA,"0.1.4"
"11669","646",2022-12-31 13:00:00,1000,1006,6,136,TRUE,NA,"0.1.4"
"11670","646",2022-12-31 13:15:00,1000,1006,6,136,TRUE,NA,"0.1.4"
"11671","646",2022-12-31 13:30:00,1000,1006,6,136,TRUE,NA,"0.1.4"
"11672","646",2022-12-31 13:45:00,1000,1006,6,136,TRUE,NA,"0.1.4"
"11673","646",2022-12-31 14:00:00,1000,1006,6,136,TRUE,NA,"0.1.4"
"11674","646",2022-12-31 14:15:00,1000,1006,6,136,TRUE,NA,"0.1.4"
"11675","646",2022-12-31 14:30:00,1000,1006,6,136,TRUE,NA,"0.1.4"
"11676","646",2022-12-31 14:45:00,1000,1006,6,136,TRUE,NA,"0.1.4"
"11677","646",2022-12-31 15:00:00,1000,1006,6,136,TRUE,NA,"0.1.4"
"11678","646",2022-12-31 15:15:00,1000,1006,6,136,TRUE,NA,"0.1.4"
"11679","646",2022-12-31 15:30:00,1000,1006,6,136,TRUE,NA,"0.1.4"
"11680","646",2022-12-31 15:45:00,1000,1006,6,136,TRUE,NA,"0.1.4"
"11681","646",2022-12-31 16:00:00,1000,1006,6,136,TRUE,NA,"0.1.4"
"11682","646",2022-12-31 16:15:00,1000,1006,6,136,TRUE,NA,"0.1.4"
"11683","646",2022-12-31 16:30:00,1000,1006,6,136,TRUE,NA,"0.1.4"
"11684","646",2022-12-31 16:45:00,1000,1006,6,136,TRUE,NA,"0.1.4"
"11685","646",2022-12-31 17:00:00,1000,1006,6,136,TRUE,NA,"0.1.4"
"11686","646",2022-12-31 17:15:00,1000,1006,6,136,TRUE,NA,"0.1.4"
"11687","646",2022-12-31 17:30:00,1000,1006,6,136,TRUE,NA,"0.1.4"
"11688","646",2022-12-31 17:45:00,1000,1006,6,136,TRUE,NA,"0.1.4"
"11689","646",2022-12-31 18:00:00,1000,1006,6,136,TRUE,NA,"0.1.4"
"11690","646",2022-12-31 18:15:00,1000,1006,6,136,TRUE,NA,"0.1.4"
"11691","646",2022-12-31 18:30:00,1000,1006,6,136,TRUE,NA,"0.1.4"
"11692","646",2022-12-31 18:45:00,1000,1006,6,136,TRUE,NA,"0.1.4"
"11693","646",2022-12-31 19:00:00,1000,1006,6,136,TRUE,NA,"0.1.4"
"11694","646",2022-12-31 19:15:00,1000,1006,6,136,TRUE,NA,"0.1.4"
"11695","646",2022-12-31 19:30:00,1000,1006,6,136,TRUE,NA,"0.1.4"
"11696","646",2022-12-31 19:45:00,1000,1006,6,136,TRUE,NA,"0.1.4"
"11697","646",2022-12-31 20:00:00,1000,1006,6,136,TRUE,NA,"0.1.4"
"11698","646",2022-12-31 20:15:00,1000,1006,6,136,TRUE,NA,"0.1.4"
"11699","646",2022-12-31 20:30:00,1000,1006,6,136,TRUE,NA,"0.1.4"
"11700","646",2022-12-31 20:45:00,1000,1006,6,136,TRUE,NA,"0.1.4"
"11701","646",2022-12-31 21:00:00,1000,1006,6,136,TRUE,NA,"0.1.4"
"11702","646",2022-12-31 21:15:00,1000,1006,6,136,FALSE,NA,"0.1.4"
"11703","646",2022-12-31 21:30:00,1000,1006,6,136,FALSE,NA,"0.1.4"
"11704","646",2022-12-31 21:45:00,1000,1006,6,136,FALSE,NA,"0.1.4"
"11705","646",2022-12-31 22:00:00,1000,1006,6,136,FALSE,NA,"0.1.4"
"11706","646",2022-12-31 22:15:00,1000,1006,6,136,FALSE,NA,"0.1.4"
"11707","646",2022-12-31 22:30:00,1000,1006,6,136,FALSE,NA,"0.1.4"
"11708","646",2022-12-31 22:45:00,1000,1006,6,136,FALSE,NA,"0.1.4"
"11709","646",2022-12-31 23:00:00,1000,1006,6,136,FALSE,NA,"0.1.4"
"11710","646",2022-12-31 23:15:00,1000,1006,6,136,FALSE,NA,"0.1.4"
"11711","646",2022-12-31 23:30:00,1000,1006,6,136,FALSE,NA,"0.1.4"
"11712","646",2022-12-31 23:45:00,1000,1006,6,136,FALSE,NA,"0.1.4"
"11713","646",2023-01-01,1000,1006,6,0,FALSE,NA,"0.1.4"
"11714","646",2023-01-01 00:15:00,1000,1006,6,0,FALSE,NA,"0.1.4"
"11715","646",2023-01-01 00:30:00,1000,1006,6,0,TRUE,NA,"0.1.4"
"11716","646",2023-01-01 00:45:00,1000,1006,6,0,TRUE,NA,"0.1.4"
"11717","646",2023-01-01 01:00:00,1000,1006,6,0,TRUE,NA,"0.1.4"
"11718","646",2023-01-01 01:15:00,1000,1006,6,0,TRUE,NA,"0.1.4"
"11719","646",2023-01-01 01:30:00,1000,1006,6,0,TRUE,NA,"0.1.4"
"11720","646",2023-01-01 01:45:00,1000,1006,6,0,TRUE,NA,"0.1.4"
"11721","646",2023-01-01 02:00:00,1000,1006,6,0,TRUE,NA,"0.1.4"
"11722","646",2023-01-01 02:15:00,1000,1006,6,0,TRUE,NA,"0.1.4"
"11723","646",2023-01-01 02:30:00,1000,1006,6,0,TRUE,NA,"0.1.4"
"11724","646",2023-01-01 02:45:00,1000,1006,6,0,TRUE,NA,"0.1.4"
"11725","646",2023-01-01 03:00:00,1000,1006,6,0,TRUE,NA,"0.1.4"
"11726","646",2023-01-01 03:15:00,1000,1006,6,0,TRUE,NA,"0.1.4"
"11727","646",2023-01-01 03:30:00,1000,1006,6,0,TRUE,NA,"0.1.4"
"11728","646",2023-01-01 03:45:00,1000,1006,6,0,TRUE,NA,"0.1.4"
"11729","646",2023-01-01 04:00:00,1000,1006,6,0,TRUE,NA,"0.1.4"
"11730","646",2023-01-01 04:15:00,1000,1006,6,0,TRUE,NA,"0.1.4"
"11731","646",2023-01-01 04:30:00,1000,1006,6,0,TRUE,NA,"0.1.4"
"11732","646",2023-01-01 04:45:00,1000,1006,6,0,TRUE,NA,"0.1.4"
"11733","646",2023-01-01 05:00:00,1000,1006,6,0,TRUE,NA,"0.1.4"
"11734","646",2023-01-01 05:15:00,1000,1006,6,0,TRUE,NA,"0.1.4"
"11735","646",2023-01-01 05:30:00,1000,1006,6,0,TRUE,NA,"0.1.4"
"11736","646",2023-01-01 05:45:00,1000,1006,6,0,TRUE,NA,"0.1.4"
"11737","646",2023-01-01 06:00:00,1000,1006,6,0,TRUE,NA,"0.1.4"
"11738","646",2023-01-01 06:15:00,1000,1006,6,0,TRUE,NA,"0.1.4"
"11739","646",2023-01-01 06:30:00,1000,1006,6,0,TRUE,NA,"0.1.4"
"11740","646",2023-01-01 06:45:00,1000,1006,6,0,TRUE,NA,"0.1.4"
"11741","646",2023-01-01 07:00:00,1000,1006,6,0,TRUE,NA,"0.1.4"
"11742","646",2023-01-01 07:15:00,1000,1006,6,0,TRUE,NA,"0.1.4"
"11743","646",2023-01-01 07:30:00,1000,1006,6,0,TRUE,NA,"0.1.4"
"11744","646",2023-01-01 07:45:00,1000,1006,6,0,TRUE,NA,"0.1.4"
"11745","646",2023-01-01 08:00:00,1000,1006,6,0,TRUE,NA,"0.1.4"
"11746","646",2023-01-01 08:15:00,1000,1006,6,0,TRUE,NA,"0.1.4"
"11747","646",2023-01-01 08:30:00,1000,1006,6,0,TRUE,NA,"0.1.4"
"11748","646",2023-01-01 08:45:00,1000,1006,6,0,TRUE,NA,"0.1.4"
"11749","646",2023-01-01 09:00:00,1000,1006,6,0,TRUE,NA,"0.1.4"
"11750","646",2023-01-01 09:15:00,1000,1006,6,0,TRUE,NA,"0.1.4"
"11751","646",2023-01-01 09:30:00,1000,1006,6,0,TRUE,NA,"0.1.4"
"11752","646",2023-01-01 09:45:00,999,1006,7,0,TRUE,NA,"0.1.4"
"11753","646",2023-01-01 10:00:00,999,1006,7,0,TRUE,NA,"0.1.4"
"11754","646",2023-01-01 10:15:00,1000,1006,6,0,TRUE,NA,"0.1.4"
"11755","646",2023-01-01 10:30:00,999,1006,7,0,TRUE,NA,"0.1.4"
"11756","646",2023-01-01 10:45:00,1000,1006,6,0,TRUE,NA,"0.1.4"
"11757","646",2023-01-01 11:00:00,999,1006,7,0,TRUE,NA,"0.1.4"
"11758","646",2023-01-01 11:15:00,999,1006,7,0,TRUE,NA,"0.1.4"
"11759","646",2023-01-01 11:30:00,999,1006,7,0,TRUE,NA,"0.1.4"
"11760","646",2023-01-01 11:45:00,999,1006,7,0,TRUE,NA,"0.1.4"
"11761","646",2023-01-01 12:00:00,999,1006,7,0,TRUE,NA,"0.1.4"
"11762","646",2023-01-01 12:15:00,999,1006,7,0,TRUE,NA,"0.1.4"
"11763","646",2023-01-01 12:30:00,999,1006,7,0,TRUE,NA,"0.1.4"
"11764","646",2023-01-01 12:45:00,999,1006,7,0,TRUE,NA,"0.1.4"
"11765","646",2023-01-01 13:00:00,999,1006,7,0,TRUE,NA,"0.1.4"
"11766","646",2023-01-01 13:15:00,999,1006,7,0,TRUE,NA,"0.1.4"
"11767","646",2023-01-01 13:30:00,999,1006,7,0,TRUE,NA,"0.1.4"
"11768","646",2023-01-01 13:45:00,1000,1006,6,0,TRUE,NA,"0.1.4"
"11769","646",2023-01-01 14:00:00,999,1006,7,0,TRUE,NA,"0.1.4"
"11770","646",2023-01-01 14:15:00,999,1006,7,0,TRUE,NA,"0.1.4"
"11771","646",2023-01-01 14:30:00,999,1006,7,0,TRUE,NA,"0.1.4"
"11772","646",2023-01-01 14:45:00,999,1006,7,0,TRUE,NA,"0.1.4"
"11773","646",2023-01-01 15:00:00,999,1006,7,0,TRUE,NA,"0.1.4"
"11774","646",2023-01-01 15:15:00,999,1006,7,0,TRUE,NA,"0.1.4"
"11775","646",2023-01-01 15:30:00,1000,1006,6,0,TRUE,NA,"0.1.4"
"11776","646",2023-01-01 15:45:00,1000,1006,6,0,TRUE,NA,"0.1.4"
"11777","646",2023-01-01 16:00:00,1000,1006,6,0,TRUE,NA,"0.1.4"
"11778","646",2023-01-01 16:15:00,1000,1006,6,0,TRUE,NA,"0.1.4"
"11779","646",2023-01-01 16:30:00,1000,1006,6,0,TRUE,NA,"0.1.4"
"11780","646",2023-01-01 16:45:00,1000,1006,6,0,TRUE,NA,"0.1.4"
"11781","646",2023-01-01 17:00:00,1000,1006,6,0,TRUE,NA,"0.1.4"
"11782","646",2023-01-01 17:15:00,1000,1006,6,0,TRUE,NA,"0.1.4"
"11783","646",2023-01-01 17:30:00,1000,1006,6,0,TRUE,NA,"0.1.4"
"11784","646",2023-01-01 17:45:00,1000,1006,6,0,TRUE,NA,"0.1.4"
"11785","646",2023-01-01 18:00:00,1000,1006,6,0,TRUE,NA,"0.1.4"
"11786","646",2023-01-01 18:15:00,1000,1006,6,0,TRUE,NA,"0.1.4"
"11787","646",2023-01-01 18:30:00,1000,1006,6,0,TRUE,NA,"0.1.4"
"11788","646",2023-01-01 18:45:00,1000,1006,6,0,TRUE,NA,"0.1.4"
"11789","646",2023-01-01 19:00:00,1000,1006,6,0,TRUE,NA,"0.1.4"
"11790","646",2023-01-01 19:15:00,1000,1006,6,0,TRUE,NA,"0.1.4"
"11791","646",2023-01-01 19:30:00,1000,1006,6,0,TRUE,NA,"0.1.4"
"11792","646",2023-01-01 19:45:00,1000,1006,6,0,TRUE,NA,"0.1.4"
"11793","646",2023-01-01 20:00:00,1000,1006,6,0,TRUE,NA,"0.1.4"
"11794","646",2023-01-01 20:15:00,1000,1006,6,0,TRUE,NA,"0.1.4"
"11795","646",2023-01-01 20:30:00,1000,1006,6,0,TRUE,NA,"0.1.4"
"11796","646",2023-01-01 20:45:00,1000,1006,6,0,TRUE,NA,"0.1.4"
"11797","646",2023-01-01 21:00:00,1000,1006,6,0,TRUE,NA,"0.1.4"
"11798","646",2023-01-01 21:15:00,1000,1006,6,0,TRUE,NA,"0.1.4"
"11799","646",2023-01-01 21:30:00,1000,1006,6,0,TRUE,NA,"0.1.4"
"11800","646",2023-01-01 21:45:00,1000,1006,6,0,TRUE,NA,"0.1.4"
"11801","646",2023-01-01 22:00:00,1000,1006,6,0,TRUE,NA,"0.1.4"
"11802","646",2023-01-01 22:15:00,1000,1006,6,0,TRUE,NA,"0.1.4"
"11803","646",2023-01-01 22:30:00,1000,1006,6,0,TRUE,NA,"0.1.4"
"11804","646",2023-01-01 22:45:00,1000,1006,6,0,TRUE,NA,"0.1.4"
"11805","646",2023-01-01 23:00:00,1000,1006,6,0,TRUE,NA,"0.1.4"
"11806","646",2023-01-01 23:15:00,1000,1006,6,0,TRUE,NA,"0.1.4"
"11807","646",2023-01-01 23:30:00,1000,1006,6,0,TRUE,NA,"0.1.4"
"11808","646",2023-01-01 23:45:00,1000,1006,6,0,TRUE,NA,"0.1.4"
"11809","646",2023-01-02,1000,1006,6,0,TRUE,NA,"0.1.4"
"11810","646",2023-01-02 00:15:00,1000,1006,6,0,TRUE,NA,"0.1.4"
"11811","646",2023-01-02 00:30:00,1000,1006,6,0,TRUE,NA,"0.1.4"
"11812","646",2023-01-02 00:45:00,1000,1006,6,0,TRUE,NA,"0.1.4"
"11813","646",2023-01-02 01:00:00,1000,1006,6,0,TRUE,NA,"0.1.4"
"11814","646",2023-01-02 01:15:00,1000,1006,6,0,TRUE,NA,"0.1.4"
"11815","646",2023-01-02 01:30:00,1000,1006,6,0,TRUE,NA,"0.1.4"
"11816","646",2023-01-02 01:45:00,1000,1006,6,0,TRUE,NA,"0.1.4"
"11817","646",2023-01-02 02:00:00,1000,1006,6,0,TRUE,NA,"0.1.4"
"11818","646",2023-01-02 02:15:00,1000,1006,6,0,TRUE,NA,"0.1.4"
"11819","646",2023-01-02 02:30:00,1000,1006,6,0,TRUE,NA,"0.1.4"
"11820","646",2023-01-02 02:45:00,1000,1006,6,0,TRUE,NA,"0.1.4"
"11821","646",2023-01-02 03:00:00,1000,1006,6,0,TRUE,NA,"0.1.4"
"11822","646",2023-01-02 03:15:00,1000,1006,6,0,TRUE,NA,"0.1.4"
"11823","646",2023-01-02 03:30:00,1000,1006,6,0,TRUE,NA,"0.1.4"
"11824","646",2023-01-02 03:45:00,1000,1006,6,0,TRUE,NA,"0.1.4"
"11825","646",2023-01-02 04:00:00,1000,1006,6,0,TRUE,NA,"0.1.4"
"11826","646",2023-01-02 04:15:00,1000,1006,6,0,TRUE,NA,"0.1.4"
"11827","646",2023-01-02 04:30:00,1000,1006,6,0,TRUE,NA,"0.1.4"
"11828","646",2023-01-02 04:45:00,1000,1006,6,0,TRUE,NA,"0.1.4"
"11829","646",2023-01-02 05:00:00,1000,1006,6,0,TRUE,NA,"0.1.4"
"11830","646",2023-01-02 05:15:00,1000,1006,6,0,TRUE,NA,"0.1.4"
"11831","646",2023-01-02 05:30:00,1000,1006,6,0,TRUE,NA,"0.1.4"
"11832","646",2023-01-02 05:45:00,1000,1006,6,0,TRUE,NA,"0.1.4"
"11833","646",2023-01-02 06:00:00,1000,1006,6,0,TRUE,NA,"0.1.4"
"11834","646",2023-01-02 06:15:00,1000,1006,6,0,TRUE,NA,"0.1.4"
"11835","646",2023-01-02 06:30:00,1000,1006,6,0,TRUE,NA,"0.1.4"
"11836","646",2023-01-02 06:45:00,1000,1006,6,0,TRUE,NA,"0.1.4"
"11837","646",2023-01-02 07:00:00,1000,1006,6,0,TRUE,NA,"0.1.4"
"11838","646",2023-01-02 07:15:00,1000,1006,6,0,TRUE,NA,"0.1.4"
"11839","646",2023-01-02 07:30:00,1000,1006,6,0,TRUE,NA,"0.1.4"
"11840","646",2023-01-02 07:45:00,1000,1006,6,0,TRUE,NA,"0.1.4"
"11841","646",2023-01-02 08:00:00,1000,1006,6,0,TRUE,NA,"0.1.4"
"11842","646",2023-01-02 08:15:00,1000,1006,6,0,TRUE,NA,"0.1.4"
"11843","646",2023-01-02 08:30:00,1000,1006,6,0,TRUE,NA,"0.1.4"
"11844","646",2023-01-02 08:45:00,1000,1006,6,0,TRUE,NA,"0.1.4"
"11845","646",2023-01-02 09:00:00,1000,1006,6,0,TRUE,NA,"0.1.4"
"11846","646",2023-01-02 09:15:00,1000,1006,6,0,TRUE,NA,"0.1.4"
"11847","646",2023-01-02 09:30:00,1000,1006,6,0,TRUE,NA,"0.1.4"
"11848","646",2023-01-02 09:45:00,1000,1006,6,0,TRUE,NA,"0.1.4"
"11849","646",2023-01-02 10:00:00,1000,1006,6,0,TRUE,NA,"0.1.4"
"11850","646",2023-01-02 10:15:00,1000,1006,6,0,TRUE,NA,"0.1.4"
"11851","646",2023-01-02 10:30:00,1000,1006,6,0,TRUE,NA,"0.1.4"
"11852","646",2023-01-02 10:45:00,1000,1006,6,0,TRUE,NA,"0.1.4"
"11853","646",2023-01-02 11:00:00,1000,1006,6,0,TRUE,NA,"0.1.4"
"11854","646",2023-01-02 11:15:00,1000,1006,6,0,TRUE,NA,"0.1.4"
"11855","646",2023-01-02 11:30:00,1000,1006,6,0,TRUE,NA,"0.1.4"
"11856","646",2023-01-02 11:45:00,1000,1006,6,0,TRUE,NA,"0.1.4"
"11857","646",2023-01-02 12:00:00,1000,1006,6,0,TRUE,NA,"0.1.4"
"11858","646",2023-01-02 12:15:00,1000,1006,6,0,TRUE,NA,"0.1.4"
"11859","646",2023-01-02 12:30:00,1000,1006,6,0,TRUE,NA,"0.1.4"
"11860","646",2023-01-02 12:45:00,1000,1006,6,0,TRUE,NA,"0.1.4"
"11861","646",2023-01-02 13:00:00,1000,1006,6,0,TRUE,NA,"0.1.4"
"11862","646",2023-01-02 13:15:00,1000,1006,6,0,TRUE,NA,"0.1.4"
"11863","646",2023-01-02 13:30:00,1000,1006,6,0,TRUE,NA,"0.1.4"
"11864","646",2023-01-02 13:45:00,1000,1006,6,0,TRUE,NA,"0.1.4"
"11865","646",2023-01-02 14:00:00,1000,1006,6,0,TRUE,NA,"0.1.4"
"11866","646",2023-01-02 14:15:00,1000,1006,6,0,TRUE,NA,"0.1.4"
"11867","646",2023-01-02 14:30:00,1000,1006,6,0,TRUE,NA,"0.1.4"
"11868","646",2023-01-02 14:45:00,1000,1006,6,0,TRUE,NA,"0.1.4"
"11869","646",2023-01-02 15:00:00,1000,1006,6,0,TRUE,NA,"0.1.4"
"11870","646",2023-01-02 15:15:00,1000,1006,6,0,TRUE,NA,"0.1.4"
"11871","646",2023-01-02 15:30:00,1000,1006,6,0,TRUE,NA,"0.1.4"
"11872","646",2023-01-02 15:45:00,1000,1006,6,0,TRUE,NA,"0.1.4"
"11873","646",2023-01-02 16:00:00,1000,1006,6,0,TRUE,NA,"0.1.4"
"11874","646",2023-01-02 16:15:00,1000,1006,6,0,TRUE,NA,"0.1.4"
"11875","646",2023-01-02 16:30:00,1000,1006,6,0,TRUE,NA,"0.1.4"
"11876","646",2023-01-02 16:45:00,1000,1006,6,0,TRUE,NA,"0.1.4"
"11877","646",2023-01-02 17:00:00,1000,1006,6,0,TRUE,NA,"0.1.4"
"11878","646",2023-01-02 17:15:00,1000,1006,6,0,TRUE,NA,"0.1.4"
"11879","646",2023-01-02 17:30:00,1000,1006,6,0,TRUE,NA,"0.1.4"
"11880","646",2023-01-02 17:45:00,1000,1006,6,0,TRUE,NA,"0.1.4"
"11881","646",2023-01-02 18:00:00,1000,1006,6,0,TRUE,NA,"0.1.4"
"11882","646",2023-01-02 18:15:00,1000,1006,6,0,TRUE,NA,"0.1.4"
"11883","646",2023-01-02 18:30:00,1000,1006,6,0,TRUE,NA,"0.1.4"
"11884","646",2023-01-02 18:45:00,1000,1006,6,0,TRUE,NA,"0.1.4"
"11885","646",2023-01-02 19:00:00,999,1006,7,0,TRUE,NA,"0.1.4"
"11886","646",2023-01-02 19:15:00,1000,1006,6,0,TRUE,NA,"0.1.4"
"11887","646",2023-01-02 19:30:00,1000,1006,6,0,TRUE,NA,"0.1.4"
"11888","646",2023-01-02 19:45:00,999,1006,7,0,TRUE,NA,"0.1.4"
"11889","646",2023-01-02 20:00:00,1000,1006,6,0,TRUE,NA,"0.1.4"
"11890","646",2023-01-02 20:15:00,1000,1006,6,0,TRUE,NA,"0.1.4"
"11891","646",2023-01-02 20:30:00,1000,1006,6,0,TRUE,NA,"0.1.4"
"11892","646",2023-01-02 20:45:00,999,1006,7,0,TRUE,NA,"0.1.4"
"11893","646",2023-01-02 21:00:00,999,1006,7,0,TRUE,NA,"0.1.4"
"11894","646",2023-01-02 21:15:00,999,1006,7,0,TRUE,NA,"0.1.4"
"11895","646",2023-01-02 21:30:00,999,1006,7,0,TRUE,NA,"0.1.4"
"11896","646",2023-01-02 21:45:00,999,1006,7,0,TRUE,NA,"0.1.4"
"11897","646",2023-01-02 22:00:00,999,1006,7,0,TRUE,NA,"0.1.4"
"11898","646",2023-01-02 22:15:00,999,1006,7,0,TRUE,NA,"0.1.4"
"11899","646",2023-01-02 22:30:00,999,1006,7,0,TRUE,NA,"0.1.4"
"11900","646",2023-01-02 22:45:00,999,1006,7,0,TRUE,NA,"0.1.4"
"11901","646",2023-01-02 23:00:00,999,1006,7,0,TRUE,NA,"0.1.4"
"11902","646",2023-01-02 23:15:00,999,1006,7,0,TRUE,NA,"0.1.4"
"11903","646",2023-01-02 23:30:00,999,1006,7,0,TRUE,NA,"0.1.4"
"11904","646",2023-01-02 23:45:00,999,1006,7,0,TRUE,NA,"0.1.4"
"11905","646",2023-01-03,999,1006,7,0,TRUE,NA,"0.1.4"
"11906","646",2023-01-03 00:15:00,999,1006,7,0,TRUE,NA,"0.1.4"
"11907","646",2023-01-03 00:30:00,999,1006,7,0,TRUE,NA,"0.1.4"
"11908","646",2023-01-03 00:45:00,999,1006,7,0,TRUE,NA,"0.1.4"
"11909","646",2023-01-03 01:00:00,999,1006,7,0,TRUE,NA,"0.1.4"
"11910","646",2023-01-03 01:15:00,999,1006,7,0,TRUE,NA,"0.1.4"
"11911","646",2023-01-03 01:30:00,999,1006,7,0,TRUE,NA,"0.1.4"
"11912","646",2023-01-03 01:45:00,999,1006,7,0,TRUE,NA,"0.1.4"
"11913","646",2023-01-03 02:00:00,999,1006,7,0,TRUE,NA,"0.1.4"
"11914","646",2023-01-03 02:15:00,999,1006,7,0,TRUE,NA,"0.1.4"
"11915","646",2023-01-03 02:30:00,999,1006,7,0,TRUE,NA,"0.1.4"
"11916","646",2023-01-03 02:45:00,999,1006,7,0,TRUE,NA,"0.1.4"
"11917","646",2023-01-03 03:00:00,1000,1006,6,0,TRUE,NA,"0.1.4"
"11918","646",2023-01-03 03:15:00,999,1006,7,0,TRUE,NA,"0.1.4"
"11919","646",2023-01-03 03:30:00,999,1006,7,0,TRUE,NA,"0.1.4"
"11920","646",2023-01-03 03:45:00,999,1006,7,0,TRUE,NA,"0.1.4"
"11921","646",2023-01-03 04:00:00,999,1006,7,0,TRUE,NA,"0.1.4"
"11922","646",2023-01-03 04:15:00,999,1006,7,0,TRUE,NA,"0.1.4"
"11923","646",2023-01-03 04:30:00,999,1006,7,0,TRUE,NA,"0.1.4"
"11924","646",2023-01-03 04:45:00,999,1006,7,0,TRUE,NA,"0.1.4"
"11925","646",2023-01-03 05:00:00,999,1006,7,0,TRUE,NA,"0.1.4"
"11926","646",2023-01-03 05:15:00,999,1006,7,0,TRUE,NA,"0.1.4"
"11927","646",2023-01-03 05:30:00,999,1006,7,0,TRUE,NA,"0.1.4"
"11928","646",2023-01-03 05:45:00,999,1006,7,0,TRUE,NA,"0.1.4"
"11929","646",2023-01-03 06:00:00,999,1006,7,0,TRUE,NA,"0.1.4"
"11930","646",2023-01-03 06:15:00,999,1006,7,0,TRUE,NA,"0.1.4"
"11931","646",2023-01-03 06:30:00,999,1006,7,0,TRUE,NA,"0.1.4"
"11932","646",2023-01-03 06:45:00,999,1006,7,0,TRUE,NA,"0.1.4"
"11933","646",2023-01-03 07:00:00,999,1006,7,0,TRUE,NA,"0.1.4"
"11934","646",2023-01-03 07:15:00,999,1006,7,0,TRUE,NA,"0.1.4"
"11935","646",2023-01-03 07:30:00,999,1006,7,0,TRUE,NA,"0.1.4"
"11936","646",2023-01-03 07:45:00,999,1006,7,0,TRUE,NA,"0.1.4"
"11937","646",2023-01-03 08:00:00,999,1006,7,0,TRUE,NA,"0.1.4"
"11938","646",2023-01-03 08:15:00,999,1006,7,0,TRUE,NA,"0.1.4"
"11939","646",2023-01-03 08:30:00,999,1006,7,0,TRUE,NA,"0.1.4"
"11940","646",2023-01-03 08:45:00,999,1006,7,0,TRUE,NA,"0.1.4"
"11941","646",2023-01-03 09:00:00,999,1006,7,0,TRUE,NA,"0.1.4"
"11942","646",2023-01-03 09:15:00,999,1006,7,0,TRUE,NA,"0.1.4"
"11943","646",2023-01-03 09:30:00,999,1006,7,0,TRUE,NA,"0.1.4"
"11944","646",2023-01-03 09:45:00,999,1006,7,0,TRUE,NA,"0.1.4"
"11945","646",2023-01-03 10:00:00,999,1006,7,0,TRUE,NA,"0.1.4"
"11946","646",2023-01-03 10:15:00,999,1006,7,0,TRUE,NA,"0.1.4"
"11947","646",2023-01-03 10:30:00,999,1006,7,0,TRUE,NA,"0.1.4"
"11948","646",2023-01-03 10:45:00,999,1006,7,0,TRUE,NA,"0.1.4"
"11949","646",2023-01-03 11:00:00,999,1006,7,0,TRUE,NA,"0.1.4"
"11950","646",2023-01-03 11:15:00,999,1006,7,0,TRUE,NA,"0.1.4"
"11951","646",2023-01-03 11:30:00,999,1006,7,0,TRUE,NA,"0.1.4"
"11952","646",2023-01-03 11:45:00,999,1006,7,0,TRUE,NA,"0.1.4"
"11953","646",2023-01-03 12:00:00,999,1006,7,0,TRUE,NA,"0.1.4"
"11954","646",2023-01-03 12:15:00,999,1006,7,0,TRUE,NA,"0.1.4"
"11955","646",2023-01-03 12:30:00,999,1006,7,0,TRUE,NA,"0.1.4"
"11956","646",2023-01-03 12:45:00,999,1006,7,0,TRUE,NA,"0.1.4"
"11957","646",2023-01-03 13:00:00,999,1006,7,0,TRUE,NA,"0.1.4"
"11958","646",2023-01-03 13:15:00,999,1006,7,0,TRUE,NA,"0.1.4"
"11959","646",2023-01-03 13:30:00,999,1006,7,0,TRUE,NA,"0.1.4"
"11960","646",2023-01-03 13:45:00,999,1006,7,0,TRUE,NA,"0.1.4"
"11961","646",2023-01-03 14:00:00,999,1006,7,0,TRUE,NA,"0.1.4"
"11962","646",2023-01-03 14:15:00,999,1006,7,0,TRUE,NA,"0.1.4"
"11963","646",2023-01-03 14:30:00,999,1006,7,0,TRUE,NA,"0.1.4"
"11964","646",2023-01-03 14:45:00,999,1006,7,0,TRUE,NA,"0.1.4"
"11965","646",2023-01-03 15:00:00,999,1006,7,0,TRUE,NA,"0.1.4"
"11966","646",2023-01-03 15:15:00,999,1006,7,0,TRUE,NA,"0.1.4"
"11967","646",2023-01-03 15:30:00,999,1006,7,0,TRUE,NA,"0.1.4"
"11968","646",2023-01-03 15:45:00,999,1006,7,0,TRUE,NA,"0.1.4"
"11969","646",2023-01-03 16:00:00,999,1006,7,0,TRUE,NA,"0.1.4"
"11970","646",2023-01-03 16:15:00,999,1006,7,0,TRUE,NA,"0.1.4"
"11971","646",2023-01-03 16:30:00,999,1006,7,0,TRUE,NA,"0.1.4"
"11972","646",2023-01-03 16:45:00,999,1006,7,0,TRUE,NA,"0.1.4"
"11973","646",2023-01-03 17:00:00,999,1006,7,0,TRUE,NA,"0.1.4"
"11974","646",2023-01-03 17:15:00,999,1006,7,0,TRUE,NA,"0.1.4"
"11975","646",2023-01-03 17:30:00,999,1006,7,0,TRUE,NA,"0.1.4"
"11976","646",2023-01-03 17:45:00,999,1006,7,0,TRUE,NA,"0.1.4"
"11977","646",2023-01-03 18:00:00,999,1006,7,0,TRUE,NA,"0.1.4"
"11978","646",2023-01-03 18:15:00,999,1006,7,0,TRUE,NA,"0.1.4"
"11979","646",2023-01-03 18:30:00,999,1006,7,0,TRUE,NA,"0.1.4"
"11980","646",2023-01-03 18:45:00,999,1006,7,0,TRUE,NA,"0.1.4"
"11981","646",2023-01-03 19:00:00,999,1006,7,0,TRUE,NA,"0.1.4"
"11982","646",2023-01-03 19:15:00,999,1006,7,0,TRUE,NA,"0.1.4"
"11983","646",2023-01-03 19:30:00,999,1006,7,0,TRUE,NA,"0.1.4"
"11984","646",2023-01-03 19:45:00,999,1006,7,0,TRUE,NA,"0.1.4"
"11985","646",2023-01-03 20:00:00,999,1006,7,0,TRUE,NA,"0.1.4"
"11986","646",2023-01-03 20:15:00,999,1006,7,0,TRUE,NA,"0.1.4"
"11987","646",2023-01-03 20:30:00,999,1006,7,0,TRUE,NA,"0.1.4"
"11988","646",2023-01-03 20:45:00,999,1006,7,0,TRUE,NA,"0.1.4"
"11989","646",2023-01-03 21:00:00,999,1006,7,0,TRUE,NA,"0.1.4"
"11990","646",2023-01-03 21:15:00,999,1006,7,0,TRUE,NA,"0.1.4"
"11991","646",2023-01-03 21:30:00,999,1006,7,0,TRUE,NA,"0.1.4"
"11992","646",2023-01-03 21:45:00,999,1006,7,0,TRUE,NA,"0.1.4"
"11993","646",2023-01-03 22:00:00,999,1006,7,0,TRUE,NA,"0.1.4"
"11994","646",2023-01-03 22:15:00,999,1006,7,0,TRUE,NA,"0.1.4"
"11995","646",2023-01-03 22:30:00,999,1006,7,0,TRUE,NA,"0.1.4"
"11996","646",2023-01-03 22:45:00,999,1006,7,0,TRUE,NA,"0.1.4"
"11997","646",2023-01-03 23:00:00,999,1006,7,0,TRUE,NA,"0.1.4"
"11998","646",2023-01-03 23:15:00,999,1006,7,0,TRUE,NA,"0.1.4"
"11999","646",2023-01-03 23:30:00,999,1006,7,0,TRUE,NA,"0.1.4"
"12000","646",2023-01-03 23:45:00,999,1006,7,0,TRUE,NA,"0.1.4"
"12001","646",2023-01-04,999,1006,7,0,TRUE,NA,"0.1.4"
"12002","646",2023-01-04 00:15:00,999,1006,7,0,TRUE,NA,"0.1.4"
"12003","646",2023-01-04 00:30:00,999,1006,7,0,TRUE,NA,"0.1.4"
"12004","646",2023-01-04 00:45:00,999,1006,7,0,TRUE,NA,"0.1.4"
"12005","646",2023-01-04 01:00:00,999,1006,7,0,TRUE,NA,"0.1.4"
"12006","646",2023-01-04 01:15:00,999,1006,7,0,TRUE,NA,"0.1.4"
"12007","646",2023-01-04 01:30:00,999,1006,7,0,TRUE,NA,"0.1.4"
"12008","646",2023-01-04 01:45:00,999,1006,7,0,TRUE,NA,"0.1.4"
"12009","646",2023-01-04 02:00:00,999,1006,7,0,TRUE,NA,"0.1.4"
"12010","646",2023-01-04 02:15:00,999,1006,7,0,TRUE,NA,"0.1.4"
"12011","646",2023-01-04 02:30:00,999,1006,7,0,TRUE,NA,"0.1.4"
"12012","646",2023-01-04 02:45:00,999,1006,7,0,TRUE,NA,"0.1.4"
"12013","646",2023-01-04 03:00:00,999,1006,7,0,TRUE,NA,"0.1.4"
"12014","646",2023-01-04 03:15:00,999,1006,7,0,TRUE,NA,"0.1.4"
"12015","646",2023-01-04 03:30:00,999,1006,7,0,TRUE,NA,"0.1.4"
"12016","646",2023-01-04 03:45:00,999,1006,7,0,TRUE,NA,"0.1.4"
"12017","646",2023-01-04 04:00:00,999,1006,7,0,TRUE,NA,"0.1.4"
"12018","646",2023-01-04 04:15:00,999,1006,7,0,TRUE,NA,"0.1.4"
"12019","646",2023-01-04 04:30:00,999,1006,7,0,TRUE,NA,"0.1.4"
"12020","646",2023-01-04 04:45:00,999,1006,7,0,TRUE,NA,"0.1.4"
"12021","646",2023-01-04 05:00:00,999,1006,7,0,TRUE,NA,"0.1.4"
"12022","646",2023-01-04 05:15:00,999,1006,7,0,TRUE,NA,"0.1.4"
"12023","646",2023-01-04 05:30:00,999,1006,7,0,TRUE,NA,"0.1.4"
"12024","646",2023-01-04 05:45:00,999,1006,7,0,TRUE,NA,"0.1.4"
"12025","646",2023-01-04 06:00:00,999,1006,7,0,TRUE,NA,"0.1.4"
"12026","646",2023-01-04 06:15:00,999,1006,7,0,TRUE,NA,"0.1.4"
"12027","646",2023-01-04 06:30:00,999,1006,7,0,TRUE,NA,"0.1.4"
"12028","646",2023-01-04 06:45:00,999,1006,7,0,TRUE,NA,"0.1.4"
"12029","646",2023-01-04 07:00:00,999,1006,7,0,TRUE,NA,"0.1.4"
"12030","646",2023-01-04 07:15:00,999,1006,7,0,TRUE,NA,"0.1.4"
"12031","646",2023-01-04 07:30:00,999,1006,7,0,TRUE,NA,"0.1.4"
"12032","646",2023-01-04 07:45:00,999,1006,7,0,TRUE,NA,"0.1.4"
"12033","646",2023-01-04 08:00:00,999,1006,7,0,TRUE,NA,"0.1.4"
"12034","646",2023-01-04 08:15:00,999,1006,7,0,TRUE,NA,"0.1.4"
"12035","646",2023-01-04 08:30:00,999,1006,7,0,TRUE,NA,"0.1.4"
"12036","646",2023-01-04 08:45:00,999,1006,7,0,TRUE,NA,"0.1.4"
"12037","646",2023-01-04 09:00:00,999,1006,7,0,TRUE,NA,"0.1.4"
"12038","646",2023-01-04 09:15:00,999,1006,7,0,TRUE,NA,"0.1.4"
"12039","646",2023-01-04 09:30:00,999,1006,7,0,TRUE,NA,"0.1.4"
"12040","646",2023-01-04 09:45:00,999,1006,7,0,TRUE,NA,"0.1.4"
"12041","646",2023-01-04 10:00:00,999,1006,7,0,TRUE,NA,"0.1.4"
"12042","646",2023-01-04 10:15:00,999,1006,7,0,TRUE,NA,"0.1.4"
"12043","646",2023-01-04 10:30:00,999,1006,7,0,TRUE,NA,"0.1.4"
"12044","646",2023-01-04 10:45:00,999,1006,7,0,TRUE,NA,"0.1.4"
"12045","646",2023-01-04 11:00:00,999,1006,7,0,TRUE,NA,"0.1.4"
"12046","646",2023-01-04 11:15:00,999,1006,7,0,TRUE,NA,"0.1.4"
"12047","646",2023-01-04 11:30:00,999,1006,7,0,TRUE,NA,"0.1.4"
"12048","646",2023-01-04 11:45:00,999,1006,7,0,TRUE,NA,"0.1.4"
"12049","646",2023-01-04 12:00:00,999,1006,7,0,TRUE,NA,"0.1.4"
"12050","646",2023-01-04 12:15:00,999,1006,7,0,TRUE,NA,"0.1.4"
"12051","646",2023-01-04 12:30:00,999,1006,7,0,TRUE,NA,"0.1.4"
"12052","646",2023-01-04 12:45:00,999,1006,7,0,TRUE,NA,"0.1.4"
"12053","646",2023-01-04 13:00:00,999,1006,7,0,TRUE,NA,"0.1.4"
"12054","646",2023-01-04 13:15:00,999,1006,7,0,TRUE,NA,"0.1.4"
"12055","646",2023-01-04 13:30:00,999,1006,7,0,TRUE,NA,"0.1.4"
"12056","646",2023-01-04 13:45:00,999,1006,7,0,TRUE,NA,"0.1.4"
"12057","646",2023-01-04 14:00:00,999,1006,7,0,TRUE,NA,"0.1.4"
"12058","646",2023-01-04 14:15:00,999,1006,7,0,TRUE,NA,"0.1.4"
"12059","646",2023-01-04 14:30:00,999,1006,7,0,TRUE,NA,"0.1.4"
"12060","646",2023-01-04 14:45:00,999,1006,7,0,TRUE,NA,"0.1.4"
"12061","646",2023-01-04 15:00:00,999,1006,7,0,TRUE,NA,"0.1.4"
"12062","646",2023-01-04 15:15:00,999,1006,7,0,TRUE,NA,"0.1.4"
"12063","646",2023-01-04 15:30:00,999,1006,7,0,TRUE,NA,"0.1.4"
"12064","646",2023-01-04 15:45:00,999,1006,7,0,TRUE,NA,"0.1.4"
"12065","646",2023-01-04 16:00:00,999,1006,7,0,TRUE,NA,"0.1.4"
"12066","646",2023-01-04 16:15:00,999,1006,7,0,TRUE,NA,"0.1.4"
"12067","646",2023-01-04 16:30:00,999,1006,7,0,TRUE,NA,"0.1.4"
"12068","646",2023-01-04 16:45:00,999,1006,7,0,TRUE,NA,"0.1.4"
"12069","646",2023-01-04 17:00:00,999,1006,7,0,TRUE,NA,"0.1.4"
"12070","646",2023-01-04 17:15:00,999,1006,7,0,TRUE,NA,"0.1.4"
"12071","646",2023-01-04 17:30:00,999,1006,7,0,TRUE,NA,"0.1.4"
"12072","646",2023-01-04 17:45:00,999,1006,7,0,TRUE,NA,"0.1.4"
"12073","646",2023-01-04 18:00:00,999,1006,7,0,TRUE,NA,"0.1.4"
"12074","646",2023-01-04 18:15:00,999,1006,7,0,TRUE,NA,"0.1.4"
"12075","646",2023-01-04 18:30:00,999,1006,7,0,TRUE,NA,"0.1.4"
"12076","646",2023-01-04 18:45:00,999,1006,7,0,TRUE,NA,"0.1.4"
"12077","646",2023-01-04 19:00:00,999,1006,7,0,TRUE,NA,"0.1.4"
"12078","646",2023-01-04 19:15:00,999,1006,7,0,TRUE,NA,"0.1.4"
"12079","646",2023-01-04 19:30:00,999,1006,7,0,TRUE,NA,"0.1.4"
"12080","646",2023-01-04 19:45:00,999,1006,7,0,TRUE,NA,"0.1.4"
"12081","646",2023-01-04 20:00:00,999,1006,7,0,TRUE,NA,"0.1.4"
"12082","646",2023-01-04 20:15:00,999,1006,7,0,TRUE,NA,"0.1.4"
"12083","646",2023-01-04 20:30:00,999,1006,7,0,TRUE,NA,"0.1.4"
"12084","646",2023-01-04 20:45:00,999,1006,7,0,TRUE,NA,"0.1.4"
"12085","646",2023-01-04 21:00:00,999,1006,7,0,TRUE,NA,"0.1.4"
"12086","646",2023-01-04 21:15:00,999,1006,7,0,TRUE,NA,"0.1.4"
"12087","646",2023-01-04 21:30:00,999,1006,7,0,TRUE,NA,"0.1.4"
"12088","646",2023-01-04 21:45:00,999,1006,7,0,TRUE,NA,"0.1.4"
"12089","646",2023-01-04 22:00:00,999,1006,7,0,TRUE,NA,"0.1.4"
"12090","646",2023-01-04 22:15:00,999,1006,7,0,TRUE,NA,"0.1.4"
"12091","646",2023-01-04 22:30:00,999,1006,7,0,TRUE,NA,"0.1.4"
"12092","646",2023-01-04 22:45:00,999,1006,7,0,TRUE,NA,"0.1.4"
"12093","646",2023-01-04 23:00:00,999,1006,7,0,TRUE,NA,"0.1.4"
"12094","646",2023-01-04 23:15:00,999,1006,7,0,TRUE,NA,"0.1.4"
"12095","646",2023-01-04 23:30:00,999,1006,7,0,TRUE,NA,"0.1.4"
"12096","646",2023-01-04 23:45:00,999,1006,7,0,TRUE,NA,"0.1.4"
"12097","646",2023-01-05,999,1006,7,0,TRUE,NA,"0.1.4"
"12098","646",2023-01-05 00:15:00,999,1006,7,0,TRUE,NA,"0.1.4"
"12099","646",2023-01-05 00:30:00,999,1006,7,0,TRUE,NA,"0.1.4"
"12100","646",2023-01-05 00:45:00,999,1006,7,0,TRUE,NA,"0.1.4"
"12101","646",2023-01-05 01:00:00,999,1006,7,0,TRUE,NA,"0.1.4"
"12102","646",2023-01-05 01:15:00,999,1006,7,0,TRUE,NA,"0.1.4"
"12103","646",2023-01-05 01:30:00,999,1006,7,0,TRUE,NA,"0.1.4"
"12104","646",2023-01-05 01:45:00,999,1006,7,0,TRUE,NA,"0.1.4"
"12105","646",2023-01-05 02:00:00,999,1006,7,0,TRUE,NA,"0.1.4"
"12106","646",2023-01-05 02:15:00,999,1006,7,0,TRUE,NA,"0.1.4"
"12107","646",2023-01-05 02:30:00,999,1006,7,0,TRUE,NA,"0.1.4"
"12108","646",2023-01-05 02:45:00,999,1006,7,0,TRUE,NA,"0.1.4"
"12109","646",2023-01-05 03:00:00,999,1006,7,0,TRUE,NA,"0.1.4"
"12110","646",2023-01-05 03:15:00,999,1006,7,0,TRUE,NA,"0.1.4"
"12111","646",2023-01-05 03:30:00,999,1006,7,0,TRUE,NA,"0.1.4"
"12112","646",2023-01-05 03:45:00,999,1006,7,0,TRUE,NA,"0.1.4"
"12113","646",2023-01-05 04:00:00,999,1006,7,0,TRUE,NA,"0.1.4"
"12114","646",2023-01-05 04:15:00,999,1006,7,0,TRUE,NA,"0.1.4"
"12115","646",2023-01-05 04:30:00,999,1006,7,0,TRUE,NA,"0.1.4"
"12116","646",2023-01-05 04:45:00,999,1006,7,0,TRUE,NA,"0.1.4"
"12117","646",2023-01-05 05:00:00,999,1006,7,0,TRUE,NA,"0.1.4"
"12118","646",2023-01-05 05:15:00,999,1006,7,0,TRUE,NA,"0.1.4"
"12119","646",2023-01-05 05:30:00,1000,1006,6,0,TRUE,NA,"0.1.4"
"12120","646",2023-01-05 05:45:00,1000,1006,6,0,TRUE,NA,"0.1.4"
"12121","646",2023-01-05 06:00:00,1000,1006,6,0,TRUE,NA,"0.1.4"
"12122","646",2023-01-05 06:15:00,1000,1006,6,0,TRUE,NA,"0.1.4"
"12123","646",2023-01-05 06:30:00,1000,1006,6,0,TRUE,NA,"0.1.4"
"12124","646",2023-01-05 06:45:00,1000,1006,6,0,TRUE,NA,"0.1.4"
"12125","646",2023-01-05 07:00:00,1000,1006,6,0,TRUE,NA,"0.1.4"
"12126","646",2023-01-05 07:15:00,1000,1006,6,0,TRUE,NA,"0.1.4"
"12127","646",2023-01-05 07:30:00,1000,1006,6,0,TRUE,NA,"0.1.4"
"12128","646",2023-01-05 07:45:00,1000,1006,6,0,TRUE,NA,"0.1.4"
"12129","646",2023-01-05 08:00:00,1000,1006,6,0,TRUE,NA,"0.1.4"
"12130","646",2023-01-05 08:15:00,1000,1006,6,0,TRUE,NA,"0.1.4"
"12131","646",2023-01-05 08:30:00,1000,1006,6,0,FALSE,NA,"0.1.4"
"12132","646",2023-01-05 08:45:00,1000,1006,6,0,FALSE,NA,"0.1.4"
"12133","646",2023-01-05 09:00:00,1000,1006,6,0,FALSE,NA,"0.1.4"
"12134","646",2023-01-05 09:15:00,1000,1006,6,0,FALSE,NA,"0.1.4"
"12135","646",2023-01-05 09:30:00,1000,1006,6,0,FALSE,NA,"0.1.4"
"12136","646",2023-01-05 09:45:00,1000,1006,6,0,FALSE,NA,"0.1.4"
"12137","646",2023-01-05 10:00:00,1000,1006,6,0,FALSE,NA,"0.1.4"
"12138","646",2023-01-05 10:15:00,1000,1006,6,0,FALSE,NA,"0.1.4"
"12139","646",2023-01-05 10:30:00,1000,1006,6,0,FALSE,NA,"0.1.4"
"12140","646",2023-01-05 10:45:00,1000,1006,6,0,FALSE,NA,"0.1.4"
"12141","646",2023-01-05 11:00:00,1000,1006,6,0,TRUE,NA,"0.1.4"
"12142","646",2023-01-05 11:15:00,1000,1006,6,0,TRUE,NA,"0.1.4"
"12143","646",2023-01-05 11:30:00,1000,1006,6,0,TRUE,NA,"0.1.4"
"12144","646",2023-01-05 11:45:00,1000,1006,6,0,TRUE,NA,"0.1.4"
"12145","646",2023-01-05 12:00:00,1000,1006,6,0,TRUE,NA,"0.1.4"
"12146","646",2023-01-05 12:15:00,1000,1006,6,0,TRUE,NA,"0.1.4"
"12147","646",2023-01-05 12:30:00,1000,1006,6,0,TRUE,NA,"0.1.4"
"12148","646",2023-01-05 12:45:00,1000,1006,6,0,TRUE,NA,"0.1.4"
"12149","646",2023-01-05 13:00:00,1000,1006,6,0,TRUE,NA,"0.1.4"
"12150","646",2023-01-05 13:15:00,1000,1006,6,0,TRUE,NA,"0.1.4"
"12151","646",2023-01-05 13:30:00,1000,1006,6,0,TRUE,NA,"0.1.4"
"12152","646",2023-01-05 13:45:00,1000,1006,6,0,TRUE,NA,"0.1.4"
"12153","646",2023-01-05 14:00:00,1000,1006,6,0,TRUE,NA,"0.1.4"
"12154","646",2023-01-05 14:15:00,1000,1006,6,0,TRUE,NA,"0.1.4"
"12155","646",2023-01-05 14:30:00,1000,1006,6,0,TRUE,NA,"0.1.4"
"12156","646",2023-01-05 14:45:00,1000,1006,6,0,TRUE,NA,"0.1.4"
"12157","646",2023-01-05 15:00:00,1000,1006,6,0,TRUE,NA,"0.1.4"
"12158","646",2023-01-05 15:15:00,1000,1006,6,0,TRUE,NA,"0.1.4"
"12159","646",2023-01-05 15:30:00,1000,1006,6,0,TRUE,NA,"0.1.4"
"12160","646",2023-01-05 15:45:00,1000,1006,6,0,TRUE,NA,"0.1.4"
"12161","646",2023-01-05 16:00:00,1000,1006,6,0,TRUE,NA,"0.1.4"
"12162","646",2023-01-05 16:15:00,1000,1006,6,0,TRUE,NA,"0.1.4"
"12163","646",2023-01-05 16:30:00,1000,1006,6,0,TRUE,NA,"0.1.4"
"12164","646",2023-01-05 16:45:00,1000,1006,6,0,TRUE,NA,"0.1.4"
"12165","646",2023-01-05 17:00:00,1000,1006,6,0,TRUE,NA,"0.1.4"
"12166","646",2023-01-05 17:15:00,1000,1006,6,0,TRUE,NA,"0.1.4"
"12167","646",2023-01-05 17:30:00,1000,1006,6,0,TRUE,NA,"0.1.4"
"12168","646",2023-01-05 17:45:00,1000,1006,6,0,TRUE,NA,"0.1.4"
"12169","646",2023-01-05 18:00:00,1000,1006,6,0,TRUE,NA,"0.1.4"
"12170","646",2023-01-05 18:15:00,1000,1006,6,0,TRUE,NA,"0.1.4"
"12171","646",2023-01-05 18:30:00,1000,1006,6,0,TRUE,NA,"0.1.4"
"12172","646",2023-01-05 18:45:00,1000,1006,6,0,TRUE,NA,"0.1.4"
"12173","646",2023-01-05 19:00:00,1000,1006,6,0,TRUE,NA,"0.1.4"
"12174","646",2023-01-05 19:15:00,1000,1006,6,0,FALSE,NA,"0.1.4"
"12175","646",2023-01-05 19:30:00,1000,1006,6,0,FALSE,NA,"0.1.4"
"12176","646",2023-01-05 19:45:00,1000,1006,6,0,FALSE,NA,"0.1.4"
"12177","646",2023-01-05 20:00:00,1000,1006,6,0,FALSE,NA,"0.1.4"
"12178","646",2023-01-05 20:15:00,1000,1006,6,0,FALSE,NA,"0.1.4"
"12179","646",2023-01-05 20:30:00,1000,1006,6,0,FALSE,NA,"0.1.4"
"12180","646",2023-01-05 20:45:00,1000,1006,6,0,FALSE,NA,"0.1.4"
"12181","646",2023-01-05 21:00:00,1000,1006,6,0,FALSE,NA,"0.1.4"
"12182","646",2023-01-05 21:15:00,1000,1006,6,0,FALSE,NA,"0.1.4"
"12183","646",2023-01-05 21:30:00,1000,1006,6,0,FALSE,NA,"0.1.4"
"12184","646",2023-01-05 21:45:00,1000,1006,6,0,FALSE,NA,"0.1.4"
"12185","646",2023-01-05 22:00:00,1000,1006,6,0,FALSE,NA,"0.1.4"
"12186","646",2023-01-05 22:15:00,1000,1006,6,0,FALSE,NA,"0.1.4"
"12187","646",2023-01-05 22:30:00,1000,1006,6,0,FALSE,NA,"0.1.4"
"12188","646",2023-01-05 22:45:00,1000,1006,6,0,FALSE,NA,"0.1.4"
"12189","646",2023-01-05 23:00:00,1000,1006,6,0,FALSE,NA,"0.1.4"
"12190","646",2023-01-05 23:15:00,1000,1006,6,0,FALSE,NA,"0.1.4"
"12191","646",2023-01-05 23:30:00,1000,1006,6,0,FALSE,NA,"0.1.4"
"12192","646",2023-01-05 23:45:00,1000,1006,6,0,FALSE,NA,"0.1.4"
"12193","646",2023-01-06,1000,1006,6,0,FALSE,NA,"0.1.4"
"12194","646",2023-01-06 00:15:00,1000,1006,6,0,FALSE,NA,"0.1.4"
"12195","646",2023-01-06 00:30:00,1000,1006,6,0,FALSE,NA,"0.1.4"
"12196","646",2023-01-06 00:45:00,1000,1006,6,0,FALSE,NA,"0.1.4"
"12197","646",2023-01-06 01:00:00,1000,1006,6,0,FALSE,NA,"0.1.4"
"12198","646",2023-01-06 01:15:00,1000,1006,6,0,FALSE,NA,"0.1.4"
"12199","646",2023-01-06 01:30:00,1000,1006,6,0,FALSE,NA,"0.1.4"
"12200","646",2023-01-06 01:45:00,1000,1006,6,0,FALSE,NA,"0.1.4"
"12201","646",2023-01-06 02:00:00,1000,1006,6,0,FALSE,NA,"0.1.4"
"12202","646",2023-01-06 02:15:00,1000,1006,6,0,FALSE,NA,"0.1.4"
"12203","646",2023-01-06 02:30:00,1000,1006,6,0,FALSE,NA,"0.1.4"
"12204","646",2023-01-06 02:45:00,1000,1006,6,0,FALSE,NA,"0.1.4"
"12205","646",2023-01-06 03:00:00,1000,1006,6,0,FALSE,NA,"0.1.4"
"12206","646",2023-01-06 03:15:00,1000,1006,6,0,FALSE,NA,"0.1.4"
"12207","646",2023-01-06 03:30:00,1000,1006,6,0,FALSE,NA,"0.1.4"
"12208","646",2023-01-06 03:45:00,1000,1006,6,0,FALSE,NA,"0.1.4"
"12209","646",2023-01-06 04:00:00,1000,1006,6,0,FALSE,NA,"0.1.4"
"12210","646",2023-01-06 04:15:00,1000,1006,6,0,FALSE,NA,"0.1.4"
"12211","646",2023-01-06 04:30:00,1000,1006,6,0,FALSE,NA,"0.1.4"
"12212","646",2023-01-06 04:45:00,1000,1006,6,0,FALSE,NA,"0.1.4"
"12213","646",2023-01-06 05:00:00,1000,1006,6,0,FALSE,NA,"0.1.4"
"12214","646",2023-01-06 05:15:00,1000,1006,6,0,FALSE,NA,"0.1.4"
"12215","646",2023-01-06 05:30:00,1000,1006,6,0,FALSE,NA,"0.1.4"
"12216","646",2023-01-06 05:45:00,1000,1006,6,0,FALSE,NA,"0.1.4"
"12217","646",2023-01-06 06:00:00,1000,1006,6,0,FALSE,NA,"0.1.4"
"12218","646",2023-01-06 06:15:00,1000,1006,6,0,FALSE,NA,"0.1.4"
"12219","646",2023-01-06 06:30:00,1000,1006,6,0,FALSE,NA,"0.1.4"
"12220","646",2023-01-06 06:45:00,1000,1006,6,0,FALSE,NA,"0.1.4"
"12221","646",2023-01-06 07:00:00,1000,1006,6,0,FALSE,NA,"0.1.4"
"12222","646",2023-01-06 07:15:00,1000,1006,6,0,FALSE,NA,"0.1.4"
"12223","646",2023-01-06 07:30:00,1000,1006,6,0,FALSE,NA,"0.1.4"
"12224","646",2023-01-06 07:45:00,1000,1006,6,0,FALSE,NA,"0.1.4"
"12225","646",2023-01-06 08:00:00,1000,1006,6,0,FALSE,NA,"0.1.4"
"12226","646",2023-01-06 08:15:00,1000,1006,6,0,FALSE,NA,"0.1.4"
"12227","646",2023-01-06 08:30:00,1000,1006,6,0,FALSE,NA,"0.1.4"
"12228","646",2023-01-06 08:45:00,1000,1006,6,0,FALSE,NA,"0.1.4"
"12229","646",2023-01-06 09:00:00,1000,1006,6,0,TRUE,NA,"0.1.4"
"12230","646",2023-01-06 09:15:00,1000,1006,6,0,TRUE,NA,"0.1.4"
"12231","646",2023-01-06 09:30:00,1000,1006,6,0,TRUE,NA,"0.1.4"
"12232","646",2023-01-06 09:45:00,1000,1006,6,0,TRUE,NA,"0.1.4"
"12233","646",2023-01-06 10:00:00,1000,1006,6,0,TRUE,NA,"0.1.4"
"12234","646",2023-01-06 10:15:00,1000,1006,6,0,TRUE,NA,"0.1.4"
"12235","646",2023-01-06 10:30:00,1000,1006,6,0,TRUE,NA,"0.1.4"
"12236","646",2023-01-06 10:45:00,1000,1006,6,0,TRUE,NA,"0.1.4"
"12237","646",2023-01-06 11:00:00,1000,1006,6,0,TRUE,NA,"0.1.4"
"12238","646",2023-01-06 11:15:00,1000,1006,6,0,TRUE,NA,"0.1.4"
"12239","646",2023-01-06 11:30:00,1000,1006,6,0,TRUE,NA,"0.1.4"
"12240","646",2023-01-06 11:45:00,1000,1006,6,0,TRUE,NA,"0.1.4"
"12241","646",2023-01-06 12:00:00,1000,1006,6,0,TRUE,NA,"0.1.4"
"12242","646",2023-01-06 12:15:00,1000,1006,6,0,TRUE,NA,"0.1.4"
"12243","646",2023-01-06 12:30:00,1000,1006,6,0,TRUE,NA,"0.1.4"
"12244","646",2023-01-06 12:45:00,1000,1006,6,0,TRUE,NA,"0.1.4"
"12245","646",2023-01-06 13:00:00,1000,1006,6,0,TRUE,NA,"0.1.4"
"12246","646",2023-01-06 13:15:00,1000,1006,6,0,TRUE,NA,"0.1.4"
"12247","646",2023-01-06 13:30:00,1000,1006,6,0,TRUE,NA,"0.1.4"
"12248","646",2023-01-06 13:45:00,1000,1006,6,0,TRUE,NA,"0.1.4"
"12249","646",2023-01-06 14:00:00,1000,1006,6,0,TRUE,NA,"0.1.4"
"12250","646",2023-01-06 14:15:00,1000,1006,6,0,TRUE,NA,"0.1.4"
"12251","646",2023-01-06 14:30:00,1000,1006,6,0,TRUE,NA,"0.1.4"
"12252","646",2023-01-06 14:45:00,1000,1006,6,0,TRUE,NA,"0.1.4"
"12253","646",2023-01-06 15:00:00,1000,1006,6,0,TRUE,NA,"0.1.4"
"12254","646",2023-01-06 15:15:00,1000,1006,6,0,TRUE,NA,"0.1.4"
"12255","646",2023-01-06 15:30:00,1000,1006,6,0,TRUE,NA,"0.1.4"
"12256","646",2023-01-06 15:45:00,1000,1006,6,0,TRUE,NA,"0.1.4"
"12257","646",2023-01-06 16:00:00,1000,1006,6,0,TRUE,NA,"0.1.4"
"12258","646",2023-01-06 16:15:00,1000,1006,6,0,TRUE,NA,"0.1.4"
"12259","646",2023-01-06 16:30:00,1000,1006,6,0,TRUE,NA,"0.1.4"
"12260","646",2023-01-06 16:45:00,1000,1006,6,0,TRUE,NA,"0.1.4"
"12261","646",2023-01-06 17:00:00,1000,1006,6,0,TRUE,NA,"0.1.4"
"12262","646",2023-01-06 17:15:00,1000,1006,6,0,TRUE,NA,"0.1.4"
"12263","646",2023-01-06 17:30:00,1000,1006,6,0,TRUE,NA,"0.1.4"
"12264","646",2023-01-06 17:45:00,1000,1006,6,0,TRUE,NA,"0.1.4"
"12265","646",2023-01-06 18:00:00,1000,1006,6,0,TRUE,NA,"0.1.4"
"12266","646",2023-01-06 18:15:00,1000,1006,6,0,TRUE,NA,"0.1.4"
"12267","646",2023-01-06 18:30:00,1000,1006,6,0,TRUE,NA,"0.1.4"
"12268","646",2023-01-06 18:45:00,1000,1006,6,0,TRUE,NA,"0.1.4"
"12269","646",2023-01-06 19:00:00,1000,1006,6,0,TRUE,NA,"0.1.4"
"12270","646",2023-01-06 19:15:00,1000,1006,6,0,TRUE,NA,"0.1.4"
"12271","646",2023-01-06 19:30:00,1000,1006,6,0,TRUE,NA,"0.1.4"
"12272","646",2023-01-06 19:45:00,1000,1006,6,0,TRUE,NA,"0.1.4"
"12273","646",2023-01-06 20:00:00,1000,1006,6,0,TRUE,NA,"0.1.4"
"12274","646",2023-01-06 20:15:00,1000,1006,6,0,TRUE,NA,"0.1.4"
"12275","646",2023-01-06 20:30:00,1000,1006,6,0,TRUE,NA,"0.1.4"
"12276","646",2023-01-06 20:45:00,1000,1006,6,0,TRUE,NA,"0.1.4"
"12277","646",2023-01-06 21:00:00,1000,1006,6,0,TRUE,NA,"0.1.4"
"12278","646",2023-01-06 21:15:00,1000,1006,6,0,FALSE,NA,"0.1.4"
"12279","646",2023-01-06 21:30:00,1000,1006,6,0,FALSE,NA,"0.1.4"
"12280","646",2023-01-06 21:45:00,1000,1006,6,0,FALSE,NA,"0.1.4"
"12281","646",2023-01-06 22:00:00,1000,1006,6,0,FALSE,NA,"0.1.4"
"12282","646",2023-01-06 22:15:00,1000,1006,6,0,FALSE,NA,"0.1.4"
"12283","646",2023-01-06 22:30:00,1000,1006,6,0,FALSE,NA,"0.1.4"
"12284","646",2023-01-06 22:45:00,1000,1006,6,0,FALSE,NA,"0.1.4"
"12285","646",2023-01-06 23:00:00,1000,1006,6,0,FALSE,NA,"0.1.4"
"12286","646",2023-01-06 23:15:00,1000,1006,6,0,FALSE,NA,"0.1.4"
"12287","646",2023-01-06 23:30:00,1000,1006,6,0,FALSE,NA,"0.1.4"
"12288","646",2023-01-06 23:45:00,1000,1006,6,0,FALSE,NA,"0.1.4"
"12289","646",2023-01-07,1000,1006,6,0,FALSE,NA,"0.1.4"
"12290","646",2023-01-07 00:15:00,1000,1006,6,0,FALSE,NA,"0.1.4"
"12291","646",2023-01-07 00:30:00,1000,1006,6,0,FALSE,NA,"0.1.4"
"12292","646",2023-01-07 00:45:00,1000,1006,6,0,FALSE,NA,"0.1.4"
"12293","646",2023-01-07 01:00:00,1000,1006,6,0,FALSE,NA,"0.1.4"
"12294","646",2023-01-07 01:15:00,1000,1006,6,0,FALSE,NA,"0.1.4"
"12295","646",2023-01-07 01:30:00,1000,1006,6,0,FALSE,NA,"0.1.4"
"12296","646",2023-01-07 01:45:00,1000,1006,6,0,FALSE,NA,"0.1.4"
"12297","646",2023-01-07 02:00:00,1000,1006,6,0,FALSE,NA,"0.1.4"
"12298","646",2023-01-07 02:15:00,1000,1006,6,0,FALSE,NA,"0.1.4"
"12299","646",2023-01-07 02:30:00,1000,1006,6,0,FALSE,NA,"0.1.4"
"12300","646",2023-01-07 02:45:00,1000,1006,6,0,FALSE,NA,"0.1.4"
"12301","646",2023-01-07 03:00:00,1000,1006,6,0,FALSE,NA,"0.1.4"
"12302","646",2023-01-07 03:15:00,1000,1006,6,0,TRUE,NA,"0.1.4"
"12303","646",2023-01-07 03:30:00,1000,1006,6,0,TRUE,NA,"0.1.4"
"12304","646",2023-01-07 03:45:00,1000,1006,6,0,TRUE,NA,"0.1.4"
"12305","646",2023-01-07 04:00:00,1000,1006,6,0,TRUE,NA,"0.1.4"
"12306","646",2023-01-07 04:15:00,1000,1006,6,0,TRUE,NA,"0.1.4"
"12307","646",2023-01-07 04:30:00,1000,1006,6,0,TRUE,NA,"0.1.4"
"12308","646",2023-01-07 04:45:00,1000,1006,6,0,TRUE,NA,"0.1.4"
"12309","646",2023-01-07 05:00:00,1000,1006,6,0,TRUE,NA,"0.1.4"
"12310","646",2023-01-07 05:15:00,1000,1006,6,0,TRUE,NA,"0.1.4"
"12311","646",2023-01-07 05:30:00,1000,1006,6,0,TRUE,NA,"0.1.4"
"12312","646",2023-01-07 05:45:00,1000,1006,6,0,TRUE,NA,"0.1.4"
"12313","646",2023-01-07 06:00:00,1000,1006,6,0,TRUE,NA,"0.1.4"
"12314","646",2023-01-07 06:15:00,1000,1006,6,0,TRUE,NA,"0.1.4"
"12315","646",2023-01-07 06:30:00,1000,1006,6,0,TRUE,NA,"0.1.4"
"12316","646",2023-01-07 06:45:00,1000,1006,6,0,TRUE,NA,"0.1.4"
"12317","646",2023-01-07 07:00:00,1000,1006,6,0,TRUE,NA,"0.1.4"
"12318","646",2023-01-07 07:15:00,1000,1006,6,0,TRUE,NA,"0.1.4"
"12319","646",2023-01-07 07:30:00,1000,1006,6,0,TRUE,NA,"0.1.4"
"12320","646",2023-01-07 07:45:00,1000,1006,6,0,TRUE,NA,"0.1.4"
"12321","646",2023-01-07 08:00:00,1000,1006,6,0,TRUE,NA,"0.1.4"
"12322","646",2023-01-07 08:15:00,1000,1006,6,0,TRUE,NA,"0.1.4"
"12323","646",2023-01-07 08:30:00,1000,1006,6,0,TRUE,NA,"0.1.4"
"12324","646",2023-01-07 08:45:00,1000,1006,6,0,TRUE,NA,"0.1.4"
"12325","646",2023-01-07 09:00:00,1000,1006,6,0,TRUE,NA,"0.1.4"
"12326","646",2023-01-07 09:15:00,1000,1006,6,0,TRUE,NA,"0.1.4"
"12327","646",2023-01-07 09:30:00,1000,1006,6,0,TRUE,NA,"0.1.4"
"12328","646",2023-01-07 09:45:00,1000,1006,6,0,TRUE,NA,"0.1.4"
"12329","646",2023-01-07 10:00:00,1000,1006,6,0,TRUE,NA,"0.1.4"
"12330","646",2023-01-07 10:15:00,1000,1006,6,0,TRUE,NA,"0.1.4"
"12331","646",2023-01-07 10:30:00,1000,1006,6,0,TRUE,NA,"0.1.4"
"12332","646",2023-01-07 10:45:00,1000,1006,6,0,TRUE,NA,"0.1.4"
"12333","646",2023-01-07 11:00:00,1000,1006,6,0,TRUE,NA,"0.1.4"
"12334","646",2023-01-07 11:15:00,1000,1006,6,0,TRUE,NA,"0.1.4"
"12335","646",2023-01-07 11:30:00,1000,1006,6,0,TRUE,NA,"0.1.4"
"12336","646",2023-01-07 11:45:00,1000,1006,6,0,TRUE,NA,"0.1.4"
"12337","646",2023-01-07 12:00:00,1000,1006,6,0,TRUE,NA,"0.1.4"
"12338","646",2023-01-07 12:15:00,1000,1006,6,0,TRUE,NA,"0.1.4"
"12339","646",2023-01-07 12:30:00,1000,1006,6,0,TRUE,NA,"0.1.4"
"12340","646",2023-01-07 12:45:00,1000,1006,6,0,TRUE,NA,"0.1.4"
"12341","646",2023-01-07 13:00:00,1000,1006,6,0,TRUE,NA,"0.1.4"
"12342","646",2023-01-07 13:15:00,1000,1006,6,0,TRUE,NA,"0.1.4"
"12343","646",2023-01-07 13:30:00,1000,1006,6,0,TRUE,NA,"0.1.4"
"12344","646",2023-01-07 13:45:00,1000,1006,6,0,TRUE,NA,"0.1.4"
"12345","646",2023-01-07 14:00:00,1000,1006,6,0,TRUE,NA,"0.1.4"
"12346","646",2023-01-07 14:15:00,1000,1006,6,0,TRUE,NA,"0.1.4"
"12347","646",2023-01-07 14:30:00,1000,1006,6,0,TRUE,NA,"0.1.4"
"12348","646",2023-01-07 14:45:00,1000,1006,6,0,TRUE,NA,"0.1.4"
"12349","646",2023-01-07 15:00:00,1000,1006,6,0,TRUE,NA,"0.1.4"
"12350","646",2023-01-07 15:15:00,1000,1006,6,0,TRUE,NA,"0.1.4"
"12351","646",2023-01-07 15:30:00,1000,1006,6,0,TRUE,NA,"0.1.4"
"12352","646",2023-01-07 15:45:00,1000,1006,6,0,TRUE,NA,"0.1.4"
"12353","646",2023-01-07 16:00:00,1000,1006,6,0,TRUE,NA,"0.1.4"
"12354","646",2023-01-07 16:15:00,1000,1006,6,0,TRUE,NA,"0.1.4"
"12355","646",2023-01-07 16:30:00,1000,1006,6,0,TRUE,NA,"0.1.4"
"12356","646",2023-01-07 16:45:00,1000,1006,6,0,TRUE,NA,"0.1.4"
"12357","646",2023-01-07 17:00:00,1000,1006,6,0,TRUE,NA,"0.1.4"
"12358","646",2023-01-07 17:15:00,1000,1006,6,0,TRUE,NA,"0.1.4"
"12359","646",2023-01-07 17:30:00,1000,1006,6,0,TRUE,NA,"0.1.4"
"12360","646",2023-01-07 17:45:00,1000,1006,6,0,TRUE,NA,"0.1.4"
"12361","646",2023-01-07 18:00:00,1000,1006,6,0,TRUE,NA,"0.1.4"
"12362","646",2023-01-07 18:15:00,1000,1006,6,0,TRUE,NA,"0.1.4"
"12363","646",2023-01-07 18:30:00,1000,1006,6,0,FALSE,NA,"0.1.4"
"12364","646",2023-01-07 18:45:00,1000,1006,6,0,FALSE,NA,"0.1.4"
"12365","646",2023-01-07 19:00:00,1000,1006,6,0,FALSE,NA,"0.1.4"
"12366","646",2023-01-07 19:15:00,1000,1006,6,0,FALSE,NA,"0.1.4"
"12367","646",2023-01-07 19:30:00,1000,1006,6,0,FALSE,NA,"0.1.4"
"12368","646",2023-01-07 19:45:00,1000,1006,6,0,FALSE,NA,"0.1.4"
"12369","646",2023-01-07 20:00:00,1000,1006,6,0,FALSE,NA,"0.1.4"
"12370","646",2023-01-07 20:15:00,1000,1006,6,0,FALSE,NA,"0.1.4"
"12371","646",2023-01-07 20:30:00,1000,1006,6,0,FALSE,NA,"0.1.4"
"12372","646",2023-01-07 20:45:00,1000,1006,6,0,FALSE,NA,"0.1.4"
"12373","646",2023-01-07 21:00:00,1000,1006,6,0,FALSE,NA,"0.1.4"
"12374","646",2023-01-07 21:15:00,1000,1006,6,0,FALSE,NA,"0.1.4"
"12375","646",2023-01-07 21:30:00,1000,1006,6,0,FALSE,NA,"0.1.4"
"12376","646",2023-01-07 21:45:00,1000,1006,6,0,FALSE,NA,"0.1.4"
"12377","646",2023-01-07 22:00:00,1000,1006,6,0,FALSE,NA,"0.1.4"
"12378","646",2023-01-07 22:15:00,1000,1006,6,0,FALSE,NA,"0.1.4"
"12379","646",2023-01-07 22:30:00,1000,1006,6,0,FALSE,NA,"0.1.4"
"12380","646",2023-01-07 22:45:00,1000,1006,6,0,FALSE,NA,"0.1.4"
"12381","646",2023-01-07 23:00:00,1000,1006,6,0,FALSE,NA,"0.1.4"
"12382","646",2023-01-07 23:15:00,1000,1006,6,0,FALSE,NA,"0.1.4"
"12383","646",2023-01-07 23:30:00,1000,1006,6,0,FALSE,NA,"0.1.4"
"12384","646",2023-01-07 23:45:00,1000,1006,6,0,FALSE,NA,"0.1.4"
"12385","646",2023-01-08,1000,1006,6,0,FALSE,NA,"0.1.4"
"12386","646",2023-01-08 00:15:00,1000,1006,6,0,FALSE,NA,"0.1.4"
"12387","646",2023-01-08 00:30:00,1000,1006,6,0,FALSE,NA,"0.1.4"
"12388","646",2023-01-08 00:45:00,1000,1006,6,0,FALSE,NA,"0.1.4"
"12389","646",2023-01-08 01:00:00,1000,1006,6,0,FALSE,NA,"0.1.4"
"12390","646",2023-01-08 01:15:00,1000,1006,6,0,FALSE,NA,"0.1.4"
"12391","646",2023-01-08 01:30:00,1000,1006,6,0,FALSE,NA,"0.1.4"
"12392","646",2023-01-08 01:45:00,1000,1006,6,0,FALSE,NA,"0.1.4"
"12393","646",2023-01-08 02:00:00,1000,1006,6,0,FALSE,NA,"0.1.4"
"12394","646",2023-01-08 02:15:00,1000,1006,6,0,FALSE,NA,"0.1.4"
"12395","646",2023-01-08 02:30:00,1000,1006,6,0,FALSE,NA,"0.1.4"
"12396","646",2023-01-08 02:45:00,1000,1006,6,0,FALSE,NA,"0.1.4"
"12397","646",2023-01-08 03:00:00,1000,1006,6,0,FALSE,NA,"0.1.4"
"12398","646",2023-01-08 03:15:00,1000,1006,6,0,FALSE,NA,"0.1.4"
"12399","646",2023-01-08 03:30:00,1000,1006,6,0,FALSE,NA,"0.1.4"
"12400","646",2023-01-08 03:45:00,1000,1006,6,0,FALSE,NA,"0.1.4"
"12401","646",2023-01-08 04:00:00,1000,1006,6,0,FALSE,NA,"0.1.4"
"12402","646",2023-01-08 04:15:00,1000,1006,6,0,FALSE,NA,"0.1.4"
"12403","646",2023-01-08 04:30:00,1000,1006,6,0,FALSE,NA,"0.1.4"
"12404","646",2023-01-08 04:45:00,1000,1006,6,0,FALSE,NA,"0.1.4"
"12405","646",2023-01-08 05:00:00,1000,1006,6,0,FALSE,NA,"0.1.4"
"12406","646",2023-01-08 05:15:00,1000,1006,6,0,FALSE,NA,"0.1.4"
"12407","646",2023-01-08 05:30:00,1000,1006,6,0,FALSE,NA,"0.1.4"
"12408","646",2023-01-08 05:45:00,1000,1006,6,0,FALSE,NA,"0.1.4"
"12409","646",2023-01-08 06:00:00,1000,1006,6,0,FALSE,NA,"0.1.4"
"12410","646",2023-01-08 06:15:00,1000,1006,6,0,FALSE,NA,"0.1.4"
"12411","646",2023-01-08 06:30:00,1000,1006,6,0,FALSE,NA,"0.1.4"
"12412","646",2023-01-08 06:45:00,1000,1006,6,0,FALSE,NA,"0.1.4"
"12413","646",2023-01-08 07:00:00,1000,1006,6,0,FALSE,NA,"0.1.4"
"12414","646",2023-01-08 07:15:00,1000,1006,6,0,FALSE,NA,"0.1.4"
"12415","646",2023-01-08 07:30:00,1000,1006,6,0,TRUE,NA,"0.1.4"
"12416","646",2023-01-08 07:45:00,1000,1006,6,0,FALSE,NA,"0.1.4"
"12417","646",2023-01-08 08:00:00,1000,1006,6,0,TRUE,NA,"0.1.4"
"12418","646",2023-01-08 08:15:00,1000,1006,6,0,TRUE,NA,"0.1.4"
"12419","646",2023-01-08 08:30:00,1000,1006,6,0,TRUE,NA,"0.1.4"
"12420","646",2023-01-08 08:45:00,1000,1006,6,0,TRUE,NA,"0.1.4"
"12421","646",2023-01-08 09:00:00,1000,1006,6,0,TRUE,NA,"0.1.4"
"12422","646",2023-01-08 09:15:00,1000,1006,6,0,TRUE,NA,"0.1.4"
"12423","646",2023-01-08 09:30:00,1000,1006,6,0,TRUE,NA,"0.1.4"
"12424","646",2023-01-08 09:45:00,1000,1006,6,0,TRUE,NA,"0.1.4"
"12425","646",2023-01-08 10:00:00,1000,1006,6,0,TRUE,NA,"0.1.4"
"12426","646",2023-01-08 10:15:00,1000,1006,6,0,TRUE,NA,"0.1.4"
"12427","646",2023-01-08 10:30:00,1000,1006,6,0,TRUE,NA,"0.1.4"
"12428","646",2023-01-08 10:45:00,1000,1006,6,0,TRUE,NA,"0.1.4"
"12429","646",2023-01-08 11:00:00,1000,1006,6,0,TRUE,NA,"0.1.4"
"12430","646",2023-01-08 11:15:00,1000,1006,6,0,TRUE,NA,"0.1.4"
"12431","646",2023-01-08 11:30:00,1000,1006,6,0,TRUE,NA,"0.1.4"
"12432","646",2023-01-08 11:45:00,1000,1006,6,0,TRUE,NA,"0.1.4"
"12433","646",2023-01-08 12:00:00,1000,1006,6,0,TRUE,NA,"0.1.4"
"12434","646",2023-01-08 12:15:00,1000,1006,6,0,TRUE,NA,"0.1.4"
"12435","646",2023-01-08 12:30:00,1000,1006,6,0,TRUE,NA,"0.1.4"
"12436","646",2023-01-08 12:45:00,1000,1006,6,0,TRUE,NA,"0.1.4"
"12437","646",2023-01-08 13:00:00,1000,1006,6,0,TRUE,NA,"0.1.4"
"12438","646",2023-01-08 13:15:00,1000,1006,6,0,TRUE,NA,"0.1.4"
"12439","646",2023-01-08 13:30:00,1000,1006,6,0,TRUE,NA,"0.1.4"
"12440","646",2023-01-08 13:45:00,1000,1006,6,0,TRUE,NA,"0.1.4"
"12441","646",2023-01-08 14:00:00,1000,1006,6,0,TRUE,NA,"0.1.4"
"12442","646",2023-01-08 14:15:00,1000,1006,6,0,TRUE,NA,"0.1.4"
"12443","646",2023-01-08 14:30:00,1000,1006,6,0,TRUE,NA,"0.1.4"
"12444","646",2023-01-08 14:45:00,1000,1006,6,0,TRUE,NA,"0.1.4"
"12445","646",2023-01-08 15:00:00,1000,1006,6,0,TRUE,NA,"0.1.4"
"12446","646",2023-01-08 15:15:00,1000,1006,6,0,TRUE,NA,"0.1.4"
"12447","646",2023-01-08 15:30:00,1000,1006,6,0,TRUE,NA,"0.1.4"
"12448","646",2023-01-08 15:45:00,1000,1006,6,0,TRUE,NA,"0.1.4"
"12449","646",2023-01-08 16:00:00,1000,1006,6,0,TRUE,NA,"0.1.4"
"12450","646",2023-01-08 16:15:00,1000,1006,6,0,TRUE,NA,"0.1.4"
"12451","646",2023-01-08 16:30:00,1000,1006,6,0,TRUE,NA,"0.1.4"
"12452","646",2023-01-08 16:45:00,1000,1006,6,0,TRUE,NA,"0.1.4"
"12453","646",2023-01-08 17:00:00,1000,1006,6,0,TRUE,NA,"0.1.4"
"12454","646",2023-01-08 17:15:00,1000,1006,6,0,TRUE,NA,"0.1.4"
"12455","646",2023-01-08 17:30:00,1000,1006,6,0,TRUE,NA,"0.1.4"
"12456","646",2023-01-08 17:45:00,1000,1006,6,0,TRUE,NA,"0.1.4"
"12457","646",2023-01-08 18:00:00,1000,1006,6,0,FALSE,NA,"0.1.4"
"12458","646",2023-01-08 18:15:00,1000,1006,6,0,FALSE,NA,"0.1.4"
"12459","646",2023-01-08 18:30:00,1000,1006,6,0,FALSE,NA,"0.1.4"
"12460","646",2023-01-08 18:45:00,1000,1006,6,0,FALSE,NA,"0.1.4"
"12461","646",2023-01-08 19:00:00,1000,1006,6,0,FALSE,NA,"0.1.4"
"12462","646",2023-01-08 19:15:00,1000,1006,6,0,FALSE,NA,"0.1.4"
"12463","646",2023-01-08 19:30:00,1000,1006,6,0,FALSE,NA,"0.1.4"
"12464","646",2023-01-08 19:45:00,1000,1006,6,0,FALSE,NA,"0.1.4"
"12465","646",2023-01-08 20:00:00,1000,1006,6,0,FALSE,NA,"0.1.4"
"12466","646",2023-01-08 20:15:00,1000,1006,6,0,FALSE,NA,"0.1.4"
"12467","646",2023-01-08 20:30:00,1000,1006,6,0,FALSE,NA,"0.1.4"
"12468","646",2023-01-08 20:45:00,1000,1006,6,0,FALSE,NA,"0.1.4"
"12469","646",2023-01-08 21:00:00,1000,1006,6,0,FALSE,NA,"0.1.4"
"12470","646",2023-01-08 21:15:00,1000,1006,6,0,FALSE,NA,"0.1.4"
"12471","646",2023-01-08 21:30:00,1000,1006,6,0,FALSE,NA,"0.1.4"
"12472","646",2023-01-08 21:45:00,1000,1006,6,0,FALSE,NA,"0.1.4"
"12473","646",2023-01-08 22:00:00,1000,1006,6,0,FALSE,NA,"0.1.4"
"12474","646",2023-01-08 22:15:00,1000,1006,6,0,FALSE,NA,"0.1.4"
"12475","646",2023-01-08 22:30:00,1000,1006,6,0,FALSE,NA,"0.1.4"
"12476","646",2023-01-08 22:45:00,1000,1006,6,0,FALSE,NA,"0.1.4"
"12477","646",2023-01-08 23:00:00,1000,1006,6,0,FALSE,NA,"0.1.4"
"12478","646",2023-01-08 23:15:00,1000,1006,6,0,FALSE,NA,"0.1.4"
"12479","646",2023-01-08 23:30:00,1000,1006,6,0,FALSE,NA,"0.1.4"
"12480","646",2023-01-08 23:45:00,1000,1006,6,0,FALSE,NA,"0.1.4"
"12481","646",2023-01-09,1000,1006,6,0,FALSE,NA,"0.1.4"
"12482","646",2023-01-09 00:15:00,1000,1006,6,0,FALSE,NA,"0.1.4"
"12483","646",2023-01-09 00:30:00,1000,1006,6,0,FALSE,NA,"0.1.4"
"12484","646",2023-01-09 00:45:00,1000,1006,6,0,FALSE,NA,"0.1.4"
"12485","646",2023-01-09 01:00:00,1000,1006,6,0,FALSE,NA,"0.1.4"
"12486","646",2023-01-09 01:15:00,1000,1006,6,0,FALSE,NA,"0.1.4"
"12487","646",2023-01-09 01:30:00,1000,1006,6,0,FALSE,NA,"0.1.4"
"12488","646",2023-01-09 01:45:00,1000,1006,6,0,FALSE,NA,"0.1.4"
"12489","646",2023-01-09 02:00:00,1000,1006,6,0,FALSE,NA,"0.1.4"
"12490","646",2023-01-09 02:15:00,1000,1006,6,0,FALSE,NA,"0.1.4"
"12491","646",2023-01-09 02:30:00,1000,1006,6,0,FALSE,NA,"0.1.4"
"12492","646",2023-01-09 02:45:00,1000,1006,6,0,FALSE,NA,"0.1.4"
"12493","646",2023-01-09 03:00:00,1000,1006,6,0,FALSE,NA,"0.1.4"
"12494","646",2023-01-09 03:15:00,1000,1006,6,0,TRUE,NA,"0.1.4"
"12495","646",2023-01-09 03:30:00,1000,1006,6,0,TRUE,NA,"0.1.4"
"12496","646",2023-01-09 03:45:00,1000,1006,6,0,TRUE,NA,"0.1.4"
"12497","646",2023-01-09 04:00:00,1000,1006,6,0,TRUE,NA,"0.1.4"
"12498","646",2023-01-09 04:15:00,1000,1006,6,0,TRUE,NA,"0.1.4"
"12499","646",2023-01-09 04:30:00,1000,1006,6,0,TRUE,NA,"0.1.4"
"12500","646",2023-01-09 04:45:00,1000,1006,6,0,TRUE,NA,"0.1.4"
"12501","646",2023-01-09 05:00:00,1000,1006,6,0,TRUE,NA,"0.1.4"
"12502","646",2023-01-09 05:15:00,1000,1006,6,0,TRUE,NA,"0.1.4"
"12503","646",2023-01-09 05:30:00,1000,1006,6,0,TRUE,NA,"0.1.4"
"12504","646",2023-01-09 05:45:00,1000,1006,6,0,TRUE,NA,"0.1.4"
"12505","646",2023-01-09 06:00:00,1000,1006,6,0,TRUE,NA,"0.1.4"
"12506","646",2023-01-09 06:15:00,1000,1006,6,0,TRUE,NA,"0.1.4"
"12507","646",2023-01-09 06:30:00,1000,1006,6,0,TRUE,NA,"0.1.4"
"12508","646",2023-01-09 06:45:00,1000,1006,6,0,TRUE,NA,"0.1.4"
"12509","646",2023-01-09 07:00:00,1000,1006,6,0,TRUE,NA,"0.1.4"
"12510","646",2023-01-09 07:15:00,1000,1006,6,0,TRUE,NA,"0.1.4"
"12511","646",2023-01-09 07:30:00,1000,1006,6,0,TRUE,NA,"0.1.4"
"12512","646",2023-01-09 07:45:00,1000,1006,6,0,TRUE,NA,"0.1.4"
"12513","646",2023-01-09 08:00:00,1000,1006,6,0,TRUE,NA,"0.1.4"
"12514","646",2023-01-09 08:15:00,1000,1006,6,0,TRUE,NA,"0.1.4"
"12515","646",2023-01-09 08:30:00,1000,1006,6,0,TRUE,NA,"0.1.4"
"12516","646",2023-01-09 08:45:00,1000,1006,6,0,TRUE,NA,"0.1.4"
"12517","646",2023-01-09 09:00:00,1000,1006,6,0,TRUE,NA,"0.1.4"
"12518","646",2023-01-09 09:15:00,1000,1006,6,0,TRUE,NA,"0.1.4"
"12519","646",2023-01-09 09:30:00,1000,1006,6,0,TRUE,NA,"0.1.4"
"12520","646",2023-01-09 09:45:00,1000,1006,6,0,TRUE,NA,"0.1.4"
"12521","646",2023-01-09 10:00:00,1000,1006,6,0,TRUE,NA,"0.1.4"
"12522","646",2023-01-09 10:15:00,1000,1006,6,0,TRUE,NA,"0.1.4"
"12523","646",2023-01-09 10:30:00,1000,1006,6,0,TRUE,NA,"0.1.4"
"12524","646",2023-01-09 10:45:00,1000,1006,6,0,TRUE,NA,"0.1.4"
"12525","646",2023-01-09 11:00:00,1000,1006,6,0,TRUE,NA,"0.1.4"
"12526","646",2023-01-09 11:15:00,1000,1006,6,0,TRUE,NA,"0.1.4"
"12527","646",2023-01-09 11:30:00,1000,1006,6,0,TRUE,NA,"0.1.4"
"12528","646",2023-01-09 11:45:00,1000,1006,6,0,TRUE,NA,"0.1.4"
"12529","646",2023-01-09 12:00:00,1000,1006,6,0,TRUE,NA,"0.1.4"
"12530","646",2023-01-09 12:15:00,1000,1006,6,0,TRUE,NA,"0.1.4"
"12531","646",2023-01-09 12:30:00,1000,1006,6,0,TRUE,NA,"0.1.4"
"12532","646",2023-01-09 12:45:00,1000,1006,6,0,TRUE,NA,"0.1.4"
"12533","646",2023-01-09 13:00:00,1000,1006,6,0,TRUE,NA,"0.1.4"
"12534","646",2023-01-09 13:15:00,1000,1006,6,0,TRUE,NA,"0.1.4"
"12535","646",2023-01-09 13:30:00,1000,1006,6,0,TRUE,NA,"0.1.4"
"12536","646",2023-01-09 13:45:00,1000,1006,6,0,TRUE,NA,"0.1.4"
"12537","646",2023-01-09 14:00:00,1000,1006,6,0,TRUE,NA,"0.1.4"
"12538","646",2023-01-09 14:15:00,1000,1006,6,0,TRUE,NA,"0.1.4"
"12539","646",2023-01-09 14:30:00,1000,1006,6,0,TRUE,NA,"0.1.4"
"12540","646",2023-01-09 14:45:00,1000,1006,6,0,TRUE,NA,"0.1.4"
"12541","646",2023-01-09 15:00:00,1000,1006,6,0,TRUE,NA,"0.1.4"
"12542","646",2023-01-09 15:15:00,1000,1006,6,0,TRUE,NA,"0.1.4"
"12543","646",2023-01-09 15:30:00,1000,1006,6,0,TRUE,NA,"0.1.4"
"12544","646",2023-01-09 15:45:00,1000,1006,6,0,TRUE,NA,"0.1.4"
"12545","646",2023-01-09 16:00:00,1000,1006,6,0,TRUE,NA,"0.1.4"
"12546","646",2023-01-09 16:15:00,1000,1006,6,0,TRUE,NA,"0.1.4"
"12547","646",2023-01-09 16:30:00,1000,1006,6,0,TRUE,NA,"0.1.4"
"12548","646",2023-01-09 16:45:00,1000,1006,6,0,TRUE,NA,"0.1.4"
"12549","646",2023-01-09 17:00:00,1000,1006,6,0,TRUE,NA,"0.1.4"
"12550","646",2023-01-09 17:15:00,1000,1006,6,0,TRUE,NA,"0.1.4"
"12551","646",2023-01-09 17:30:00,1000,1006,6,0,TRUE,NA,"0.1.4"
"12552","646",2023-01-09 17:45:00,999,1006,7,0,TRUE,NA,"0.1.4"
"12553","646",2023-01-09 18:00:00,999,1006,7,0,TRUE,NA,"0.1.4"
"12554","646",2023-01-09 18:15:00,999,1006,7,0,TRUE,NA,"0.1.4"
"12555","646",2023-01-09 18:30:00,999,1006,7,0,TRUE,NA,"0.1.4"
"12556","646",2023-01-09 18:45:00,999,1006,7,0,TRUE,NA,"0.1.4"
"12557","646",2023-01-09 19:00:00,999,1006,7,0,FALSE,NA,"0.1.4"
"12558","646",2023-01-09 19:15:00,999,1006,7,0,FALSE,NA,"0.1.4"
"12559","646",2023-01-09 19:30:00,999,1006,7,0,FALSE,NA,"0.1.4"
"12560","646",2023-01-09 19:45:00,999,1006,7,0,FALSE,NA,"0.1.4"
"12561","646",2023-01-09 20:00:00,999,1006,7,0,FALSE,NA,"0.1.4"
"12562","646",2023-01-09 20:15:00,999,1006,7,0,FALSE,NA,"0.1.4"
"12563","646",2023-01-09 20:30:00,999,1006,7,0,FALSE,NA,"0.1.4"
"12564","646",2023-01-09 20:45:00,999,1006,7,0,FALSE,NA,"0.1.4"
"12565","646",2023-01-09 21:00:00,998,1006,8,0,FALSE,NA,"0.1.4"
"12566","646",2023-01-09 21:15:00,999,1006,7,0,FALSE,NA,"0.1.4"
"12567","646",2023-01-09 21:30:00,999,1006,7,0,FALSE,NA,"0.1.4"
"12568","646",2023-01-09 21:45:00,999,1006,7,0,FALSE,NA,"0.1.4"
"12569","646",2023-01-09 22:00:00,999,1006,7,0,FALSE,NA,"0.1.4"
"12570","646",2023-01-09 22:15:00,999,1006,7,0,FALSE,NA,"0.1.4"
"12571","646",2023-01-09 22:30:00,999,1006,7,0,FALSE,NA,"0.1.4"
"12572","646",2023-01-09 22:45:00,999,1006,7,0,FALSE,NA,"0.1.4"
"12573","646",2023-01-09 23:00:00,999,1006,7,0,FALSE,NA,"0.1.4"
"12574","646",2023-01-09 23:15:00,999,1006,7,0,FALSE,NA,"0.1.4"
"12575","646",2023-01-09 23:30:00,999,1006,7,0,FALSE,NA,"0.1.4"
"12576","646",2023-01-09 23:45:00,999,1006,7,0,FALSE,NA,"0.1.4"
"12577","646",2023-01-10,999,1006,7,0,FALSE,NA,"0.1.4"
"12578","646",2023-01-10 00:15:00,999,1006,7,0,FALSE,NA,"0.1.4"
"12579","646",2023-01-10 00:30:00,999,1006,7,0,FALSE,NA,"0.1.4"
"12580","646",2023-01-10 00:45:00,999,1006,7,0,FALSE,NA,"0.1.4"
"12581","646",2023-01-10 01:00:00,999,1006,7,0,FALSE,NA,"0.1.4"
"12582","646",2023-01-10 01:15:00,999,1006,7,0,FALSE,NA,"0.1.4"
"12583","646",2023-01-10 01:30:00,999,1006,7,0,TRUE,NA,"0.1.4"
"12584","646",2023-01-10 01:45:00,999,1006,7,0,TRUE,NA,"0.1.4"
"12585","646",2023-01-10 02:00:00,999,1006,7,0,TRUE,NA,"0.1.4"
"12586","646",2023-01-10 02:15:00,999,1006,7,0,TRUE,NA,"0.1.4"
"12587","646",2023-01-10 02:30:00,999,1006,7,0,TRUE,NA,"0.1.4"
"12588","646",2023-01-10 02:45:00,998,1006,8,0,TRUE,NA,"0.1.4"
"12589","646",2023-01-10 03:00:00,999,1006,7,0,TRUE,NA,"0.1.4"
"12590","646",2023-01-10 03:15:00,999,1006,7,0,TRUE,NA,"0.1.4"
"12591","646",2023-01-10 03:30:00,998,1006,8,0,TRUE,NA,"0.1.4"
"12592","646",2023-01-10 03:45:00,998,1006,8,0,TRUE,NA,"0.1.4"
"12593","646",2023-01-10 04:00:00,999,1006,7,0,TRUE,NA,"0.1.4"
"12594","646",2023-01-10 04:15:00,998,1006,8,0,TRUE,NA,"0.1.4"
"12595","646",2023-01-10 04:30:00,998,1006,8,0,TRUE,NA,"0.1.4"
"12596","646",2023-01-10 04:45:00,998,1006,8,0,TRUE,NA,"0.1.4"
"12597","646",2023-01-10 05:00:00,998,1006,8,0,TRUE,NA,"0.1.4"
"12598","646",2023-01-10 05:15:00,998,1006,8,0,TRUE,NA,"0.1.4"
"12599","646",2023-01-10 05:30:00,998,1006,8,0,TRUE,NA,"0.1.4"
"12600","646",2023-01-10 05:45:00,998,1006,8,0,TRUE,NA,"0.1.4"
"12601","646",2023-01-10 06:00:00,998,1006,8,0,TRUE,NA,"0.1.4"
"12602","646",2023-01-10 06:15:00,998,1006,8,0,TRUE,NA,"0.1.4"
"12603","646",2023-01-10 06:30:00,998,1006,8,0,TRUE,NA,"0.1.4"
"12604","646",2023-01-10 06:45:00,998,1006,8,0,TRUE,NA,"0.1.4"
"12605","646",2023-01-10 07:00:00,998,1006,8,0,TRUE,NA,"0.1.4"
"12606","646",2023-01-10 07:15:00,998,1006,8,0,TRUE,NA,"0.1.4"
"12607","646",2023-01-10 07:30:00,998,1006,8,0,TRUE,NA,"0.1.4"
"12608","646",2023-01-10 07:45:00,998,1006,8,0,TRUE,NA,"0.1.4"
"12609","646",2023-01-10 08:00:00,998,1006,8,0,TRUE,NA,"0.1.4"
"12610","646",2023-01-10 08:15:00,998,1006,8,0,TRUE,NA,"0.1.4"
"12611","646",2023-01-10 08:30:00,998,1006,8,0,TRUE,NA,"0.1.4"
"12612","646",2023-01-10 08:45:00,998,1006,8,0,TRUE,NA,"0.1.4"
"12613","646",2023-01-10 09:00:00,998,1006,8,0,TRUE,NA,"0.1.4"
"12614","646",2023-01-10 09:15:00,998,1006,8,0,TRUE,NA,"0.1.4"
"12615","646",2023-01-10 09:30:00,998,1006,8,0,TRUE,NA,"0.1.4"
"12616","646",2023-01-10 09:45:00,998,1006,8,0,TRUE,NA,"0.1.4"
"12617","646",2023-01-10 10:00:00,998,1006,8,0,TRUE,NA,"0.1.4"
"12618","646",2023-01-10 10:15:00,998,1006,8,0,TRUE,NA,"0.1.4"
"12619","646",2023-01-10 10:30:00,998,1006,8,0,TRUE,NA,"0.1.4"
"12620","646",2023-01-10 10:45:00,998,1006,8,0,TRUE,NA,"0.1.4"
"12621","646",2023-01-10 11:00:00,998,1006,8,0,TRUE,NA,"0.1.4"
"12622","646",2023-01-10 11:15:00,998,1006,8,0,TRUE,NA,"0.1.4"
"12623","646",2023-01-10 11:30:00,998,1006,8,0,TRUE,NA,"0.1.4"
"12624","646",2023-01-10 11:45:00,998,1006,8,0,TRUE,NA,"0.1.4"
"12625","646",2023-01-10 12:00:00,998,1006,8,0,TRUE,NA,"0.1.4"
"12626","646",2023-01-10 12:15:00,998,1006,8,0,TRUE,NA,"0.1.4"
"12627","646",2023-01-10 12:30:00,998,1006,8,0,TRUE,NA,"0.1.4"
"12628","646",2023-01-10 12:45:00,998,1006,8,0,TRUE,NA,"0.1.4"
"12629","646",2023-01-10 13:00:00,998,1006,8,0,TRUE,NA,"0.1.4"
"12630","646",2023-01-10 13:15:00,998,1006,8,0,TRUE,NA,"0.1.4"
"12631","646",2023-01-10 13:30:00,998,1006,8,0,TRUE,NA,"0.1.4"
"12632","646",2023-01-10 13:45:00,998,1006,8,0,TRUE,NA,"0.1.4"
"12633","646",2023-01-10 14:00:00,998,1006,8,0,TRUE,NA,"0.1.4"
"12634","646",2023-01-10 14:15:00,998,1006,8,0,TRUE,NA,"0.1.4"
"12635","646",2023-01-10 14:30:00,998,1006,8,0,TRUE,NA,"0.1.4"
"12636","646",2023-01-10 14:45:00,998,1006,8,0,TRUE,NA,"0.1.4"
"12637","646",2023-01-10 15:00:00,998,1006,8,0,TRUE,NA,"0.1.4"
"12638","646",2023-01-10 15:15:00,998,1006,8,0,TRUE,NA,"0.1.4"
"12639","646",2023-01-10 15:30:00,998,1006,8,0,TRUE,NA,"0.1.4"
"12640","646",2023-01-10 15:45:00,998,1006,8,0,TRUE,NA,"0.1.4"
"12641","646",2023-01-10 16:00:00,998,1006,8,0,TRUE,NA,"0.1.4"
"12642","646",2023-01-10 16:15:00,998,1006,8,0,TRUE,NA,"0.1.4"
"12643","646",2023-01-10 16:30:00,998,1006,8,0,TRUE,NA,"0.1.4"
"12644","646",2023-01-10 16:45:00,998,1006,8,0,TRUE,NA,"0.1.4"
"12645","646",2023-01-10 17:00:00,998,1006,8,0,TRUE,NA,"0.1.4"
"12646","646",2023-01-10 17:15:00,998,1006,8,0,TRUE,NA,"0.1.4"
"12647","646",2023-01-10 17:30:00,998,1006,8,0,TRUE,NA,"0.1.4"
"12648","646",2023-01-10 17:45:00,998,1006,8,0,TRUE,NA,"0.1.4"
"12649","646",2023-01-10 18:00:00,998,1006,8,0,TRUE,NA,"0.1.4"
"12650","646",2023-01-10 18:15:00,998,1006,8,0,TRUE,NA,"0.1.4"
"12651","646",2023-01-10 18:30:00,998,1006,8,0,TRUE,NA,"0.1.4"
"12652","646",2023-01-10 18:45:00,998,1006,8,0,TRUE,NA,"0.1.4"
"12653","646",2023-01-10 19:00:00,998,1006,8,0,TRUE,NA,"0.1.4"
"12654","646",2023-01-10 19:15:00,998,1006,8,0,TRUE,NA,"0.1.4"
"12655","646",2023-01-10 19:30:00,998,1006,8,0,TRUE,NA,"0.1.4"
"12656","646",2023-01-10 19:45:00,998,1006,8,0,TRUE,NA,"0.1.4"
"12657","646",2023-01-10 20:00:00,998,1006,8,0,TRUE,NA,"0.1.4"
"12658","646",2023-01-10 20:15:00,998,1006,8,0,TRUE,NA,"0.1.4"
"12659","646",2023-01-10 20:30:00,998,1006,8,0,TRUE,NA,"0.1.4"
"12660","646",2023-01-10 20:45:00,998,1006,8,0,TRUE,NA,"0.1.4"
"12661","646",2023-01-10 21:00:00,998,1006,8,0,TRUE,NA,"0.1.4"
"12662","646",2023-01-10 21:15:00,998,1006,8,0,TRUE,NA,"0.1.4"
"12663","646",2023-01-10 21:30:00,998,1006,8,0,TRUE,NA,"0.1.4"
"12664","646",2023-01-10 21:45:00,998,1006,8,0,TRUE,NA,"0.1.4"
"12665","646",2023-01-10 22:00:00,998,1006,8,0,TRUE,NA,"0.1.4"
"12666","646",2023-01-10 22:15:00,998,1006,8,0,TRUE,NA,"0.1.4"
"12667","646",2023-01-10 22:30:00,998,1006,8,0,TRUE,NA,"0.1.4"
"12668","646",2023-01-10 22:45:00,998,1006,8,0,TRUE,NA,"0.1.4"
"12669","646",2023-01-10 23:00:00,998,1006,8,0,TRUE,NA,"0.1.4"
"12670","646",2023-01-10 23:15:00,998,1006,8,0,TRUE,NA,"0.1.4"
"12671","646",2023-01-10 23:30:00,998,1006,8,0,TRUE,NA,"0.1.4"
"12672","646",2023-01-10 23:45:00,998,1006,8,0,TRUE,NA,"0.1.4"
"12673","646",2023-01-11,998,1006,8,0,TRUE,NA,"0.1.4"
"12674","646",2023-01-11 00:15:00,998,1006,8,0,TRUE,NA,"0.1.4"
"12675","646",2023-01-11 00:30:00,998,1006,8,0,TRUE,NA,"0.1.4"
"12676","646",2023-01-11 00:45:00,998,1006,8,0,TRUE,NA,"0.1.4"
"12677","646",2023-01-11 01:00:00,998,1006,8,0,TRUE,NA,"0.1.4"
"12678","646",2023-01-11 01:15:00,998,1006,8,0,TRUE,NA,"0.1.4"
"12679","646",2023-01-11 01:30:00,998,1006,8,0,TRUE,NA,"0.1.4"
"12680","646",2023-01-11 01:45:00,998,1006,8,0,TRUE,NA,"0.1.4"
"12681","646",2023-01-11 02:00:00,998,1006,8,0,TRUE,NA,"0.1.4"
"12682","646",2023-01-11 02:15:00,998,1006,8,0,TRUE,NA,"0.1.4"
"12683","646",2023-01-11 02:30:00,998,1006,8,0,TRUE,NA,"0.1.4"
"12684","646",2023-01-11 02:45:00,998,1006,8,0,TRUE,NA,"0.1.4"
"12685","646",2023-01-11 03:00:00,998,1006,8,0,TRUE,NA,"0.1.4"
"12686","646",2023-01-11 03:15:00,998,1006,8,0,TRUE,NA,"0.1.4"
"12687","646",2023-01-11 03:30:00,998,1006,8,0,TRUE,NA,"0.1.4"
"12688","646",2023-01-11 03:45:00,998,1006,8,0,TRUE,NA,"0.1.4"
"12689","646",2023-01-11 04:00:00,998,1006,8,0,TRUE,NA,"0.1.4"
"12690","646",2023-01-11 04:15:00,998,1006,8,0,TRUE,NA,"0.1.4"
"12691","646",2023-01-11 04:30:00,998,1006,8,0,TRUE,NA,"0.1.4"
"12692","646",2023-01-11 04:45:00,998,1006,8,0,TRUE,NA,"0.1.4"
"12693","646",2023-01-11 05:00:00,998,1006,8,0,TRUE,NA,"0.1.4"
"12694","646",2023-01-11 05:15:00,998,1006,8,0,TRUE,NA,"0.1.4"
"12695","646",2023-01-11 05:30:00,998,1006,8,0,TRUE,NA,"0.1.4"
"12696","646",2023-01-11 05:45:00,998,1006,8,0,TRUE,NA,"0.1.4"
"12697","646",2023-01-11 06:00:00,998,1006,8,0,TRUE,NA,"0.1.4"
"12698","646",2023-01-11 06:15:00,998,1006,8,0,TRUE,NA,"0.1.4"
"12699","646",2023-01-11 06:30:00,998,1006,8,0,TRUE,NA,"0.1.4"
"12700","646",2023-01-11 06:45:00,998,1006,8,0,TRUE,NA,"0.1.4"
"12701","646",2023-01-11 07:00:00,998,1006,8,0,TRUE,NA,"0.1.4"
"12702","646",2023-01-11 07:15:00,998,1006,8,0,TRUE,NA,"0.1.4"
"12703","646",2023-01-11 07:30:00,998,1006,8,0,TRUE,NA,"0.1.4"
"12704","646",2023-01-11 07:45:00,998,1006,8,0,TRUE,NA,"0.1.4"
"12705","646",2023-01-11 08:00:00,998,1006,8,0,TRUE,NA,"0.1.4"
"12706","646",2023-01-11 08:15:00,998,1006,8,0,TRUE,NA,"0.1.4"
"12707","646",2023-01-11 08:30:00,998,1006,8,0,TRUE,NA,"0.1.4"
"12708","646",2023-01-11 08:45:00,998,1006,8,0,TRUE,NA,"0.1.4"
"12709","646",2023-01-11 09:00:00,998,1006,8,0,TRUE,NA,"0.1.4"
"12710","646",2023-01-11 09:15:00,998,1006,8,0,TRUE,NA,"0.1.4"
"12711","646",2023-01-11 09:30:00,998,1006,8,0,TRUE,NA,"0.1.4"
"12712","646",2023-01-11 09:45:00,998,1006,8,0,TRUE,NA,"0.1.4"
"12713","646",2023-01-11 10:00:00,998,1006,8,0,TRUE,NA,"0.1.4"
"12714","646",2023-01-11 10:15:00,998,1006,8,0,TRUE,NA,"0.1.4"
"12715","646",2023-01-11 10:30:00,998,1006,8,0,TRUE,NA,"0.1.4"
"12716","646",2023-01-11 10:45:00,998,1006,8,0,TRUE,NA,"0.1.4"
"12717","646",2023-01-11 11:00:00,998,1006,8,0,TRUE,NA,"0.1.4"
"12718","646",2023-01-11 11:15:00,998,1006,8,0,TRUE,NA,"0.1.4"
"12719","646",2023-01-11 11:30:00,998,1006,8,0,TRUE,NA,"0.1.4"
"12720","646",2023-01-11 11:45:00,998,1006,8,0,TRUE,NA,"0.1.4"
"12721","646",2023-01-11 12:00:00,998,1006,8,0,TRUE,NA,"0.1.4"
"12722","646",2023-01-11 12:15:00,998,1006,8,0,TRUE,NA,"0.1.4"
"12723","646",2023-01-11 12:30:00,998,1006,8,0,TRUE,NA,"0.1.4"
"12724","646",2023-01-11 12:45:00,998,1006,8,0,TRUE,NA,"0.1.4"
"12725","646",2023-01-11 13:00:00,998,1006,8,0,TRUE,NA,"0.1.4"
"12726","646",2023-01-11 13:15:00,998,1006,8,0,TRUE,NA,"0.1.4"
"12727","646",2023-01-11 13:30:00,998,1006,8,0,TRUE,NA,"0.1.4"
"12728","646",2023-01-11 13:45:00,998,1006,8,0,TRUE,NA,"0.1.4"
"12729","646",2023-01-11 14:00:00,998,1006,8,0,TRUE,NA,"0.1.4"
"12730","646",2023-01-11 14:15:00,998,1006,8,0,TRUE,NA,"0.1.4"
"12731","646",2023-01-11 14:30:00,998,1006,8,0,TRUE,NA,"0.1.4"
"12732","646",2023-01-11 14:45:00,998,1006,8,0,TRUE,NA,"0.1.4"
"12733","646",2023-01-11 15:00:00,998,1006,8,0,TRUE,NA,"0.1.4"
"12734","646",2023-01-11 15:15:00,998,1006,8,0,TRUE,NA,"0.1.4"
"12735","646",2023-01-11 15:30:00,998,1006,8,0,TRUE,NA,"0.1.4"
"12736","646",2023-01-11 15:45:00,998,1006,8,0,TRUE,NA,"0.1.4"
"12737","646",2023-01-11 16:00:00,998,1006,8,0,TRUE,NA,"0.1.4"
"12738","646",2023-01-11 16:15:00,998,1006,8,0,TRUE,NA,"0.1.4"
"12739","646",2023-01-11 16:30:00,998,1006,8,0,TRUE,NA,"0.1.4"
"12740","646",2023-01-11 16:45:00,998,1006,8,0,TRUE,NA,"0.1.4"
"12741","646",2023-01-11 17:00:00,998,1006,8,0,TRUE,NA,"0.1.4"
"12742","646",2023-01-11 17:15:00,998,1006,8,0,TRUE,NA,"0.1.4"
"12743","646",2023-01-11 17:30:00,998,1006,8,0,TRUE,NA,"0.1.4"
"12744","646",2023-01-11 17:45:00,998,1006,8,0,TRUE,NA,"0.1.4"
"12745","646",2023-01-11 18:00:00,998,1006,8,0,TRUE,NA,"0.1.4"
"12746","646",2023-01-11 18:15:00,998,1006,8,0,TRUE,NA,"0.1.4"
"12747","646",2023-01-11 18:30:00,998,1006,8,0,TRUE,NA,"0.1.4"
"12748","646",2023-01-11 18:45:00,998,1006,8,0,TRUE,NA,"0.1.4"
"12749","646",2023-01-11 19:00:00,998,1006,8,0,TRUE,NA,"0.1.4"
"12750","646",2023-01-11 19:15:00,998,1006,8,0,TRUE,NA,"0.1.4"
"12751","646",2023-01-11 19:30:00,998,1006,8,0,TRUE,NA,"0.1.4"
"12752","646",2023-01-11 19:45:00,998,1006,8,0,TRUE,NA,"0.1.4"
"12753","646",2023-01-11 20:00:00,998,1006,8,0,TRUE,NA,"0.1.4"
"12754","646",2023-01-11 20:15:00,998,1006,8,0,TRUE,NA,"0.1.4"
"12755","646",2023-01-11 20:30:00,998,1006,8,0,TRUE,NA,"0.1.4"
"12756","646",2023-01-11 20:45:00,998,1006,8,0,TRUE,NA,"0.1.4"
"12757","646",2023-01-11 21:00:00,998,1006,8,0,TRUE,NA,"0.1.4"
"12758","646",2023-01-11 21:15:00,998,1006,8,0,TRUE,NA,"0.1.4"
"12759","646",2023-01-11 21:30:00,998,1006,8,0,TRUE,NA,"0.1.4"
"12760","646",2023-01-11 21:45:00,998,1006,8,0,TRUE,NA,"0.1.4"
"12761","646",2023-01-11 22:00:00,998,1006,8,0,TRUE,NA,"0.1.4"
"12762","646",2023-01-11 22:15:00,998,1006,8,0,TRUE,NA,"0.1.4"
"12763","646",2023-01-11 22:30:00,998,1006,8,0,TRUE,NA,"0.1.4"
"12764","646",2023-01-11 22:45:00,998,1006,8,0,TRUE,NA,"0.1.4"
"12765","646",2023-01-11 23:00:00,998,1006,8,0,TRUE,NA,"0.1.4"
"12766","646",2023-01-11 23:15:00,998,1006,8,0,TRUE,NA,"0.1.4"
"12767","646",2023-01-11 23:30:00,998,1006,8,0,TRUE,NA,"0.1.4"
"12768","646",2023-01-11 23:45:00,998,1006,8,0,TRUE,NA,"0.1.4"
"12769","646",2023-01-12,998,1006,8,0,TRUE,NA,"0.1.4"
"12770","646",2023-01-12 00:15:00,998,1006,8,0,TRUE,NA,"0.1.4"
"12771","646",2023-01-12 00:30:00,998,1006,8,0,TRUE,NA,"0.1.4"
"12772","646",2023-01-12 00:45:00,998,1006,8,0,TRUE,NA,"0.1.4"
"12773","646",2023-01-12 01:00:00,998,1006,8,0,TRUE,NA,"0.1.4"
"12774","646",2023-01-12 01:15:00,998,1006,8,0,TRUE,NA,"0.1.4"
"12775","646",2023-01-12 01:30:00,998,1006,8,0,TRUE,NA,"0.1.4"
"12776","646",2023-01-12 01:45:00,998,1006,8,0,TRUE,NA,"0.1.4"
"12777","646",2023-01-12 02:00:00,998,1006,8,0,TRUE,NA,"0.1.4"
"12778","646",2023-01-12 02:15:00,998,1006,8,0,TRUE,NA,"0.1.4"
"12779","646",2023-01-12 02:30:00,998,1006,8,0,TRUE,NA,"0.1.4"
"12780","646",2023-01-12 02:45:00,998,1006,8,0,TRUE,NA,"0.1.4"
"12781","646",2023-01-12 03:00:00,998,1006,8,0,TRUE,NA,"0.1.4"
"12782","646",2023-01-12 03:15:00,998,1006,8,0,TRUE,NA,"0.1.4"
"12783","646",2023-01-12 03:30:00,998,1006,8,0,TRUE,NA,"0.1.4"
"12784","646",2023-01-12 03:45:00,998,1006,8,0,TRUE,NA,"0.1.4"
"12785","646",2023-01-12 04:00:00,998,1006,8,0,TRUE,NA,"0.1.4"
"12786","646",2023-01-12 04:15:00,998,1006,8,0,TRUE,NA,"0.1.4"
"12787","646",2023-01-12 04:30:00,998,1006,8,0,TRUE,NA,"0.1.4"
"12788","646",2023-01-12 04:45:00,998,1006,8,0,TRUE,NA,"0.1.4"
"12789","646",2023-01-12 05:00:00,998,1006,8,0,TRUE,NA,"0.1.4"
"12790","646",2023-01-12 05:15:00,998,1006,8,0,TRUE,NA,"0.1.4"
"12791","646",2023-01-12 05:30:00,998,1006,8,0,TRUE,NA,"0.1.4"
"12792","646",2023-01-12 05:45:00,998,1006,8,0,TRUE,NA,"0.1.4"
"12793","646",2023-01-12 06:00:00,998,1006,8,0,TRUE,NA,"0.1.4"
"12794","646",2023-01-12 06:15:00,998,1006,8,0,TRUE,NA,"0.1.4"
"12795","646",2023-01-12 06:30:00,998,1006,8,0,TRUE,NA,"0.1.4"
"12796","646",2023-01-12 06:45:00,998,1006,8,0,TRUE,NA,"0.1.4"
"12797","646",2023-01-12 07:00:00,998,1006,8,0,TRUE,NA,"0.1.4"
"12798","646",2023-01-12 07:15:00,998,1006,8,0,TRUE,NA,"0.1.4"
"12799","646",2023-01-12 07:30:00,998,1006,8,0,TRUE,NA,"0.1.4"
"12800","646",2023-01-12 07:45:00,998,1006,8,0,TRUE,NA,"0.1.4"
"12801","646",2023-01-12 08:00:00,998,1006,8,0,TRUE,NA,"0.1.4"
"12802","646",2023-01-12 08:15:00,998,1006,8,0,TRUE,NA,"0.1.4"
"12803","646",2023-01-12 08:30:00,998,1006,8,0,TRUE,NA,"0.1.4"
"12804","646",2023-01-12 08:45:00,998,1006,8,0,TRUE,NA,"0.1.4"
"12805","646",2023-01-12 09:00:00,998,1006,8,0,TRUE,NA,"0.1.4"
"12806","646",2023-01-12 09:15:00,998,1006,8,0,TRUE,NA,"0.1.4"
"12807","646",2023-01-12 09:30:00,998,1006,8,0,TRUE,NA,"0.1.4"
"12808","646",2023-01-12 09:45:00,998,1006,8,0,TRUE,NA,"0.1.4"
"12809","646",2023-01-12 10:00:00,998,1006,8,0,TRUE,NA,"0.1.4"
"12810","646",2023-01-12 10:15:00,998,1006,8,0,TRUE,NA,"0.1.4"
"12811","646",2023-01-12 10:30:00,998,1006,8,0,TRUE,NA,"0.1.4"
"12812","646",2023-01-12 10:45:00,998,1006,8,0,TRUE,NA,"0.1.4"
"12813","646",2023-01-12 11:00:00,998,1006,8,0,TRUE,NA,"0.1.4"
"12814","646",2023-01-12 11:15:00,998,1006,8,0,TRUE,NA,"0.1.4"
"12815","646",2023-01-12 11:30:00,998,1006,8,0,TRUE,NA,"0.1.4"
"12816","646",2023-01-12 11:45:00,998,1006,8,0,TRUE,NA,"0.1.4"
"12817","646",2023-01-12 12:00:00,998,1006,8,0,TRUE,NA,"0.1.4"
"12818","646",2023-01-12 12:15:00,998,1006,8,0,TRUE,NA,"0.1.4"
"12819","646",2023-01-12 12:30:00,998,1006,8,0,TRUE,NA,"0.1.4"
"12820","646",2023-01-12 12:45:00,998,1006,8,0,TRUE,NA,"0.1.4"
"12821","646",2023-01-12 13:00:00,998,1006,8,0,TRUE,NA,"0.1.4"
"12822","646",2023-01-12 13:15:00,998,1006,8,0,TRUE,NA,"0.1.4"
"12823","646",2023-01-12 13:30:00,998,1006,8,0,TRUE,NA,"0.1.4"
"12824","646",2023-01-12 13:45:00,998,1006,8,0,TRUE,NA,"0.1.4"
"12825","646",2023-01-12 14:00:00,998,1006,8,0,TRUE,NA,"0.1.4"
"12826","646",2023-01-12 14:15:00,998,1006,8,0,TRUE,NA,"0.1.4"
"12827","646",2023-01-12 14:30:00,998,1006,8,0,TRUE,NA,"0.1.4"
"12828","646",2023-01-12 14:45:00,998,1006,8,0,TRUE,NA,"0.1.4"
"12829","646",2023-01-12 15:00:00,998,1006,8,0,TRUE,NA,"0.1.4"
"12830","646",2023-01-12 15:15:00,998,1006,8,0,TRUE,NA,"0.1.4"
"12831","646",2023-01-12 15:30:00,998,1006,8,0,TRUE,NA,"0.1.4"
"12832","646",2023-01-12 15:45:00,998,1006,8,0,TRUE,NA,"0.1.4"
"12833","646",2023-01-12 16:00:00,998,1006,8,0,TRUE,NA,"0.1.4"
"12834","646",2023-01-12 16:15:00,998,1006,8,0,TRUE,NA,"0.1.4"
"12835","646",2023-01-12 16:30:00,998,1006,8,0,TRUE,NA,"0.1.4"
"12836","646",2023-01-12 16:45:00,998,1006,8,0,TRUE,NA,"0.1.4"
"12837","646",2023-01-12 17:00:00,998,1006,8,0,TRUE,NA,"0.1.4"
"12838","646",2023-01-12 17:15:00,998,1006,8,0,TRUE,NA,"0.1.4"
"12839","646",2023-01-12 17:30:00,998,1006,8,0,TRUE,NA,"0.1.4"
"12840","646",2023-01-12 17:45:00,998,1006,8,0,TRUE,NA,"0.1.4"
"12841","646",2023-01-12 18:00:00,999,1006,7,0,TRUE,NA,"0.1.4"
"12842","646",2023-01-12 18:15:00,998,1006,8,0,FALSE,NA,"0.1.4"
"12843","646",2023-01-12 18:30:00,999,1006,7,0,FALSE,NA,"0.1.4"
"12844","646",2023-01-12 18:45:00,998,1006,8,0,FALSE,NA,"0.1.4"
"12845","646",2023-01-12 19:00:00,998,1006,8,0,FALSE,NA,"0.1.4"
"12846","646",2023-01-12 19:15:00,999,1006,7,0,FALSE,NA,"0.1.4"
"12847","646",2023-01-12 19:30:00,998,1006,8,0,FALSE,NA,"0.1.4"
"12848","646",2023-01-12 19:45:00,998,1006,8,0,FALSE,NA,"0.1.4"
"12849","646",2023-01-12 20:00:00,998,1006,8,0,FALSE,NA,"0.1.4"
"12850","646",2023-01-12 20:15:00,998,1006,8,0,FALSE,NA,"0.1.4"
"12851","646",2023-01-12 20:30:00,998,1006,8,0,FALSE,NA,"0.1.4"
"12852","646",2023-01-12 20:45:00,998,1006,8,0,FALSE,NA,"0.1.4"
"12853","646",2023-01-12 21:00:00,998,1006,8,0,FALSE,NA,"0.1.4"
"12854","646",2023-01-12 21:15:00,998,1006,8,0,FALSE,NA,"0.1.4"
"12855","646",2023-01-12 21:30:00,998,1006,8,0,FALSE,NA,"0.1.4"
"12856","646",2023-01-12 21:45:00,998,1006,8,0,FALSE,NA,"0.1.4"
"12857","646",2023-01-12 22:00:00,998,1006,8,0,FALSE,NA,"0.1.4"
"12858","646",2023-01-12 22:15:00,999,1006,7,0,FALSE,NA,"0.1.4"
"12859","646",2023-01-12 22:30:00,999,1006,7,0,FALSE,NA,"0.1.4"
"12860","646",2023-01-12 22:45:00,998,1006,8,0,FALSE,NA,"0.1.4"
"12861","646",2023-01-12 23:00:00,999,1006,7,0,FALSE,NA,"0.1.4"
"12862","646",2023-01-12 23:15:00,999,1006,7,0,FALSE,NA,"0.1.4"
"12863","646",2023-01-12 23:30:00,999,1006,7,0,FALSE,NA,"0.1.4"
"12864","646",2023-01-12 23:45:00,999,1006,7,0,FALSE,NA,"0.1.4"
"12865","646",2023-01-13,999,1006,7,0,FALSE,NA,"0.1.4"
"12866","646",2023-01-13 00:15:00,999,1006,7,0,FALSE,NA,"0.1.4"
"12867","646",2023-01-13 00:30:00,999,1006,7,0,FALSE,NA,"0.1.4"
"12868","646",2023-01-13 00:45:00,999,1006,7,0,FALSE,NA,"0.1.4"
"12869","646",2023-01-13 01:00:00,999,1006,7,0,FALSE,NA,"0.1.4"
"12870","646",2023-01-13 01:15:00,999,1006,7,0,FALSE,NA,"0.1.4"
"12871","646",2023-01-13 01:30:00,999,1006,7,0,FALSE,NA,"0.1.4"
"12872","646",2023-01-13 01:45:00,999,1006,7,0,FALSE,NA,"0.1.4"
"12873","646",2023-01-13 02:00:00,999,1006,7,0,FALSE,NA,"0.1.4"
"12874","646",2023-01-13 02:15:00,999,1006,7,0,FALSE,NA,"0.1.4"
"12875","646",2023-01-13 02:30:00,999,1006,7,0,FALSE,NA,"0.1.4"
"12876","646",2023-01-13 02:45:00,999,1006,7,0,FALSE,NA,"0.1.4"
"12877","646",2023-01-13 03:00:00,999,1006,7,0,FALSE,NA,"0.1.4"
"12878","646",2023-01-13 03:15:00,999,1006,7,0,FALSE,NA,"0.1.4"
"12879","646",2023-01-13 03:30:00,999,1006,7,0,FALSE,NA,"0.1.4"
"12880","646",2023-01-13 03:45:00,999,1006,7,0,FALSE,NA,"0.1.4"
"12881","646",2023-01-13 04:00:00,999,1006,7,0,FALSE,NA,"0.1.4"
"12882","646",2023-01-13 04:15:00,999,1006,7,0,FALSE,NA,"0.1.4"
"12883","646",2023-01-13 04:30:00,999,1006,7,0,FALSE,NA,"0.1.4"
"12884","646",2023-01-13 04:45:00,999,1006,7,0,FALSE,NA,"0.1.4"
"12885","646",2023-01-13 05:00:00,999,1006,7,0,FALSE,NA,"0.1.4"
"12886","646",2023-01-13 05:15:00,999,1006,7,0,FALSE,NA,"0.1.4"
"12887","646",2023-01-13 05:30:00,999,1006,7,0,FALSE,NA,"0.1.4"
"12888","646",2023-01-13 05:45:00,999,1006,7,0,FALSE,NA,"0.1.4"
"12889","646",2023-01-13 06:00:00,999,1006,7,0,FALSE,NA,"0.1.4"
"12890","646",2023-01-13 06:15:00,999,1006,7,0,FALSE,NA,"0.1.4"
"12891","646",2023-01-13 06:30:00,999,1006,7,0,FALSE,NA,"0.1.4"
"12892","646",2023-01-13 06:45:00,999,1006,7,0,FALSE,NA,"0.1.4"
"12893","646",2023-01-13 07:00:00,999,1006,7,0,FALSE,NA,"0.1.4"
"12894","646",2023-01-13 07:15:00,999,1006,7,0,FALSE,NA,"0.1.4"
"12895","646",2023-01-13 07:30:00,999,1006,7,0,FALSE,NA,"0.1.4"
"12896","646",2023-01-13 07:45:00,999,1006,7,0,FALSE,NA,"0.1.4"
"12897","646",2023-01-13 08:00:00,999,1006,7,0,FALSE,NA,"0.1.4"
"12898","646",2023-01-13 08:15:00,999,1006,7,0,FALSE,NA,"0.1.4"
"12899","646",2023-01-13 08:30:00,999,1006,7,0,FALSE,NA,"0.1.4"
"12900","646",2023-01-13 08:45:00,999,1006,7,0,FALSE,NA,"0.1.4"
"12901","646",2023-01-13 09:00:00,999,1006,7,0,FALSE,NA,"0.1.4"
"12902","646",2023-01-13 09:15:00,999,1006,7,0,FALSE,NA,"0.1.4"
"12903","646",2023-01-13 09:30:00,999,1006,7,0,FALSE,NA,"0.1.4"
"12904","646",2023-01-13 09:45:00,999,1006,7,0,FALSE,NA,"0.1.4"
"12905","646",2023-01-13 10:00:00,999,1006,7,0,FALSE,NA,"0.1.4"
"12906","646",2023-01-13 10:15:00,999,1006,7,0,FALSE,NA,"0.1.4"
"12907","646",2023-01-13 10:30:00,999,1006,7,0,FALSE,NA,"0.1.4"
"12908","646",2023-01-13 10:45:00,999,1006,7,0,FALSE,NA,"0.1.4"
"12909","646",2023-01-13 11:00:00,999,1006,7,0,FALSE,NA,"0.1.4"
"12910","646",2023-01-13 11:15:00,999,1006,7,0,FALSE,NA,"0.1.4"
"12911","646",2023-01-13 11:30:00,999,1006,7,0,FALSE,NA,"0.1.4"
"12912","646",2023-01-13 11:45:00,999,1006,7,0,FALSE,NA,"0.1.4"
"12913","646",2023-01-13 12:00:00,999,1006,7,0,FALSE,NA,"0.1.4"
"12914","646",2023-01-13 12:15:00,999,1006,7,0,FALSE,NA,"0.1.4"
"12915","646",2023-01-13 12:30:00,999,1006,7,0,FALSE,NA,"0.1.4"
"12916","646",2023-01-13 12:45:00,999,1006,7,0,FALSE,NA,"0.1.4"
"12917","646",2023-01-13 13:00:00,999,1006,7,0,FALSE,NA,"0.1.4"
"12918","646",2023-01-13 13:15:00,999,1006,7,0,FALSE,NA,"0.1.4"
"12919","646",2023-01-13 13:30:00,999,1006,7,0,FALSE,NA,"0.1.4"
"12920","646",2023-01-13 13:45:00,999,1006,7,0,FALSE,NA,"0.1.4"
"12921","646",2023-01-13 14:00:00,999,1006,7,0,FALSE,NA,"0.1.4"
"12922","646",2023-01-13 14:15:00,999,1006,7,0,FALSE,NA,"0.1.4"
"12923","646",2023-01-13 14:30:00,999,1006,7,0,FALSE,NA,"0.1.4"
"12924","646",2023-01-13 14:45:00,999,1006,7,0,FALSE,NA,"0.1.4"
"12925","646",2023-01-13 15:00:00,999,1006,7,0,FALSE,NA,"0.1.4"
"12926","646",2023-01-13 15:15:00,999,1006,7,0,FALSE,NA,"0.1.4"
"12927","646",2023-01-13 15:30:00,999,1006,7,0,FALSE,NA,"0.1.4"
"12928","646",2023-01-13 15:45:00,999,1006,7,0,FALSE,NA,"0.1.4"
"12929","646",2023-01-13 16:00:00,999,1006,7,0,FALSE,NA,"0.1.4"
"12930","646",2023-01-13 16:15:00,999,1006,7,0,FALSE,NA,"0.1.4"
"12931","646",2023-01-13 16:30:00,999,1006,7,0,FALSE,NA,"0.1.4"
"12932","646",2023-01-13 16:45:00,999,1006,7,0,FALSE,NA,"0.1.4"
"12933","646",2023-01-13 17:00:00,999,1006,7,0,FALSE,NA,"0.1.4"
"12934","646",2023-01-13 17:15:00,999,1006,7,0,FALSE,NA,"0.1.4"
"12935","646",2023-01-13 17:30:00,999,1006,7,0,FALSE,NA,"0.1.4"
"12936","646",2023-01-13 17:45:00,999,1006,7,0,FALSE,NA,"0.1.4"
"12937","646",2023-01-13 18:00:00,999,1006,7,0,FALSE,NA,"0.1.4"
"12938","646",2023-01-13 18:15:00,999,1006,7,0,FALSE,NA,"0.1.4"
"12939","646",2023-01-13 18:30:00,999,1006,7,0,FALSE,NA,"0.1.4"
"12940","646",2023-01-13 18:45:00,999,1006,7,0,FALSE,NA,"0.1.4"
"12941","646",2023-01-13 19:00:00,999,1006,7,0,FALSE,NA,"0.1.4"
"12942","646",2023-01-13 19:15:00,999,1006,7,0,FALSE,NA,"0.1.4"
"12943","646",2023-01-13 19:30:00,999,1006,7,0,FALSE,NA,"0.1.4"
"12944","646",2023-01-13 19:45:00,999,1006,7,0,FALSE,NA,"0.1.4"
"12945","646",2023-01-13 20:00:00,999,1006,7,0,FALSE,NA,"0.1.4"
"12946","646",2023-01-13 20:15:00,999,1006,7,0,FALSE,NA,"0.1.4"
"12947","646",2023-01-13 20:30:00,999,1006,7,0,FALSE,NA,"0.1.4"
"12948","646",2023-01-13 20:45:00,999,1006,7,0,FALSE,NA,"0.1.4"
"12949","646",2023-01-13 21:00:00,999,1006,7,0,FALSE,NA,"0.1.4"
"12950","646",2023-01-13 21:15:00,999,1006,7,0,FALSE,NA,"0.1.4"
"12951","646",2023-01-13 21:30:00,999,1006,7,0,FALSE,NA,"0.1.4"
"12952","646",2023-01-13 21:45:00,999,1006,7,0,FALSE,NA,"0.1.4"
"12953","646",2023-01-13 22:00:00,999,1006,7,0,FALSE,NA,"0.1.4"
"12954","646",2023-01-13 22:15:00,998,1006,8,0,FALSE,NA,"0.1.4"
"12955","646",2023-01-13 22:30:00,998,1006,8,0,FALSE,NA,"0.1.4"
"12956","646",2023-01-13 22:45:00,998,1006,8,0,FALSE,NA,"0.1.4"
"12957","646",2023-01-13 23:00:00,998,1006,8,0,FALSE,NA,"0.1.4"
"12958","646",2023-01-13 23:15:00,998,1006,8,0,FALSE,NA,"0.1.4"
"12959","646",2023-01-13 23:30:00,999,1006,7,0,FALSE,NA,"0.1.4"
"12960","646",2023-01-13 23:45:00,998,1006,8,0,FALSE,NA,"0.1.4"
"12961","646",2023-01-14,998,1006,8,0,FALSE,NA,"0.1.4"
"12962","646",2023-01-14 00:15:00,999,1006,7,0,FALSE,NA,"0.1.4"
"12963","646",2023-01-14 00:30:00,998,1006,8,0,FALSE,NA,"0.1.4"
"12964","646",2023-01-14 00:45:00,998,1006,8,0,FALSE,NA,"0.1.4"
"12965","646",2023-01-14 01:00:00,998,1006,8,0,FALSE,NA,"0.1.4"
"12966","646",2023-01-14 01:15:00,998,1006,8,0,FALSE,NA,"0.1.4"
"12967","646",2023-01-14 01:30:00,998,1006,8,0,FALSE,NA,"0.1.4"
"12968","646",2023-01-14 01:45:00,998,1006,8,0,FALSE,NA,"0.1.4"
"12969","646",2023-01-14 02:00:00,998,1006,8,0,FALSE,NA,"0.1.4"
"12970","646",2023-01-14 02:15:00,998,1006,8,0,FALSE,NA,"0.1.4"
"12971","646",2023-01-14 02:30:00,998,1006,8,0,FALSE,NA,"0.1.4"
"12972","646",2023-01-14 02:45:00,998,1006,8,0,FALSE,NA,"0.1.4"
"12973","646",2023-01-14 03:00:00,998,1006,8,0,FALSE,NA,"0.1.4"
"12974","646",2023-01-14 03:15:00,998,1006,8,0,FALSE,NA,"0.1.4"
"12975","646",2023-01-14 03:30:00,998,1006,8,0,FALSE,NA,"0.1.4"
"12976","646",2023-01-14 03:45:00,998,1006,8,0,FALSE,NA,"0.1.4"
"12977","646",2023-01-14 04:00:00,998,1006,8,0,FALSE,NA,"0.1.4"
"12978","646",2023-01-14 04:15:00,998,1006,8,0,FALSE,NA,"0.1.4"
"12979","646",2023-01-14 04:30:00,998,1006,8,0,FALSE,NA,"0.1.4"
"12980","646",2023-01-14 04:45:00,998,1006,8,0,FALSE,NA,"0.1.4"
"12981","646",2023-01-14 05:00:00,998,1006,8,0,FALSE,NA,"0.1.4"
"12982","646",2023-01-14 05:15:00,998,1006,8,0,FALSE,NA,"0.1.4"
"12983","646",2023-01-14 05:30:00,998,1006,8,0,FALSE,NA,"0.1.4"
"12984","646",2023-01-14 05:45:00,998,1006,8,0,FALSE,NA,"0.1.4"
"12985","646",2023-01-14 06:00:00,998,1006,8,0,FALSE,NA,"0.1.4"
"12986","646",2023-01-14 06:15:00,998,1006,8,0,FALSE,NA,"0.1.4"
"12987","646",2023-01-14 06:30:00,998,1006,8,0,FALSE,NA,"0.1.4"
"12988","646",2023-01-14 06:45:00,998,1006,8,0,FALSE,NA,"0.1.4"
"12989","646",2023-01-14 07:00:00,998,1006,8,0,FALSE,NA,"0.1.4"
"12990","646",2023-01-14 07:15:00,998,1006,8,0,FALSE,NA,"0.1.4"
"12991","646",2023-01-14 07:30:00,998,1006,8,0,FALSE,NA,"0.1.4"
"12992","646",2023-01-14 07:45:00,998,1006,8,0,FALSE,NA,"0.1.4"
"12993","646",2023-01-14 08:00:00,998,1006,8,0,FALSE,NA,"0.1.4"
"12994","646",2023-01-14 08:15:00,998,1006,8,0,FALSE,NA,"0.1.4"
"12995","646",2023-01-14 08:30:00,998,1006,8,0,FALSE,NA,"0.1.4"
"12996","646",2023-01-14 08:45:00,998,1006,8,0,FALSE,NA,"0.1.4"
"12997","646",2023-01-14 09:00:00,998,1006,8,0,FALSE,NA,"0.1.4"
"12998","646",2023-01-14 09:15:00,998,1006,8,0,FALSE,NA,"0.1.4"
"12999","646",2023-01-14 09:30:00,998,1006,8,0,FALSE,NA,"0.1.4"
"13000","646",2023-01-14 09:45:00,998,1006,8,0,FALSE,NA,"0.1.4"
"13001","646",2023-01-14 10:00:00,998,1006,8,0,FALSE,NA,"0.1.4"
"13002","646",2023-01-14 10:15:00,998,1006,8,0,FALSE,NA,"0.1.4"
"13003","646",2023-01-14 10:30:00,998,1006,8,0,FALSE,NA,"0.1.4"
"13004","646",2023-01-14 10:45:00,998,1006,8,0,FALSE,NA,"0.1.4"
"13005","646",2023-01-14 11:00:00,998,1006,8,0,FALSE,NA,"0.1.4"
"13006","646",2023-01-14 11:15:00,998,1006,8,0,FALSE,NA,"0.1.4"
"13007","646",2023-01-14 11:30:00,998,1006,8,0,FALSE,NA,"0.1.4"
"13008","646",2023-01-14 11:45:00,998,1006,8,0,FALSE,NA,"0.1.4"
"13009","646",2023-01-14 12:00:00,998,1006,8,0,FALSE,NA,"0.1.4"
"13010","646",2023-01-14 12:15:00,998,1006,8,0,FALSE,NA,"0.1.4"
"13011","646",2023-01-14 12:30:00,998,1006,8,0,FALSE,NA,"0.1.4"
"13012","646",2023-01-14 12:45:00,998,1006,8,0,FALSE,NA,"0.1.4"
"13013","646",2023-01-14 13:00:00,998,1006,8,0,FALSE,NA,"0.1.4"
"13014","646",2023-01-14 13:15:00,998,1006,8,0,FALSE,NA,"0.1.4"
"13015","646",2023-01-14 13:30:00,998,1006,8,0,FALSE,NA,"0.1.4"
"13016","646",2023-01-14 13:45:00,998,1006,8,0,FALSE,NA,"0.1.4"
"13017","646",2023-01-14 14:00:00,998,1006,8,0,FALSE,NA,"0.1.4"
"13018","646",2023-01-14 14:15:00,998,1006,8,0,FALSE,NA,"0.1.4"
"13019","646",2023-01-14 14:30:00,998,1006,8,0,FALSE,NA,"0.1.4"
"13020","646",2023-01-14 14:45:00,998,1006,8,0,FALSE,NA,"0.1.4"
"13021","646",2023-01-14 15:00:00,998,1006,8,0,FALSE,NA,"0.1.4"
"13022","646",2023-01-14 15:15:00,998,1006,8,0,FALSE,NA,"0.1.4"
"13023","646",2023-01-14 15:30:00,998,1006,8,0,FALSE,NA,"0.1.4"
"13024","646",2023-01-14 15:45:00,998,1006,8,0,FALSE,NA,"0.1.4"
"13025","646",2023-01-14 16:00:00,998,1006,8,0,FALSE,NA,"0.1.4"
"13026","646",2023-01-14 16:15:00,998,1006,8,0,FALSE,NA,"0.1.4"
"13027","646",2023-01-14 16:30:00,998,1006,8,0,FALSE,NA,"0.1.4"
"13028","646",2023-01-14 16:45:00,998,1006,8,0,FALSE,NA,"0.1.4"
"13029","646",2023-01-14 17:00:00,998,1006,8,0,FALSE,NA,"0.1.4"
"13030","646",2023-01-14 17:15:00,998,1006,8,0,FALSE,NA,"0.1.4"
"13031","646",2023-01-14 17:30:00,998,1006,8,0,FALSE,NA,"0.1.4"
"13032","646",2023-01-14 17:45:00,998,1006,8,0,FALSE,NA,"0.1.4"
"13033","646",2023-01-14 18:00:00,998,1006,8,0,FALSE,NA,"0.1.4"
"13034","646",2023-01-14 18:15:00,998,1006,8,0,FALSE,NA,"0.1.4"
"13035","646",2023-01-14 18:30:00,998,1006,8,0,FALSE,NA,"0.1.4"
"13036","646",2023-01-14 18:45:00,998,1006,8,0,FALSE,NA,"0.1.4"
"13037","646",2023-01-14 19:00:00,998,1006,8,0,FALSE,NA,"0.1.4"
"13038","646",2023-01-14 19:15:00,998,1006,8,0,FALSE,NA,"0.1.4"
"13039","646",2023-01-14 19:30:00,998,1006,8,0,FALSE,NA,"0.1.4"
"13040","646",2023-01-14 19:45:00,998,1006,8,0,FALSE,NA,"0.1.4"
"13041","646",2023-01-14 20:00:00,998,1006,8,0,FALSE,NA,"0.1.4"
"13042","646",2023-01-14 20:15:00,998,1006,8,0,FALSE,NA,"0.1.4"
"13043","646",2023-01-14 20:30:00,998,1006,8,0,FALSE,NA,"0.1.4"
"13044","646",2023-01-14 20:45:00,998,1006,8,0,FALSE,NA,"0.1.4"
"13045","646",2023-01-14 21:00:00,998,1006,8,0,FALSE,NA,"0.1.4"
"13046","646",2023-01-14 21:15:00,998,1006,8,0,FALSE,NA,"0.1.4"
"13047","646",2023-01-14 21:30:00,998,1006,8,0,FALSE,NA,"0.1.4"
"13048","646",2023-01-14 21:45:00,998,1006,8,0,FALSE,NA,"0.1.4"
"13049","646",2023-01-14 22:00:00,998,1006,8,0,FALSE,NA,"0.1.4"
"13050","646",2023-01-14 22:15:00,998,1006,8,0,FALSE,NA,"0.1.4"
"13051","646",2023-01-14 22:30:00,998,1006,8,0,FALSE,NA,"0.1.4"
"13052","646",2023-01-14 22:45:00,998,1006,8,0,FALSE,NA,"0.1.4"
"13053","646",2023-01-14 23:00:00,998,1006,8,0,FALSE,NA,"0.1.4"
"13054","646",2023-01-14 23:15:00,998,1006,8,0,FALSE,NA,"0.1.4"
"13055","646",2023-01-14 23:30:00,998,1006,8,0,FALSE,NA,"0.1.4"
"13056","646",2023-01-14 23:45:00,998,1006,8,0,FALSE,NA,"0.1.4"
"13057","646",2023-01-15,998,1006,8,0,FALSE,NA,"0.1.4"
"13058","646",2023-01-15 00:15:00,998,1006,8,0,FALSE,NA,"0.1.4"
"13059","646",2023-01-15 00:30:00,998,1006,8,0,FALSE,NA,"0.1.4"
"13060","646",2023-01-15 00:45:00,998,1006,8,0,FALSE,NA,"0.1.4"
"13061","646",2023-01-15 01:00:00,998,1006,8,0,FALSE,NA,"0.1.4"
"13062","646",2023-01-15 01:15:00,998,1006,8,0,FALSE,NA,"0.1.4"
"13063","646",2023-01-15 01:30:00,998,1006,8,0,FALSE,NA,"0.1.4"
"13064","646",2023-01-15 01:45:00,998,1006,8,0,FALSE,NA,"0.1.4"
"13065","646",2023-01-15 02:00:00,998,1006,8,0,FALSE,NA,"0.1.4"
"13066","646",2023-01-15 02:15:00,998,1006,8,0,FALSE,NA,"0.1.4"
"13067","646",2023-01-15 02:30:00,998,1006,8,0,FALSE,NA,"0.1.4"
"13068","646",2023-01-15 02:45:00,998,1006,8,0,FALSE,NA,"0.1.4"
"13069","646",2023-01-15 03:00:00,998,1006,8,0,FALSE,NA,"0.1.4"
"13070","646",2023-01-15 03:15:00,998,1006,8,0,FALSE,NA,"0.1.4"
"13071","646",2023-01-15 03:30:00,998,1006,8,0,FALSE,NA,"0.1.4"
"13072","646",2023-01-15 03:45:00,998,1006,8,0,FALSE,NA,"0.1.4"
"13073","646",2023-01-15 04:00:00,998,1006,8,0,FALSE,NA,"0.1.4"
"13074","646",2023-01-15 04:15:00,998,1006,8,0,FALSE,NA,"0.1.4"
"13075","646",2023-01-15 04:30:00,998,1006,8,0,FALSE,NA,"0.1.4"
"13076","646",2023-01-15 04:45:00,998,1006,8,0,FALSE,NA,"0.1.4"
"13077","646",2023-01-15 05:00:00,998,1006,8,0,FALSE,NA,"0.1.4"
"13078","646",2023-01-15 05:15:00,998,1006,8,0,FALSE,NA,"0.1.4"
"13079","646",2023-01-15 05:30:00,998,1006,8,0,FALSE,NA,"0.1.4"
"13080","646",2023-01-15 05:45:00,998,1006,8,0,FALSE,NA,"0.1.4"
"13081","646",2023-01-15 06:00:00,998,1006,8,0,FALSE,NA,"0.1.4"
"13082","646",2023-01-15 06:15:00,998,1006,8,0,FALSE,NA,"0.1.4"
"13083","646",2023-01-15 06:30:00,998,1006,8,0,FALSE,NA,"0.1.4"
"13084","646",2023-01-15 06:45:00,998,1006,8,0,TRUE,NA,"0.1.4"
"13085","646",2023-01-15 07:00:00,998,1006,8,0,FALSE,NA,"0.1.4"
"13086","646",2023-01-15 07:15:00,998,1006,8,0,FALSE,NA,"0.1.4"
"13087","646",2023-01-15 07:30:00,998,1006,8,0,FALSE,NA,"0.1.4"
"13088","646",2023-01-15 07:45:00,998,1006,8,0,FALSE,NA,"0.1.4"
"13089","646",2023-01-15 08:00:00,998,1006,8,0,FALSE,NA,"0.1.4"
"13090","646",2023-01-15 08:15:00,998,1006,8,0,TRUE,NA,"0.1.4"
"13091","646",2023-01-15 08:30:00,998,1006,8,0,TRUE,NA,"0.1.4"
"13092","646",2023-01-15 08:45:00,998,1006,8,0,TRUE,NA,"0.1.4"
"13093","646",2023-01-15 09:00:00,998,1006,8,0,TRUE,NA,"0.1.4"
"13094","646",2023-01-15 09:15:00,998,1006,8,0,TRUE,NA,"0.1.4"
"13095","646",2023-01-15 09:30:00,998,1006,8,0,TRUE,NA,"0.1.4"
"13096","646",2023-01-15 09:45:00,998,1006,8,0,TRUE,NA,"0.1.4"
"13097","646",2023-01-15 10:00:00,998,1006,8,0,TRUE,NA,"0.1.4"
"13098","646",2023-01-15 10:15:00,998,1006,8,0,TRUE,NA,"0.1.4"
"13099","646",2023-01-15 10:30:00,998,1006,8,0,TRUE,NA,"0.1.4"
"13100","646",2023-01-15 10:45:00,998,1006,8,0,TRUE,NA,"0.1.4"
"13101","646",2023-01-15 11:00:00,998,1006,8,0,TRUE,NA,"0.1.4"
"13102","646",2023-01-15 11:15:00,998,1006,8,0,FALSE,NA,"0.1.4"
"13103","646",2023-01-15 11:30:00,998,1006,8,0,FALSE,NA,"0.1.4"
"13104","646",2023-01-15 11:45:00,998,1006,8,0,TRUE,NA,"0.1.4"
"13105","646",2023-01-15 12:00:00,998,1006,8,0,TRUE,NA,"0.1.4"
"13106","646",2023-01-15 12:15:00,998,1006,8,0,TRUE,NA,"0.1.4"
"13107","646",2023-01-15 12:30:00,998,1006,8,0,TRUE,NA,"0.1.4"
"13108","646",2023-01-15 12:45:00,998,1006,8,0,TRUE,NA,"0.1.4"
"13109","646",2023-01-15 13:00:00,998,1006,8,0,TRUE,NA,"0.1.4"
"13110","646",2023-01-15 13:15:00,998,1006,8,0,TRUE,NA,"0.1.4"
"13111","646",2023-01-15 13:30:00,998,1006,8,0,TRUE,NA,"0.1.4"
"13112","646",2023-01-15 13:45:00,998,1006,8,0,TRUE,NA,"0.1.4"
"13113","646",2023-01-15 14:00:00,998,1006,8,0,TRUE,NA,"0.1.4"
"13114","646",2023-01-15 14:15:00,998,1006,8,0,TRUE,NA,"0.1.4"
"13115","646",2023-01-15 14:30:00,998,1006,8,0,TRUE,NA,"0.1.4"
"13116","646",2023-01-15 14:45:00,998,1006,8,0,TRUE,NA,"0.1.4"
"13117","646",2023-01-15 15:00:00,998,1006,8,0,TRUE,NA,"0.1.4"
"13118","646",2023-01-15 15:15:00,998,1006,8,0,TRUE,NA,"0.1.4"
"13119","646",2023-01-15 15:30:00,998,1006,8,0,TRUE,NA,"0.1.4"
"13120","646",2023-01-15 15:45:00,998,1006,8,0,TRUE,NA,"0.1.4"
"13121","646",2023-01-15 16:00:00,998,1006,8,0,TRUE,NA,"0.1.4"
"13122","646",2023-01-15 16:15:00,998,1006,8,0,TRUE,NA,"0.1.4"
"13123","646",2023-01-15 16:30:00,998,1006,8,0,TRUE,NA,"0.1.4"
"13124","646",2023-01-15 16:45:00,998,1006,8,0,TRUE,NA,"0.1.4"
"13125","646",2023-01-15 17:00:00,998,1006,8,0,TRUE,NA,"0.1.4"
"13126","646",2023-01-15 17:15:00,998,1006,8,0,TRUE,NA,"0.1.4"
"13127","646",2023-01-15 17:30:00,998,1006,8,0,TRUE,NA,"0.1.4"
"13128","646",2023-01-15 17:45:00,998,1006,8,0,TRUE,NA,"0.1.4"
"13129","646",2023-01-15 18:00:00,998,1006,8,0,TRUE,NA,"0.1.4"
"13130","646",2023-01-15 18:15:00,998,1006,8,0,TRUE,NA,"0.1.4"
"13131","646",2023-01-15 18:30:00,998,1006,8,0,TRUE,NA,"0.1.4"
"13132","646",2023-01-15 18:45:00,998,1006,8,0,TRUE,NA,"0.1.4"
"13133","646",2023-01-15 19:00:00,998,1006,8,0,TRUE,NA,"0.1.4"
"13134","646",2023-01-15 19:15:00,998,1006,8,0,TRUE,NA,"0.1.4"
"13135","646",2023-01-15 19:30:00,998,1006,8,0,TRUE,NA,"0.1.4"
"13136","646",2023-01-15 19:45:00,998,1006,8,0,TRUE,NA,"0.1.4"
"13137","646",2023-01-15 20:00:00,998,1006,8,0,TRUE,NA,"0.1.4"
"13138","646",2023-01-15 20:15:00,998,1006,8,0,TRUE,NA,"0.1.4"
"13139","646",2023-01-15 20:30:00,998,1006,8,0,TRUE,NA,"0.1.4"
"13140","646",2023-01-15 20:45:00,998,1006,8,0,TRUE,NA,"0.1.4"
"13141","646",2023-01-15 21:00:00,998,1006,8,0,TRUE,NA,"0.1.4"
"13142","646",2023-01-15 21:15:00,998,1006,8,0,FALSE,NA,"0.1.4"
"13143","646",2023-01-15 21:30:00,998,1006,8,0,FALSE,NA,"0.1.4"
"13144","646",2023-01-15 21:45:00,998,1006,8,0,FALSE,NA,"0.1.4"
"13145","646",2023-01-15 22:00:00,998,1006,8,0,FALSE,NA,"0.1.4"
"13146","646",2023-01-15 22:15:00,998,1006,8,0,FALSE,NA,"0.1.4"
"13147","646",2023-01-15 22:30:00,998,1006,8,0,FALSE,NA,"0.1.4"
"13148","646",2023-01-15 22:45:00,998,1006,8,0,FALSE,NA,"0.1.4"
"13149","646",2023-01-15 23:00:00,998,1006,8,0,FALSE,NA,"0.1.4"
"13150","646",2023-01-15 23:15:00,998,1006,8,0,FALSE,NA,"0.1.4"
"13151","646",2023-01-15 23:30:00,998,1006,8,0,FALSE,NA,"0.1.4"
"13152","646",2023-01-15 23:45:00,998,1006,8,0,TRUE,NA,"0.1.4"
"13153","646",2023-01-16,998,1006,8,0,TRUE,NA,"0.1.4"
"13154","646",2023-01-16 00:15:00,998,1006,8,0,TRUE,NA,"0.1.4"
"13155","646",2023-01-16 00:30:00,998,1006,8,0,TRUE,NA,"0.1.4"
"13156","646",2023-01-16 00:45:00,998,1006,8,0,TRUE,NA,"0.1.4"
"13157","646",2023-01-16 01:00:00,998,1006,8,0,TRUE,NA,"0.1.4"
"13158","646",2023-01-16 01:15:00,998,1006,8,0,TRUE,NA,"0.1.4"
"13159","646",2023-01-16 01:30:00,998,1006,8,0,TRUE,NA,"0.1.4"
"13160","646",2023-01-16 01:45:00,998,1006,8,0,TRUE,NA,"0.1.4"
"13161","646",2023-01-16 02:00:00,998,1006,8,0,TRUE,NA,"0.1.4"
"13162","646",2023-01-16 02:15:00,998,1006,8,0,TRUE,NA,"0.1.4"
"13163","646",2023-01-16 02:30:00,998,1006,8,0,TRUE,NA,"0.1.4"
"13164","646",2023-01-16 02:45:00,998,1006,8,0,TRUE,NA,"0.1.4"
"13165","646",2023-01-16 03:00:00,998,1006,8,0,TRUE,NA,"0.1.4"
"13166","646",2023-01-16 03:15:00,998,1006,8,0,TRUE,NA,"0.1.4"
"13167","646",2023-01-16 03:30:00,998,1006,8,0,TRUE,NA,"0.1.4"
"13168","646",2023-01-16 03:45:00,998,1006,8,0,TRUE,NA,"0.1.4"
"13169","646",2023-01-16 04:00:00,998,1006,8,0,TRUE,NA,"0.1.4"
"13170","646",2023-01-16 04:15:00,998,1006,8,0,TRUE,NA,"0.1.4"
"13171","646",2023-01-16 04:30:00,998,1006,8,0,TRUE,NA,"0.1.4"
"13172","646",2023-01-16 04:45:00,998,1006,8,0,TRUE,NA,"0.1.4"
"13173","646",2023-01-16 05:00:00,998,1006,8,0,TRUE,NA,"0.1.4"
"13174","646",2023-01-16 05:15:00,998,1006,8,0,TRUE,NA,"0.1.4"
"13175","646",2023-01-16 05:30:00,998,1006,8,0,TRUE,NA,"0.1.4"
"13176","646",2023-01-16 05:45:00,998,1006,8,0,TRUE,NA,"0.1.4"
"13177","646",2023-01-16 06:00:00,998,1006,8,0,TRUE,NA,"0.1.4"
"13178","646",2023-01-16 06:15:00,998,1006,8,0,TRUE,NA,"0.1.4"
"13179","646",2023-01-16 06:30:00,998,1006,8,0,TRUE,NA,"0.1.4"
"13180","646",2023-01-16 06:45:00,998,1006,8,0,TRUE,NA,"0.1.4"
"13181","646",2023-01-16 07:00:00,998,1006,8,0,TRUE,NA,"0.1.4"
"13182","646",2023-01-16 07:15:00,998,1006,8,0,TRUE,NA,"0.1.4"
"13183","646",2023-01-16 07:30:00,998,1006,8,0,TRUE,NA,"0.1.4"
"13184","646",2023-01-16 07:45:00,998,1006,8,0,TRUE,NA,"0.1.4"
"13185","646",2023-01-16 08:00:00,998,1006,8,0,TRUE,NA,"0.1.4"
"13186","646",2023-01-16 08:15:00,998,1006,8,0,TRUE,NA,"0.1.4"
"13187","646",2023-01-16 08:30:00,998,1006,8,0,TRUE,NA,"0.1.4"
"13188","646",2023-01-16 08:45:00,998,1006,8,0,TRUE,NA,"0.1.4"
"13189","646",2023-01-16 09:00:00,998,1006,8,0,TRUE,NA,"0.1.4"
"13190","646",2023-01-16 09:15:00,998,1006,8,0,TRUE,NA,"0.1.4"
"13191","646",2023-01-16 09:30:00,998,1006,8,0,TRUE,NA,"0.1.4"
"13192","646",2023-01-16 09:45:00,998,1006,8,0,TRUE,NA,"0.1.4"
"13193","646",2023-01-16 10:00:00,998,1006,8,0,TRUE,NA,"0.1.4"
"13194","646",2023-01-16 10:15:00,998,1006,8,0,TRUE,NA,"0.1.4"
"13195","646",2023-01-16 10:30:00,998,1006,8,0,TRUE,NA,"0.1.4"
"13196","646",2023-01-16 10:45:00,998,1006,8,0,TRUE,NA,"0.1.4"
"13197","646",2023-01-16 11:00:00,998,1006,8,0,TRUE,NA,"0.1.4"
"13198","646",2023-01-16 11:15:00,998,1006,8,0,TRUE,NA,"0.1.4"
"13199","646",2023-01-16 11:30:00,998,1006,8,0,TRUE,NA,"0.1.4"
"13200","646",2023-01-16 11:45:00,998,1006,8,0,TRUE,NA,"0.1.4"
"13201","646",2023-01-16 12:00:00,998,1006,8,0,TRUE,NA,"0.1.4"
"13202","646",2023-01-16 12:15:00,998,1006,8,0,TRUE,NA,"0.1.4"
"13203","646",2023-01-16 12:30:00,998,1006,8,0,TRUE,NA,"0.1.4"
"13204","646",2023-01-16 12:45:00,998,1006,8,0,TRUE,NA,"0.1.4"
"13205","646",2023-01-16 13:00:00,998,1006,8,0,TRUE,NA,"0.1.4"
"13206","646",2023-01-16 13:15:00,998,1006,8,0,TRUE,NA,"0.1.4"
"13207","646",2023-01-16 13:30:00,998,1006,8,0,TRUE,NA,"0.1.4"
"13208","646",2023-01-16 13:45:00,998,1006,8,0,TRUE,NA,"0.1.4"
"13209","646",2023-01-16 14:00:00,998,1006,8,0,TRUE,NA,"0.1.4"
"13210","646",2023-01-16 14:15:00,998,1006,8,0,TRUE,NA,"0.1.4"
"13211","646",2023-01-16 14:30:00,998,1006,8,0,TRUE,NA,"0.1.4"
"13212","646",2023-01-16 14:45:00,998,1006,8,0,TRUE,NA,"0.1.4"
"13213","646",2023-01-16 15:00:00,998,1006,8,0,TRUE,NA,"0.1.4"
"13214","646",2023-01-16 15:15:00,998,1006,8,0,TRUE,NA,"0.1.4"
"13215","646",2023-01-16 15:30:00,998,1006,8,0,TRUE,NA,"0.1.4"
"13216","646",2023-01-16 15:45:00,998,1006,8,0,TRUE,NA,"0.1.4"
"13217","646",2023-01-16 16:00:00,998,1006,8,0,TRUE,NA,"0.1.4"
"13218","646",2023-01-16 16:15:00,998,1006,8,0,TRUE,NA,"0.1.4"
"13219","646",2023-01-16 16:30:00,998,1006,8,0,TRUE,NA,"0.1.4"
"13220","646",2023-01-16 16:45:00,998,1006,8,0,TRUE,NA,"0.1.4"
"13221","646",2023-01-16 17:00:00,998,1006,8,0,TRUE,NA,"0.1.4"
"13222","646",2023-01-16 17:15:00,998,1006,8,0,TRUE,NA,"0.1.4"
"13223","646",2023-01-16 17:30:00,998,1006,8,0,TRUE,NA,"0.1.4"
"13224","646",2023-01-16 17:45:00,998,1006,8,0,TRUE,NA,"0.1.4"
"13225","646",2023-01-16 18:00:00,998,1006,8,0,TRUE,NA,"0.1.4"
"13226","646",2023-01-16 18:15:00,998,1006,8,0,TRUE,NA,"0.1.4"
"13227","646",2023-01-16 18:30:00,998,1006,8,0,TRUE,NA,"0.1.4"
"13228","646",2023-01-16 18:45:00,998,1006,8,0,TRUE,NA,"0.1.4"
"13229","646",2023-01-16 19:00:00,998,1006,8,0,TRUE,NA,"0.1.4"
"13230","646",2023-01-16 19:15:00,998,1006,8,0,TRUE,NA,"0.1.4"
"13231","646",2023-01-16 19:30:00,998,1006,8,0,TRUE,NA,"0.1.4"
"13232","646",2023-01-16 19:45:00,998,1006,8,0,TRUE,NA,"0.1.4"
"13233","646",2023-01-16 20:00:00,998,1006,8,0,TRUE,NA,"0.1.4"
"13234","646",2023-01-16 20:15:00,998,1006,8,0,TRUE,NA,"0.1.4"
"13235","646",2023-01-16 20:30:00,998,1006,8,0,TRUE,NA,"0.1.4"
"13236","646",2023-01-16 20:45:00,998,1006,8,0,TRUE,NA,"0.1.4"
"13237","646",2023-01-16 21:00:00,998,1006,8,0,TRUE,NA,"0.1.4"
"13238","646",2023-01-16 21:15:00,998,1006,8,0,TRUE,NA,"0.1.4"
"13239","646",2023-01-16 21:30:00,998,1006,8,0,TRUE,NA,"0.1.4"
"13240","646",2023-01-16 21:45:00,998,1006,8,0,TRUE,NA,"0.1.4"
"13241","646",2023-01-16 22:00:00,998,1006,8,0,TRUE,NA,"0.1.4"
"13242","646",2023-01-16 22:15:00,998,1006,8,0,TRUE,NA,"0.1.4"
"13243","646",2023-01-16 22:30:00,998,1006,8,0,TRUE,NA,"0.1.4"
"13244","646",2023-01-16 22:45:00,998,1006,8,0,TRUE,NA,"0.1.4"
"13245","646",2023-01-16 23:00:00,998,1006,8,0,TRUE,NA,"0.1.4"
"13246","646",2023-01-16 23:15:00,998,1006,8,0,TRUE,NA,"0.1.4"
"13247","646",2023-01-16 23:30:00,998,1006,8,0,TRUE,NA,"0.1.4"
"13248","646",2023-01-16 23:45:00,998,1006,8,0,TRUE,NA,"0.1.4"
"13249","646",2023-01-17,998,1006,8,0,TRUE,NA,"0.1.4"
"13250","646",2023-01-17 00:15:00,998,1006,8,0,TRUE,NA,"0.1.4"
"13251","646",2023-01-17 00:30:00,998,1006,8,0,TRUE,NA,"0.1.4"
"13252","646",2023-01-17 00:45:00,998,1006,8,0,TRUE,NA,"0.1.4"
"13253","646",2023-01-17 01:00:00,998,1006,8,0,TRUE,NA,"0.1.4"
"13254","646",2023-01-17 01:15:00,998,1006,8,0,TRUE,NA,"0.1.4"
"13255","646",2023-01-17 01:30:00,998,1006,8,0,TRUE,NA,"0.1.4"
"13256","646",2023-01-17 01:45:00,998,1006,8,0,TRUE,NA,"0.1.4"
"13257","646",2023-01-17 02:00:00,998,1006,8,0,TRUE,NA,"0.1.4"
"13258","646",2023-01-17 02:15:00,998,1006,8,0,TRUE,NA,"0.1.4"
"13259","646",2023-01-17 02:30:00,998,1006,8,0,TRUE,NA,"0.1.4"
"13260","646",2023-01-17 02:45:00,998,1006,8,0,TRUE,NA,"0.1.4"
"13261","646",2023-01-17 03:00:00,998,1006,8,0,TRUE,NA,"0.1.4"
"13262","646",2023-01-17 03:15:00,998,1006,8,0,TRUE,NA,"0.1.4"
"13263","646",2023-01-17 03:30:00,998,1006,8,0,TRUE,NA,"0.1.4"
"13264","646",2023-01-17 03:45:00,998,1006,8,0,TRUE,NA,"0.1.4"
"13265","646",2023-01-17 04:00:00,998,1006,8,0,TRUE,NA,"0.1.4"
"13266","646",2023-01-17 04:15:00,998,1006,8,0,TRUE,NA,"0.1.4"
"13267","646",2023-01-17 04:30:00,998,1006,8,0,TRUE,NA,"0.1.4"
"13268","646",2023-01-17 04:45:00,998,1006,8,0,TRUE,NA,"0.1.4"
"13269","646",2023-01-17 05:00:00,998,1006,8,0,TRUE,NA,"0.1.4"
"13270","646",2023-01-17 05:15:00,998,1006,8,0,TRUE,NA,"0.1.4"
"13271","646",2023-01-17 05:30:00,998,1006,8,0,TRUE,NA,"0.1.4"
"13272","646",2023-01-17 05:45:00,998,1006,8,0,TRUE,NA,"0.1.4"
"13273","646",2023-01-17 06:00:00,998,1006,8,0,TRUE,NA,"0.1.4"
"13274","646",2023-01-17 06:15:00,998,1006,8,0,TRUE,NA,"0.1.4"
"13275","646",2023-01-17 06:30:00,998,1006,8,0,TRUE,NA,"0.1.4"
"13276","646",2023-01-17 06:45:00,998,1006,8,0,TRUE,NA,"0.1.4"
"13277","646",2023-01-17 07:00:00,998,1006,8,0,TRUE,NA,"0.1.4"
"13278","646",2023-01-17 07:15:00,998,1006,8,0,TRUE,NA,"0.1.4"
"13279","646",2023-01-17 07:30:00,998,1006,8,0,TRUE,NA,"0.1.4"
"13280","646",2023-01-17 07:45:00,998,1006,8,0,TRUE,NA,"0.1.4"
"13281","646",2023-01-17 08:00:00,998,1006,8,0,TRUE,NA,"0.1.4"
"13282","646",2023-01-17 08:15:00,998,1006,8,0,TRUE,NA,"0.1.4"
"13283","646",2023-01-17 08:30:00,998,1006,8,0,TRUE,NA,"0.1.4"
"13284","646",2023-01-17 08:45:00,998,1006,8,0,TRUE,NA,"0.1.4"
"13285","646",2023-01-17 09:00:00,998,1006,8,0,TRUE,NA,"0.1.4"
"13286","646",2023-01-17 09:15:00,998,1006,8,0,TRUE,NA,"0.1.4"
"13287","646",2023-01-17 09:30:00,998,1006,8,0,TRUE,NA,"0.1.4"
"13288","646",2023-01-17 09:45:00,998,1006,8,0,TRUE,NA,"0.1.4"
"13289","646",2023-01-17 10:00:00,998,1006,8,0,TRUE,NA,"0.1.4"
"13290","646",2023-01-17 10:15:00,998,1006,8,0,TRUE,NA,"0.1.4"
"13291","646",2023-01-17 10:30:00,998,1006,8,0,TRUE,NA,"0.1.4"
"13292","646",2023-01-17 10:45:00,998,1006,8,0,TRUE,NA,"0.1.4"
"13293","646",2023-01-17 11:00:00,998,1006,8,0,TRUE,NA,"0.1.4"
"13294","646",2023-01-17 11:15:00,998,1006,8,0,TRUE,NA,"0.1.4"
"13295","646",2023-01-17 11:30:00,998,1006,8,0,TRUE,NA,"0.1.4"
"13296","646",2023-01-17 11:45:00,998,1006,8,0,TRUE,NA,"0.1.4"
"13297","646",2023-01-17 12:00:00,998,1006,8,0,TRUE,NA,"0.1.4"
"13298","646",2023-01-17 12:15:00,998,1006,8,0,TRUE,NA,"0.1.4"
"13299","646",2023-01-17 12:30:00,998,1006,8,0,TRUE,NA,"0.1.4"
"13300","646",2023-01-17 12:45:00,998,1006,8,0,TRUE,NA,"0.1.4"
"13301","646",2023-01-17 13:00:00,998,1006,8,0,TRUE,NA,"0.1.4"
"13302","646",2023-01-17 13:15:00,998,1006,8,0,TRUE,NA,"0.1.4"
"13303","646",2023-01-17 13:30:00,998,1006,8,0,TRUE,NA,"0.1.4"
"13304","646",2023-01-17 13:45:00,998,1006,8,0,TRUE,NA,"0.1.4"
"13305","646",2023-01-17 14:00:00,998,1006,8,0,TRUE,NA,"0.1.4"
"13306","646",2023-01-17 14:15:00,998,1006,8,0,TRUE,NA,"0.1.4"
"13307","646",2023-01-17 14:30:00,998,1006,8,0,TRUE,NA,"0.1.4"
"13308","646",2023-01-17 14:45:00,998,1006,8,0,TRUE,NA,"0.1.4"
"13309","646",2023-01-17 15:00:00,998,1006,8,0,TRUE,NA,"0.1.4"
"13310","646",2023-01-17 15:15:00,998,1006,8,0,TRUE,NA,"0.1.4"
"13311","646",2023-01-17 15:30:00,998,1006,8,0,TRUE,NA,"0.1.4"
"13312","646",2023-01-17 15:45:00,998,1006,8,0,TRUE,NA,"0.1.4"
"13313","646",2023-01-17 16:00:00,998,1006,8,0,TRUE,NA,"0.1.4"
"13314","646",2023-01-17 16:15:00,998,1006,8,0,TRUE,NA,"0.1.4"
"13315","646",2023-01-17 16:30:00,998,1006,8,0,TRUE,NA,"0.1.4"
"13316","646",2023-01-17 16:45:00,998,1006,8,0,TRUE,NA,"0.1.4"
"13317","646",2023-01-17 17:00:00,998,1006,8,0,TRUE,NA,"0.1.4"
"13318","646",2023-01-17 17:15:00,998,1006,8,0,TRUE,NA,"0.1.4"
"13319","646",2023-01-17 17:30:00,998,1006,8,0,TRUE,NA,"0.1.4"
"13320","646",2023-01-17 17:45:00,998,1006,8,0,TRUE,NA,"0.1.4"
"13321","646",2023-01-17 18:00:00,998,1006,8,0,TRUE,NA,"0.1.4"
"13322","646",2023-01-17 18:15:00,998,1006,8,0,TRUE,NA,"0.1.4"
"13323","646",2023-01-17 18:30:00,998,1006,8,0,TRUE,NA,"0.1.4"
"13324","646",2023-01-17 18:45:00,998,1006,8,0,TRUE,NA,"0.1.4"
"13325","646",2023-01-17 19:00:00,998,1006,8,0,TRUE,NA,"0.1.4"
"13326","646",2023-01-17 19:15:00,998,1006,8,0,TRUE,NA,"0.1.4"
"13327","646",2023-01-17 19:30:00,998,1006,8,0,TRUE,NA,"0.1.4"
"13328","646",2023-01-17 19:45:00,998,1006,8,0,TRUE,NA,"0.1.4"
"13329","646",2023-01-17 20:00:00,998,1006,8,0,TRUE,NA,"0.1.4"
"13330","646",2023-01-17 20:15:00,998,1006,8,0,TRUE,NA,"0.1.4"
"13331","646",2023-01-17 20:30:00,998,1006,8,0,TRUE,NA,"0.1.4"
"13332","646",2023-01-17 20:45:00,998,1006,8,0,TRUE,NA,"0.1.4"
"13333","646",2023-01-17 21:00:00,998,1006,8,0,TRUE,NA,"0.1.4"
"13334","646",2023-01-17 21:15:00,998,1006,8,0,TRUE,NA,"0.1.4"
"13335","646",2023-01-17 21:30:00,998,1006,8,0,TRUE,NA,"0.1.4"
"13336","646",2023-01-17 21:45:00,998,1006,8,0,TRUE,NA,"0.1.4"
"13337","646",2023-01-17 22:00:00,998,1006,8,0,TRUE,NA,"0.1.4"
"13338","646",2023-01-17 22:15:00,998,1006,8,0,TRUE,NA,"0.1.4"
"13339","646",2023-01-17 22:30:00,998,1006,8,0,TRUE,NA,"0.1.4"
"13340","646",2023-01-17 22:45:00,998,1006,8,0,TRUE,NA,"0.1.4"
"13341","646",2023-01-17 23:00:00,998,1006,8,0,TRUE,NA,"0.1.4"
"13342","646",2023-01-17 23:15:00,998,1006,8,0,TRUE,NA,"0.1.4"
"13343","646",2023-01-17 23:30:00,998,1006,8,0,TRUE,NA,"0.1.4"
"13344","646",2023-01-17 23:45:00,998,1006,8,0,TRUE,NA,"0.1.4"
"13345","646",2023-01-18,998,1006,8,0,TRUE,NA,"0.1.4"
"13346","646",2023-01-18 00:15:00,998,1006,8,0,TRUE,NA,"0.1.4"
"13347","646",2023-01-18 00:30:00,998,1006,8,0,TRUE,NA,"0.1.4"
"13348","646",2023-01-18 00:45:00,998,1006,8,0,TRUE,NA,"0.1.4"
"13349","646",2023-01-18 01:00:00,998,1006,8,0,TRUE,NA,"0.1.4"
"13350","646",2023-01-18 01:15:00,998,1006,8,0,TRUE,NA,"0.1.4"
"13351","646",2023-01-18 01:30:00,998,1006,8,0,TRUE,NA,"0.1.4"
"13352","646",2023-01-18 01:45:00,998,1006,8,0,TRUE,NA,"0.1.4"
"13353","646",2023-01-18 02:00:00,998,1006,8,0,TRUE,NA,"0.1.4"
"13354","646",2023-01-18 02:15:00,998,1006,8,0,TRUE,NA,"0.1.4"
"13355","646",2023-01-18 02:30:00,998,1006,8,0,TRUE,NA,"0.1.4"
"13356","646",2023-01-18 02:45:00,998,1006,8,0,TRUE,NA,"0.1.4"
"13357","646",2023-01-18 03:00:00,998,1006,8,0,TRUE,NA,"0.1.4"
"13358","646",2023-01-18 03:15:00,998,1006,8,0,TRUE,NA,"0.1.4"
"13359","646",2023-01-18 03:30:00,998,1006,8,0,TRUE,NA,"0.1.4"
"13360","646",2023-01-18 03:45:00,998,1006,8,0,TRUE,NA,"0.1.4"
"13361","646",2023-01-18 04:00:00,998,1006,8,0,TRUE,NA,"0.1.4"
"13362","646",2023-01-18 04:15:00,998,1006,8,0,TRUE,NA,"0.1.4"
"13363","646",2023-01-18 04:30:00,998,1006,8,0,TRUE,NA,"0.1.4"
"13364","646",2023-01-18 04:45:00,998,1006,8,0,TRUE,NA,"0.1.4"
"13365","646",2023-01-18 05:00:00,998,1006,8,0,TRUE,NA,"0.1.4"
"13366","646",2023-01-18 05:15:00,998,1006,8,0,TRUE,NA,"0.1.4"
"13367","646",2023-01-18 05:30:00,998,1006,8,0,TRUE,NA,"0.1.4"
"13368","646",2023-01-18 05:45:00,998,1006,8,0,TRUE,NA,"0.1.4"
"13369","646",2023-01-18 06:00:00,998,1006,8,0,TRUE,NA,"0.1.4"
"13370","646",2023-01-18 06:15:00,998,1006,8,0,TRUE,NA,"0.1.4"
"13371","646",2023-01-18 06:30:00,998,1006,8,0,TRUE,NA,"0.1.4"
"13372","646",2023-01-18 06:45:00,998,1006,8,0,TRUE,NA,"0.1.4"
"13373","646",2023-01-18 07:00:00,998,1006,8,0,TRUE,NA,"0.1.4"
"13374","646",2023-01-18 07:15:00,998,1006,8,0,TRUE,NA,"0.1.4"
"13375","646",2023-01-18 07:30:00,998,1006,8,0,TRUE,NA,"0.1.4"
"13376","646",2023-01-18 07:45:00,998,1006,8,0,TRUE,NA,"0.1.4"
"13377","646",2023-01-18 08:00:00,998,1006,8,0,TRUE,NA,"0.1.4"
"13378","646",2023-01-18 08:15:00,998,1006,8,0,TRUE,NA,"0.1.4"
"13379","646",2023-01-18 08:30:00,998,1006,8,0,TRUE,NA,"0.1.4"
"13380","646",2023-01-18 08:45:00,998,1006,8,0,TRUE,NA,"0.1.4"
"13381","646",2023-01-18 09:00:00,998,1006,8,0,TRUE,NA,"0.1.4"
"13382","646",2023-01-18 09:15:00,998,1006,8,0,TRUE,NA,"0.1.4"
"13383","646",2023-01-18 09:30:00,998,1006,8,0,TRUE,NA,"0.1.4"
"13384","646",2023-01-18 09:45:00,998,1006,8,0,TRUE,NA,"0.1.4"
"13385","646",2023-01-18 10:00:00,998,1006,8,0,TRUE,NA,"0.1.4"
"13386","646",2023-01-18 10:15:00,998,1006,8,0,TRUE,NA,"0.1.4"
"13387","646",2023-01-18 10:30:00,998,1006,8,0,TRUE,NA,"0.1.4"
"13388","646",2023-01-18 10:45:00,998,1006,8,0,TRUE,NA,"0.1.4"
"13389","646",2023-01-18 11:00:00,998,1006,8,0,TRUE,NA,"0.1.4"
"13390","646",2023-01-18 11:15:00,998,1006,8,0,TRUE,NA,"0.1.4"
"13391","646",2023-01-18 11:30:00,998,1006,8,0,TRUE,NA,"0.1.4"
"13392","646",2023-01-18 11:45:00,998,1006,8,0,TRUE,NA,"0.1.4"
"13393","646",2023-01-18 12:00:00,998,1006,8,0,TRUE,NA,"0.1.4"
"13394","646",2023-01-18 12:15:00,998,1006,8,0,TRUE,NA,"0.1.4"
"13395","646",2023-01-18 12:30:00,998,1006,8,0,TRUE,NA,"0.1.4"
"13396","646",2023-01-18 12:45:00,998,1006,8,0,TRUE,NA,"0.1.4"
"13397","646",2023-01-18 13:00:00,998,1006,8,0,TRUE,NA,"0.1.4"
"13398","646",2023-01-18 13:15:00,998,1006,8,0,TRUE,NA,"0.1.4"
"13399","646",2023-01-18 13:30:00,998,1006,8,0,TRUE,NA,"0.1.4"
"13400","646",2023-01-18 13:45:00,998,1006,8,0,TRUE,NA,"0.1.4"
"13401","646",2023-01-18 14:00:00,998,1006,8,0,TRUE,NA,"0.1.4"
"13402","646",2023-01-18 14:15:00,998,1006,8,0,TRUE,NA,"0.1.4"
"13403","646",2023-01-18 14:30:00,998,1006,8,0,TRUE,NA,"0.1.4"
"13404","646",2023-01-18 14:45:00,998,1006,8,0,TRUE,NA,"0.1.4"
"13405","646",2023-01-18 15:00:00,998,1006,8,0,TRUE,NA,"0.1.4"
"13406","646",2023-01-18 15:15:00,998,1006,8,0,TRUE,NA,"0.1.4"
"13407","646",2023-01-18 15:30:00,998,1006,8,0,TRUE,NA,"0.1.4"
"13408","646",2023-01-18 15:45:00,998,1006,8,0,TRUE,NA,"0.1.4"
"13409","646",2023-01-18 16:00:00,998,1006,8,0,TRUE,NA,"0.1.4"
"13410","646",2023-01-18 16:15:00,998,1006,8,0,TRUE,NA,"0.1.4"
"13411","646",2023-01-18 16:30:00,998,1006,8,0,TRUE,NA,"0.1.4"
"13412","646",2023-01-18 16:45:00,998,1006,8,0,TRUE,NA,"0.1.4"
"13413","646",2023-01-18 17:00:00,998,1006,8,0,TRUE,NA,"0.1.4"
"13414","646",2023-01-18 17:15:00,998,1006,8,0,TRUE,NA,"0.1.4"
"13415","646",2023-01-18 17:30:00,998,1006,8,0,TRUE,NA,"0.1.4"
"13416","646",2023-01-18 17:45:00,998,1006,8,0,TRUE,NA,"0.1.4"
"13417","646",2023-01-18 18:00:00,998,1006,8,0,TRUE,NA,"0.1.4"
"13418","646",2023-01-18 18:15:00,998,1006,8,0,TRUE,NA,"0.1.4"
"13419","646",2023-01-18 18:30:00,998,1006,8,0,TRUE,NA,"0.1.4"
"13420","646",2023-01-18 18:45:00,998,1006,8,0,TRUE,NA,"0.1.4"
"13421","646",2023-01-18 19:00:00,998,1006,8,0,TRUE,NA,"0.1.4"
"13422","646",2023-01-18 19:15:00,998,1006,8,0,TRUE,NA,"0.1.4"
"13423","646",2023-01-18 19:30:00,998,1006,8,0,TRUE,NA,"0.1.4"
"13424","646",2023-01-18 19:45:00,998,1006,8,0,TRUE,NA,"0.1.4"
"13425","646",2023-01-18 20:00:00,998,1006,8,0,TRUE,NA,"0.1.4"
"13426","646",2023-01-18 20:15:00,998,1006,8,0,TRUE,NA,"0.1.4"
"13427","646",2023-01-18 20:30:00,998,1006,8,0,TRUE,NA,"0.1.4"
"13428","646",2023-01-18 20:45:00,998,1006,8,0,TRUE,NA,"0.1.4"
"13429","646",2023-01-18 21:00:00,998,1006,8,0,TRUE,NA,"0.1.4"
"13430","646",2023-01-18 21:15:00,998,1006,8,0,TRUE,NA,"0.1.4"
"13431","646",2023-01-18 21:30:00,998,1006,8,0,TRUE,NA,"0.1.4"
"13432","646",2023-01-18 21:45:00,998,1006,8,0,TRUE,NA,"0.1.4"
"13433","646",2023-01-18 22:00:00,998,1006,8,0,TRUE,NA,"0.1.4"
"13434","646",2023-01-18 22:15:00,998,1006,8,0,TRUE,NA,"0.1.4"
"13435","646",2023-01-18 22:30:00,998,1006,8,0,TRUE,NA,"0.1.4"
"13436","646",2023-01-18 22:45:00,998,1006,8,0,TRUE,NA,"0.1.4"
"13437","646",2023-01-18 23:00:00,998,1006,8,0,TRUE,NA,"0.1.4"
"13438","646",2023-01-18 23:15:00,998,1006,8,0,TRUE,NA,"0.1.4"
"13439","646",2023-01-18 23:30:00,998,1006,8,0,TRUE,NA,"0.1.4"
"13440","646",2023-01-18 23:45:00,998,1006,8,0,TRUE,NA,"0.1.4"
"13441","646",2023-01-19,998,1006,8,0,TRUE,NA,"0.1.4"
"13442","646",2023-01-19 00:15:00,998,1006,8,0,TRUE,NA,"0.1.4"
"13443","646",2023-01-19 00:30:00,998,1006,8,0,TRUE,NA,"0.1.4"
"13444","646",2023-01-19 00:45:00,998,1006,8,0,TRUE,NA,"0.1.4"
"13445","646",2023-01-19 01:00:00,998,1006,8,0,TRUE,NA,"0.1.4"
"13446","646",2023-01-19 01:15:00,998,1006,8,0,TRUE,NA,"0.1.4"
"13447","646",2023-01-19 01:30:00,998,1006,8,0,TRUE,NA,"0.1.4"
"13448","646",2023-01-19 01:45:00,998,1006,8,0,TRUE,NA,"0.1.4"
"13449","646",2023-01-19 02:00:00,998,1006,8,0,TRUE,NA,"0.1.4"
"13450","646",2023-01-19 02:15:00,998,1006,8,0,TRUE,NA,"0.1.4"
"13451","646",2023-01-19 02:30:00,998,1006,8,0,TRUE,NA,"0.1.4"
"13452","646",2023-01-19 02:45:00,998,1006,8,0,TRUE,NA,"0.1.4"
"13453","646",2023-01-19 03:00:00,998,1006,8,0,TRUE,NA,"0.1.4"
"13454","646",2023-01-19 03:15:00,998,1006,8,0,TRUE,NA,"0.1.4"
"13455","646",2023-01-19 03:30:00,998,1006,8,0,TRUE,NA,"0.1.4"
"13456","646",2023-01-19 03:45:00,998,1006,8,0,TRUE,NA,"0.1.4"
"13457","646",2023-01-19 04:00:00,998,1006,8,0,TRUE,NA,"0.1.4"
"13458","646",2023-01-19 04:15:00,998,1006,8,0,TRUE,NA,"0.1.4"
"13459","646",2023-01-19 04:30:00,998,1006,8,0,TRUE,NA,"0.1.4"
"13460","646",2023-01-19 04:45:00,998,1006,8,0,TRUE,NA,"0.1.4"
"13461","646",2023-01-19 05:00:00,998,1006,8,0,TRUE,NA,"0.1.4"
"13462","646",2023-01-19 05:15:00,998,1006,8,0,TRUE,NA,"0.1.4"
"13463","646",2023-01-19 05:30:00,998,1006,8,0,TRUE,NA,"0.1.4"
"13464","646",2023-01-19 05:45:00,998,1006,8,0,TRUE,NA,"0.1.4"
"13465","646",2023-01-19 06:00:00,998,1006,8,0,TRUE,NA,"0.1.4"
"13466","646",2023-01-19 06:15:00,998,1006,8,0,TRUE,NA,"0.1.4"
"13467","646",2023-01-19 06:30:00,998,1006,8,0,TRUE,NA,"0.1.4"
"13468","646",2023-01-19 06:45:00,998,1006,8,0,TRUE,NA,"0.1.4"
"13469","646",2023-01-19 07:00:00,998,1006,8,0,TRUE,NA,"0.1.4"
"13470","646",2023-01-19 07:15:00,998,1006,8,0,TRUE,NA,"0.1.4"
"13471","646",2023-01-19 07:30:00,998,1006,8,0,TRUE,NA,"0.1.4"
"13472","646",2023-01-19 07:45:00,998,1006,8,0,TRUE,NA,"0.1.4"
"13473","646",2023-01-19 08:00:00,998,1006,8,0,TRUE,NA,"0.1.4"
"13474","646",2023-01-19 08:15:00,998,1006,8,0,TRUE,NA,"0.1.4"
"13475","646",2023-01-19 08:30:00,998,1006,8,0,TRUE,NA,"0.1.4"
"13476","646",2023-01-19 08:45:00,998,1006,8,0,TRUE,NA,"0.1.4"
"13477","646",2023-01-19 09:00:00,998,1006,8,0,TRUE,NA,"0.1.4"
"13478","646",2023-01-19 09:15:00,998,1006,8,0,TRUE,NA,"0.1.4"
"13479","646",2023-01-19 09:30:00,998,1006,8,0,TRUE,NA,"0.1.4"
"13480","646",2023-01-19 09:45:00,998,1006,8,0,TRUE,NA,"0.1.4"
"13481","646",2023-01-19 10:00:00,998,1006,8,0,TRUE,NA,"0.1.4"
"13482","646",2023-01-19 10:15:00,998,1006,8,0,TRUE,NA,"0.1.4"
"13483","646",2023-01-19 10:30:00,998,1006,8,0,TRUE,NA,"0.1.4"
"13484","646",2023-01-19 10:45:00,998,1006,8,0,TRUE,NA,"0.1.4"
"13485","646",2023-01-19 11:00:00,998,1006,8,0,TRUE,NA,"0.1.4"
"13486","646",2023-01-19 11:15:00,998,1006,8,0,TRUE,NA,"0.1.4"
"13487","646",2023-01-19 11:30:00,998,1006,8,0,TRUE,NA,"0.1.4"
"13488","646",2023-01-19 11:45:00,998,1006,8,0,TRUE,NA,"0.1.4"
"13489","646",2023-01-19 12:00:00,998,1006,8,0,TRUE,NA,"0.1.4"
"13490","646",2023-01-19 12:15:00,998,1006,8,0,TRUE,NA,"0.1.4"
"13491","646",2023-01-19 12:30:00,998,1006,8,0,TRUE,NA,"0.1.4"
"13492","646",2023-01-19 12:45:00,998,1006,8,0,TRUE,NA,"0.1.4"
"13493","646",2023-01-19 13:00:00,998,1006,8,0,TRUE,NA,"0.1.4"
"13494","646",2023-01-19 13:15:00,998,1006,8,0,TRUE,NA,"0.1.4"
"13495","646",2023-01-19 13:30:00,998,1006,8,0,TRUE,NA,"0.1.4"
"13496","646",2023-01-19 13:45:00,998,1006,8,0,TRUE,NA,"0.1.4"
"13497","646",2023-01-19 14:00:00,998,1006,8,0,TRUE,NA,"0.1.4"
"13498","646",2023-01-19 14:15:00,998,1006,8,0,TRUE,NA,"0.1.4"
"13499","646",2023-01-19 14:30:00,998,1006,8,0,TRUE,NA,"0.1.4"
"13500","646",2023-01-19 14:45:00,998,1006,8,0,TRUE,NA,"0.1.4"
"13501","646",2023-01-19 15:00:00,998,1006,8,0,TRUE,NA,"0.1.4"
"13502","646",2023-01-19 15:15:00,998,1006,8,0,TRUE,NA,"0.1.4"
"13503","646",2023-01-19 15:30:00,998,1006,8,0,TRUE,NA,"0.1.4"
"13504","646",2023-01-19 15:45:00,998,1006,8,0,TRUE,NA,"0.1.4"
"13505","646",2023-01-19 16:00:00,998,1006,8,0,TRUE,NA,"0.1.4"
"13506","646",2023-01-19 16:15:00,998,1006,8,0,TRUE,NA,"0.1.4"
"13507","646",2023-01-19 16:30:00,998,1006,8,0,TRUE,NA,"0.1.4"
"13508","646",2023-01-19 16:45:00,998,1006,8,0,TRUE,NA,"0.1.4"
"13509","646",2023-01-19 17:00:00,998,1006,8,0,TRUE,NA,"0.1.4"
"13510","646",2023-01-19 17:15:00,998,1006,8,0,TRUE,NA,"0.1.4"
"13511","646",2023-01-19 17:30:00,998,1006,8,0,TRUE,NA,"0.1.4"
"13512","646",2023-01-19 17:45:00,998,1006,8,0,TRUE,NA,"0.1.4"
"13513","646",2023-01-19 18:00:00,998,1006,8,0,TRUE,NA,"0.1.4"
"13514","646",2023-01-19 18:15:00,998,1006,8,0,TRUE,NA,"0.1.4"
"13515","646",2023-01-19 18:30:00,998,1006,8,0,TRUE,NA,"0.1.4"
"13516","646",2023-01-19 18:45:00,998,1006,8,0,TRUE,NA,"0.1.4"
"13517","646",2023-01-19 19:00:00,998,1006,8,0,TRUE,NA,"0.1.4"
"13518","646",2023-01-19 19:15:00,998,1006,8,0,TRUE,NA,"0.1.4"
"13519","646",2023-01-19 19:30:00,998,1006,8,0,TRUE,NA,"0.1.4"
"13520","646",2023-01-19 19:45:00,998,1006,8,0,TRUE,NA,"0.1.4"
"13521","646",2023-01-19 20:00:00,998,1006,8,0,TRUE,NA,"0.1.4"
"13522","646",2023-01-19 20:15:00,998,1006,8,0,TRUE,NA,"0.1.4"
"13523","646",2023-01-19 20:30:00,998,1006,8,0,TRUE,NA,"0.1.4"
"13524","646",2023-01-19 20:45:00,998,1006,8,0,TRUE,NA,"0.1.4"
"13525","646",2023-01-19 21:00:00,998,1006,8,0,TRUE,NA,"0.1.4"
"13526","646",2023-01-19 21:15:00,998,1006,8,0,TRUE,NA,"0.1.4"
"13527","646",2023-01-19 21:30:00,998,1006,8,0,TRUE,NA,"0.1.4"
"13528","646",2023-01-19 21:45:00,998,1006,8,0,TRUE,NA,"0.1.4"
"13529","646",2023-01-19 22:00:00,998,1006,8,0,TRUE,NA,"0.1.4"
"13530","646",2023-01-19 22:15:00,998,1006,8,0,TRUE,NA,"0.1.4"
"13531","646",2023-01-19 22:30:00,998,1006,8,0,TRUE,NA,"0.1.4"
"13532","646",2023-01-19 22:45:00,998,1006,8,0,TRUE,NA,"0.1.4"
"13533","646",2023-01-19 23:00:00,998,1006,8,0,TRUE,NA,"0.1.4"
"13534","646",2023-01-19 23:15:00,998,1006,8,0,TRUE,NA,"0.1.4"
"13535","646",2023-01-19 23:30:00,998,1006,8,0,TRUE,NA,"0.1.4"
"13536","646",2023-01-19 23:45:00,998,1006,8,0,TRUE,NA,"0.1.4"
"13537","646",2023-01-20,998,1006,8,0,TRUE,NA,"0.1.4"
"13538","646",2023-01-20 00:15:00,998,1006,8,0,TRUE,NA,"0.1.4"
"13539","646",2023-01-20 00:30:00,998,1006,8,0,TRUE,NA,"0.1.4"
"13540","646",2023-01-20 00:45:00,998,1006,8,0,TRUE,NA,"0.1.4"
"13541","646",2023-01-20 01:00:00,998,1006,8,0,TRUE,NA,"0.1.4"
"13542","646",2023-01-20 01:15:00,998,1006,8,0,TRUE,NA,"0.1.4"
"13543","646",2023-01-20 01:30:00,998,1006,8,0,TRUE,NA,"0.1.4"
"13544","646",2023-01-20 01:45:00,998,1006,8,0,TRUE,NA,"0.1.4"
"13545","646",2023-01-20 02:00:00,998,1006,8,0,TRUE,NA,"0.1.4"
"13546","646",2023-01-20 02:15:00,998,1006,8,0,TRUE,NA,"0.1.4"
"13547","646",2023-01-20 02:30:00,998,1006,8,0,TRUE,NA,"0.1.4"
"13548","646",2023-01-20 02:45:00,998,1006,8,0,TRUE,NA,"0.1.4"
"13549","646",2023-01-20 03:00:00,998,1006,8,0,TRUE,NA,"0.1.4"
"13550","646",2023-01-20 03:15:00,998,1006,8,0,TRUE,NA,"0.1.4"
"13551","646",2023-01-20 03:30:00,998,1006,8,0,TRUE,NA,"0.1.4"
"13552","646",2023-01-20 03:45:00,998,1006,8,0,TRUE,NA,"0.1.4"
"13553","646",2023-01-20 04:00:00,998,1006,8,0,TRUE,NA,"0.1.4"
"13554","646",2023-01-20 04:15:00,998,1006,8,0,TRUE,NA,"0.1.4"
"13555","646",2023-01-20 04:30:00,998,1006,8,0,TRUE,NA,"0.1.4"
"13556","646",2023-01-20 04:45:00,998,1006,8,0,TRUE,NA,"0.1.4"
"13557","646",2023-01-20 05:00:00,998,1006,8,0,TRUE,NA,"0.1.4"
"13558","646",2023-01-20 05:15:00,998,1006,8,0,TRUE,NA,"0.1.4"
"13559","646",2023-01-20 05:30:00,998,1006,8,0,TRUE,NA,"0.1.4"
"13560","646",2023-01-20 05:45:00,998,1006,8,0,TRUE,NA,"0.1.4"
"13561","646",2023-01-20 06:00:00,998,1006,8,0,TRUE,NA,"0.1.4"
"13562","646",2023-01-20 06:15:00,998,1006,8,0,TRUE,NA,"0.1.4"
"13563","646",2023-01-20 06:30:00,998,1006,8,0,TRUE,NA,"0.1.4"
"13564","646",2023-01-20 06:45:00,998,1006,8,0,TRUE,NA,"0.1.4"
"13565","646",2023-01-20 07:00:00,998,1006,8,0,TRUE,NA,"0.1.4"
"13566","646",2023-01-20 07:15:00,998,1006,8,0,TRUE,NA,"0.1.4"
"13567","646",2023-01-20 07:30:00,998,1006,8,0,TRUE,NA,"0.1.4"
"13568","646",2023-01-20 07:45:00,998,1006,8,0,TRUE,NA,"0.1.4"
"13569","646",2023-01-20 08:00:00,998,1006,8,0,TRUE,NA,"0.1.4"
"13570","646",2023-01-20 08:15:00,998,1006,8,0,TRUE,NA,"0.1.4"
"13571","646",2023-01-20 08:30:00,998,1006,8,0,TRUE,NA,"0.1.4"
"13572","646",2023-01-20 08:45:00,998,1006,8,0,TRUE,NA,"0.1.4"
"13573","646",2023-01-20 09:00:00,998,1006,8,0,TRUE,NA,"0.1.4"
"13574","646",2023-01-20 09:15:00,998,1006,8,0,TRUE,NA,"0.1.4"
"13575","646",2023-01-20 09:30:00,998,1006,8,0,TRUE,NA,"0.1.4"
"13576","646",2023-01-20 09:45:00,998,1006,8,0,TRUE,NA,"0.1.4"
"13577","646",2023-01-20 10:00:00,998,1006,8,0,TRUE,NA,"0.1.4"
"13578","646",2023-01-20 10:15:00,998,1006,8,0,TRUE,NA,"0.1.4"
"13579","646",2023-01-20 10:30:00,998,1006,8,0,TRUE,NA,"0.1.4"
"13580","646",2023-01-20 10:45:00,998,1006,8,0,TRUE,NA,"0.1.4"
"13581","646",2023-01-20 11:00:00,998,1006,8,0,TRUE,NA,"0.1.4"
"13582","646",2023-01-20 11:15:00,998,1006,8,0,TRUE,NA,"0.1.4"
"13583","646",2023-01-20 11:30:00,998,1006,8,0,TRUE,NA,"0.1.4"
"13584","646",2023-01-20 11:45:00,998,1006,8,0,TRUE,NA,"0.1.4"
"13585","646",2023-01-20 12:00:00,998,1006,8,0,TRUE,NA,"0.1.4"
"13586","646",2023-01-20 12:15:00,998,1006,8,0,TRUE,NA,"0.1.4"
"13587","646",2023-01-20 12:30:00,998,1006,8,0,TRUE,NA,"0.1.4"
"13588","646",2023-01-20 12:45:00,998,1006,8,0,TRUE,NA,"0.1.4"
"13589","646",2023-01-20 13:00:00,998,1006,8,0,TRUE,NA,"0.1.4"
"13590","646",2023-01-20 13:15:00,998,1006,8,0,TRUE,NA,"0.1.4"
"13591","646",2023-01-20 13:30:00,998,1006,8,0,TRUE,NA,"0.1.4"
"13592","646",2023-01-20 13:45:00,998,1006,8,0,TRUE,NA,"0.1.4"
"13593","646",2023-01-20 14:00:00,998,1006,8,0,TRUE,NA,"0.1.4"
"13594","646",2023-01-20 14:15:00,998,1006,8,0,TRUE,NA,"0.1.4"
"13595","646",2023-01-20 14:30:00,998,1006,8,0,TRUE,NA,"0.1.4"
"13596","646",2023-01-20 14:45:00,998,1006,8,0,TRUE,NA,"0.1.4"
"13597","646",2023-01-20 15:00:00,998,1006,8,0,TRUE,NA,"0.1.4"
"13598","646",2023-01-20 15:15:00,998,1006,8,0,TRUE,NA,"0.1.4"
"13599","646",2023-01-20 15:30:00,998,1006,8,0,TRUE,NA,"0.1.4"
"13600","646",2023-01-20 15:45:00,998,1006,8,0,TRUE,NA,"0.1.4"
"13601","646",2023-01-20 16:00:00,998,1006,8,0,TRUE,NA,"0.1.4"
"13602","646",2023-01-20 16:15:00,998,1006,8,0,TRUE,NA,"0.1.4"
"13603","646",2023-01-20 16:30:00,998,1006,8,0,TRUE,NA,"0.1.4"
"13604","646",2023-01-20 16:45:00,998,1006,8,0,TRUE,NA,"0.1.4"
"13605","646",2023-01-20 17:00:00,998,1006,8,0,TRUE,NA,"0.1.4"
"13606","646",2023-01-20 17:15:00,998,1006,8,0,TRUE,NA,"0.1.4"
"13607","646",2023-01-20 17:30:00,998,1006,8,0,TRUE,NA,"0.1.4"
"13608","646",2023-01-20 17:45:00,998,1006,8,0,TRUE,NA,"0.1.4"
"13609","646",2023-01-20 18:00:00,998,1006,8,0,TRUE,NA,"0.1.4"
"13610","646",2023-01-20 18:15:00,998,1006,8,0,TRUE,NA,"0.1.4"
"13611","646",2023-01-20 18:30:00,998,1006,8,0,TRUE,NA,"0.1.4"
"13612","646",2023-01-20 18:45:00,998,1006,8,0,TRUE,NA,"0.1.4"
"13613","646",2023-01-20 19:00:00,998,1006,8,0,TRUE,NA,"0.1.4"
"13614","646",2023-01-20 19:15:00,998,1006,8,0,TRUE,NA,"0.1.4"
"13615","646",2023-01-20 19:30:00,998,1006,8,0,TRUE,NA,"0.1.4"
"13616","646",2023-01-20 19:45:00,998,1006,8,0,TRUE,NA,"0.1.4"
"13617","646",2023-01-20 20:00:00,998,1006,8,0,TRUE,NA,"0.1.4"
"13618","646",2023-01-20 20:15:00,998,1006,8,0,TRUE,NA,"0.1.4"
"13619","646",2023-01-20 20:30:00,998,1006,8,0,TRUE,NA,"0.1.4"
"13620","646",2023-01-20 20:45:00,998,1006,8,0,TRUE,NA,"0.1.4"
"13621","646",2023-01-20 21:00:00,998,1006,8,0,TRUE,NA,"0.1.4"
"13622","646",2023-01-20 21:15:00,998,1006,8,0,TRUE,NA,"0.1.4"
"13623","646",2023-01-20 21:30:00,998,1006,8,0,TRUE,NA,"0.1.4"
"13624","646",2023-01-20 21:45:00,998,1006,8,0,TRUE,NA,"0.1.4"
"13625","646",2023-01-20 22:00:00,998,1006,8,0,TRUE,NA,"0.1.4"
"13626","646",2023-01-20 22:15:00,998,1006,8,0,TRUE,NA,"0.1.4"
"13627","646",2023-01-20 22:30:00,998,1006,8,0,TRUE,NA,"0.1.4"
"13628","646",2023-01-20 22:45:00,998,1006,8,0,TRUE,NA,"0.1.4"
"13629","646",2023-01-20 23:00:00,998,1006,8,0,TRUE,NA,"0.1.4"
"13630","646",2023-01-20 23:15:00,998,1006,8,0,TRUE,NA,"0.1.4"
"13631","646",2023-01-20 23:30:00,998,1006,8,0,TRUE,NA,"0.1.4"
"13632","646",2023-01-20 23:45:00,998,1006,8,0,TRUE,NA,"0.1.4"
"13633","646",2023-01-21,998,1006,8,0,TRUE,NA,"0.1.4"
"13634","646",2023-01-21 00:15:00,998,1006,8,0,TRUE,NA,"0.1.4"
"13635","646",2023-01-21 00:30:00,998,1006,8,0,TRUE,NA,"0.1.4"
"13636","646",2023-01-21 00:45:00,998,1006,8,0,TRUE,NA,"0.1.4"
"13637","646",2023-01-21 01:00:00,998,1006,8,0,TRUE,NA,"0.1.4"
"13638","646",2023-01-21 01:15:00,998,1006,8,0,TRUE,NA,"0.1.4"
"13639","646",2023-01-21 01:30:00,998,1006,8,0,TRUE,NA,"0.1.4"
"13640","646",2023-01-21 01:45:00,998,1006,8,0,TRUE,NA,"0.1.4"
"13641","646",2023-01-21 02:00:00,998,1006,8,0,TRUE,NA,"0.1.4"
"13642","646",2023-01-21 02:15:00,998,1006,8,0,TRUE,NA,"0.1.4"
"13643","646",2023-01-21 02:30:00,998,1006,8,0,TRUE,NA,"0.1.4"
"13644","646",2023-01-21 02:45:00,998,1006,8,0,TRUE,NA,"0.1.4"
"13645","646",2023-01-21 03:00:00,998,1006,8,0,TRUE,NA,"0.1.4"
"13646","646",2023-01-21 03:15:00,998,1006,8,0,TRUE,NA,"0.1.4"
"13647","646",2023-01-21 03:30:00,998,1006,8,0,TRUE,NA,"0.1.4"
"13648","646",2023-01-21 03:45:00,998,1006,8,0,TRUE,NA,"0.1.4"
"13649","646",2023-01-21 04:00:00,998,1006,8,0,TRUE,NA,"0.1.4"
"13650","646",2023-01-21 04:15:00,998,1006,8,0,TRUE,NA,"0.1.4"
"13651","646",2023-01-21 04:30:00,998,1006,8,0,TRUE,NA,"0.1.4"
"13652","646",2023-01-21 04:45:00,998,1006,8,0,TRUE,NA,"0.1.4"
"13653","646",2023-01-21 05:00:00,998,1006,8,0,TRUE,NA,"0.1.4"
"13654","646",2023-01-21 05:15:00,998,1006,8,0,TRUE,NA,"0.1.4"
"13655","646",2023-01-21 05:30:00,998,1006,8,0,TRUE,NA,"0.1.4"
"13656","646",2023-01-21 05:45:00,998,1006,8,0,TRUE,NA,"0.1.4"
"13657","646",2023-01-21 06:00:00,998,1006,8,0,TRUE,NA,"0.1.4"
"13658","646",2023-01-21 06:15:00,998,1006,8,0,TRUE,NA,"0.1.4"
"13659","646",2023-01-21 06:30:00,998,1006,8,0,TRUE,NA,"0.1.4"
"13660","646",2023-01-21 06:45:00,998,1006,8,0,TRUE,NA,"0.1.4"
"13661","646",2023-01-21 07:00:00,998,1006,8,0,TRUE,NA,"0.1.4"
"13662","646",2023-01-21 07:15:00,998,1006,8,0,TRUE,NA,"0.1.4"
"13663","646",2023-01-21 07:30:00,998,1006,8,0,TRUE,NA,"0.1.4"
"13664","646",2023-01-21 07:45:00,998,1006,8,0,TRUE,NA,"0.1.4"
"13665","646",2023-01-21 08:00:00,998,1006,8,0,TRUE,NA,"0.1.4"
"13666","646",2023-01-21 08:15:00,998,1006,8,0,TRUE,NA,"0.1.4"
"13667","646",2023-01-21 08:30:00,998,1006,8,0,TRUE,NA,"0.1.4"
"13668","646",2023-01-21 08:45:00,998,1006,8,0,TRUE,NA,"0.1.4"
"13669","646",2023-01-21 09:00:00,998,1006,8,0,TRUE,NA,"0.1.4"
"13670","646",2023-01-21 09:15:00,998,1006,8,0,TRUE,NA,"0.1.4"
"13671","646",2023-01-21 09:30:00,998,1006,8,0,TRUE,NA,"0.1.4"
"13672","646",2023-01-21 09:45:00,998,1006,8,0,TRUE,NA,"0.1.4"
"13673","646",2023-01-21 10:00:00,998,1006,8,0,TRUE,NA,"0.1.4"
"13674","646",2023-01-21 10:15:00,998,1006,8,0,TRUE,NA,"0.1.4"
"13675","646",2023-01-21 10:30:00,998,1006,8,0,TRUE,NA,"0.1.4"
"13676","646",2023-01-21 10:45:00,998,1006,8,0,TRUE,NA,"0.1.4"
"13677","646",2023-01-21 11:00:00,998,1006,8,0,TRUE,NA,"0.1.4"
"13678","646",2023-01-21 11:15:00,998,1006,8,0,TRUE,NA,"0.1.4"
"13679","646",2023-01-21 11:30:00,998,1006,8,0,TRUE,NA,"0.1.4"
"13680","646",2023-01-21 11:45:00,998,1006,8,0,TRUE,NA,"0.1.4"
"13681","646",2023-01-21 12:00:00,998,1006,8,0,TRUE,NA,"0.1.4"
"13682","646",2023-01-21 12:15:00,998,1006,8,0,TRUE,NA,"0.1.4"
"13683","646",2023-01-21 12:30:00,998,1006,8,0,TRUE,NA,"0.1.4"
"13684","646",2023-01-21 12:45:00,998,1006,8,0,TRUE,NA,"0.1.4"
"13685","646",2023-01-21 13:00:00,998,1006,8,0,TRUE,NA,"0.1.4"
"13686","646",2023-01-21 13:15:00,998,1006,8,0,TRUE,NA,"0.1.4"
"13687","646",2023-01-21 13:30:00,998,1006,8,0,TRUE,NA,"0.1.4"
"13688","646",2023-01-21 13:45:00,998,1006,8,0,TRUE,NA,"0.1.4"
"13689","646",2023-01-21 14:00:00,998,1006,8,0,TRUE,NA,"0.1.4"
"13690","646",2023-01-21 14:15:00,998,1006,8,0,TRUE,NA,"0.1.4"
"13691","646",2023-01-21 14:30:00,998,1006,8,0,TRUE,NA,"0.1.4"
"13692","646",2023-01-21 14:45:00,998,1006,8,0,TRUE,NA,"0.1.4"
"13693","646",2023-01-21 15:00:00,998,1006,8,0,TRUE,NA,"0.1.4"
"13694","646",2023-01-21 15:15:00,998,1006,8,0,TRUE,NA,"0.1.4"
"13695","646",2023-01-21 15:30:00,998,1006,8,0,TRUE,NA,"0.1.4"
"13696","646",2023-01-21 15:45:00,998,1006,8,0,TRUE,NA,"0.1.4"
"13697","646",2023-01-21 16:00:00,998,1006,8,0,TRUE,NA,"0.1.4"
"13698","646",2023-01-21 16:15:00,998,1006,8,0,TRUE,NA,"0.1.4"
"13699","646",2023-01-21 16:30:00,998,1006,8,0,TRUE,NA,"0.1.4"
"13700","646",2023-01-21 16:45:00,998,1006,8,0,TRUE,NA,"0.1.4"
"13701","646",2023-01-21 17:00:00,998,1006,8,0,TRUE,NA,"0.1.4"
"13702","646",2023-01-21 17:15:00,998,1006,8,0,TRUE,NA,"0.1.4"
"13703","646",2023-01-21 17:30:00,998,1006,8,0,TRUE,NA,"0.1.4"
"13704","646",2023-01-21 17:45:00,998,1006,8,0,TRUE,NA,"0.1.4"
"13705","646",2023-01-21 18:00:00,998,1006,8,0,TRUE,NA,"0.1.4"
"13706","646",2023-01-21 18:15:00,998,1006,8,0,TRUE,NA,"0.1.4"
"13707","646",2023-01-21 18:30:00,998,1006,8,0,TRUE,NA,"0.1.4"
"13708","646",2023-01-21 18:45:00,998,1006,8,0,TRUE,NA,"0.1.4"
"13709","646",2023-01-21 19:00:00,998,1006,8,0,TRUE,NA,"0.1.4"
"13710","646",2023-01-21 19:15:00,998,1006,8,0,TRUE,NA,"0.1.4"
"13711","646",2023-01-21 19:30:00,998,1006,8,0,TRUE,NA,"0.1.4"
"13712","646",2023-01-21 19:45:00,998,1006,8,0,TRUE,NA,"0.1.4"
"13713","646",2023-01-21 20:00:00,998,1006,8,0,TRUE,NA,"0.1.4"
"13714","646",2023-01-21 20:15:00,998,1006,8,0,TRUE,NA,"0.1.4"
"13715","646",2023-01-21 20:30:00,998,1006,8,0,TRUE,NA,"0.1.4"
"13716","646",2023-01-21 20:45:00,998,1006,8,0,TRUE,NA,"0.1.4"
"13717","646",2023-01-21 21:00:00,998,1006,8,0,TRUE,NA,"0.1.4"
"13718","646",2023-01-21 21:15:00,998,1006,8,0,TRUE,NA,"0.1.4"
"13719","646",2023-01-21 21:30:00,998,1006,8,0,TRUE,NA,"0.1.4"
"13720","646",2023-01-21 21:45:00,998,1006,8,0,TRUE,NA,"0.1.4"
"13721","646",2023-01-21 22:00:00,998,1006,8,0,TRUE,NA,"0.1.4"
"13722","646",2023-01-21 22:15:00,998,1006,8,0,TRUE,NA,"0.1.4"
"13723","646",2023-01-21 22:30:00,998,1006,8,0,TRUE,NA,"0.1.4"
"13724","646",2023-01-21 22:45:00,998,1006,8,0,TRUE,NA,"0.1.4"
"13725","646",2023-01-21 23:00:00,998,1006,8,0,TRUE,NA,"0.1.4"
"13726","646",2023-01-21 23:15:00,998,1006,8,0,TRUE,NA,"0.1.4"
"13727","646",2023-01-21 23:30:00,998,1006,8,0,TRUE,NA,"0.1.4"
"13728","646",2023-01-21 23:45:00,998,1006,8,0,TRUE,NA,"0.1.4"
"13729","646",2023-01-22,998,1006,8,0,TRUE,NA,"0.1.4"
"13730","646",2023-01-22 00:15:00,998,1006,8,0,TRUE,NA,"0.1.4"
"13731","646",2023-01-22 00:30:00,998,1006,8,0,TRUE,NA,"0.1.4"
"13732","646",2023-01-22 00:45:00,998,1006,8,0,TRUE,NA,"0.1.4"
"13733","646",2023-01-22 01:00:00,998,1006,8,0,TRUE,NA,"0.1.4"
"13734","646",2023-01-22 01:15:00,998,1006,8,0,TRUE,NA,"0.1.4"
"13735","646",2023-01-22 01:30:00,998,1006,8,0,TRUE,NA,"0.1.4"
"13736","646",2023-01-22 01:45:00,998,1006,8,0,TRUE,NA,"0.1.4"
"13737","646",2023-01-22 02:00:00,998,1006,8,0,TRUE,NA,"0.1.4"
"13738","646",2023-01-22 02:15:00,998,1006,8,0,TRUE,NA,"0.1.4"
"13739","646",2023-01-22 02:30:00,998,1006,8,0,TRUE,NA,"0.1.4"
"13740","646",2023-01-22 02:45:00,998,1006,8,0,TRUE,NA,"0.1.4"
"13741","646",2023-01-22 03:00:00,998,1006,8,0,TRUE,NA,"0.1.4"
"13742","646",2023-01-22 03:15:00,998,1006,8,0,TRUE,NA,"0.1.4"
"13743","646",2023-01-22 03:30:00,998,1006,8,0,TRUE,NA,"0.1.4"
"13744","646",2023-01-22 03:45:00,998,1006,8,0,TRUE,NA,"0.1.4"
"13745","646",2023-01-22 04:00:00,998,1006,8,0,TRUE,NA,"0.1.4"
"13746","646",2023-01-22 04:15:00,998,1006,8,0,TRUE,NA,"0.1.4"
"13747","646",2023-01-22 04:30:00,998,1006,8,0,TRUE,NA,"0.1.4"
"13748","646",2023-01-22 04:45:00,998,1006,8,0,TRUE,NA,"0.1.4"
"13749","646",2023-01-22 05:00:00,998,1006,8,0,TRUE,NA,"0.1.4"
"13750","646",2023-01-22 05:15:00,998,1006,8,0,TRUE,NA,"0.1.4"
"13751","646",2023-01-22 05:30:00,998,1006,8,0,TRUE,NA,"0.1.4"
"13752","646",2023-01-22 05:45:00,998,1006,8,0,TRUE,NA,"0.1.4"
"13753","646",2023-01-22 06:00:00,998,1006,8,0,TRUE,NA,"0.1.4"
"13754","646",2023-01-22 06:15:00,998,1006,8,0,TRUE,NA,"0.1.4"
"13755","646",2023-01-22 06:30:00,998,1006,8,0,TRUE,NA,"0.1.4"
"13756","646",2023-01-22 06:45:00,998,1006,8,0,TRUE,NA,"0.1.4"
"13757","646",2023-01-22 07:00:00,998,1006,8,0,TRUE,NA,"0.1.4"
"13758","646",2023-01-22 07:15:00,998,1006,8,0,TRUE,NA,"0.1.4"
"13759","646",2023-01-22 07:30:00,998,1006,8,0,TRUE,NA,"0.1.4"
"13760","646",2023-01-22 07:45:00,998,1006,8,0,TRUE,NA,"0.1.4"
"13761","646",2023-01-22 08:00:00,998,1006,8,0,TRUE,NA,"0.1.4"
"13762","646",2023-01-22 08:15:00,998,1006,8,0,TRUE,NA,"0.1.4"
"13763","646",2023-01-22 08:30:00,998,1006,8,0,TRUE,NA,"0.1.4"
"13764","646",2023-01-22 08:45:00,998,1006,8,0,TRUE,NA,"0.1.4"
"13765","646",2023-01-22 09:00:00,998,1006,8,0,TRUE,NA,"0.1.4"
"13766","646",2023-01-22 09:15:00,998,1006,8,0,TRUE,NA,"0.1.4"
"13767","646",2023-01-22 09:30:00,998,1006,8,0,TRUE,NA,"0.1.4"
"13768","646",2023-01-22 09:45:00,998,1006,8,0,TRUE,NA,"0.1.4"
"13769","646",2023-01-22 10:00:00,998,1006,8,0,TRUE,NA,"0.1.4"
"13770","646",2023-01-22 10:15:00,998,1006,8,0,TRUE,NA,"0.1.4"
"13771","646",2023-01-22 10:30:00,998,1006,8,0,TRUE,NA,"0.1.4"
"13772","646",2023-01-22 10:45:00,998,1006,8,0,TRUE,NA,"0.1.4"
"13773","646",2023-01-22 11:00:00,998,1006,8,0,TRUE,NA,"0.1.4"
"13774","646",2023-01-22 11:15:00,998,1006,8,0,TRUE,NA,"0.1.4"
"13775","646",2023-01-22 11:30:00,998,1006,8,0,TRUE,NA,"0.1.4"
"13776","646",2023-01-22 11:45:00,998,1006,8,0,TRUE,NA,"0.1.4"
"13777","646",2023-01-22 12:00:00,998,1006,8,0,TRUE,NA,"0.1.4"
"13778","646",2023-01-22 12:15:00,998,1006,8,0,TRUE,NA,"0.1.4"
"13779","646",2023-01-22 12:30:00,998,1006,8,0,TRUE,NA,"0.1.4"
"13780","646",2023-01-22 12:45:00,998,1006,8,0,TRUE,NA,"0.1.4"
"13781","646",2023-01-22 13:00:00,998,1006,8,0,TRUE,NA,"0.1.4"
"13782","646",2023-01-22 13:15:00,998,1006,8,0,TRUE,NA,"0.1.4"
"13783","646",2023-01-22 13:30:00,998,1006,8,0,TRUE,NA,"0.1.4"
"13784","646",2023-01-22 13:45:00,998,1006,8,0,TRUE,NA,"0.1.4"
"13785","646",2023-01-22 14:00:00,998,1006,8,0,TRUE,NA,"0.1.4"
"13786","646",2023-01-22 14:15:00,998,1006,8,0,TRUE,NA,"0.1.4"
"13787","646",2023-01-22 14:30:00,998,1006,8,0,TRUE,NA,"0.1.4"
"13788","646",2023-01-22 14:45:00,998,1006,8,0,TRUE,NA,"0.1.4"
"13789","646",2023-01-22 15:00:00,998,1006,8,0,TRUE,NA,"0.1.4"
"13790","646",2023-01-22 15:15:00,998,1006,8,0,TRUE,NA,"0.1.4"
"13791","646",2023-01-22 15:30:00,998,1006,8,0,TRUE,NA,"0.1.4"
"13792","646",2023-01-22 15:45:00,998,1006,8,0,TRUE,NA,"0.1.4"
"13793","646",2023-01-22 16:00:00,998,1006,8,0,TRUE,NA,"0.1.4"
"13794","646",2023-01-22 16:15:00,998,1006,8,0,TRUE,NA,"0.1.4"
"13795","646",2023-01-22 16:30:00,998,1006,8,0,TRUE,NA,"0.1.4"
"13796","646",2023-01-22 16:45:00,998,1006,8,0,TRUE,NA,"0.1.4"
"13797","646",2023-01-22 17:00:00,998,1006,8,0,TRUE,NA,"0.1.4"
"13798","646",2023-01-22 17:15:00,998,1006,8,0,TRUE,NA,"0.1.4"
"13799","646",2023-01-22 17:30:00,998,1006,8,0,TRUE,NA,"0.1.4"
"13800","646",2023-01-22 17:45:00,998,1006,8,0,TRUE,NA,"0.1.4"
"13801","646",2023-01-22 18:00:00,998,1006,8,0,TRUE,NA,"0.1.4"
"13802","646",2023-01-22 18:15:00,998,1006,8,0,TRUE,NA,"0.1.4"
"13803","646",2023-01-22 18:30:00,998,1006,8,0,TRUE,NA,"0.1.4"
"13804","646",2023-01-22 18:45:00,998,1006,8,0,TRUE,NA,"0.1.4"
"13805","646",2023-01-22 19:00:00,998,1006,8,0,TRUE,NA,"0.1.4"
"13806","646",2023-01-22 19:15:00,998,1006,8,0,TRUE,NA,"0.1.4"
"13807","646",2023-01-22 19:30:00,998,1006,8,0,TRUE,NA,"0.1.4"
"13808","646",2023-01-22 19:45:00,998,1006,8,0,TRUE,NA,"0.1.4"
"13809","646",2023-01-22 20:00:00,998,1006,8,0,TRUE,NA,"0.1.4"
"13810","646",2023-01-22 20:15:00,998,1006,8,0,TRUE,NA,"0.1.4"
"13811","646",2023-01-22 20:30:00,998,1006,8,0,TRUE,NA,"0.1.4"
"13812","646",2023-01-22 20:45:00,998,1006,8,0,TRUE,NA,"0.1.4"
"13813","646",2023-01-22 21:00:00,998,1006,8,0,TRUE,NA,"0.1.4"
"13814","646",2023-01-22 21:15:00,998,1006,8,0,TRUE,NA,"0.1.4"
"13815","646",2023-01-22 21:30:00,998,1006,8,0,TRUE,NA,"0.1.4"
"13816","646",2023-01-22 21:45:00,998,1006,8,0,TRUE,NA,"0.1.4"
"13817","646",2023-01-22 22:00:00,998,1006,8,0,TRUE,NA,"0.1.4"
"13818","646",2023-01-22 22:15:00,998,1006,8,0,TRUE,NA,"0.1.4"
"13819","646",2023-01-22 22:30:00,998,1006,8,0,TRUE,NA,"0.1.4"
"13820","646",2023-01-22 22:45:00,998,1006,8,0,TRUE,NA,"0.1.4"
"13821","646",2023-01-22 23:00:00,998,1006,8,0,TRUE,NA,"0.1.4"
"13822","646",2023-01-22 23:15:00,998,1006,8,0,TRUE,NA,"0.1.4"
"13823","646",2023-01-22 23:30:00,998,1006,8,0,TRUE,NA,"0.1.4"
"13824","646",2023-01-22 23:45:00,998,1006,8,0,TRUE,NA,"0.1.4"
"13825","646",2023-01-23,998,1006,8,0,TRUE,NA,"0.1.4"
"13826","646",2023-01-23 00:15:00,998,1006,8,0,TRUE,NA,"0.1.4"
"13827","646",2023-01-23 00:30:00,998,1006,8,0,TRUE,NA,"0.1.4"
"13828","646",2023-01-23 00:45:00,998,1006,8,0,TRUE,NA,"0.1.4"
"13829","646",2023-01-23 01:00:00,998,1006,8,0,TRUE,NA,"0.1.4"
"13830","646",2023-01-23 01:15:00,998,1006,8,0,TRUE,NA,"0.1.4"
"13831","646",2023-01-23 01:30:00,998,1006,8,0,TRUE,NA,"0.1.4"
"13832","646",2023-01-23 01:45:00,998,1006,8,0,TRUE,NA,"0.1.4"
"13833","646",2023-01-23 02:00:00,998,1006,8,0,TRUE,NA,"0.1.4"
"13834","646",2023-01-23 02:15:00,998,1006,8,0,TRUE,NA,"0.1.4"
"13835","646",2023-01-23 02:30:00,998,1006,8,0,TRUE,NA,"0.1.4"
"13836","646",2023-01-23 02:45:00,998,1006,8,0,TRUE,NA,"0.1.4"
"13837","646",2023-01-23 03:00:00,998,1006,8,0,TRUE,NA,"0.1.4"
"13838","646",2023-01-23 03:15:00,998,1006,8,0,TRUE,NA,"0.1.4"
"13839","646",2023-01-23 03:30:00,998,1006,8,0,TRUE,NA,"0.1.4"
"13840","646",2023-01-23 03:45:00,998,1006,8,0,TRUE,NA,"0.1.4"
"13841","646",2023-01-23 04:00:00,998,1006,8,0,TRUE,NA,"0.1.4"
"13842","646",2023-01-23 04:15:00,998,1006,8,0,TRUE,NA,"0.1.4"
"13843","646",2023-01-23 04:30:00,998,1006,8,0,TRUE,NA,"0.1.4"
"13844","646",2023-01-23 04:45:00,998,1006,8,0,TRUE,NA,"0.1.4"
"13845","646",2023-01-23 05:00:00,998,1006,8,0,TRUE,NA,"0.1.4"
"13846","646",2023-01-23 05:15:00,998,1006,8,0,TRUE,NA,"0.1.4"
"13847","646",2023-01-23 05:30:00,998,1006,8,0,TRUE,NA,"0.1.4"
"13848","646",2023-01-23 05:45:00,998,1006,8,0,TRUE,NA,"0.1.4"
"13849","646",2023-01-23 06:00:00,998,1006,8,0,TRUE,NA,"0.1.4"
"13850","646",2023-01-23 06:15:00,998,1006,8,0,TRUE,NA,"0.1.4"
"13851","646",2023-01-23 06:30:00,998,1006,8,0,TRUE,NA,"0.1.4"
"13852","646",2023-01-23 06:45:00,998,1006,8,0,TRUE,NA,"0.1.4"
"13853","646",2023-01-23 07:00:00,998,1006,8,0,TRUE,NA,"0.1.4"
"13854","646",2023-01-23 07:15:00,998,1006,8,0,TRUE,NA,"0.1.4"
"13855","646",2023-01-23 07:30:00,998,1006,8,0,TRUE,NA,"0.1.4"
"13856","646",2023-01-23 07:45:00,998,1006,8,0,TRUE,NA,"0.1.4"
"13857","646",2023-01-23 08:00:00,998,1006,8,0,TRUE,NA,"0.1.4"
"13858","646",2023-01-23 08:15:00,998,1006,8,0,TRUE,NA,"0.1.4"
"13859","646",2023-01-23 08:30:00,998,1006,8,0,TRUE,NA,"0.1.4"
"13860","646",2023-01-23 08:45:00,998,1006,8,0,TRUE,NA,"0.1.4"
"13861","646",2023-01-23 09:00:00,998,1006,8,0,TRUE,NA,"0.1.4"
"13862","646",2023-01-23 09:15:00,998,1006,8,0,TRUE,NA,"0.1.4"
"13863","646",2023-01-23 09:30:00,998,1006,8,0,TRUE,NA,"0.1.4"
"13864","646",2023-01-23 09:45:00,998,1006,8,0,TRUE,NA,"0.1.4"
"13865","646",2023-01-23 10:00:00,998,1006,8,0,TRUE,NA,"0.1.4"
"13866","646",2023-01-23 10:15:00,998,1006,8,0,TRUE,NA,"0.1.4"
"13867","646",2023-01-23 10:30:00,998,1006,8,0,TRUE,NA,"0.1.4"
"13868","646",2023-01-23 10:45:00,998,1006,8,0,TRUE,NA,"0.1.4"
"13869","646",2023-01-23 11:00:00,998,1006,8,0,TRUE,NA,"0.1.4"
"13870","646",2023-01-23 11:15:00,998,1006,8,0,TRUE,NA,"0.1.4"
"13871","646",2023-01-23 11:30:00,998,1006,8,0,TRUE,NA,"0.1.4"
"13872","646",2023-01-23 11:45:00,998,1006,8,0,TRUE,NA,"0.1.4"
"13873","646",2023-01-23 12:00:00,998,1006,8,0,TRUE,NA,"0.1.4"
"13874","646",2023-01-23 12:15:00,998,1006,8,0,TRUE,NA,"0.1.4"
"13875","646",2023-01-23 12:30:00,998,1006,8,0,TRUE,NA,"0.1.4"
"13876","646",2023-01-23 12:45:00,998,1006,8,0,TRUE,NA,"0.1.4"
"13877","646",2023-01-23 13:00:00,998,1006,8,0,TRUE,NA,"0.1.4"
"13878","646",2023-01-23 13:15:00,998,1006,8,0,TRUE,NA,"0.1.4"
"13879","646",2023-01-23 13:30:00,998,1006,8,0,TRUE,NA,"0.1.4"
"13880","646",2023-01-23 13:45:00,998,1006,8,0,TRUE,NA,"0.1.4"
"13881","646",2023-01-23 14:00:00,998,1006,8,0,TRUE,NA,"0.1.4"
"13882","646",2023-01-23 14:15:00,998,1006,8,0,TRUE,NA,"0.1.4"
"13883","646",2023-01-23 14:30:00,998,1006,8,0,TRUE,NA,"0.1.4"
"13884","646",2023-01-23 14:45:00,998,1006,8,0,TRUE,NA,"0.1.4"
"13885","646",2023-01-23 15:00:00,998,1006,8,0,TRUE,NA,"0.1.4"
"13886","646",2023-01-23 15:15:00,998,1006,8,0,TRUE,NA,"0.1.4"
"13887","646",2023-01-23 15:30:00,998,1006,8,0,TRUE,NA,"0.1.4"
"13888","646",2023-01-23 15:45:00,998,1006,8,0,TRUE,NA,"0.1.4"
"13889","646",2023-01-23 16:00:00,998,1006,8,0,TRUE,NA,"0.1.4"
"13890","646",2023-01-23 16:15:00,998,1006,8,0,TRUE,NA,"0.1.4"
"13891","646",2023-01-23 16:30:00,998,1006,8,0,TRUE,NA,"0.1.4"
"13892","646",2023-01-23 16:45:00,998,1006,8,0,TRUE,NA,"0.1.4"
"13893","646",2023-01-23 17:00:00,998,1006,8,0,TRUE,NA,"0.1.4"
"13894","646",2023-01-23 17:15:00,998,1006,8,0,TRUE,NA,"0.1.4"
"13895","646",2023-01-23 17:30:00,998,1006,8,0,TRUE,NA,"0.1.4"
"13896","646",2023-01-23 17:45:00,998,1006,8,0,TRUE,NA,"0.1.4"
"13897","646",2023-01-23 18:00:00,998,1006,8,0,TRUE,NA,"0.1.4"
"13898","646",2023-01-23 18:15:00,998,1006,8,0,TRUE,NA,"0.1.4"
"13899","646",2023-01-23 18:30:00,998,1006,8,0,TRUE,NA,"0.1.4"
"13900","646",2023-01-23 18:45:00,998,1006,8,0,TRUE,NA,"0.1.4"
"13901","646",2023-01-23 19:00:00,998,1006,8,0,TRUE,NA,"0.1.4"
"13902","646",2023-01-23 19:15:00,998,1006,8,0,TRUE,NA,"0.1.4"
"13903","646",2023-01-23 19:30:00,998,1006,8,0,TRUE,NA,"0.1.4"
"13904","646",2023-01-23 19:45:00,998,1006,8,0,TRUE,NA,"0.1.4"
"13905","646",2023-01-23 20:00:00,998,1006,8,0,TRUE,NA,"0.1.4"
"13906","646",2023-01-23 20:15:00,998,1006,8,0,TRUE,NA,"0.1.4"
"13907","646",2023-01-23 20:30:00,998,1006,8,0,TRUE,NA,"0.1.4"
"13908","646",2023-01-23 20:45:00,998,1006,8,0,TRUE,NA,"0.1.4"
"13909","646",2023-01-23 21:00:00,998,1006,8,0,TRUE,NA,"0.1.4"
"13910","646",2023-01-23 21:15:00,998,1006,8,0,TRUE,NA,"0.1.4"
"13911","646",2023-01-23 21:30:00,998,1006,8,0,TRUE,NA,"0.1.4"
"13912","646",2023-01-23 21:45:00,998,1006,8,0,TRUE,NA,"0.1.4"
"13913","646",2023-01-23 22:00:00,998,1006,8,0,TRUE,NA,"0.1.4"
"13914","646",2023-01-23 22:15:00,998,1006,8,0,TRUE,NA,"0.1.4"
"13915","646",2023-01-23 22:30:00,998,1006,8,0,TRUE,NA,"0.1.4"
"13916","646",2023-01-23 22:45:00,998,1006,8,0,TRUE,NA,"0.1.4"
"13917","646",2023-01-23 23:00:00,998,1006,8,0,TRUE,NA,"0.1.4"
"13918","646",2023-01-23 23:15:00,998,1006,8,0,TRUE,NA,"0.1.4"
"13919","646",2023-01-23 23:30:00,998,1006,8,0,TRUE,NA,"0.1.4"
"13920","646",2023-01-23 23:45:00,998,1006,8,0,TRUE,NA,"0.1.4"
"13921","646",2023-01-24,998,1006,8,0,TRUE,NA,"0.1.4"
"13922","646",2023-01-24 00:15:00,998,1006,8,0,TRUE,NA,"0.1.4"
"13923","646",2023-01-24 00:30:00,998,1006,8,0,TRUE,NA,"0.1.4"
"13924","646",2023-01-24 00:45:00,998,1006,8,0,TRUE,NA,"0.1.4"
"13925","646",2023-01-24 01:00:00,998,1006,8,0,TRUE,NA,"0.1.4"
"13926","646",2023-01-24 01:15:00,998,1006,8,0,TRUE,NA,"0.1.4"
"13927","646",2023-01-24 01:30:00,998,1006,8,0,TRUE,NA,"0.1.4"
"13928","646",2023-01-24 01:45:00,998,1006,8,0,TRUE,NA,"0.1.4"
"13929","646",2023-01-24 02:00:00,998,1006,8,0,TRUE,NA,"0.1.4"
"13930","646",2023-01-24 02:15:00,998,1006,8,0,TRUE,NA,"0.1.4"
"13931","646",2023-01-24 02:30:00,998,1006,8,0,TRUE,NA,"0.1.4"
"13932","646",2023-01-24 02:45:00,998,1006,8,0,TRUE,NA,"0.1.4"
"13933","646",2023-01-24 03:00:00,998,1006,8,0,TRUE,NA,"0.1.4"
"13934","646",2023-01-24 03:15:00,998,1006,8,0,TRUE,NA,"0.1.4"
"13935","646",2023-01-24 03:30:00,998,1006,8,0,TRUE,NA,"0.1.4"
"13936","646",2023-01-24 03:45:00,998,1006,8,0,TRUE,NA,"0.1.4"
"13937","646",2023-01-24 04:00:00,998,1006,8,0,TRUE,NA,"0.1.4"
"13938","646",2023-01-24 04:15:00,998,1006,8,0,TRUE,NA,"0.1.4"
"13939","646",2023-01-24 04:30:00,998,1006,8,0,TRUE,NA,"0.1.4"
"13940","646",2023-01-24 04:45:00,998,1006,8,0,TRUE,NA,"0.1.4"
"13941","646",2023-01-24 05:00:00,998,1006,8,0,TRUE,NA,"0.1.4"
"13942","646",2023-01-24 05:15:00,998,1006,8,0,TRUE,NA,"0.1.4"
"13943","646",2023-01-24 05:30:00,998,1006,8,0,TRUE,NA,"0.1.4"
"13944","646",2023-01-24 05:45:00,998,1006,8,0,TRUE,NA,"0.1.4"
"13945","646",2023-01-24 06:00:00,998,1006,8,0,TRUE,NA,"0.1.4"
"13946","646",2023-01-24 06:15:00,998,1006,8,0,TRUE,NA,"0.1.4"
"13947","646",2023-01-24 06:30:00,998,1006,8,0,TRUE,NA,"0.1.4"
"13948","646",2023-01-24 06:45:00,998,1006,8,0,TRUE,NA,"0.1.4"
"13949","646",2023-01-24 07:00:00,998,1006,8,0,TRUE,NA,"0.1.4"
"13950","646",2023-01-24 07:15:00,998,1006,8,0,TRUE,NA,"0.1.4"
"13951","646",2023-01-24 07:30:00,998,1006,8,0,TRUE,NA,"0.1.4"
"13952","646",2023-01-24 07:45:00,998,1006,8,0,TRUE,NA,"0.1.4"
"13953","646",2023-01-24 08:00:00,998,1006,8,0,TRUE,NA,"0.1.4"
"13954","646",2023-01-24 08:15:00,998,1006,8,0,TRUE,NA,"0.1.4"
"13955","646",2023-01-24 08:30:00,998,1006,8,0,TRUE,NA,"0.1.4"
"13956","646",2023-01-24 08:45:00,998,1006,8,0,TRUE,NA,"0.1.4"
"13957","646",2023-01-24 09:00:00,998,1006,8,0,TRUE,NA,"0.1.4"
"13958","646",2023-01-24 09:15:00,998,1006,8,0,TRUE,NA,"0.1.4"
"13959","646",2023-01-24 09:30:00,998,1006,8,0,TRUE,NA,"0.1.4"
"13960","646",2023-01-24 09:45:00,998,1006,8,0,TRUE,NA,"0.1.4"
"13961","646",2023-01-24 10:00:00,998,1006,8,0,TRUE,NA,"0.1.4"
"13962","646",2023-01-24 10:15:00,998,1006,8,0,TRUE,NA,"0.1.4"
"13963","646",2023-01-24 10:30:00,998,1006,8,0,TRUE,NA,"0.1.4"
"13964","646",2023-01-24 10:45:00,998,1006,8,0,TRUE,NA,"0.1.4"
"13965","646",2023-01-24 11:00:00,998,1006,8,0,TRUE,NA,"0.1.4"
"13966","646",2023-01-24 11:15:00,998,1006,8,0,TRUE,NA,"0.1.4"
"13967","646",2023-01-24 11:30:00,998,1006,8,0,TRUE,NA,"0.1.4"
"13968","646",2023-01-24 11:45:00,998,1006,8,0,TRUE,NA,"0.1.4"
"13969","646",2023-01-24 12:00:00,998,1006,8,0,TRUE,NA,"0.1.4"
"13970","646",2023-01-24 12:15:00,998,1006,8,0,TRUE,NA,"0.1.4"
"13971","646",2023-01-24 12:30:00,998,1006,8,0,TRUE,NA,"0.1.4"
"13972","646",2023-01-24 12:45:00,998,1006,8,0,TRUE,NA,"0.1.4"
"13973","646",2023-01-24 13:00:00,998,1006,8,0,TRUE,NA,"0.1.4"
"13974","646",2023-01-24 13:15:00,998,1006,8,0,TRUE,NA,"0.1.4"
"13975","646",2023-01-24 13:30:00,998,1006,8,0,TRUE,NA,"0.1.4"
"13976","646",2023-01-24 13:45:00,998,1006,8,0,TRUE,NA,"0.1.4"
"13977","646",2023-01-24 14:00:00,998,1006,8,0,TRUE,NA,"0.1.4"
"13978","646",2023-01-24 14:15:00,998,1006,8,0,TRUE,NA,"0.1.4"
"13979","646",2023-01-24 14:30:00,998,1006,8,0,TRUE,NA,"0.1.4"
"13980","646",2023-01-24 14:45:00,998,1006,8,0,TRUE,NA,"0.1.4"
"13981","646",2023-01-24 15:00:00,998,1006,8,0,TRUE,NA,"0.1.4"
"13982","646",2023-01-24 15:15:00,998,1006,8,0,TRUE,NA,"0.1.4"
"13983","646",2023-01-24 15:30:00,998,1006,8,0,TRUE,NA,"0.1.4"
"13984","646",2023-01-24 15:45:00,998,1006,8,0,TRUE,NA,"0.1.4"
"13985","646",2023-01-24 16:00:00,998,1006,8,0,TRUE,NA,"0.1.4"
"13986","646",2023-01-24 16:15:00,998,1006,8,0,TRUE,NA,"0.1.4"
"13987","646",2023-01-24 16:30:00,998,1006,8,0,TRUE,NA,"0.1.4"
"13988","646",2023-01-24 16:45:00,998,1006,8,0,TRUE,NA,"0.1.4"
"13989","646",2023-01-24 17:00:00,998,1006,8,0,TRUE,NA,"0.1.4"
"13990","646",2023-01-24 17:15:00,998,1006,8,0,TRUE,NA,"0.1.4"
"13991","646",2023-01-24 17:30:00,998,1006,8,0,TRUE,NA,"0.1.4"
"13992","646",2023-01-24 17:45:00,998,1006,8,0,TRUE,NA,"0.1.4"
"13993","646",2023-01-24 18:00:00,998,1006,8,0,TRUE,NA,"0.1.4"
"13994","646",2023-01-24 18:15:00,998,1006,8,0,TRUE,NA,"0.1.4"
"13995","646",2023-01-24 18:30:00,998,1006,8,0,TRUE,NA,"0.1.4"
"13996","646",2023-01-24 18:45:00,998,1006,8,0,TRUE,NA,"0.1.4"
"13997","646",2023-01-24 19:00:00,998,1006,8,0,TRUE,NA,"0.1.4"
"13998","646",2023-01-24 19:15:00,998,1006,8,0,TRUE,NA,"0.1.4"
"13999","646",2023-01-24 19:30:00,998,1006,8,0,TRUE,NA,"0.1.4"
"14000","646",2023-01-24 19:45:00,998,1006,8,0,TRUE,NA,"0.1.4"
"14001","646",2023-01-24 20:00:00,998,1006,8,0,TRUE,NA,"0.1.4"
"14002","646",2023-01-24 20:15:00,998,1006,8,0,TRUE,NA,"0.1.4"
"14003","646",2023-01-24 20:30:00,998,1006,8,0,TRUE,NA,"0.1.4"
"14004","646",2023-01-24 20:45:00,998,1006,8,0,TRUE,NA,"0.1.4"
"14005","646",2023-01-24 21:00:00,999,1006,7,0,TRUE,NA,"0.1.4"
"14006","646",2023-01-24 21:15:00,999,1006,7,0,TRUE,NA,"0.1.4"
"14007","646",2023-01-24 21:30:00,999,1006,7,0,TRUE,NA,"0.1.4"
"14008","646",2023-01-24 21:45:00,998,1006,8,0,TRUE,NA,"0.1.4"
"14009","646",2023-01-24 22:00:00,999,1006,7,0,TRUE,NA,"0.1.4"
"14010","646",2023-01-24 22:15:00,998,1006,8,0,TRUE,NA,"0.1.4"
"14011","646",2023-01-24 22:30:00,998,1006,8,0,TRUE,NA,"0.1.4"
"14012","646",2023-01-24 22:45:00,999,1006,7,0,TRUE,NA,"0.1.4"
"14013","646",2023-01-24 23:00:00,998,1006,8,0,TRUE,NA,"0.1.4"
"14014","646",2023-01-24 23:15:00,998,1006,8,0,TRUE,NA,"0.1.4"
"14015","646",2023-01-24 23:30:00,998,1006,8,0,TRUE,NA,"0.1.4"
"14016","646",2023-01-24 23:45:00,999,1006,7,0,TRUE,NA,"0.1.4"
"14017","646",2023-01-25,998,1006,8,0,TRUE,NA,"0.1.4"
"14018","646",2023-01-25 00:15:00,998,1006,8,0,TRUE,NA,"0.1.4"
"14019","646",2023-01-25 00:30:00,998,1006,8,0,TRUE,NA,"0.1.4"
"14020","646",2023-01-25 00:45:00,998,1006,8,0,TRUE,NA,"0.1.4"
"14021","646",2023-01-25 01:00:00,998,1006,8,0,TRUE,NA,"0.1.4"
"14022","646",2023-01-25 01:15:00,998,1006,8,0,TRUE,NA,"0.1.4"
"14023","646",2023-01-25 01:30:00,998,1006,8,0,TRUE,NA,"0.1.4"
"14024","646",2023-01-25 01:45:00,998,1006,8,0,TRUE,NA,"0.1.4"
"14025","646",2023-01-25 02:00:00,998,1006,8,0,TRUE,NA,"0.1.4"
"14026","646",2023-01-25 02:15:00,998,1006,8,0,TRUE,NA,"0.1.4"
"14027","646",2023-01-25 02:30:00,998,1006,8,0,TRUE,NA,"0.1.4"
"14028","646",2023-01-25 02:45:00,999,1006,7,0,TRUE,NA,"0.1.4"
"14029","646",2023-01-25 03:00:00,998,1006,8,0,TRUE,NA,"0.1.4"
"14030","646",2023-01-25 03:15:00,998,1006,8,0,TRUE,NA,"0.1.4"
"14031","646",2023-01-25 03:30:00,998,1006,8,0,TRUE,NA,"0.1.4"
"14032","646",2023-01-25 03:45:00,998,1006,8,0,TRUE,NA,"0.1.4"
"14033","646",2023-01-25 04:00:00,998,1006,8,0,TRUE,NA,"0.1.4"
"14034","646",2023-01-25 04:15:00,998,1006,8,0,TRUE,NA,"0.1.4"
"14035","646",2023-01-25 04:30:00,998,1006,8,0,TRUE,NA,"0.1.4"
"14036","646",2023-01-25 04:45:00,998,1006,8,0,TRUE,NA,"0.1.4"
"14037","646",2023-01-25 05:00:00,998,1006,8,0,TRUE,NA,"0.1.4"
"14038","646",2023-01-25 05:15:00,998,1006,8,0,TRUE,NA,"0.1.4"
"14039","646",2023-01-25 05:30:00,998,1006,8,0,TRUE,NA,"0.1.4"
"14040","646",2023-01-25 05:45:00,998,1006,8,0,TRUE,NA,"0.1.4"
"14041","646",2023-01-25 06:00:00,998,1006,8,0,TRUE,NA,"0.1.4"
"14042","646",2023-01-25 06:15:00,998,1006,8,0,TRUE,NA,"0.1.4"
"14043","646",2023-01-25 06:30:00,998,1006,8,0,TRUE,NA,"0.1.4"
"14044","646",2023-01-25 06:45:00,998,1006,8,0,TRUE,NA,"0.1.4"
"14045","646",2023-01-25 07:00:00,998,1006,8,0,TRUE,NA,"0.1.4"
"14046","646",2023-01-25 07:15:00,998,1006,8,0,TRUE,NA,"0.1.4"
"14047","646",2023-01-25 07:30:00,998,1006,8,0,TRUE,NA,"0.1.4"
"14048","646",2023-01-25 07:45:00,998,1006,8,0,TRUE,NA,"0.1.4"
"14049","646",2023-01-25 08:00:00,998,1006,8,0,TRUE,NA,"0.1.4"
"14050","646",2023-01-25 08:15:00,998,1006,8,0,TRUE,NA,"0.1.4"
"14051","646",2023-01-25 08:30:00,998,1006,8,0,TRUE,NA,"0.1.4"
"14052","646",2023-01-25 08:45:00,998,1006,8,0,TRUE,NA,"0.1.4"
"14053","646",2023-01-25 09:00:00,998,1006,8,0,TRUE,NA,"0.1.4"
"14054","646",2023-01-25 09:15:00,998,1006,8,0,TRUE,NA,"0.1.4"
"14055","646",2023-01-25 09:30:00,998,1006,8,0,TRUE,NA,"0.1.4"
"14056","646",2023-01-25 09:45:00,998,1006,8,0,TRUE,NA,"0.1.4"
"14057","646",2023-01-25 10:00:00,998,1006,8,0,TRUE,NA,"0.1.4"
"14058","646",2023-01-25 10:15:00,998,1006,8,0,TRUE,NA,"0.1.4"
"14059","646",2023-01-25 10:30:00,998,1006,8,0,TRUE,NA,"0.1.4"
"14060","646",2023-01-25 10:45:00,998,1006,8,0,TRUE,NA,"0.1.4"
"14061","646",2023-01-25 11:00:00,998,1006,8,0,TRUE,NA,"0.1.4"
"14062","646",2023-01-25 11:15:00,999,1006,7,0,TRUE,NA,"0.1.4"
"14063","646",2023-01-25 11:30:00,999,1006,7,0,TRUE,NA,"0.1.4"
"14064","646",2023-01-25 11:45:00,999,1006,7,0,TRUE,NA,"0.1.4"
"14065","646",2023-01-25 12:00:00,999,1006,7,0,TRUE,NA,"0.1.4"
"14066","646",2023-01-25 12:15:00,999,1006,7,0,TRUE,NA,"0.1.4"
"14067","646",2023-01-25 12:30:00,999,1006,7,0,TRUE,NA,"0.1.4"
"14068","646",2023-01-25 12:45:00,999,1006,7,0,TRUE,NA,"0.1.4"
"14069","646",2023-01-25 13:00:00,999,1006,7,0,TRUE,NA,"0.1.4"
"14070","646",2023-01-25 13:15:00,999,1006,7,0,TRUE,NA,"0.1.4"
"14071","646",2023-01-25 13:30:00,999,1006,7,0,TRUE,NA,"0.1.4"
"14072","646",2023-01-25 13:45:00,999,1006,7,0,TRUE,NA,"0.1.4"
"14073","646",2023-01-25 14:00:00,999,1006,7,0,TRUE,NA,"0.1.4"
"14074","646",2023-01-25 14:15:00,999,1006,7,0,TRUE,NA,"0.1.4"
"14075","646",2023-01-25 14:30:00,999,1006,7,0,TRUE,NA,"0.1.4"
"14076","646",2023-01-25 14:45:00,999,1006,7,0,TRUE,NA,"0.1.4"
"14077","646",2023-01-25 15:00:00,999,1006,7,0,TRUE,NA,"0.1.4"
"14078","646",2023-01-25 15:15:00,999,1006,7,0,TRUE,NA,"0.1.4"
"14079","646",2023-01-25 15:30:00,999,1006,7,0,TRUE,NA,"0.1.4"
"14080","646",2023-01-25 15:45:00,999,1006,7,0,TRUE,NA,"0.1.4"
"14081","646",2023-01-25 16:00:00,999,1006,7,0,TRUE,NA,"0.1.4"
"14082","646",2023-01-25 16:15:00,999,1006,7,0,TRUE,NA,"0.1.4"
"14083","646",2023-01-25 16:30:00,999,1006,7,0,TRUE,NA,"0.1.4"
"14084","646",2023-01-25 16:45:00,999,1006,7,0,TRUE,NA,"0.1.4"
"14085","646",2023-01-25 17:00:00,999,1006,7,0,TRUE,NA,"0.1.4"
"14086","646",2023-01-25 17:15:00,999,1006,7,0,TRUE,NA,"0.1.4"
"14087","646",2023-01-25 17:30:00,999,1006,7,0,TRUE,NA,"0.1.4"
"14088","646",2023-01-25 17:45:00,999,1006,7,0,TRUE,NA,"0.1.4"
"14089","646",2023-01-25 18:00:00,999,1006,7,0,TRUE,NA,"0.1.4"
"14090","646",2023-01-25 18:15:00,999,1006,7,0,TRUE,NA,"0.1.4"
"14091","646",2023-01-25 18:30:00,999,1006,7,0,TRUE,NA,"0.1.4"
"14092","646",2023-01-25 18:45:00,999,1006,7,0,TRUE,NA,"0.1.4"
"14093","646",2023-01-25 19:00:00,999,1006,7,0,TRUE,NA,"0.1.4"
"14094","646",2023-01-25 19:15:00,999,1006,7,0,TRUE,NA,"0.1.4"
"14095","646",2023-01-25 19:30:00,999,1006,7,0,TRUE,NA,"0.1.4"
"14096","646",2023-01-25 19:45:00,999,1006,7,0,TRUE,NA,"0.1.4"
"14097","646",2023-01-25 20:00:00,999,1006,7,0,TRUE,NA,"0.1.4"
"14098","646",2023-01-25 20:15:00,999,1006,7,0,TRUE,NA,"0.1.4"
"14099","646",2023-01-25 20:30:00,999,1006,7,0,TRUE,NA,"0.1.4"
"14100","646",2023-01-25 20:45:00,999,1006,7,0,TRUE,NA,"0.1.4"
"14101","646",2023-01-25 21:00:00,999,1006,7,0,TRUE,NA,"0.1.4"
"14102","646",2023-01-25 21:15:00,999,1006,7,0,TRUE,NA,"0.1.4"
"14103","646",2023-01-25 21:30:00,999,1006,7,0,TRUE,NA,"0.1.4"
"14104","646",2023-01-25 21:45:00,999,1006,7,0,TRUE,NA,"0.1.4"
"14105","646",2023-01-25 22:00:00,999,1006,7,0,TRUE,NA,"0.1.4"
"14106","646",2023-01-25 22:15:00,999,1006,7,0,TRUE,NA,"0.1.4"
"14107","646",2023-01-25 22:30:00,999,1006,7,0,TRUE,NA,"0.1.4"
"14108","646",2023-01-25 22:45:00,999,1006,7,0,TRUE,NA,"0.1.4"
"14109","646",2023-01-25 23:00:00,999,1006,7,0,TRUE,NA,"0.1.4"
"14110","646",2023-01-25 23:15:00,999,1006,7,0,TRUE,NA,"0.1.4"
"14111","646",2023-01-25 23:30:00,999,1006,7,0,TRUE,NA,"0.1.4"
"14112","646",2023-01-25 23:45:00,999,1006,7,0,TRUE,NA,"0.1.4"
"14113","646",2023-01-26,999,1006,7,0,TRUE,NA,"0.1.4"
"14114","646",2023-01-26 00:15:00,999,1006,7,0,TRUE,NA,"0.1.4"
"14115","646",2023-01-26 00:30:00,999,1006,7,0,TRUE,NA,"0.1.4"
"14116","646",2023-01-26 00:45:00,999,1006,7,0,TRUE,NA,"0.1.4"
"14117","646",2023-01-26 01:00:00,999,1006,7,0,TRUE,NA,"0.1.4"
"14118","646",2023-01-26 01:15:00,999,1006,7,0,TRUE,NA,"0.1.4"
"14119","646",2023-01-26 01:30:00,999,1006,7,0,TRUE,NA,"0.1.4"
"14120","646",2023-01-26 01:45:00,999,1006,7,0,TRUE,NA,"0.1.4"
"14121","646",2023-01-26 02:00:00,999,1006,7,0,TRUE,NA,"0.1.4"
"14122","646",2023-01-26 02:15:00,999,1006,7,0,TRUE,NA,"0.1.4"
"14123","646",2023-01-26 02:30:00,999,1006,7,0,TRUE,NA,"0.1.4"
"14124","646",2023-01-26 02:45:00,999,1006,7,0,TRUE,NA,"0.1.4"
"14125","646",2023-01-26 03:00:00,999,1006,7,0,TRUE,NA,"0.1.4"
"14126","646",2023-01-26 03:15:00,999,1006,7,0,TRUE,NA,"0.1.4"
"14127","646",2023-01-26 03:30:00,999,1006,7,0,TRUE,NA,"0.1.4"
"14128","646",2023-01-26 03:45:00,999,1006,7,0,TRUE,NA,"0.1.4"
"14129","646",2023-01-26 04:00:00,999,1006,7,0,TRUE,NA,"0.1.4"
"14130","646",2023-01-26 04:15:00,999,1006,7,0,TRUE,NA,"0.1.4"
"14131","646",2023-01-26 04:30:00,999,1006,7,0,TRUE,NA,"0.1.4"
"14132","646",2023-01-26 04:45:00,999,1006,7,0,TRUE,NA,"0.1.4"
"14133","646",2023-01-26 05:00:00,999,1006,7,0,TRUE,NA,"0.1.4"
"14134","646",2023-01-26 05:15:00,999,1006,7,0,TRUE,NA,"0.1.4"
"14135","646",2023-01-26 05:30:00,999,1006,7,0,TRUE,NA,"0.1.4"
"14136","646",2023-01-26 05:45:00,999,1006,7,0,TRUE,NA,"0.1.4"
"14137","646",2023-01-26 06:00:00,999,1006,7,0,TRUE,NA,"0.1.4"
"14138","646",2023-01-26 06:15:00,999,1006,7,0,TRUE,NA,"0.1.4"
"14139","646",2023-01-26 06:30:00,999,1006,7,0,TRUE,NA,"0.1.4"
"14140","646",2023-01-26 06:45:00,999,1006,7,0,TRUE,NA,"0.1.4"
"14141","646",2023-01-26 07:00:00,999,1006,7,0,TRUE,NA,"0.1.4"
"14142","646",2023-01-26 07:15:00,999,1006,7,0,TRUE,NA,"0.1.4"
"14143","646",2023-01-26 07:30:00,999,1006,7,0,TRUE,NA,"0.1.4"
"14144","646",2023-01-26 07:45:00,999,1006,7,0,TRUE,NA,"0.1.4"
"14145","646",2023-01-26 08:00:00,999,1006,7,0,TRUE,NA,"0.1.4"
"14146","646",2023-01-26 08:15:00,999,1006,7,0,TRUE,NA,"0.1.4"
"14147","646",2023-01-26 08:30:00,999,1006,7,0,TRUE,NA,"0.1.4"
"14148","646",2023-01-26 08:45:00,999,1006,7,0,TRUE,NA,"0.1.4"
"14149","646",2023-01-26 09:00:00,999,1006,7,0,TRUE,NA,"0.1.4"
"14150","646",2023-01-26 09:15:00,999,1006,7,0,TRUE,NA,"0.1.4"
"14151","646",2023-01-26 09:30:00,999,1006,7,0,TRUE,NA,"0.1.4"
"14152","646",2023-01-26 09:45:00,999,1006,7,0,TRUE,NA,"0.1.4"
"14153","646",2023-01-26 10:00:00,999,1006,7,0,TRUE,NA,"0.1.4"
"14154","646",2023-01-26 10:15:00,999,1006,7,0,TRUE,NA,"0.1.4"
"14155","646",2023-01-26 10:30:00,999,1006,7,0,TRUE,NA,"0.1.4"
"14156","646",2023-01-26 10:45:00,999,1006,7,0,TRUE,NA,"0.1.4"
"14157","646",2023-01-26 11:00:00,999,1006,7,0,TRUE,NA,"0.1.4"
"14158","646",2023-01-26 11:15:00,999,1006,7,0,TRUE,NA,"0.1.4"
"14159","646",2023-01-26 11:30:00,999,1006,7,0,TRUE,NA,"0.1.4"
"14160","646",2023-01-26 11:45:00,1000,1006,6,0,TRUE,NA,"0.1.4"
"14161","646",2023-01-26 12:00:00,999,1006,7,0,TRUE,NA,"0.1.4"
"14162","646",2023-01-26 12:15:00,999,1006,7,0,TRUE,NA,"0.1.4"
"14163","646",2023-01-26 12:30:00,999,1006,7,0,TRUE,NA,"0.1.4"
"14164","646",2023-01-26 12:45:00,999,1006,7,0,TRUE,NA,"0.1.4"
"14165","646",2023-01-26 13:00:00,999,1006,7,0,TRUE,NA,"0.1.4"
"14166","646",2023-01-26 13:15:00,999,1006,7,0,TRUE,NA,"0.1.4"
"14167","646",2023-01-26 13:30:00,999,1006,7,0,TRUE,NA,"0.1.4"
"14168","646",2023-01-26 13:45:00,999,1006,7,0,TRUE,NA,"0.1.4"
"14169","646",2023-01-26 14:00:00,1000,1006,6,0,TRUE,NA,"0.1.4"
"14170","646",2023-01-26 14:15:00,999,1006,7,0,TRUE,NA,"0.1.4"
"14171","646",2023-01-26 14:30:00,999,1006,7,0,TRUE,NA,"0.1.4"
"14172","646",2023-01-26 14:45:00,999,1006,7,0,TRUE,NA,"0.1.4"
"14173","646",2023-01-26 15:00:00,999,1006,7,0,TRUE,NA,"0.1.4"
"14174","646",2023-01-26 15:15:00,999,1006,7,0,TRUE,NA,"0.1.4"
"14175","646",2023-01-26 15:30:00,999,1006,7,0,TRUE,NA,"0.1.4"
"14176","646",2023-01-26 15:45:00,999,1006,7,0,TRUE,NA,"0.1.4"
"14177","646",2023-01-26 16:00:00,1000,1006,6,0,TRUE,NA,"0.1.4"
"14178","646",2023-01-26 16:15:00,999,1006,7,0,TRUE,NA,"0.1.4"
"14179","646",2023-01-26 16:30:00,999,1006,7,0,TRUE,NA,"0.1.4"
"14180","646",2023-01-26 16:45:00,999,1006,7,0,TRUE,NA,"0.1.4"
"14181","646",2023-01-26 17:00:00,999,1006,7,0,TRUE,NA,"0.1.4"
"14182","646",2023-01-26 17:15:00,999,1006,7,0,TRUE,NA,"0.1.4"
"14183","646",2023-01-26 17:30:00,999,1006,7,0,TRUE,NA,"0.1.4"
"14184","646",2023-01-26 17:45:00,999,1006,7,0,TRUE,NA,"0.1.4"
"14185","646",2023-01-26 18:00:00,999,1006,7,0,TRUE,NA,"0.1.4"
"14186","646",2023-01-26 18:15:00,1000,1006,6,0,TRUE,NA,"0.1.4"
"14187","646",2023-01-26 18:30:00,999,1006,7,0,TRUE,NA,"0.1.4"
"14188","646",2023-01-26 18:45:00,999,1006,7,0,TRUE,NA,"0.1.4"
"14189","646",2023-01-26 19:00:00,1000,1006,6,0,TRUE,NA,"0.1.4"
"14190","646",2023-01-26 19:15:00,999,1006,7,0,TRUE,NA,"0.1.4"
"14191","646",2023-01-26 19:30:00,1000,1006,6,0,TRUE,NA,"0.1.4"
"14192","646",2023-01-26 19:45:00,1000,1006,6,0,TRUE,NA,"0.1.4"
"14193","646",2023-01-26 20:00:00,1000,1006,6,0,TRUE,NA,"0.1.4"
"14194","646",2023-01-26 20:15:00,999,1006,7,0,TRUE,NA,"0.1.4"
"14195","646",2023-01-26 20:30:00,999,1006,7,0,TRUE,NA,"0.1.4"
"14196","646",2023-01-26 20:45:00,999,1006,7,0,TRUE,NA,"0.1.4"
"14197","646",2023-01-26 21:00:00,999,1006,7,0,TRUE,NA,"0.1.4"
"14198","646",2023-01-26 21:15:00,999,1006,7,0,TRUE,NA,"0.1.4"
"14199","646",2023-01-26 21:30:00,999,1006,7,0,TRUE,NA,"0.1.4"
"14200","646",2023-01-26 21:45:00,999,1006,7,0,TRUE,NA,"0.1.4"
"14201","646",2023-01-26 22:00:00,999,1006,7,0,TRUE,NA,"0.1.4"
"14202","646",2023-01-26 22:15:00,1000,1006,6,0,TRUE,NA,"0.1.4"
"14203","646",2023-01-26 22:30:00,999,1006,7,0,TRUE,NA,"0.1.4"
"14204","646",2023-01-26 22:45:00,999,1006,7,0,TRUE,NA,"0.1.4"
"14205","646",2023-01-26 23:00:00,1000,1006,6,0,TRUE,NA,"0.1.4"
"14206","646",2023-01-26 23:15:00,999,1006,7,0,TRUE,NA,"0.1.4"
"14207","646",2023-01-26 23:30:00,1000,1006,6,0,TRUE,NA,"0.1.4"
"14208","646",2023-01-26 23:45:00,1000,1006,6,0,TRUE,NA,"0.1.4"
"14209","646",2023-01-27,1000,1006,6,0,TRUE,NA,"0.1.4"
"14210","646",2023-01-27 00:15:00,999,1006,7,0,TRUE,NA,"0.1.4"
"14211","646",2023-01-27 00:30:00,999,1006,7,0,TRUE,NA,"0.1.4"
"14212","646",2023-01-27 00:45:00,1000,1006,6,0,TRUE,NA,"0.1.4"
"14213","646",2023-01-27 01:00:00,1000,1006,6,0,TRUE,NA,"0.1.4"
"14214","646",2023-01-27 01:15:00,999,1006,7,0,TRUE,NA,"0.1.4"
"14215","646",2023-01-27 01:30:00,999,1006,7,0,TRUE,NA,"0.1.4"
"14216","646",2023-01-27 01:45:00,999,1006,7,0,TRUE,NA,"0.1.4"
"14217","646",2023-01-27 02:00:00,999,1006,7,0,TRUE,NA,"0.1.4"
"14218","646",2023-01-27 02:15:00,999,1006,7,0,TRUE,NA,"0.1.4"
"14219","646",2023-01-27 02:30:00,999,1006,7,0,TRUE,NA,"0.1.4"
"14220","646",2023-01-27 02:45:00,1000,1006,6,0,TRUE,NA,"0.1.4"
"14221","646",2023-01-27 03:00:00,999,1006,7,0,TRUE,NA,"0.1.4"
"14222","646",2023-01-27 03:15:00,999,1006,7,0,TRUE,NA,"0.1.4"
"14223","646",2023-01-27 03:30:00,999,1006,7,0,TRUE,NA,"0.1.4"
"14224","646",2023-01-27 03:45:00,999,1006,7,0,TRUE,NA,"0.1.4"
"14225","646",2023-01-27 04:00:00,999,1006,7,0,TRUE,NA,"0.1.4"
"14226","646",2023-01-27 04:15:00,999,1006,7,0,TRUE,NA,"0.1.4"
"14227","646",2023-01-27 04:30:00,999,1006,7,0,TRUE,NA,"0.1.4"
"14228","646",2023-01-27 04:45:00,999,1006,7,0,TRUE,NA,"0.1.4"
"14229","646",2023-01-27 05:00:00,999,1006,7,0,TRUE,NA,"0.1.4"
"14230","646",2023-01-27 05:15:00,1000,1006,6,0,TRUE,NA,"0.1.4"
"14231","646",2023-01-27 05:30:00,999,1006,7,0,TRUE,NA,"0.1.4"
"14232","646",2023-01-27 05:45:00,999,1006,7,0,TRUE,NA,"0.1.4"
"14233","646",2023-01-27 06:00:00,999,1006,7,0,TRUE,NA,"0.1.4"
"14234","646",2023-01-27 06:15:00,1000,1006,6,0,TRUE,NA,"0.1.4"
"14235","646",2023-01-27 06:30:00,1000,1006,6,0,TRUE,NA,"0.1.4"
"14236","646",2023-01-27 06:45:00,999,1006,7,0,TRUE,NA,"0.1.4"
"14237","646",2023-01-27 07:00:00,999,1006,7,0,TRUE,NA,"0.1.4"
"14238","646",2023-01-27 07:15:00,1000,1006,6,0,TRUE,NA,"0.1.4"
"14239","646",2023-01-27 07:30:00,999,1006,7,0,TRUE,NA,"0.1.4"
"14240","646",2023-01-27 07:45:00,999,1006,7,0,TRUE,NA,"0.1.4"
"14241","646",2023-01-27 08:00:00,999,1006,7,0,TRUE,NA,"0.1.4"
"14242","646",2023-01-27 08:15:00,999,1006,7,0,TRUE,NA,"0.1.4"
"14243","646",2023-01-27 08:30:00,999,1006,7,0,TRUE,NA,"0.1.4"
"14244","646",2023-01-27 08:45:00,999,1006,7,0,TRUE,NA,"0.1.4"
"14245","646",2023-01-27 09:00:00,999,1006,7,0,TRUE,NA,"0.1.4"
"14246","646",2023-01-27 09:15:00,999,1006,7,0,TRUE,NA,"0.1.4"
"14247","646",2023-01-27 09:30:00,999,1006,7,0,TRUE,NA,"0.1.4"
"14248","646",2023-01-27 09:45:00,999,1006,7,0,TRUE,NA,"0.1.4"
"14249","646",2023-01-27 10:00:00,999,1006,7,0,TRUE,NA,"0.1.4"
"14250","646",2023-01-27 10:15:00,999,1006,7,0,TRUE,NA,"0.1.4"
"14251","646",2023-01-27 10:30:00,999,1006,7,0,TRUE,NA,"0.1.4"
"14252","646",2023-01-27 10:45:00,999,1006,7,0,TRUE,NA,"0.1.4"
"14253","646",2023-01-27 11:00:00,999,1006,7,0,TRUE,NA,"0.1.4"
"14254","646",2023-01-27 11:15:00,999,1006,7,0,TRUE,NA,"0.1.4"
"14255","646",2023-01-27 11:30:00,999,1006,7,0,TRUE,NA,"0.1.4"
"14256","646",2023-01-27 11:45:00,999,1006,7,0,TRUE,NA,"0.1.4"
"14257","646",2023-01-27 12:00:00,999,1006,7,0,TRUE,NA,"0.1.4"
"14258","646",2023-01-27 12:15:00,999,1006,7,0,TRUE,NA,"0.1.4"
"14259","646",2023-01-27 12:30:00,999,1006,7,0,TRUE,NA,"0.1.4"
"14260","646",2023-01-27 12:45:00,999,1006,7,0,TRUE,NA,"0.1.4"
"14261","646",2023-01-27 13:00:00,999,1006,7,0,TRUE,NA,"0.1.4"
"14262","646",2023-01-27 13:15:00,999,1006,7,0,TRUE,NA,"0.1.4"
"14263","646",2023-01-27 13:30:00,999,1006,7,0,TRUE,NA,"0.1.4"
"14264","646",2023-01-27 13:45:00,999,1006,7,0,TRUE,NA,"0.1.4"
"14265","646",2023-01-27 14:00:00,999,1006,7,0,TRUE,NA,"0.1.4"
"14266","646",2023-01-27 14:15:00,999,1006,7,0,TRUE,NA,"0.1.4"
"14267","646",2023-01-27 14:30:00,999,1006,7,0,TRUE,NA,"0.1.4"
"14268","646",2023-01-27 14:45:00,999,1006,7,0,TRUE,NA,"0.1.4"
"14269","646",2023-01-27 15:00:00,999,1006,7,0,TRUE,NA,"0.1.4"
"14270","646",2023-01-27 15:15:00,999,1006,7,0,TRUE,NA,"0.1.4"
"14271","646",2023-01-27 15:30:00,999,1006,7,0,TRUE,NA,"0.1.4"
"14272","646",2023-01-27 15:45:00,999,1006,7,0,TRUE,NA,"0.1.4"
"14273","646",2023-01-27 16:00:00,999,1006,7,0,TRUE,NA,"0.1.4"
"14274","646",2023-01-27 16:15:00,999,1006,7,0,TRUE,NA,"0.1.4"
"14275","646",2023-01-27 16:30:00,999,1006,7,0,TRUE,NA,"0.1.4"
"14276","646",2023-01-27 16:45:00,999,1006,7,0,TRUE,NA,"0.1.4"
"14277","646",2023-01-27 17:00:00,1000,1006,6,0,TRUE,NA,"0.1.4"
"14278","646",2023-01-27 17:15:00,999,1006,7,0,TRUE,NA,"0.1.4"
"14279","646",2023-01-27 17:30:00,999,1006,7,0,TRUE,NA,"0.1.4"
"14280","646",2023-01-27 17:45:00,999,1006,7,0,TRUE,NA,"0.1.4"
"14281","646",2023-01-27 18:00:00,1000,1006,6,0,TRUE,NA,"0.1.4"
"14282","646",2023-01-27 18:15:00,999,1006,7,0,TRUE,NA,"0.1.4"
"14283","646",2023-01-27 18:30:00,999,1006,7,0,TRUE,NA,"0.1.4"
"14284","646",2023-01-27 18:45:00,999,1006,7,0,TRUE,NA,"0.1.4"
"14285","646",2023-01-27 19:00:00,999,1006,7,0,TRUE,NA,"0.1.4"
"14286","646",2023-01-27 19:15:00,999,1006,7,0,TRUE,NA,"0.1.4"
"14287","646",2023-01-27 19:30:00,1000,1006,6,0,TRUE,NA,"0.1.4"
"14288","646",2023-01-27 19:45:00,1000,1006,6,0,TRUE,NA,"0.1.4"
"14289","646",2023-01-27 20:00:00,999,1006,7,0,TRUE,NA,"0.1.4"
"14290","646",2023-01-27 20:15:00,999,1006,7,0,TRUE,NA,"0.1.4"
"14291","646",2023-01-27 20:30:00,999,1006,7,0,TRUE,NA,"0.1.4"
"14292","646",2023-01-27 20:45:00,999,1006,7,0,TRUE,NA,"0.1.4"
"14293","646",2023-01-27 21:00:00,999,1006,7,0,TRUE,NA,"0.1.4"
"14294","646",2023-01-27 21:15:00,999,1006,7,0,TRUE,NA,"0.1.4"
"14295","646",2023-01-27 21:30:00,999,1006,7,0,TRUE,NA,"0.1.4"
"14296","646",2023-01-27 21:45:00,999,1006,7,0,TRUE,NA,"0.1.4"
"14297","646",2023-01-27 22:00:00,1000,1006,6,0,TRUE,NA,"0.1.4"
"14298","646",2023-01-27 22:15:00,999,1006,7,0,TRUE,NA,"0.1.4"
"14299","646",2023-01-27 22:30:00,999,1006,7,0,TRUE,NA,"0.1.4"
"14300","646",2023-01-27 22:45:00,999,1006,7,0,TRUE,NA,"0.1.4"
"14301","646",2023-01-27 23:00:00,999,1006,7,0,TRUE,NA,"0.1.4"
"14302","646",2023-01-27 23:15:00,999,1006,7,0,TRUE,NA,"0.1.4"
"14303","646",2023-01-27 23:30:00,999,1006,7,0,TRUE,NA,"0.1.4"
"14304","646",2023-01-27 23:45:00,999,1006,7,0,TRUE,NA,"0.1.4"
"14305","646",2023-01-28,999,1006,7,0,TRUE,NA,"0.1.4"
"14306","646",2023-01-28 00:15:00,999,1006,7,0,TRUE,NA,"0.1.4"
"14307","646",2023-01-28 00:30:00,999,1006,7,0,TRUE,NA,"0.1.4"
"14308","646",2023-01-28 00:45:00,999,1006,7,0,TRUE,NA,"0.1.4"
"14309","646",2023-01-28 01:00:00,999,1006,7,0,TRUE,NA,"0.1.4"
"14310","646",2023-01-28 01:15:00,999,1006,7,0,TRUE,NA,"0.1.4"
"14311","646",2023-01-28 01:30:00,999,1006,7,0,TRUE,NA,"0.1.4"
"14312","646",2023-01-28 01:45:00,999,1006,7,0,TRUE,NA,"0.1.4"
"14313","646",2023-01-28 02:00:00,999,1006,7,0,TRUE,NA,"0.1.4"
"14314","646",2023-01-28 02:15:00,1000,1006,6,0,TRUE,NA,"0.1.4"
"14315","646",2023-01-28 02:30:00,999,1006,7,0,TRUE,NA,"0.1.4"
"14316","646",2023-01-28 02:45:00,999,1006,7,0,TRUE,NA,"0.1.4"
"14317","646",2023-01-28 03:00:00,999,1006,7,0,TRUE,NA,"0.1.4"
"14318","646",2023-01-28 03:15:00,999,1006,7,0,TRUE,NA,"0.1.4"
"14319","646",2023-01-28 03:30:00,999,1006,7,0,TRUE,NA,"0.1.4"
"14320","646",2023-01-28 03:45:00,999,1006,7,0,TRUE,NA,"0.1.4"
"14321","646",2023-01-28 04:00:00,999,1006,7,0,TRUE,NA,"0.1.4"
"14322","646",2023-01-28 04:15:00,999,1006,7,0,TRUE,NA,"0.1.4"
"14323","646",2023-01-28 04:30:00,999,1006,7,0,TRUE,NA,"0.1.4"
"14324","646",2023-01-28 04:45:00,999,1006,7,0,TRUE,NA,"0.1.4"
"14325","646",2023-01-28 05:00:00,999,1006,7,0,TRUE,NA,"0.1.4"
"14326","646",2023-01-28 05:15:00,999,1006,7,0,TRUE,NA,"0.1.4"
"14327","646",2023-01-28 05:30:00,999,1006,7,0,TRUE,NA,"0.1.4"
"14328","646",2023-01-28 05:45:00,999,1006,7,0,TRUE,NA,"0.1.4"
"14329","646",2023-01-28 06:00:00,999,1006,7,0,TRUE,NA,"0.1.4"
"14330","646",2023-01-28 06:15:00,999,1006,7,0,TRUE,NA,"0.1.4"
"14331","646",2023-01-28 06:30:00,999,1006,7,0,TRUE,NA,"0.1.4"
"14332","646",2023-01-28 06:45:00,999,1006,7,0,TRUE,NA,"0.1.4"
"14333","646",2023-01-28 07:00:00,999,1006,7,0,TRUE,NA,"0.1.4"
"14334","646",2023-01-28 07:15:00,999,1006,7,0,TRUE,NA,"0.1.4"
"14335","646",2023-01-28 07:30:00,999,1006,7,0,TRUE,NA,"0.1.4"
"14336","646",2023-01-28 07:45:00,999,1006,7,0,TRUE,NA,"0.1.4"
"14337","646",2023-01-28 08:00:00,999,1006,7,0,TRUE,NA,"0.1.4"
"14338","646",2023-01-28 08:15:00,999,1006,7,0,TRUE,NA,"0.1.4"
"14339","646",2023-01-28 08:30:00,999,1006,7,0,TRUE,NA,"0.1.4"
"14340","646",2023-01-28 08:45:00,999,1006,7,0,TRUE,NA,"0.1.4"
"14341","646",2023-01-28 09:00:00,999,1006,7,0,TRUE,NA,"0.1.4"
"14342","646",2023-01-28 09:15:00,999,1006,7,0,TRUE,NA,"0.1.4"
"14343","646",2023-01-28 09:30:00,999,1006,7,0,TRUE,NA,"0.1.4"
"14344","646",2023-01-28 09:45:00,999,1006,7,0,TRUE,NA,"0.1.4"
"14345","646",2023-01-28 10:00:00,999,1006,7,0,TRUE,NA,"0.1.4"
"14346","646",2023-01-28 10:15:00,999,1006,7,0,TRUE,NA,"0.1.4"
"14347","646",2023-01-28 10:30:00,999,1006,7,0,TRUE,NA,"0.1.4"
"14348","646",2023-01-28 10:45:00,999,1006,7,0,TRUE,NA,"0.1.4"
"14349","646",2023-01-28 11:00:00,999,1006,7,0,TRUE,NA,"0.1.4"
"14350","646",2023-01-28 11:15:00,999,1006,7,0,TRUE,NA,"0.1.4"
"14351","646",2023-01-28 11:30:00,999,1006,7,0,TRUE,NA,"0.1.4"
"14352","646",2023-01-28 11:45:00,999,1006,7,0,TRUE,NA,"0.1.4"
"14353","646",2023-01-28 12:00:00,999,1006,7,0,TRUE,NA,"0.1.4"
"14354","646",2023-01-28 12:15:00,999,1006,7,0,TRUE,NA,"0.1.4"
"14355","646",2023-01-28 12:30:00,999,1006,7,0,TRUE,NA,"0.1.4"
"14356","646",2023-01-28 12:45:00,999,1006,7,0,TRUE,NA,"0.1.4"
"14357","646",2023-01-28 13:00:00,999,1006,7,0,TRUE,NA,"0.1.4"
"14358","646",2023-01-28 13:15:00,999,1006,7,0,TRUE,NA,"0.1.4"
"14359","646",2023-01-28 13:30:00,999,1006,7,0,TRUE,NA,"0.1.4"
"14360","646",2023-01-28 13:45:00,999,1006,7,0,TRUE,NA,"0.1.4"
"14361","646",2023-01-28 14:00:00,999,1006,7,0,TRUE,NA,"0.1.4"
"14362","646",2023-01-28 14:15:00,999,1006,7,0,TRUE,NA,"0.1.4"
"14363","646",2023-01-28 14:30:00,999,1006,7,0,TRUE,NA,"0.1.4"
"14364","646",2023-01-28 14:45:00,999,1006,7,0,TRUE,NA,"0.1.4"
"14365","646",2023-01-28 15:00:00,999,1006,7,0,TRUE,NA,"0.1.4"
"14366","646",2023-01-28 15:15:00,999,1006,7,0,TRUE,NA,"0.1.4"
"14367","646",2023-01-28 15:30:00,999,1006,7,0,TRUE,NA,"0.1.4"
"14368","646",2023-01-28 15:45:00,1000,1006,6,0,TRUE,NA,"0.1.4"
"14369","646",2023-01-28 16:00:00,999,1006,7,0,TRUE,NA,"0.1.4"
"14370","646",2023-01-28 16:15:00,999,1006,7,0,TRUE,NA,"0.1.4"
"14371","646",2023-01-28 16:30:00,999,1006,7,0,TRUE,NA,"0.1.4"
"14372","646",2023-01-28 16:45:00,999,1006,7,0,TRUE,NA,"0.1.4"
"14373","646",2023-01-28 17:00:00,999,1006,7,0,TRUE,NA,"0.1.4"
"14374","646",2023-01-28 17:15:00,999,1006,7,0,TRUE,NA,"0.1.4"
"14375","646",2023-01-28 17:30:00,999,1006,7,0,TRUE,NA,"0.1.4"
"14376","646",2023-01-28 17:45:00,999,1006,7,0,TRUE,NA,"0.1.4"
"14377","646",2023-01-28 18:00:00,999,1006,7,0,TRUE,NA,"0.1.4"
"14378","646",2023-01-28 18:15:00,999,1006,7,0,TRUE,NA,"0.1.4"
"14379","646",2023-01-28 18:30:00,999,1006,7,0,TRUE,NA,"0.1.4"
"14380","646",2023-01-28 18:45:00,999,1006,7,0,TRUE,NA,"0.1.4"
"14381","646",2023-01-28 19:00:00,999,1006,7,0,TRUE,NA,"0.1.4"
"14382","646",2023-01-28 19:15:00,999,1006,7,0,TRUE,NA,"0.1.4"
"14383","646",2023-01-28 19:30:00,999,1006,7,0,TRUE,NA,"0.1.4"
"14384","646",2023-01-28 19:45:00,999,1006,7,0,TRUE,NA,"0.1.4"
"14385","646",2023-01-28 20:00:00,999,1006,7,0,TRUE,NA,"0.1.4"
"14386","646",2023-01-28 20:15:00,999,1006,7,0,TRUE,NA,"0.1.4"
"14387","646",2023-01-28 20:30:00,999,1006,7,0,TRUE,NA,"0.1.4"
"14388","646",2023-01-28 20:45:00,999,1006,7,0,TRUE,NA,"0.1.4"
"14389","646",2023-01-28 21:00:00,999,1006,7,0,TRUE,NA,"0.1.4"
"14390","646",2023-01-28 21:15:00,999,1006,7,0,TRUE,NA,"0.1.4"
"14391","646",2023-01-28 21:30:00,999,1006,7,0,TRUE,NA,"0.1.4"
"14392","646",2023-01-28 21:45:00,999,1006,7,0,TRUE,NA,"0.1.4"
"14393","646",2023-01-28 22:00:00,999,1006,7,0,TRUE,NA,"0.1.4"
"14394","646",2023-01-28 22:15:00,999,1006,7,0,TRUE,NA,"0.1.4"
"14395","646",2023-01-28 22:30:00,999,1006,7,0,TRUE,NA,"0.1.4"
"14396","646",2023-01-28 22:45:00,999,1006,7,0,TRUE,NA,"0.1.4"
"14397","646",2023-01-28 23:00:00,999,1006,7,0,TRUE,NA,"0.1.4"
"14398","646",2023-01-28 23:15:00,999,1006,7,0,TRUE,NA,"0.1.4"
"14399","646",2023-01-28 23:30:00,999,1006,7,0,TRUE,NA,"0.1.4"
"14400","646",2023-01-28 23:45:00,999,1006,7,0,TRUE,NA,"0.1.4"
"14401","646",2023-01-29,999,1006,7,0,TRUE,NA,"0.1.4"
"14402","646",2023-01-29 00:15:00,999,1006,7,0,TRUE,NA,"0.1.4"
"14403","646",2023-01-29 00:30:00,999,1006,7,0,TRUE,NA,"0.1.4"
"14404","646",2023-01-29 00:45:00,999,1006,7,0,TRUE,NA,"0.1.4"
"14405","646",2023-01-29 01:00:00,999,1006,7,0,TRUE,NA,"0.1.4"
"14406","646",2023-01-29 01:15:00,999,1006,7,0,TRUE,NA,"0.1.4"
"14407","646",2023-01-29 01:30:00,999,1006,7,0,TRUE,NA,"0.1.4"
"14408","646",2023-01-29 01:45:00,999,1006,7,0,TRUE,NA,"0.1.4"
"14409","646",2023-01-29 02:00:00,999,1006,7,0,TRUE,NA,"0.1.4"
"14410","646",2023-01-29 02:15:00,999,1006,7,0,TRUE,NA,"0.1.4"
"14411","646",2023-01-29 02:30:00,999,1006,7,0,TRUE,NA,"0.1.4"
"14412","646",2023-01-29 02:45:00,999,1006,7,0,TRUE,NA,"0.1.4"
"14413","646",2023-01-29 03:00:00,999,1006,7,0,TRUE,NA,"0.1.4"
"14414","646",2023-01-29 03:15:00,999,1006,7,0,TRUE,NA,"0.1.4"
"14415","646",2023-01-29 03:30:00,999,1006,7,0,TRUE,NA,"0.1.4"
"14416","646",2023-01-29 03:45:00,999,1006,7,0,TRUE,NA,"0.1.4"
"14417","646",2023-01-29 04:00:00,999,1006,7,0,TRUE,NA,"0.1.4"
"14418","646",2023-01-29 04:15:00,999,1006,7,0,TRUE,NA,"0.1.4"
"14419","646",2023-01-29 04:30:00,999,1006,7,0,TRUE,NA,"0.1.4"
"14420","646",2023-01-29 04:45:00,999,1006,7,0,TRUE,NA,"0.1.4"
"14421","646",2023-01-29 05:00:00,999,1006,7,0,TRUE,NA,"0.1.4"
"14422","646",2023-01-29 05:15:00,999,1006,7,0,TRUE,NA,"0.1.4"
"14423","646",2023-01-29 05:30:00,999,1006,7,0,TRUE,NA,"0.1.4"
"14424","646",2023-01-29 05:45:00,999,1006,7,0,TRUE,NA,"0.1.4"
"14425","646",2023-01-29 06:00:00,999,1006,7,0,TRUE,NA,"0.1.4"
"14426","646",2023-01-29 06:15:00,999,1006,7,0,TRUE,NA,"0.1.4"
"14427","646",2023-01-29 06:30:00,999,1006,7,0,TRUE,NA,"0.1.4"
"14428","646",2023-01-29 06:45:00,999,1006,7,0,TRUE,NA,"0.1.4"
"14429","646",2023-01-29 07:00:00,999,1006,7,0,TRUE,NA,"0.1.4"
"14430","646",2023-01-29 07:15:00,999,1006,7,0,TRUE,NA,"0.1.4"
"14431","646",2023-01-29 07:30:00,999,1006,7,0,TRUE,NA,"0.1.4"
"14432","646",2023-01-29 07:45:00,999,1006,7,0,TRUE,NA,"0.1.4"
"14433","646",2023-01-29 08:00:00,999,1006,7,0,TRUE,NA,"0.1.4"
"14434","646",2023-01-29 08:15:00,999,1006,7,0,TRUE,NA,"0.1.4"
"14435","646",2023-01-29 08:30:00,999,1006,7,0,TRUE,NA,"0.1.4"
"14436","646",2023-01-29 08:45:00,998,1006,8,0,TRUE,NA,"0.1.4"
"14437","646",2023-01-29 09:00:00,999,1006,7,0,TRUE,NA,"0.1.4"
"14438","646",2023-01-29 09:15:00,999,1006,7,0,TRUE,NA,"0.1.4"
"14439","646",2023-01-29 09:30:00,999,1006,7,0,TRUE,NA,"0.1.4"
"14440","646",2023-01-29 09:45:00,998,1006,8,0,TRUE,NA,"0.1.4"
"14441","646",2023-01-29 10:00:00,998,1006,8,0,TRUE,NA,"0.1.4"
"14442","646",2023-01-29 10:15:00,998,1006,8,0,TRUE,NA,"0.1.4"
"14443","646",2023-01-29 10:30:00,998,1006,8,0,TRUE,NA,"0.1.4"
"14444","646",2023-01-29 10:45:00,998,1006,8,0,TRUE,NA,"0.1.4"
"14445","646",2023-01-29 11:00:00,999,1006,7,0,TRUE,NA,"0.1.4"
"14446","646",2023-01-29 11:15:00,999,1006,7,0,TRUE,NA,"0.1.4"
"14447","646",2023-01-29 11:30:00,998,1006,8,0,TRUE,NA,"0.1.4"
"14448","646",2023-01-29 11:45:00,998,1006,8,0,TRUE,NA,"0.1.4"
"14449","646",2023-01-29 12:00:00,998,1006,8,0,TRUE,NA,"0.1.4"
"14450","646",2023-01-29 12:15:00,998,1006,8,0,TRUE,NA,"0.1.4"
"14451","646",2023-01-29 12:30:00,998,1006,8,0,TRUE,NA,"0.1.4"
"14452","646",2023-01-29 12:45:00,998,1006,8,0,TRUE,NA,"0.1.4"
"14453","646",2023-01-29 13:00:00,998,1006,8,0,TRUE,NA,"0.1.4"
"14454","646",2023-01-29 13:15:00,998,1006,8,0,TRUE,NA,"0.1.4"
"14455","646",2023-01-29 13:30:00,998,1006,8,0,TRUE,NA,"0.1.4"
"14456","646",2023-01-29 13:45:00,998,1006,8,0,TRUE,NA,"0.1.4"
"14457","646",2023-01-29 14:00:00,998,1006,8,0,TRUE,NA,"0.1.4"
"14458","646",2023-01-29 14:15:00,998,1006,8,0,TRUE,NA,"0.1.4"
"14459","646",2023-01-29 14:30:00,998,1006,8,0,TRUE,NA,"0.1.4"
"14460","646",2023-01-29 14:45:00,998,1006,8,0,TRUE,NA,"0.1.4"
"14461","646",2023-01-29 15:00:00,998,1006,8,0,TRUE,NA,"0.1.4"
"14462","646",2023-01-29 15:15:00,998,1006,8,0,TRUE,NA,"0.1.4"
"14463","646",2023-01-29 15:30:00,998,1006,8,0,TRUE,NA,"0.1.4"
"14464","646",2023-01-29 15:45:00,998,1006,8,0,TRUE,NA,"0.1.4"
"14465","646",2023-01-29 16:00:00,998,1006,8,0,TRUE,NA,"0.1.4"
"14466","646",2023-01-29 16:15:00,998,1006,8,0,TRUE,NA,"0.1.4"
"14467","646",2023-01-29 16:30:00,998,1006,8,0,TRUE,NA,"0.1.4"
"14468","646",2023-01-29 16:45:00,998,1006,8,0,TRUE,NA,"0.1.4"
"14469","646",2023-01-29 17:00:00,999,1006,7,0,TRUE,NA,"0.1.4"
"14470","646",2023-01-29 17:15:00,998,1006,8,0,TRUE,NA,"0.1.4"
"14471","646",2023-01-29 17:30:00,998,1006,8,0,TRUE,NA,"0.1.4"
"14472","646",2023-01-29 17:45:00,998,1006,8,0,TRUE,NA,"0.1.4"
"14473","646",2023-01-29 18:00:00,998,1006,8,0,TRUE,NA,"0.1.4"
"14474","646",2023-01-29 18:15:00,999,1006,7,0,TRUE,NA,"0.1.4"
"14475","646",2023-01-29 18:30:00,999,1006,7,0,TRUE,NA,"0.1.4"
"14476","646",2023-01-29 18:45:00,999,1006,7,0,TRUE,NA,"0.1.4"
"14477","646",2023-01-29 19:00:00,998,1006,8,0,TRUE,NA,"0.1.4"
"14478","646",2023-01-29 19:15:00,998,1006,8,0,TRUE,NA,"0.1.4"
"14479","646",2023-01-29 19:30:00,998,1006,8,0,TRUE,NA,"0.1.4"
"14480","646",2023-01-29 19:45:00,998,1006,8,0,TRUE,NA,"0.1.4"
"14481","646",2023-01-29 20:00:00,998,1006,8,0,TRUE,NA,"0.1.4"
"14482","646",2023-01-29 20:15:00,998,1006,8,0,TRUE,NA,"0.1.4"
"14483","646",2023-01-29 20:30:00,998,1006,8,0,TRUE,NA,"0.1.4"
"14484","646",2023-01-29 20:45:00,998,1006,8,0,TRUE,NA,"0.1.4"
"14485","646",2023-01-29 21:00:00,998,1006,8,0,TRUE,NA,"0.1.4"
"14486","646",2023-01-29 21:15:00,999,1006,7,0,TRUE,NA,"0.1.4"
"14487","646",2023-01-29 21:30:00,998,1006,8,0,TRUE,NA,"0.1.4"
"14488","646",2023-01-29 21:45:00,999,1006,7,0,TRUE,NA,"0.1.4"
"14489","646",2023-01-29 22:00:00,999,1006,7,0,TRUE,NA,"0.1.4"
"14490","646",2023-01-29 22:15:00,998,1006,8,0,TRUE,NA,"0.1.4"
"14491","646",2023-01-29 22:30:00,999,1006,7,0,TRUE,NA,"0.1.4"
"14492","646",2023-01-29 22:45:00,999,1006,7,0,TRUE,NA,"0.1.4"
"14493","646",2023-01-29 23:00:00,999,1006,7,0,TRUE,NA,"0.1.4"
"14494","646",2023-01-29 23:15:00,998,1006,8,0,TRUE,NA,"0.1.4"
"14495","646",2023-01-29 23:30:00,999,1006,7,0,TRUE,NA,"0.1.4"
"14496","646",2023-01-29 23:45:00,999,1006,7,0,TRUE,NA,"0.1.4"
"14497","646",2023-01-30,999,1006,7,0,TRUE,NA,"0.1.4"
"14498","646",2023-01-30 00:15:00,999,1006,7,0,TRUE,NA,"0.1.4"
"14499","646",2023-01-30 00:30:00,999,1006,7,0,TRUE,NA,"0.1.4"
"14500","646",2023-01-30 00:45:00,999,1006,7,0,TRUE,NA,"0.1.4"
"14501","646",2023-01-30 01:00:00,999,1006,7,0,TRUE,NA,"0.1.4"
"14502","646",2023-01-30 01:15:00,999,1006,7,0,TRUE,NA,"0.1.4"
"14503","646",2023-01-30 01:30:00,999,1006,7,0,TRUE,NA,"0.1.4"
"14504","646",2023-01-30 01:45:00,999,1006,7,0,TRUE,NA,"0.1.4"
"14505","646",2023-01-30 02:00:00,999,1006,7,0,TRUE,NA,"0.1.4"
"14506","646",2023-01-30 02:15:00,999,1006,7,0,TRUE,NA,"0.1.4"
"14507","646",2023-01-30 02:30:00,999,1006,7,0,TRUE,NA,"0.1.4"
"14508","646",2023-01-30 02:45:00,999,1006,7,0,TRUE,NA,"0.1.4"
"14509","646",2023-01-30 03:00:00,999,1006,7,0,TRUE,NA,"0.1.4"
"14510","646",2023-01-30 03:15:00,999,1006,7,0,TRUE,NA,"0.1.4"
"14511","646",2023-01-30 03:30:00,999,1006,7,0,TRUE,NA,"0.1.4"
"14512","646",2023-01-30 03:45:00,999,1006,7,0,TRUE,NA,"0.1.4"
"14513","646",2023-01-30 04:00:00,999,1006,7,0,TRUE,NA,"0.1.4"
"14514","646",2023-01-30 04:15:00,999,1006,7,0,TRUE,NA,"0.1.4"
"14515","646",2023-01-30 04:30:00,999,1006,7,0,TRUE,NA,"0.1.4"
"14516","646",2023-01-30 04:45:00,999,1006,7,0,TRUE,NA,"0.1.4"
"14517","646",2023-01-30 05:00:00,999,1006,7,0,TRUE,NA,"0.1.4"
"14518","646",2023-01-30 05:15:00,999,1006,7,0,TRUE,NA,"0.1.4"
"14519","646",2023-01-30 05:30:00,999,1006,7,0,TRUE,NA,"0.1.4"
"14520","646",2023-01-30 05:45:00,999,1006,7,0,TRUE,NA,"0.1.4"
"14521","646",2023-01-30 06:00:00,999,1006,7,0,TRUE,NA,"0.1.4"
"14522","646",2023-01-30 06:15:00,999,1006,7,0,TRUE,NA,"0.1.4"
"14523","646",2023-01-30 06:30:00,999,1006,7,0,TRUE,NA,"0.1.4"
"14524","646",2023-01-30 06:45:00,999,1006,7,0,TRUE,NA,"0.1.4"
"14525","646",2023-01-30 07:00:00,999,1006,7,0,TRUE,NA,"0.1.4"
"14526","646",2023-01-30 07:15:00,999,1006,7,0,TRUE,NA,"0.1.4"
"14527","646",2023-01-30 07:30:00,999,1006,7,0,TRUE,NA,"0.1.4"
"14528","646",2023-01-30 07:45:00,999,1006,7,0,TRUE,NA,"0.1.4"
"14529","646",2023-01-30 08:00:00,999,1006,7,0,TRUE,NA,"0.1.4"
"14530","646",2023-01-30 08:15:00,999,1006,7,0,TRUE,NA,"0.1.4"
"14531","646",2023-01-30 08:30:00,999,1006,7,0,TRUE,NA,"0.1.4"
"14532","646",2023-01-30 08:45:00,999,1006,7,0,TRUE,NA,"0.1.4"
"14533","646",2023-01-30 09:00:00,999,1006,7,0,TRUE,NA,"0.1.4"
"14534","646",2023-01-30 09:15:00,999,1006,7,0,TRUE,NA,"0.1.4"
"14535","646",2023-01-30 09:30:00,999,1006,7,0,TRUE,NA,"0.1.4"
"14536","646",2023-01-30 09:45:00,999,1006,7,0,TRUE,NA,"0.1.4"
"14537","646",2023-01-30 10:00:00,999,1006,7,0,TRUE,NA,"0.1.4"
"14538","646",2023-01-30 10:15:00,999,1006,7,0,TRUE,NA,"0.1.4"
"14539","646",2023-01-30 10:30:00,999,1006,7,0,TRUE,NA,"0.1.4"
"14540","646",2023-01-30 10:45:00,999,1006,7,0,TRUE,NA,"0.1.4"
"14541","646",2023-01-30 11:00:00,999,1006,7,0,TRUE,NA,"0.1.4"
"14542","646",2023-01-30 11:15:00,999,1006,7,0,TRUE,NA,"0.1.4"
"14543","646",2023-01-30 11:30:00,999,1006,7,0,TRUE,NA,"0.1.4"
"14544","646",2023-01-30 11:45:00,999,1006,7,0,TRUE,NA,"0.1.4"
"14545","646",2023-01-30 12:00:00,999,1006,7,0,TRUE,NA,"0.1.4"
"14546","646",2023-01-30 12:15:00,999,1006,7,0,TRUE,NA,"0.1.4"
"14547","646",2023-01-30 12:30:00,999,1006,7,0,TRUE,NA,"0.1.4"
"14548","646",2023-01-30 12:45:00,999,1006,7,0,TRUE,NA,"0.1.4"
"14549","646",2023-01-30 13:00:00,999,1006,7,0,TRUE,NA,"0.1.4"
"14550","646",2023-01-30 13:15:00,999,1006,7,0,TRUE,NA,"0.1.4"
"14551","646",2023-01-30 13:30:00,999,1006,7,0,TRUE,NA,"0.1.4"
"14552","646",2023-01-30 13:45:00,999,1006,7,0,TRUE,NA,"0.1.4"
"14553","646",2023-01-30 14:00:00,999,1006,7,0,TRUE,NA,"0.1.4"
"14554","646",2023-01-30 14:15:00,999,1006,7,0,TRUE,NA,"0.1.4"
"14555","646",2023-01-30 14:30:00,999,1006,7,0,TRUE,NA,"0.1.4"
"14556","646",2023-01-30 14:45:00,999,1006,7,0,TRUE,NA,"0.1.4"
"14557","646",2023-01-30 15:00:00,999,1006,7,0,TRUE,NA,"0.1.4"
"14558","646",2023-01-30 15:15:00,999,1006,7,0,TRUE,NA,"0.1.4"
"14559","646",2023-01-30 15:30:00,998,1006,8,0,TRUE,NA,"0.1.4"
"14560","646",2023-01-30 15:45:00,998,1006,8,0,TRUE,NA,"0.1.4"
"14561","646",2023-01-30 16:00:00,998,1006,8,0,TRUE,NA,"0.1.4"
"14562","646",2023-01-30 16:15:00,998,1006,8,0,TRUE,NA,"0.1.4"
"14563","646",2023-01-30 16:30:00,998,1006,8,0,TRUE,NA,"0.1.4"
"14564","646",2023-01-30 16:45:00,998,1006,8,0,TRUE,NA,"0.1.4"
"14565","646",2023-01-30 17:00:00,998,1006,8,0,TRUE,NA,"0.1.4"
"14566","646",2023-01-30 17:15:00,998,1006,8,0,TRUE,NA,"0.1.4"
"14567","646",2023-01-30 17:30:00,997,1006,9,0,TRUE,NA,"0.1.4"
"14568","646",2023-01-30 17:45:00,997,1006,9,0,TRUE,NA,"0.1.4"
"14569","646",2023-01-30 18:00:00,997,1006,9,0,TRUE,NA,"0.1.4"
"14570","646",2023-01-30 18:15:00,997,1006,9,0,TRUE,NA,"0.1.4"
"14571","646",2023-01-30 18:30:00,997,1006,9,0,TRUE,NA,"0.1.4"
"14572","646",2023-01-30 18:45:00,996,1006,10,0,TRUE,NA,"0.1.4"
"14573","646",2023-01-30 19:00:00,995,1006,11,0,TRUE,NA,"0.1.4"
"14574","646",2023-01-30 19:15:00,994,1006,12,0,TRUE,NA,"0.1.4"
"14575","646",2023-01-30 19:30:00,993,1006,13,0,TRUE,NA,"0.1.4"
"14576","646",2023-01-30 19:45:00,992,1006,14,0,TRUE,NA,"0.1.4"
"14577","646",2023-01-30 20:00:00,990,1006,16,0,TRUE,NA,"0.1.4"
"14578","646",2023-01-30 20:15:00,988,1006,18,0,TRUE,NA,"0.1.4"
"14579","646",2023-01-30 20:30:00,983,1006,23,0,TRUE,NA,"0.1.4"
"14580","646",2023-01-30 20:45:00,977,1006,29,0,TRUE,NA,"0.1.4"
"14581","646",2023-01-30 21:00:00,972,1006,34,0,TRUE,NA,"0.1.4"
"14582","646",2023-01-30 21:15:00,971,1006,35,0,TRUE,NA,"0.1.4"
"14583","646",2023-01-30 21:30:00,970,1006,36,0,TRUE,NA,"0.1.4"
"14584","646",2023-01-30 21:45:00,970,1006,36,0,TRUE,NA,"0.1.4"
"14585","646",2023-01-30 22:00:00,970,1006,36,0,TRUE,NA,"0.1.4"
"14586","646",2023-01-30 22:15:00,970,1006,36,0,TRUE,NA,"0.1.4"
"14587","646",2023-01-30 22:30:00,970,1006,36,0,TRUE,NA,"0.1.4"
"14588","646",2023-01-30 22:45:00,970,1006,36,0,TRUE,NA,"0.1.4"
"14589","646",2023-01-30 23:00:00,969,1006,37,0,TRUE,NA,"0.1.4"
"14590","646",2023-01-30 23:15:00,969,1006,37,0,TRUE,NA,"0.1.4"
"14591","646",2023-01-30 23:30:00,969,1006,37,0,TRUE,NA,"0.1.4"
"14592","646",2023-01-30 23:45:00,970,1006,36,0,TRUE,NA,"0.1.4"
"14593","646",2023-01-31,969,1006,37,0,TRUE,NA,"0.1.4"
"14594","646",2023-01-31 00:15:00,970,1006,36,0,TRUE,NA,"0.1.4"
"14595","646",2023-01-31 00:30:00,970,1006,36,0,TRUE,NA,"0.1.4"
"14596","646",2023-01-31 00:45:00,969,1006,37,0,TRUE,NA,"0.1.4"
"14597","646",2023-01-31 01:00:00,969,1006,37,0,TRUE,NA,"0.1.4"
"14598","646",2023-01-31 01:15:00,969,1006,37,0,TRUE,NA,"0.1.4"
"14599","646",2023-01-31 01:30:00,969,1006,37,0,TRUE,NA,"0.1.4"
"14600","646",2023-01-31 01:45:00,969,1006,37,0,TRUE,NA,"0.1.4"
"14601","646",2023-01-31 02:00:00,969,1006,37,0,TRUE,NA,"0.1.4"
"14602","646",2023-01-31 02:15:00,969,1006,37,0,TRUE,NA,"0.1.4"
"14603","646",2023-01-31 02:30:00,969,1006,37,0,TRUE,NA,"0.1.4"
"14604","646",2023-01-31 02:45:00,969,1006,37,0,TRUE,NA,"0.1.4"
"14605","646",2023-01-31 03:00:00,969,1006,37,0,TRUE,NA,"0.1.4"
"14606","646",2023-01-31 03:15:00,969,1006,37,0,TRUE,NA,"0.1.4"
"14607","646",2023-01-31 03:30:00,970,1006,36,0,TRUE,NA,"0.1.4"
"14608","646",2023-01-31 03:45:00,970,1006,36,0,TRUE,NA,"0.1.4"
"14609","646",2023-01-31 04:00:00,970,1006,36,0,TRUE,NA,"0.1.4"
"14610","646",2023-01-31 04:15:00,970,1006,36,0,TRUE,NA,"0.1.4"
"14611","646",2023-01-31 04:30:00,970,1006,36,0,TRUE,NA,"0.1.4"
"14612","646",2023-01-31 04:45:00,970,1006,36,0,TRUE,NA,"0.1.4"
"14613","646",2023-01-31 05:00:00,970,1006,36,0,TRUE,NA,"0.1.4"
"14614","646",2023-01-31 05:15:00,970,1006,36,0,TRUE,NA,"0.1.4"
"14615","646",2023-01-31 05:30:00,970,1006,36,0,TRUE,NA,"0.1.4"
"14616","646",2023-01-31 05:45:00,970,1006,36,0,TRUE,NA,"0.1.4"
"14617","646",2023-01-31 06:00:00,970,1006,36,0,TRUE,NA,"0.1.4"
"14618","646",2023-01-31 06:15:00,970,1006,36,0,TRUE,NA,"0.1.4"
"14619","646",2023-01-31 06:30:00,970,1006,36,0,TRUE,NA,"0.1.4"
"14620","646",2023-01-31 06:45:00,970,1006,36,0,TRUE,NA,"0.1.4"
"14621","646",2023-01-31 07:00:00,970,1006,36,0,TRUE,NA,"0.1.4"
"14622","646",2023-01-31 07:15:00,970,1006,36,0,TRUE,NA,"0.1.4"
"14623","646",2023-01-31 07:30:00,970,1006,36,0,TRUE,NA,"0.1.4"
"14624","646",2023-01-31 07:45:00,969,1006,37,0,TRUE,NA,"0.1.4"
"14625","646",2023-01-31 08:00:00,969,1006,37,0,TRUE,NA,"0.1.4"
"14626","646",2023-01-31 08:15:00,969,1006,37,0,TRUE,NA,"0.1.4"
"14627","646",2023-01-31 08:30:00,969,1006,37,0,TRUE,NA,"0.1.4"
"14628","646",2023-01-31 08:45:00,969,1006,37,0,TRUE,NA,"0.1.4"
"14629","646",2023-01-31 09:00:00,969,1006,37,0,TRUE,NA,"0.1.4"
"14630","646",2023-01-31 09:15:00,970,1006,36,0,TRUE,NA,"0.1.4"
"14631","646",2023-01-31 09:30:00,970,1006,36,0,TRUE,NA,"0.1.4"
"14632","646",2023-01-31 09:45:00,969,1006,37,0,TRUE,NA,"0.1.4"
"14633","646",2023-01-31 10:00:00,968,1006,38,0,TRUE,NA,"0.1.4"
"14634","646",2023-01-31 10:15:00,969,1006,37,0,TRUE,NA,"0.1.4"
"14635","646",2023-01-31 10:30:00,968,1006,38,0,TRUE,NA,"0.1.4"
"14636","646",2023-01-31 10:45:00,969,1006,37,0,TRUE,NA,"0.1.4"
"14637","646",2023-01-31 11:00:00,969,1006,37,0,TRUE,NA,"0.1.4"
"14638","646",2023-01-31 11:15:00,970,1006,36,0,TRUE,NA,"0.1.4"
"14639","646",2023-01-31 11:30:00,970,1006,36,0,TRUE,NA,"0.1.4"
"14640","646",2023-01-31 11:45:00,969,1006,37,0,TRUE,NA,"0.1.4"
"14641","646",2023-01-31 12:00:00,970,1006,36,0,TRUE,NA,"0.1.4"
"14642","646",2023-01-31 12:15:00,970,1006,36,0,TRUE,NA,"0.1.4"
"14643","646",2023-01-31 12:30:00,970,1006,36,0,TRUE,NA,"0.1.4"
"14644","646",2023-01-31 12:45:00,970,1006,36,0,TRUE,NA,"0.1.4"
"14645","646",2023-01-31 13:00:00,970,1006,36,0,TRUE,NA,"0.1.4"
"14646","646",2023-01-31 13:15:00,969,1006,37,0,TRUE,NA,"0.1.4"
"14647","646",2023-01-31 13:30:00,969,1006,37,0,TRUE,NA,"0.1.4"
"14648","646",2023-01-31 13:45:00,969,1006,37,0,TRUE,NA,"0.1.4"
"14649","646",2023-01-31 14:00:00,968,1006,38,0,TRUE,NA,"0.1.4"
"14650","646",2023-01-31 14:15:00,969,1006,37,0,TRUE,NA,"0.1.4"
"14651","646",2023-01-31 14:30:00,969,1006,37,0,TRUE,NA,"0.1.4"
"14652","646",2023-01-31 14:45:00,968,1006,38,0,TRUE,NA,"0.1.4"
"14653","646",2023-01-31 15:00:00,969,1006,37,0,TRUE,NA,"0.1.4"
"14654","646",2023-01-31 15:15:00,969,1006,37,0,TRUE,NA,"0.1.4"
"14655","646",2023-01-31 15:30:00,968,1006,38,0,TRUE,NA,"0.1.4"
"14656","646",2023-01-31 15:45:00,968,1006,38,0,TRUE,NA,"0.1.4"
"14657","646",2023-01-31 16:00:00,968,1006,38,0,TRUE,NA,"0.1.4"
"14658","646",2023-01-31 16:15:00,970,1006,36,0,TRUE,NA,"0.1.4"
"14659","646",2023-01-31 16:30:00,968,1006,38,0,TRUE,NA,"0.1.4"
"14660","646",2023-01-31 16:45:00,968,1006,38,0,TRUE,NA,"0.1.4"
"14661","646",2023-01-31 17:00:00,966,1006,40,0,TRUE,NA,"0.1.4"
"14662","646",2023-01-31 17:15:00,965,1006,41,0,TRUE,NA,"0.1.4"
"14663","646",2023-01-31 17:30:00,964,1006,42,0,TRUE,NA,"0.1.4"
"14664","646",2023-01-31 17:45:00,962,1006,44,0,TRUE,NA,"0.1.4"
"14665","646",2023-01-31 18:00:00,957,1006,49,0,TRUE,NA,"0.1.4"
"14666","646",2023-01-31 18:15:00,958,1006,48,0,TRUE,NA,"0.1.4"
"14667","646",2023-01-31 18:30:00,954,1006,52,0,TRUE,NA,"0.1.4"
"14668","646",2023-01-31 18:45:00,955,1006,51,0,TRUE,NA,"0.1.4"
"14669","646",2023-01-31 19:00:00,956,1006,50,0,TRUE,NA,"0.1.4"
"14670","646",2023-01-31 19:15:00,956,1006,50,0,TRUE,NA,"0.1.4"
"14671","646",2023-01-31 19:30:00,955,1006,51,0,TRUE,NA,"0.1.4"
"14672","646",2023-01-31 19:45:00,957,1006,49,0,TRUE,NA,"0.1.4"
"14673","646",2023-01-31 20:00:00,961,1006,45,0,TRUE,NA,"0.1.4"
"14674","646",2023-01-31 20:15:00,962,1006,44,0,TRUE,NA,"0.1.4"
"14675","646",2023-01-31 20:30:00,964,1006,42,0,TRUE,NA,"0.1.4"
"14676","646",2023-01-31 20:45:00,964,1006,42,0,TRUE,NA,"0.1.4"
"14677","646",2023-01-31 21:00:00,968,1006,38,0,TRUE,NA,"0.1.4"
"14678","646",2023-01-31 21:15:00,970,1006,36,0,TRUE,NA,"0.1.4"
"14679","646",2023-01-31 21:30:00,971,1006,35,0,TRUE,NA,"0.1.4"
"14680","646",2023-01-31 21:45:00,976,1006,30,0,TRUE,NA,"0.1.4"
"14681","646",2023-01-31 22:00:00,977,1006,29,0,TRUE,NA,"0.1.4"
"14682","646",2023-01-31 22:15:00,977,1006,29,0,TRUE,NA,"0.1.4"
"14683","646",2023-01-31 22:30:00,976,1006,30,0,TRUE,NA,"0.1.4"
"14684","646",2023-01-31 22:45:00,977,1006,29,0,TRUE,NA,"0.1.4"
"14685","646",2023-01-31 23:00:00,978,1006,28,0,TRUE,NA,"0.1.4"
"14686","646",2023-01-31 23:15:00,977,1006,29,0,TRUE,NA,"0.1.4"
"14687","646",2023-01-31 23:30:00,977,1006,29,0,TRUE,NA,"0.1.4"
"14688","646",2023-01-31 23:45:00,977,1006,29,0,TRUE,NA,"0.1.4"
"14689","646",2023-02-01,978,1006,28,0,TRUE,NA,"0.1.4"
"14690","646",2023-02-01 00:15:00,977,1006,29,0,TRUE,NA,"0.1.4"
"14691","646",2023-02-01 00:30:00,978,1006,28,0,TRUE,NA,"0.1.4"
"14692","646",2023-02-01 00:45:00,977,1006,29,0,TRUE,NA,"0.1.4"
"14693","646",2023-02-01 01:00:00,977,1006,29,0,TRUE,NA,"0.1.4"
"14694","646",2023-02-01 01:15:00,977,1006,29,0,TRUE,NA,"0.1.4"
"14695","646",2023-02-01 01:30:00,977,1006,29,0,TRUE,NA,"0.1.4"
"14696","646",2023-02-01 01:45:00,977,1006,29,0,TRUE,NA,"0.1.4"
"14697","646",2023-02-01 02:00:00,976,1006,30,0,TRUE,NA,"0.1.4"
"14698","646",2023-02-01 02:15:00,977,1006,29,0,TRUE,NA,"0.1.4"
"14699","646",2023-02-01 02:30:00,978,1006,28,0,TRUE,NA,"0.1.4"
"14700","646",2023-02-01 02:45:00,978,1006,28,0,TRUE,NA,"0.1.4"
"14701","646",2023-02-01 03:00:00,977,1006,29,0,TRUE,NA,"0.1.4"
"14702","646",2023-02-01 03:15:00,979,1006,27,0,TRUE,NA,"0.1.4"
"14703","646",2023-02-01 03:30:00,979,1006,27,0,TRUE,NA,"0.1.4"
"14704","646",2023-02-01 03:45:00,979,1006,27,0,TRUE,NA,"0.1.4"
"14705","646",2023-02-01 04:00:00,978,1006,28,0,TRUE,NA,"0.1.4"
"14706","646",2023-02-01 04:15:00,978,1006,28,0,TRUE,NA,"0.1.4"
"14707","646",2023-02-01 04:30:00,978,1006,28,0,TRUE,NA,"0.1.4"
"14708","646",2023-02-01 04:45:00,978,1006,28,0,TRUE,NA,"0.1.4"
"14709","646",2023-02-01 05:00:00,978,1006,28,0,TRUE,NA,"0.1.4"
"14710","646",2023-02-01 05:15:00,978,1006,28,0,TRUE,NA,"0.1.4"
"14711","646",2023-02-01 05:30:00,978,1006,28,0,TRUE,NA,"0.1.4"
"14712","646",2023-02-01 05:45:00,978,1006,28,0,TRUE,NA,"0.1.4"
"14713","646",2023-02-01 06:00:00,978,1006,28,0,TRUE,NA,"0.1.4"
"14714","646",2023-02-01 06:15:00,978,1006,28,0,TRUE,NA,"0.1.4"
"14715","646",2023-02-01 06:30:00,978,1006,28,0,TRUE,NA,"0.1.4"
"14716","646",2023-02-01 06:45:00,978,1006,28,0,TRUE,NA,"0.1.4"
"14717","646",2023-02-01 07:00:00,978,1006,28,0,TRUE,NA,"0.1.4"
"14718","646",2023-02-01 07:15:00,978,1006,28,0,TRUE,NA,"0.1.4"
"14719","646",2023-02-01 07:30:00,978,1006,28,0,TRUE,NA,"0.1.4"
"14720","646",2023-02-01 07:45:00,978,1006,28,0,TRUE,NA,"0.1.4"
"14721","646",2023-02-01 08:00:00,979,1006,27,0,TRUE,NA,"0.1.4"
"14722","646",2023-02-01 08:15:00,979,1006,27,0,TRUE,NA,"0.1.4"
"14723","646",2023-02-01 08:30:00,979,1006,27,0,TRUE,NA,"0.1.4"
"14724","646",2023-02-01 08:45:00,979,1006,27,0,TRUE,NA,"0.1.4"
"14725","646",2023-02-01 09:00:00,979,1006,27,0,TRUE,NA,"0.1.4"
"14726","646",2023-02-01 09:15:00,979,1006,27,0,TRUE,NA,"0.1.4"
"14727","646",2023-02-01 09:30:00,979,1006,27,0,TRUE,NA,"0.1.4"
"14728","646",2023-02-01 09:45:00,979,1006,27,0,TRUE,NA,"0.1.4"
"14729","646",2023-02-01 10:00:00,979,1006,27,0,TRUE,NA,"0.1.4"
"14730","646",2023-02-01 10:15:00,979,1006,27,0,TRUE,NA,"0.1.4"
"14731","646",2023-02-01 10:30:00,979,1006,27,0,TRUE,NA,"0.1.4"
"14732","646",2023-02-01 10:45:00,979,1006,27,0,TRUE,NA,"0.1.4"
"14733","646",2023-02-01 11:00:00,979,1006,27,0,TRUE,NA,"0.1.4"
"14734","646",2023-02-01 11:15:00,979,1006,27,0,TRUE,NA,"0.1.4"
"14735","646",2023-02-01 11:30:00,979,1006,27,0,TRUE,NA,"0.1.4"
"14736","646",2023-02-01 11:45:00,979,1006,27,0,TRUE,NA,"0.1.4"
"14737","646",2023-02-01 12:00:00,979,1006,27,0,TRUE,NA,"0.1.4"
"14738","646",2023-02-01 12:15:00,979,1006,27,0,TRUE,NA,"0.1.4"
"14739","646",2023-02-01 12:30:00,979,1006,27,0,TRUE,NA,"0.1.4"
"14740","646",2023-02-01 12:45:00,979,1006,27,0,TRUE,NA,"0.1.4"
"14741","646",2023-02-01 13:00:00,979,1006,27,0,TRUE,NA,"0.1.4"
"14742","646",2023-02-01 13:15:00,979,1006,27,0,TRUE,NA,"0.1.4"
"14743","646",2023-02-01 13:30:00,979,1006,27,0,TRUE,NA,"0.1.4"
"14744","646",2023-02-01 13:45:00,979,1006,27,0,TRUE,NA,"0.1.4"
"14745","646",2023-02-01 14:00:00,979,1006,27,0,TRUE,NA,"0.1.4"
"14746","646",2023-02-01 14:15:00,979,1006,27,0,TRUE,NA,"0.1.4"
"14747","646",2023-02-01 14:30:00,979,1006,27,0,TRUE,NA,"0.1.4"
"14748","646",2023-02-01 14:45:00,979,1006,27,0,TRUE,NA,"0.1.4"
"14749","646",2023-02-01 15:00:00,979,1006,27,0,TRUE,NA,"0.1.4"
"14750","646",2023-02-01 15:15:00,979,1006,27,0,TRUE,NA,"0.1.4"
"14751","646",2023-02-01 15:30:00,979,1006,27,0,TRUE,NA,"0.1.4"
"14752","646",2023-02-01 15:45:00,979,1006,27,0,TRUE,NA,"0.1.4"
"14753","646",2023-02-01 16:00:00,979,1006,27,0,TRUE,NA,"0.1.4"
"14754","646",2023-02-01 16:15:00,979,1006,27,0,TRUE,NA,"0.1.4"
"14755","646",2023-02-01 16:30:00,979,1006,27,0,TRUE,NA,"0.1.4"
"14756","646",2023-02-01 16:45:00,979,1006,27,0,TRUE,NA,"0.1.4"
"14757","646",2023-02-01 17:00:00,979,1006,27,0,TRUE,NA,"0.1.4"
"14758","646",2023-02-01 17:15:00,979,1006,27,0,TRUE,NA,"0.1.4"
"14759","646",2023-02-01 17:30:00,979,1006,27,0,TRUE,NA,"0.1.4"
"14760","646",2023-02-01 17:45:00,979,1006,27,0,TRUE,NA,"0.1.4"
"14761","646",2023-02-01 18:00:00,978,1006,28,0,TRUE,NA,"0.1.4"
"14762","646",2023-02-01 18:15:00,978,1006,28,0,TRUE,NA,"0.1.4"
"14763","646",2023-02-01 18:30:00,976,1006,30,0,TRUE,NA,"0.1.4"
"14764","646",2023-02-01 18:45:00,974,1006,32,0,TRUE,NA,"0.1.4"
"14765","646",2023-02-01 19:00:00,974,1006,32,0,TRUE,NA,"0.1.4"
"14766","646",2023-02-01 19:15:00,974,1006,32,0,TRUE,NA,"0.1.4"
"14767","646",2023-02-01 19:30:00,976,1006,30,0,TRUE,NA,"0.1.4"
"14768","646",2023-02-01 19:45:00,976,1006,30,0,TRUE,NA,"0.1.4"
"14769","646",2023-02-01 20:00:00,976,1006,30,0,TRUE,NA,"0.1.4"
"14770","646",2023-02-01 20:15:00,976,1006,30,0,TRUE,NA,"0.1.4"
"14771","646",2023-02-01 20:30:00,976,1006,30,0,TRUE,NA,"0.1.4"
"14772","646",2023-02-01 20:45:00,976,1006,30,0,TRUE,NA,"0.1.4"
"14773","646",2023-02-01 21:00:00,976,1006,30,0,TRUE,NA,"0.1.4"
"14774","646",2023-02-01 21:15:00,976,1006,30,0,TRUE,NA,"0.1.4"
"14775","646",2023-02-01 21:30:00,976,1006,30,0,TRUE,NA,"0.1.4"
"14776","646",2023-02-01 21:45:00,976,1006,30,0,TRUE,NA,"0.1.4"
"14777","646",2023-02-01 22:00:00,976,1006,30,0,TRUE,NA,"0.1.4"
"14778","646",2023-02-01 22:15:00,976,1006,30,0,TRUE,NA,"0.1.4"
"14779","646",2023-02-01 22:30:00,976,1006,30,0,TRUE,NA,"0.1.4"
"14780","646",2023-02-01 22:45:00,976,1006,30,0,TRUE,NA,"0.1.4"
"14781","646",2023-02-01 23:00:00,976,1006,30,0,TRUE,NA,"0.1.4"
"14782","646",2023-02-01 23:15:00,976,1006,30,0,TRUE,NA,"0.1.4"
"14783","646",2023-02-01 23:30:00,976,1006,30,0,TRUE,NA,"0.1.4"
"14784","646",2023-02-01 23:45:00,976,1006,30,0,TRUE,NA,"0.1.4"
"14785","646",2023-02-02,976,1006,30,0,TRUE,NA,"0.1.4"
"14786","646",2023-02-02 00:15:00,976,1006,30,0,TRUE,NA,"0.1.4"
"14787","646",2023-02-02 00:30:00,976,1006,30,0,TRUE,NA,"0.1.4"
"14788","646",2023-02-02 00:45:00,976,1006,30,0,TRUE,NA,"0.1.4"
"14789","646",2023-02-02 01:00:00,975,1006,31,0,TRUE,NA,"0.1.4"
"14790","646",2023-02-02 01:15:00,976,1006,30,0,TRUE,NA,"0.1.4"
"14791","646",2023-02-02 01:30:00,976,1006,30,0,TRUE,NA,"0.1.4"
"14792","646",2023-02-02 01:45:00,976,1006,30,0,TRUE,NA,"0.1.4"
"14793","646",2023-02-02 02:00:00,976,1006,30,0,TRUE,NA,"0.1.4"
"14794","646",2023-02-02 02:15:00,976,1006,30,0,TRUE,NA,"0.1.4"
"14795","646",2023-02-02 02:30:00,976,1006,30,0,TRUE,NA,"0.1.4"
"14796","646",2023-02-02 02:45:00,975,1006,31,0,TRUE,NA,"0.1.4"
"14797","646",2023-02-02 03:00:00,976,1006,30,0,TRUE,NA,"0.1.4"
"14798","646",2023-02-02 03:15:00,975,1006,31,0,TRUE,NA,"0.1.4"
"14799","646",2023-02-02 03:30:00,975,1006,31,0,TRUE,NA,"0.1.4"
"14800","646",2023-02-02 03:45:00,977,1006,29,0,TRUE,NA,"0.1.4"
"14801","646",2023-02-02 04:00:00,976,1006,30,0,TRUE,NA,"0.1.4"
"14802","646",2023-02-02 04:15:00,976,1006,30,0,TRUE,NA,"0.1.4"
"14803","646",2023-02-02 04:30:00,976,1006,30,0,TRUE,NA,"0.1.4"
"14804","646",2023-02-02 04:45:00,977,1006,29,0,TRUE,NA,"0.1.4"
"14805","646",2023-02-02 05:00:00,976,1006,30,0,TRUE,NA,"0.1.4"
"14806","646",2023-02-02 05:15:00,976,1006,30,0,TRUE,NA,"0.1.4"
"14807","646",2023-02-02 05:30:00,977,1006,29,0,TRUE,NA,"0.1.4"
"14808","646",2023-02-02 05:45:00,976,1006,30,0,TRUE,NA,"0.1.4"
"14809","646",2023-02-02 06:00:00,977,1006,29,0,TRUE,NA,"0.1.4"
"14810","646",2023-02-02 06:15:00,977,1006,29,0,TRUE,NA,"0.1.4"
"14811","646",2023-02-02 06:30:00,977,1006,29,0,TRUE,NA,"0.1.4"
"14812","646",2023-02-02 06:45:00,977,1006,29,0,TRUE,NA,"0.1.4"
"14813","646",2023-02-02 07:00:00,977,1006,29,0,TRUE,NA,"0.1.4"
"14814","646",2023-02-02 07:15:00,977,1006,29,0,TRUE,NA,"0.1.4"
"14815","646",2023-02-02 07:30:00,977,1006,29,0,TRUE,NA,"0.1.4"
"14816","646",2023-02-02 07:45:00,976,1006,30,0,TRUE,NA,"0.1.4"
"14817","646",2023-02-02 08:00:00,976,1006,30,0,TRUE,NA,"0.1.4"
"14818","646",2023-02-02 08:15:00,977,1006,29,0,TRUE,NA,"0.1.4"
"14819","646",2023-02-02 08:30:00,976,1006,30,0,TRUE,NA,"0.1.4"
"14820","646",2023-02-02 08:45:00,976,1006,30,0,TRUE,NA,"0.1.4"
"14821","646",2023-02-02 09:00:00,976,1006,30,0,TRUE,NA,"0.1.4"
"14822","646",2023-02-02 09:15:00,977,1006,29,0,TRUE,NA,"0.1.4"
"14823","646",2023-02-02 09:30:00,977,1006,29,0,TRUE,NA,"0.1.4"
"14824","646",2023-02-02 09:45:00,977,1006,29,0,TRUE,NA,"0.1.4"
"14825","646",2023-02-02 10:00:00,977,1006,29,0,TRUE,NA,"0.1.4"
"14826","646",2023-02-02 10:15:00,977,1006,29,0,TRUE,NA,"0.1.4"
"14827","646",2023-02-02 10:30:00,977,1006,29,0,TRUE,NA,"0.1.4"
"14828","646",2023-02-02 10:45:00,977,1006,29,0,TRUE,NA,"0.1.4"
"14829","646",2023-02-02 11:00:00,977,1006,29,0,TRUE,NA,"0.1.4"
"14830","646",2023-02-02 11:15:00,977,1006,29,0,TRUE,NA,"0.1.4"
"14831","646",2023-02-02 11:30:00,977,1006,29,0,TRUE,NA,"0.1.4"
"14832","646",2023-02-02 11:45:00,977,1006,29,0,TRUE,NA,"0.1.4"
"14833","646",2023-02-02 12:00:00,977,1006,29,0,TRUE,NA,"0.1.4"
"14834","646",2023-02-02 12:15:00,977,1006,29,0,TRUE,NA,"0.1.4"
"14835","646",2023-02-02 12:30:00,977,1006,29,0,TRUE,NA,"0.1.4"
"14836","646",2023-02-02 12:45:00,977,1006,29,0,TRUE,NA,"0.1.4"
"14837","646",2023-02-02 13:00:00,977,1006,29,0,TRUE,NA,"0.1.4"
"14838","646",2023-02-02 13:15:00,977,1006,29,0,TRUE,NA,"0.1.4"
"14839","646",2023-02-02 13:30:00,977,1006,29,0,TRUE,NA,"0.1.4"
"14840","646",2023-02-02 13:45:00,977,1006,29,0,TRUE,NA,"0.1.4"
"14841","646",2023-02-02 14:00:00,977,1006,29,0,TRUE,NA,"0.1.4"
"14842","646",2023-02-02 14:15:00,977,1006,29,0,TRUE,NA,"0.1.4"
"14843","646",2023-02-02 14:30:00,977,1006,29,0,TRUE,NA,"0.1.4"
"14844","646",2023-02-02 14:45:00,977,1006,29,0,TRUE,NA,"0.1.4"
"14845","646",2023-02-02 15:00:00,977,1006,29,0,TRUE,NA,"0.1.4"
"14846","646",2023-02-02 15:15:00,977,1006,29,0,TRUE,NA,"0.1.4"
"14847","646",2023-02-02 15:30:00,977,1006,29,0,TRUE,NA,"0.1.4"
"14848","646",2023-02-02 15:45:00,977,1006,29,0,TRUE,NA,"0.1.4"
"14849","646",2023-02-02 16:00:00,977,1006,29,0,TRUE,NA,"0.1.4"
"14850","646",2023-02-02 16:15:00,977,1006,29,0,TRUE,NA,"0.1.4"
"14851","646",2023-02-02 16:30:00,977,1006,29,0,TRUE,NA,"0.1.4"
"14852","646",2023-02-02 16:45:00,976,1006,30,0,TRUE,NA,"0.1.4"
"14853","646",2023-02-02 17:00:00,976,1006,30,0,TRUE,NA,"0.1.4"
"14854","646",2023-02-02 17:15:00,976,1006,30,0,TRUE,NA,"0.1.4"
"14855","646",2023-02-02 17:30:00,975,1006,31,0,TRUE,NA,"0.1.4"
"14856","646",2023-02-02 17:45:00,975,1006,31,0,TRUE,NA,"0.1.4"
"14857","646",2023-02-02 18:00:00,974,1006,32,0,TRUE,NA,"0.1.4"
"14858","646",2023-02-02 18:15:00,974,1006,32,0,TRUE,NA,"0.1.4"
"14859","646",2023-02-02 18:30:00,973,1006,33,0,TRUE,NA,"0.1.4"
"14860","646",2023-02-02 18:45:00,973,1006,33,0,TRUE,NA,"0.1.4"
"14861","646",2023-02-02 19:00:00,973,1006,33,0,TRUE,NA,"0.1.4"
"14862","646",2023-02-02 19:15:00,973,1006,33,0,TRUE,NA,"0.1.4"
"14863","646",2023-02-02 19:30:00,973,1006,33,0,TRUE,NA,"0.1.4"
"14864","646",2023-02-02 19:45:00,973,1006,33,0,TRUE,NA,"0.1.4"
"14865","646",2023-02-02 20:00:00,973,1006,33,0,TRUE,NA,"0.1.4"
"14866","646",2023-02-02 20:15:00,973,1006,33,0,TRUE,NA,"0.1.4"
"14867","646",2023-02-02 20:30:00,973,1006,33,0,TRUE,NA,"0.1.4"
"14868","646",2023-02-02 20:45:00,973,1006,33,0,TRUE,NA,"0.1.4"
"14869","646",2023-02-02 21:00:00,973,1006,33,0,TRUE,NA,"0.1.4"
"14870","646",2023-02-02 21:15:00,973,1006,33,0,TRUE,NA,"0.1.4"
"14871","646",2023-02-02 21:30:00,973,1006,33,0,TRUE,NA,"0.1.4"
"14872","646",2023-02-02 21:45:00,974,1006,32,0,TRUE,NA,"0.1.4"
"14873","646",2023-02-02 22:00:00,973,1006,33,0,TRUE,NA,"0.1.4"
"14874","646",2023-02-02 22:15:00,973,1006,33,0,TRUE,NA,"0.1.4"
"14875","646",2023-02-02 22:30:00,974,1006,32,0,TRUE,NA,"0.1.4"
"14876","646",2023-02-02 22:45:00,973,1006,33,0,TRUE,NA,"0.1.4"
"14877","646",2023-02-02 23:00:00,974,1006,32,0,TRUE,NA,"0.1.4"
"14878","646",2023-02-02 23:15:00,974,1006,32,0,TRUE,NA,"0.1.4"
"14879","646",2023-02-02 23:30:00,974,1006,32,0,TRUE,NA,"0.1.4"
"14880","646",2023-02-02 23:45:00,974,1006,32,0,TRUE,NA,"0.1.4"
"14881","646",2023-02-03,974,1006,32,0,TRUE,NA,"0.1.4"
"14882","646",2023-02-03 00:15:00,974,1006,32,0,TRUE,NA,"0.1.4"
"14883","646",2023-02-03 00:30:00,974,1006,32,0,TRUE,NA,"0.1.4"
"14884","646",2023-02-03 00:45:00,974,1006,32,0,TRUE,NA,"0.1.4"
"14885","646",2023-02-03 01:00:00,974,1006,32,0,TRUE,NA,"0.1.4"
"14886","646",2023-02-03 01:15:00,974,1006,32,0,TRUE,NA,"0.1.4"
"14887","646",2023-02-03 01:30:00,974,1006,32,0,TRUE,NA,"0.1.4"
"14888","646",2023-02-03 01:45:00,974,1006,32,0,TRUE,NA,"0.1.4"
"14889","646",2023-02-03 02:00:00,974,1006,32,0,TRUE,NA,"0.1.4"
"14890","646",2023-02-03 02:15:00,974,1006,32,0,TRUE,NA,"0.1.4"
"14891","646",2023-02-03 02:30:00,974,1006,32,0,TRUE,NA,"0.1.4"
"14892","646",2023-02-03 02:45:00,974,1006,32,0,TRUE,NA,"0.1.4"
"14893","646",2023-02-03 03:00:00,974,1006,32,0,TRUE,NA,"0.1.4"
"14894","646",2023-02-03 03:15:00,974,1006,32,0,TRUE,NA,"0.1.4"
"14895","646",2023-02-03 03:30:00,974,1006,32,0,TRUE,NA,"0.1.4"
"14896","646",2023-02-03 03:45:00,974,1006,32,0,TRUE,NA,"0.1.4"
"14897","646",2023-02-03 04:00:00,974,1006,32,0,TRUE,NA,"0.1.4"
"14898","646",2023-02-03 04:15:00,974,1006,32,0,TRUE,NA,"0.1.4"
"14899","646",2023-02-03 04:30:00,974,1006,32,0,TRUE,NA,"0.1.4"
"14900","646",2023-02-03 04:45:00,974,1006,32,0,TRUE,NA,"0.1.4"
"14901","646",2023-02-03 05:00:00,974,1006,32,0,TRUE,NA,"0.1.4"
"14902","646",2023-02-03 05:15:00,974,1006,32,0,TRUE,NA,"0.1.4"
"14903","646",2023-02-03 05:30:00,974,1006,32,0,TRUE,NA,"0.1.4"
"14904","646",2023-02-03 05:45:00,974,1006,32,0,TRUE,NA,"0.1.4"
"14905","646",2023-02-03 06:00:00,974,1006,32,0,TRUE,NA,"0.1.4"
"14906","646",2023-02-03 06:15:00,974,1006,32,0,TRUE,NA,"0.1.4"
"14907","646",2023-02-03 06:30:00,974,1006,32,0,TRUE,NA,"0.1.4"
"14908","646",2023-02-03 06:45:00,974,1006,32,0,TRUE,NA,"0.1.4"
"14909","646",2023-02-03 07:00:00,973,1006,33,0,TRUE,NA,"0.1.4"
"14910","646",2023-02-03 07:15:00,974,1006,32,0,TRUE,NA,"0.1.4"
"14911","646",2023-02-03 07:30:00,974,1006,32,0,TRUE,NA,"0.1.4"
"14912","646",2023-02-03 07:45:00,973,1006,33,0,TRUE,NA,"0.1.4"
"14913","646",2023-02-03 08:00:00,974,1006,32,0,TRUE,NA,"0.1.4"
"14914","646",2023-02-03 08:15:00,974,1006,32,0,TRUE,NA,"0.1.4"
"14915","646",2023-02-03 08:30:00,974,1006,32,0,TRUE,NA,"0.1.4"
"14916","646",2023-02-03 08:45:00,974,1006,32,0,TRUE,NA,"0.1.4"
"14917","646",2023-02-03 09:00:00,974,1006,32,0,TRUE,NA,"0.1.4"
"14918","646",2023-02-03 09:15:00,974,1006,32,0,TRUE,NA,"0.1.4"
"14919","646",2023-02-03 09:30:00,974,1006,32,0,TRUE,NA,"0.1.4"
"14920","646",2023-02-03 09:45:00,974,1006,32,0,TRUE,NA,"0.1.4"
"14921","646",2023-02-03 10:00:00,974,1006,32,0,TRUE,NA,"0.1.4"
"14922","646",2023-02-03 10:15:00,974,1006,32,0,TRUE,NA,"0.1.4"
"14923","646",2023-02-03 10:30:00,974,1006,32,0,TRUE,NA,"0.1.4"
"14924","646",2023-02-03 10:45:00,974,1006,32,0,TRUE,NA,"0.1.4"
"14925","646",2023-02-03 11:00:00,974,1006,32,0,TRUE,NA,"0.1.4"
"14926","646",2023-02-03 11:15:00,974,1006,32,0,TRUE,NA,"0.1.4"
"14927","646",2023-02-03 11:30:00,974,1006,32,0,TRUE,NA,"0.1.4"
"14928","646",2023-02-03 11:45:00,973,1006,33,0,TRUE,NA,"0.1.4"
"14929","646",2023-02-03 12:00:00,974,1006,32,0,TRUE,NA,"0.1.4"
"14930","646",2023-02-03 12:15:00,974,1006,32,0,TRUE,NA,"0.1.4"
"14931","646",2023-02-03 12:30:00,974,1006,32,0,TRUE,NA,"0.1.4"
"14932","646",2023-02-03 12:45:00,974,1006,32,0,TRUE,NA,"0.1.4"
"14933","646",2023-02-03 13:00:00,974,1006,32,0,TRUE,NA,"0.1.4"
"14934","646",2023-02-03 13:15:00,974,1006,32,0,TRUE,NA,"0.1.4"
"14935","646",2023-02-03 13:30:00,974,1006,32,0,TRUE,NA,"0.1.4"
"14936","646",2023-02-03 13:45:00,973,1006,33,0,TRUE,NA,"0.1.4"
"14937","646",2023-02-03 14:00:00,974,1006,32,0,TRUE,NA,"0.1.4"
"14938","646",2023-02-03 14:15:00,974,1006,32,0,TRUE,NA,"0.1.4"
"14939","646",2023-02-03 14:30:00,974,1006,32,0,TRUE,NA,"0.1.4"
"14940","646",2023-02-03 14:45:00,974,1006,32,0,TRUE,NA,"0.1.4"
"14941","646",2023-02-03 15:00:00,973,1006,33,0,TRUE,NA,"0.1.4"
"14942","646",2023-02-03 15:15:00,974,1006,32,0,TRUE,NA,"0.1.4"
"14943","646",2023-02-03 15:30:00,974,1006,32,0,TRUE,NA,"0.1.4"
"14944","646",2023-02-03 15:45:00,973,1006,33,0,TRUE,NA,"0.1.4"
"14945","646",2023-02-03 16:00:00,974,1006,32,0,TRUE,NA,"0.1.4"
"14946","646",2023-02-03 16:15:00,974,1006,32,0,TRUE,NA,"0.1.4"
"14947","646",2023-02-03 16:30:00,973,1006,33,0,TRUE,NA,"0.1.4"
"14948","646",2023-02-03 16:45:00,974,1006,32,0,TRUE,NA,"0.1.4"
"14949","646",2023-02-03 17:00:00,974,1006,32,0,TRUE,NA,"0.1.4"
"14950","646",2023-02-03 17:15:00,974,1006,32,0,TRUE,NA,"0.1.4"
"14951","646",2023-02-03 17:30:00,974,1006,32,0,TRUE,NA,"0.1.4"
"14952","646",2023-02-03 17:45:00,974,1006,32,0,TRUE,NA,"0.1.4"
"14953","646",2023-02-03 18:00:00,974,1006,32,0,TRUE,NA,"0.1.4"
"14954","646",2023-02-03 18:15:00,974,1006,32,0,TRUE,NA,"0.1.4"
"14955","646",2023-02-03 18:30:00,974,1006,32,0,TRUE,NA,"0.1.4"
"14956","646",2023-02-03 18:45:00,974,1006,32,0,TRUE,NA,"0.1.4"
"14957","646",2023-02-03 19:00:00,974,1006,32,0,TRUE,NA,"0.1.4"
"14958","646",2023-02-03 19:15:00,974,1006,32,0,TRUE,NA,"0.1.4"
"14959","646",2023-02-03 19:30:00,974,1006,32,0,TRUE,NA,"0.1.4"
"14960","646",2023-02-03 19:45:00,974,1006,32,0,TRUE,NA,"0.1.4"
"14961","646",2023-02-03 20:00:00,974,1006,32,0,TRUE,NA,"0.1.4"
"14962","646",2023-02-03 20:15:00,974,1006,32,0,TRUE,NA,"0.1.4"
"14963","646",2023-02-03 20:30:00,974,1006,32,0,TRUE,NA,"0.1.4"
"14964","646",2023-02-03 20:45:00,974,1006,32,0,TRUE,NA,"0.1.4"
"14965","646",2023-02-03 21:00:00,974,1006,32,0,TRUE,NA,"0.1.4"
"14966","646",2023-02-03 21:15:00,974,1006,32,0,TRUE,NA,"0.1.4"
"14967","646",2023-02-03 21:30:00,974,1006,32,0,TRUE,NA,"0.1.4"
"14968","646",2023-02-03 21:45:00,974,1006,32,0,TRUE,NA,"0.1.4"
"14969","646",2023-02-03 22:00:00,974,1006,32,0,TRUE,NA,"0.1.4"
"14970","646",2023-02-03 22:15:00,974,1006,32,0,TRUE,NA,"0.1.4"
"14971","646",2023-02-03 22:30:00,974,1006,32,0,TRUE,NA,"0.1.4"
"14972","646",2023-02-03 22:45:00,974,1006,32,0,TRUE,NA,"0.1.4"
"14973","646",2023-02-03 23:00:00,974,1006,32,0,TRUE,NA,"0.1.4"
"14974","646",2023-02-03 23:15:00,974,1006,32,0,TRUE,NA,"0.1.4"
"14975","646",2023-02-03 23:30:00,974,1006,32,0,TRUE,NA,"0.1.4"
"14976","646",2023-02-03 23:45:00,974,1006,32,0,TRUE,NA,"0.1.4"
"14977","646",2023-02-04,974,1006,32,0,TRUE,NA,"0.1.4"
"14978","646",2023-02-04 00:15:00,974,1006,32,0,TRUE,NA,"0.1.4"
"14979","646",2023-02-04 00:30:00,974,1006,32,0,TRUE,NA,"0.1.4"
"14980","646",2023-02-04 00:45:00,974,1006,32,0,TRUE,NA,"0.1.4"
"14981","646",2023-02-04 01:00:00,974,1006,32,0,TRUE,NA,"0.1.4"
"14982","646",2023-02-04 01:15:00,974,1006,32,0,TRUE,NA,"0.1.4"
"14983","646",2023-02-04 01:30:00,974,1006,32,0,TRUE,NA,"0.1.4"
"14984","646",2023-02-04 01:45:00,974,1006,32,0,TRUE,NA,"0.1.4"
"14985","646",2023-02-04 02:00:00,974,1006,32,0,TRUE,NA,"0.1.4"
"14986","646",2023-02-04 02:15:00,974,1006,32,0,TRUE,NA,"0.1.4"
"14987","646",2023-02-04 02:30:00,974,1006,32,0,TRUE,NA,"0.1.4"
"14988","646",2023-02-04 02:45:00,974,1006,32,0,TRUE,NA,"0.1.4"
"14989","646",2023-02-04 03:00:00,974,1006,32,0,TRUE,NA,"0.1.4"
"14990","646",2023-02-04 03:15:00,974,1006,32,0,TRUE,NA,"0.1.4"
"14991","646",2023-02-04 03:30:00,974,1006,32,0,TRUE,NA,"0.1.4"
"14992","646",2023-02-04 03:45:00,974,1006,32,0,TRUE,NA,"0.1.4"
"14993","646",2023-02-04 04:00:00,974,1006,32,0,TRUE,NA,"0.1.4"
"14994","646",2023-02-04 04:15:00,974,1006,32,0,TRUE,NA,"0.1.4"
"14995","646",2023-02-04 04:30:00,974,1006,32,0,TRUE,NA,"0.1.4"
"14996","646",2023-02-04 04:45:00,974,1006,32,0,TRUE,NA,"0.1.4"
"14997","646",2023-02-04 05:00:00,974,1006,32,0,TRUE,NA,"0.1.4"
"14998","646",2023-02-04 05:15:00,974,1006,32,0,TRUE,NA,"0.1.4"
"14999","646",2023-02-04 05:30:00,974,1006,32,0,TRUE,NA,"0.1.4"
"15000","646",2023-02-04 05:45:00,974,1006,32,0,TRUE,NA,"0.1.4"
"15001","646",2023-02-04 06:00:00,974,1006,32,0,TRUE,NA,"0.1.4"
"15002","646",2023-02-04 06:15:00,974,1006,32,0,TRUE,NA,"0.1.4"
"15003","646",2023-02-04 06:30:00,974,1006,32,0,TRUE,NA,"0.1.4"
"15004","646",2023-02-04 06:45:00,974,1006,32,0,TRUE,NA,"0.1.4"
"15005","646",2023-02-04 07:00:00,974,1006,32,0,TRUE,NA,"0.1.4"
"15006","646",2023-02-04 07:15:00,974,1006,32,0,TRUE,NA,"0.1.4"
"15007","646",2023-02-04 07:30:00,974,1006,32,0,TRUE,NA,"0.1.4"
"15008","646",2023-02-04 07:45:00,974,1006,32,0,TRUE,NA,"0.1.4"
"15009","646",2023-02-04 08:00:00,974,1006,32,0,TRUE,NA,"0.1.4"
"15010","646",2023-02-04 08:15:00,974,1006,32,0,TRUE,NA,"0.1.4"
"15011","646",2023-02-04 08:30:00,974,1006,32,0,TRUE,NA,"0.1.4"
"15012","646",2023-02-04 08:45:00,974,1006,32,0,TRUE,NA,"0.1.4"
"15013","646",2023-02-04 09:00:00,974,1006,32,0,TRUE,NA,"0.1.4"
"15014","646",2023-02-04 09:15:00,974,1006,32,0,TRUE,NA,"0.1.4"
"15015","646",2023-02-04 09:30:00,974,1006,32,0,TRUE,NA,"0.1.4"
"15016","646",2023-02-04 09:45:00,974,1006,32,0,TRUE,NA,"0.1.4"
"15017","646",2023-02-04 10:00:00,974,1006,32,0,TRUE,NA,"0.1.4"
"15018","646",2023-02-04 10:15:00,974,1006,32,0,TRUE,NA,"0.1.4"
"15019","646",2023-02-04 10:30:00,974,1006,32,0,TRUE,NA,"0.1.4"
"15020","646",2023-02-04 10:45:00,974,1006,32,0,TRUE,NA,"0.1.4"
"15021","646",2023-02-04 11:00:00,974,1006,32,0,TRUE,NA,"0.1.4"
"15022","646",2023-02-04 11:15:00,974,1006,32,0,TRUE,NA,"0.1.4"
"15023","646",2023-02-04 11:30:00,974,1006,32,0,TRUE,NA,"0.1.4"
"15024","646",2023-02-04 11:45:00,973,1006,33,0,TRUE,NA,"0.1.4"
"15025","646",2023-02-04 12:00:00,974,1006,32,0,TRUE,NA,"0.1.4"
"15026","646",2023-02-04 12:15:00,974,1006,32,0,TRUE,NA,"0.1.4"
"15027","646",2023-02-04 12:30:00,974,1006,32,0,TRUE,NA,"0.1.4"
"15028","646",2023-02-04 12:45:00,973,1006,33,0,TRUE,NA,"0.1.4"
"15029","646",2023-02-04 13:00:00,974,1006,32,0,TRUE,NA,"0.1.4"
"15030","646",2023-02-04 13:15:00,974,1006,32,0,TRUE,NA,"0.1.4"
"15031","646",2023-02-04 13:30:00,974,1006,32,0,TRUE,NA,"0.1.4"
"15032","646",2023-02-04 13:45:00,974,1006,32,0,TRUE,NA,"0.1.4"
"15033","646",2023-02-04 14:00:00,974,1006,32,0,TRUE,NA,"0.1.4"
"15034","646",2023-02-04 14:15:00,974,1006,32,0,TRUE,NA,"0.1.4"
"15035","646",2023-02-04 14:30:00,974,1006,32,0,TRUE,NA,"0.1.4"
"15036","646",2023-02-04 14:45:00,973,1006,33,0,TRUE,NA,"0.1.4"
"15037","646",2023-02-04 15:00:00,974,1006,32,0,TRUE,NA,"0.1.4"
"15038","646",2023-02-04 15:15:00,974,1006,32,0,TRUE,NA,"0.1.4"
"15039","646",2023-02-04 15:30:00,974,1006,32,0,TRUE,NA,"0.1.4"
"15040","646",2023-02-04 15:45:00,974,1006,32,0,TRUE,NA,"0.1.4"
"15041","646",2023-02-04 16:00:00,973,1006,33,0,TRUE,NA,"0.1.4"
"15042","646",2023-02-04 16:15:00,974,1006,32,0,TRUE,NA,"0.1.4"
"15043","646",2023-02-04 16:30:00,974,1006,32,0,TRUE,NA,"0.1.4"
"15044","646",2023-02-04 16:45:00,974,1006,32,0,TRUE,NA,"0.1.4"
"15045","646",2023-02-04 17:00:00,974,1006,32,0,TRUE,NA,"0.1.4"
"15046","646",2023-02-04 17:15:00,974,1006,32,0,TRUE,NA,"0.1.4"
"15047","646",2023-02-04 17:30:00,974,1006,32,0,TRUE,NA,"0.1.4"
"15048","646",2023-02-04 17:45:00,974,1006,32,0,TRUE,NA,"0.1.4"
"15049","646",2023-02-04 18:00:00,974,1006,32,0,TRUE,NA,"0.1.4"
"15050","646",2023-02-04 18:15:00,974,1006,32,0,TRUE,NA,"0.1.4"
"15051","646",2023-02-04 18:30:00,974,1006,32,0,TRUE,NA,"0.1.4"
"15052","646",2023-02-04 18:45:00,973,1006,33,0,TRUE,NA,"0.1.4"
"15053","646",2023-02-04 19:00:00,973,1006,33,0,TRUE,NA,"0.1.4"
"15054","646",2023-02-04 19:15:00,973,1006,33,0,TRUE,NA,"0.1.4"
"15055","646",2023-02-04 19:30:00,973,1006,33,0,TRUE,NA,"0.1.4"
"15056","646",2023-02-04 19:45:00,973,1006,33,0,TRUE,NA,"0.1.4"
"15057","646",2023-02-04 20:00:00,973,1006,33,0,TRUE,NA,"0.1.4"
"15058","646",2023-02-04 20:15:00,973,1006,33,0,TRUE,NA,"0.1.4"
"15059","646",2023-02-04 20:30:00,973,1006,33,0,TRUE,NA,"0.1.4"
"15060","646",2023-02-04 20:45:00,974,1006,32,0,TRUE,NA,"0.1.4"
"15061","646",2023-02-04 21:00:00,974,1006,32,0,TRUE,NA,"0.1.4"
"15062","646",2023-02-04 21:15:00,974,1006,32,0,TRUE,NA,"0.1.4"
"15063","646",2023-02-04 21:30:00,974,1006,32,0,TRUE,NA,"0.1.4"
"15064","646",2023-02-04 21:45:00,974,1006,32,0,TRUE,NA,"0.1.4"
"15065","646",2023-02-04 22:00:00,974,1006,32,0,TRUE,NA,"0.1.4"
"15066","646",2023-02-04 22:15:00,974,1006,32,0,TRUE,NA,"0.1.4"
"15067","646",2023-02-04 22:30:00,974,1006,32,0,TRUE,NA,"0.1.4"
"15068","646",2023-02-04 22:45:00,974,1006,32,0,TRUE,NA,"0.1.4"
"15069","646",2023-02-04 23:00:00,974,1006,32,0,TRUE,NA,"0.1.4"
"15070","646",2023-02-04 23:15:00,974,1006,32,0,TRUE,NA,"0.1.4"
"15071","646",2023-02-04 23:30:00,973,1006,33,0,TRUE,NA,"0.1.4"
"15072","646",2023-02-04 23:45:00,973,1006,33,0,TRUE,NA,"0.1.4"
"15073","646",2023-02-05,973,1006,33,0,TRUE,NA,"0.1.4"
"15074","646",2023-02-05 00:15:00,973,1006,33,0,TRUE,NA,"0.1.4"
"15075","646",2023-02-05 00:30:00,973,1006,33,0,TRUE,NA,"0.1.4"
"15076","646",2023-02-05 00:45:00,973,1006,33,0,TRUE,NA,"0.1.4"
"15077","646",2023-02-05 01:00:00,973,1006,33,0,TRUE,NA,"0.1.4"
"15078","646",2023-02-05 01:15:00,973,1006,33,0,TRUE,NA,"0.1.4"
"15079","646",2023-02-05 01:30:00,973,1006,33,0,TRUE,NA,"0.1.4"
"15080","646",2023-02-05 01:45:00,974,1006,32,0,TRUE,NA,"0.1.4"
"15081","646",2023-02-05 02:00:00,974,1006,32,0,TRUE,NA,"0.1.4"
"15082","646",2023-02-05 02:15:00,974,1006,32,0,TRUE,NA,"0.1.4"
"15083","646",2023-02-05 02:30:00,974,1006,32,0,TRUE,NA,"0.1.4"
"15084","646",2023-02-05 02:45:00,974,1006,32,0,TRUE,NA,"0.1.4"
"15085","646",2023-02-05 03:00:00,974,1006,32,0,TRUE,NA,"0.1.4"
"15086","646",2023-02-05 03:15:00,974,1006,32,0,TRUE,NA,"0.1.4"
"15087","646",2023-02-05 03:30:00,974,1006,32,0,TRUE,NA,"0.1.4"
"15088","646",2023-02-05 03:45:00,974,1006,32,0,TRUE,NA,"0.1.4"
"15089","646",2023-02-05 04:00:00,974,1006,32,0,TRUE,NA,"0.1.4"
"15090","646",2023-02-05 04:15:00,974,1006,32,0,TRUE,NA,"0.1.4"
"15091","646",2023-02-05 04:30:00,974,1006,32,0,TRUE,NA,"0.1.4"
"15092","646",2023-02-05 04:45:00,974,1006,32,0,TRUE,NA,"0.1.4"
"15093","646",2023-02-05 05:00:00,974,1006,32,0,TRUE,NA,"0.1.4"
"15094","646",2023-02-05 05:15:00,974,1006,32,0,TRUE,NA,"0.1.4"
"15095","646",2023-02-05 05:30:00,974,1006,32,0,TRUE,NA,"0.1.4"
"15096","646",2023-02-05 05:45:00,974,1006,32,0,TRUE,NA,"0.1.4"
"15097","646",2023-02-05 06:00:00,974,1006,32,0,TRUE,NA,"0.1.4"
"15098","646",2023-02-05 06:15:00,974,1006,32,0,TRUE,NA,"0.1.4"
"15099","646",2023-02-05 06:30:00,974,1006,32,0,TRUE,NA,"0.1.4"
"15100","646",2023-02-05 06:45:00,974,1006,32,0,TRUE,NA,"0.1.4"
"15101","646",2023-02-05 07:00:00,974,1006,32,0,TRUE,NA,"0.1.4"
"15102","646",2023-02-05 07:15:00,974,1006,32,0,TRUE,NA,"0.1.4"
"15103","646",2023-02-05 07:30:00,974,1006,32,0,TRUE,NA,"0.1.4"
"15104","646",2023-02-05 07:45:00,974,1006,32,0,TRUE,NA,"0.1.4"
"15105","646",2023-02-05 08:00:00,974,1006,32,0,TRUE,NA,"0.1.4"
"15106","646",2023-02-05 08:15:00,974,1006,32,0,TRUE,NA,"0.1.4"
"15107","646",2023-02-05 08:30:00,974,1006,32,0,TRUE,NA,"0.1.4"
"15108","646",2023-02-05 08:45:00,974,1006,32,0,TRUE,NA,"0.1.4"
"15109","646",2023-02-05 09:00:00,974,1006,32,0,TRUE,NA,"0.1.4"
"15110","646",2023-02-05 09:15:00,974,1006,32,0,TRUE,NA,"0.1.4"
"15111","646",2023-02-05 09:30:00,974,1006,32,0,TRUE,NA,"0.1.4"
"15112","646",2023-02-05 09:45:00,974,1006,32,0,TRUE,NA,"0.1.4"
"15113","646",2023-02-05 10:00:00,974,1006,32,0,TRUE,NA,"0.1.4"
"15114","646",2023-02-05 10:15:00,974,1006,32,0,TRUE,NA,"0.1.4"
"15115","646",2023-02-05 10:30:00,974,1006,32,0,TRUE,NA,"0.1.4"
"15116","646",2023-02-05 10:45:00,974,1006,32,0,TRUE,NA,"0.1.4"
"15117","646",2023-02-05 11:00:00,973,1006,33,0,TRUE,NA,"0.1.4"
"15118","646",2023-02-05 11:15:00,974,1006,32,0,TRUE,NA,"0.1.4"
"15119","646",2023-02-05 11:30:00,974,1006,32,0,TRUE,NA,"0.1.4"
"15120","646",2023-02-05 11:45:00,974,1006,32,0,TRUE,NA,"0.1.4"
"15121","646",2023-02-05 12:00:00,974,1006,32,0,TRUE,NA,"0.1.4"
"15122","646",2023-02-05 12:15:00,974,1006,32,0,TRUE,NA,"0.1.4"
"15123","646",2023-02-05 12:30:00,976,1006,30,0,FALSE,NA,"0.1.4"
"15124","646",2023-02-05 12:45:00,976,1006,30,0,FALSE,NA,"0.1.4"
"15125","646",2023-02-05 13:00:00,975,1006,31,0,TRUE,NA,"0.1.4"
"15126","646",2023-02-05 13:15:00,975,1006,31,0,TRUE,NA,"0.1.4"
"15127","646",2023-02-05 13:30:00,975,1006,31,0,TRUE,NA,"0.1.4"
"15128","646",2023-02-05 13:45:00,975,1006,31,0,TRUE,NA,"0.1.4"
"15129","646",2023-02-05 14:00:00,974,1006,32,0,TRUE,NA,"0.1.4"
"15130","646",2023-02-05 14:15:00,974,1006,32,0,TRUE,NA,"0.1.4"
"15131","646",2023-02-05 14:30:00,975,1006,31,0,TRUE,NA,"0.1.4"
"15132","646",2023-02-05 14:45:00,974,1006,32,0,TRUE,NA,"0.1.4"
"15133","646",2023-02-05 15:00:00,974,1006,32,0,TRUE,NA,"0.1.4"
"15134","646",2023-02-05 15:15:00,974,1006,32,0,TRUE,NA,"0.1.4"
"15135","646",2023-02-05 15:30:00,975,1006,31,0,TRUE,NA,"0.1.4"
"15136","646",2023-02-05 15:45:00,975,1006,31,0,TRUE,NA,"0.1.4"
"15137","646",2023-02-05 16:00:00,975,1006,31,0,TRUE,NA,"0.1.4"
"15138","646",2023-02-05 16:15:00,974,1006,32,0,TRUE,NA,"0.1.4"
"15139","646",2023-02-05 16:30:00,974,1006,32,0,TRUE,NA,"0.1.4"
"15140","646",2023-02-05 16:45:00,974,1006,32,0,TRUE,NA,"0.1.4"
"15141","646",2023-02-05 17:00:00,975,1006,31,0,TRUE,NA,"0.1.4"
"15142","646",2023-02-05 17:15:00,975,1006,31,0,TRUE,NA,"0.1.4"
"15143","646",2023-02-05 17:30:00,975,1006,31,0,TRUE,NA,"0.1.4"
"15144","646",2023-02-05 17:45:00,975,1006,31,0,TRUE,NA,"0.1.4"
"15145","646",2023-02-05 18:00:00,975,1006,31,0,TRUE,NA,"0.1.4"
"15146","646",2023-02-05 18:15:00,975,1006,31,0,TRUE,NA,"0.1.4"
"15147","646",2023-02-05 18:30:00,975,1006,31,0,TRUE,NA,"0.1.4"
"15148","646",2023-02-05 18:45:00,975,1006,31,0,TRUE,NA,"0.1.4"
"15149","646",2023-02-05 19:00:00,975,1006,31,0,TRUE,NA,"0.1.4"
"15150","646",2023-02-05 19:15:00,975,1006,31,0,TRUE,NA,"0.1.4"
"15151","646",2023-02-05 19:30:00,975,1006,31,0,TRUE,NA,"0.1.4"
"15152","646",2023-02-05 19:45:00,974,1006,32,0,TRUE,NA,"0.1.4"
"15153","646",2023-02-05 20:00:00,974,1006,32,0,TRUE,NA,"0.1.4"
"15154","646",2023-02-05 20:15:00,974,1006,32,0,TRUE,NA,"0.1.4"
"15155","646",2023-02-05 20:30:00,974,1006,32,0,TRUE,NA,"0.1.4"
"15156","646",2023-02-05 20:45:00,974,1006,32,0,TRUE,NA,"0.1.4"
"15157","646",2023-02-05 21:00:00,975,1006,31,0,TRUE,NA,"0.1.4"
"15158","646",2023-02-05 21:15:00,975,1006,31,0,TRUE,NA,"0.1.4"
"15159","646",2023-02-05 21:30:00,975,1006,31,0,TRUE,NA,"0.1.4"
"15160","646",2023-02-05 21:45:00,974,1006,32,0,TRUE,NA,"0.1.4"
"15161","646",2023-02-05 22:00:00,975,1006,31,0,TRUE,NA,"0.1.4"
"15162","646",2023-02-05 22:15:00,975,1006,31,0,TRUE,NA,"0.1.4"
"15163","646",2023-02-05 22:30:00,974,1006,32,0,TRUE,NA,"0.1.4"
"15164","646",2023-02-05 22:45:00,974,1006,32,0,TRUE,NA,"0.1.4"
"15165","646",2023-02-05 23:00:00,975,1006,31,0,TRUE,NA,"0.1.4"
"15166","646",2023-02-05 23:15:00,975,1006,31,0,TRUE,NA,"0.1.4"
"15167","646",2023-02-05 23:30:00,974,1006,32,0,TRUE,NA,"0.1.4"
"15168","646",2023-02-05 23:45:00,974,1006,32,0,TRUE,NA,"0.1.4"
"15169","646",2023-02-06,974,1006,32,0,TRUE,NA,"0.1.4"
"15170","646",2023-02-06 00:15:00,974,1006,32,0,TRUE,NA,"0.1.4"
"15171","646",2023-02-06 00:30:00,974,1006,32,0,TRUE,NA,"0.1.4"
"15172","646",2023-02-06 00:45:00,974,1006,32,0,TRUE,NA,"0.1.4"
"15173","646",2023-02-06 01:00:00,975,1006,31,0,TRUE,NA,"0.1.4"
"15174","646",2023-02-06 01:15:00,975,1006,31,0,TRUE,NA,"0.1.4"
"15175","646",2023-02-06 01:30:00,975,1006,31,0,TRUE,NA,"0.1.4"
"15176","646",2023-02-06 01:45:00,974,1006,32,0,TRUE,NA,"0.1.4"
"15177","646",2023-02-06 02:00:00,974,1006,32,0,TRUE,NA,"0.1.4"
"15178","646",2023-02-06 02:15:00,974,1006,32,0,TRUE,NA,"0.1.4"
"15179","646",2023-02-06 02:30:00,974,1006,32,0,TRUE,NA,"0.1.4"
"15180","646",2023-02-06 02:45:00,974,1006,32,0,TRUE,NA,"0.1.4"
"15181","646",2023-02-06 03:00:00,974,1006,32,0,TRUE,NA,"0.1.4"
"15182","646",2023-02-06 03:15:00,974,1006,32,0,TRUE,NA,"0.1.4"
"15183","646",2023-02-06 03:30:00,974,1006,32,0,TRUE,NA,"0.1.4"
"15184","646",2023-02-06 03:45:00,974,1006,32,0,TRUE,NA,"0.1.4"
"15185","646",2023-02-06 04:00:00,974,1006,32,0,TRUE,NA,"0.1.4"
"15186","646",2023-02-06 04:15:00,974,1006,32,0,TRUE,NA,"0.1.4"
"15187","646",2023-02-06 04:30:00,974,1006,32,0,TRUE,NA,"0.1.4"
"15188","646",2023-02-06 04:45:00,973,1006,33,0,TRUE,NA,"0.1.4"
"15189","646",2023-02-06 05:00:00,973,1006,33,0,TRUE,NA,"0.1.4"
"15190","646",2023-02-06 05:15:00,973,1006,33,0,TRUE,NA,"0.1.4"
"15191","646",2023-02-06 05:30:00,973,1006,33,0,TRUE,NA,"0.1.4"
"15192","646",2023-02-06 05:45:00,974,1006,32,0,TRUE,NA,"0.1.4"
"15193","646",2023-02-06 06:00:00,974,1006,32,0,TRUE,NA,"0.1.4"
"15194","646",2023-02-06 06:15:00,974,1006,32,0,TRUE,NA,"0.1.4"
"15195","646",2023-02-06 06:30:00,974,1006,32,0,TRUE,NA,"0.1.4"
"15196","646",2023-02-06 06:45:00,974,1006,32,0,TRUE,NA,"0.1.4"
"15197","646",2023-02-06 07:00:00,975,1006,31,0,TRUE,NA,"0.1.4"
"15198","646",2023-02-06 07:15:00,975,1006,31,0,TRUE,NA,"0.1.4"
"15199","646",2023-02-06 07:30:00,975,1006,31,0,TRUE,NA,"0.1.4"
"15200","646",2023-02-06 07:45:00,975,1006,31,0,TRUE,NA,"0.1.4"
"15201","646",2023-02-06 08:00:00,975,1006,31,0,TRUE,NA,"0.1.4"
"15202","646",2023-02-06 08:15:00,974,1006,32,0,TRUE,NA,"0.1.4"
"15203","646",2023-02-06 08:30:00,974,1006,32,0,TRUE,NA,"0.1.4"
"15204","646",2023-02-06 08:45:00,975,1006,31,0,TRUE,NA,"0.1.4"
"15205","646",2023-02-06 09:00:00,974,1006,32,0,TRUE,NA,"0.1.4"
"15206","646",2023-02-06 09:15:00,975,1006,31,0,TRUE,NA,"0.1.4"
"15207","646",2023-02-06 09:30:00,975,1006,31,0,TRUE,NA,"0.1.4"
"15208","646",2023-02-06 09:45:00,975,1006,31,0,TRUE,NA,"0.1.4"
"15209","646",2023-02-06 10:00:00,975,1006,31,0,TRUE,NA,"0.1.4"
"15210","646",2023-02-06 10:15:00,975,1006,31,0,TRUE,NA,"0.1.4"
"15211","646",2023-02-06 10:30:00,975,1006,31,0,TRUE,NA,"0.1.4"
"15212","646",2023-02-06 10:45:00,975,1006,31,0,TRUE,NA,"0.1.4"
"15213","646",2023-02-06 11:00:00,975,1006,31,0,TRUE,NA,"0.1.4"
"15214","646",2023-02-06 11:15:00,975,1006,31,0,TRUE,NA,"0.1.4"
"15215","646",2023-02-06 11:30:00,975,1006,31,0,TRUE,NA,"0.1.4"
"15216","646",2023-02-06 11:45:00,974,1006,32,0,TRUE,NA,"0.1.4"
"15217","646",2023-02-06 12:00:00,974,1006,32,0,TRUE,NA,"0.1.4"
"15218","646",2023-02-06 12:15:00,974,1006,32,0,TRUE,NA,"0.1.4"
"15219","646",2023-02-06 12:30:00,974,1006,32,0,TRUE,NA,"0.1.4"
"15220","646",2023-02-06 12:45:00,974,1006,32,0,TRUE,NA,"0.1.4"
"15221","646",2023-02-06 13:00:00,974,1006,32,0,TRUE,NA,"0.1.4"
"15222","646",2023-02-06 13:15:00,974,1006,32,0,TRUE,NA,"0.1.4"
"15223","646",2023-02-06 13:30:00,974,1006,32,0,TRUE,NA,"0.1.4"
"15224","646",2023-02-06 13:45:00,974,1006,32,0,TRUE,NA,"0.1.4"
"15225","646",2023-02-06 14:00:00,974,1006,32,0,TRUE,NA,"0.1.4"
"15226","646",2023-02-06 14:15:00,974,1006,32,0,TRUE,NA,"0.1.4"
"15227","646",2023-02-06 14:30:00,974,1006,32,0,TRUE,NA,"0.1.4"
"15228","646",2023-02-06 14:45:00,974,1006,32,0,TRUE,NA,"0.1.4"
"15229","646",2023-02-06 15:00:00,974,1006,32,0,TRUE,NA,"0.1.4"
"15230","646",2023-02-06 15:15:00,975,1006,31,0,TRUE,NA,"0.1.4"
"15231","646",2023-02-06 15:30:00,974,1006,32,0,TRUE,NA,"0.1.4"
"15232","646",2023-02-06 15:45:00,974,1006,32,0,TRUE,NA,"0.1.4"
"15233","646",2023-02-06 16:00:00,974,1006,32,0,TRUE,NA,"0.1.4"
"15234","646",2023-02-06 16:15:00,974,1006,32,0,TRUE,NA,"0.1.4"
"15235","646",2023-02-06 16:30:00,974,1006,32,0,TRUE,NA,"0.1.4"
"15236","646",2023-02-06 16:45:00,974,1006,32,0,TRUE,NA,"0.1.4"
"15237","646",2023-02-06 17:00:00,974,1006,32,0,TRUE,NA,"0.1.4"
"15238","646",2023-02-06 17:15:00,974,1006,32,0,TRUE,NA,"0.1.4"
"15239","646",2023-02-06 17:30:00,974,1006,32,0,TRUE,NA,"0.1.4"
"15240","646",2023-02-06 17:45:00,974,1006,32,0,TRUE,NA,"0.1.4"
"15241","646",2023-02-06 18:00:00,974,1006,32,0,TRUE,NA,"0.1.4"
"15242","646",2023-02-06 18:15:00,974,1006,32,0,TRUE,NA,"0.1.4"
"15243","646",2023-02-06 18:30:00,973,1006,33,0,TRUE,NA,"0.1.4"
"15244","646",2023-02-06 18:45:00,974,1006,32,0,TRUE,NA,"0.1.4"
"15245","646",2023-02-06 19:00:00,974,1006,32,0,TRUE,NA,"0.1.4"
"15246","646",2023-02-06 19:15:00,975,1006,31,0,TRUE,NA,"0.1.4"
"15247","646",2023-02-06 19:30:00,975,1006,31,0,TRUE,NA,"0.1.4"
"15248","646",2023-02-06 19:45:00,975,1006,31,0,TRUE,NA,"0.1.4"
"15249","646",2023-02-06 20:00:00,975,1006,31,0,TRUE,NA,"0.1.4"
"15250","646",2023-02-06 20:15:00,975,1006,31,0,TRUE,NA,"0.1.4"
"15251","646",2023-02-06 20:30:00,974,1006,32,0,TRUE,NA,"0.1.4"
"15252","646",2023-02-06 20:45:00,974,1006,32,0,TRUE,NA,"0.1.4"
"15253","646",2023-02-06 21:00:00,974,1006,32,0,TRUE,NA,"0.1.4"
"15254","646",2023-02-06 21:15:00,975,1006,31,0,TRUE,NA,"0.1.4"
"15255","646",2023-02-06 21:30:00,975,1006,31,0,TRUE,NA,"0.1.4"
"15256","646",2023-02-06 21:45:00,975,1006,31,0,TRUE,NA,"0.1.4"
"15257","646",2023-02-06 22:00:00,975,1006,31,0,TRUE,NA,"0.1.4"
"15258","646",2023-02-06 22:15:00,975,1006,31,0,TRUE,NA,"0.1.4"
"15259","646",2023-02-06 22:30:00,976,1006,30,0,TRUE,NA,"0.1.4"
"15260","646",2023-02-06 22:45:00,974,1006,32,0,TRUE,NA,"0.1.4"
"15261","646",2023-02-06 23:00:00,975,1006,31,0,TRUE,NA,"0.1.4"
"15262","646",2023-02-06 23:15:00,975,1006,31,0,TRUE,NA,"0.1.4"
"15263","646",2023-02-06 23:30:00,975,1006,31,0,TRUE,NA,"0.1.4"
"15264","646",2023-02-06 23:45:00,975,1006,31,0,TRUE,NA,"0.1.4"
"15265","646",2023-02-07,976,1006,30,0,TRUE,NA,"0.1.4"
"15266","646",2023-02-07 00:15:00,975,1006,31,0,TRUE,NA,"0.1.4"
"15267","646",2023-02-07 00:30:00,975,1006,31,0,TRUE,NA,"0.1.4"
"15268","646",2023-02-07 00:45:00,975,1006,31,0,TRUE,NA,"0.1.4"
"15269","646",2023-02-07 01:00:00,975,1006,31,0,TRUE,NA,"0.1.4"
"15270","646",2023-02-07 01:15:00,975,1006,31,0,TRUE,NA,"0.1.4"
"15271","646",2023-02-07 01:30:00,974,1006,32,0,TRUE,NA,"0.1.4"
"15272","646",2023-02-07 01:45:00,975,1006,31,0,TRUE,NA,"0.1.4"
"15273","646",2023-02-07 02:00:00,975,1006,31,0,TRUE,NA,"0.1.4"
"15274","646",2023-02-07 02:15:00,975,1006,31,0,TRUE,NA,"0.1.4"
"15275","646",2023-02-07 02:30:00,975,1006,31,0,TRUE,NA,"0.1.4"
"15276","646",2023-02-07 02:45:00,975,1006,31,0,TRUE,NA,"0.1.4"
"15277","646",2023-02-07 03:00:00,975,1006,31,0,TRUE,NA,"0.1.4"
"15278","646",2023-02-07 03:15:00,975,1006,31,0,TRUE,NA,"0.1.4"
"15279","646",2023-02-07 03:30:00,975,1006,31,0,TRUE,NA,"0.1.4"
"15280","646",2023-02-07 03:45:00,975,1006,31,0,TRUE,NA,"0.1.4"
"15281","646",2023-02-07 04:00:00,975,1006,31,0,TRUE,NA,"0.1.4"
"15282","646",2023-02-07 04:15:00,975,1006,31,0,TRUE,NA,"0.1.4"
"15283","646",2023-02-07 04:30:00,975,1006,31,0,TRUE,NA,"0.1.4"
"15284","646",2023-02-07 04:45:00,974,1006,32,0,TRUE,NA,"0.1.4"
"15285","646",2023-02-07 05:00:00,974,1006,32,0,TRUE,NA,"0.1.4"
"15286","646",2023-02-07 05:15:00,974,1006,32,0,TRUE,NA,"0.1.4"
"15287","646",2023-02-07 05:30:00,975,1006,31,0,TRUE,NA,"0.1.4"
"15288","646",2023-02-07 05:45:00,975,1006,31,0,TRUE,NA,"0.1.4"
"15289","646",2023-02-07 06:00:00,975,1006,31,0,TRUE,NA,"0.1.4"
"15290","646",2023-02-07 06:15:00,975,1006,31,0,TRUE,NA,"0.1.4"
"15291","646",2023-02-07 06:30:00,975,1006,31,0,TRUE,NA,"0.1.4"
"15292","646",2023-02-07 06:45:00,975,1006,31,0,TRUE,NA,"0.1.4"
"15293","646",2023-02-07 07:00:00,975,1006,31,0,TRUE,NA,"0.1.4"
"15294","646",2023-02-07 07:15:00,975,1006,31,0,TRUE,NA,"0.1.4"
"15295","646",2023-02-07 07:30:00,975,1006,31,0,TRUE,NA,"0.1.4"
"15296","646",2023-02-07 07:45:00,975,1006,31,0,TRUE,NA,"0.1.4"
"15297","646",2023-02-07 08:00:00,975,1006,31,0,TRUE,NA,"0.1.4"
"15298","646",2023-02-07 08:15:00,975,1006,31,0,TRUE,NA,"0.1.4"
"15299","646",2023-02-07 08:30:00,975,1006,31,0,TRUE,NA,"0.1.4"
"15300","646",2023-02-07 08:45:00,975,1006,31,0,TRUE,NA,"0.1.4"
"15301","646",2023-02-07 09:00:00,975,1006,31,0,TRUE,NA,"0.1.4"
"15302","646",2023-02-07 09:15:00,975,1006,31,0,TRUE,NA,"0.1.4"
"15303","646",2023-02-07 09:30:00,975,1006,31,0,TRUE,NA,"0.1.4"
"15304","646",2023-02-07 09:45:00,975,1006,31,0,TRUE,NA,"0.1.4"
"15305","646",2023-02-07 10:00:00,975,1006,31,0,TRUE,NA,"0.1.4"
"15306","646",2023-02-07 10:15:00,975,1006,31,0,TRUE,NA,"0.1.4"
"15307","646",2023-02-07 10:30:00,975,1006,31,0,TRUE,NA,"0.1.4"
"15308","646",2023-02-07 10:45:00,975,1006,31,0,TRUE,NA,"0.1.4"
"15309","646",2023-02-07 11:00:00,975,1006,31,0,TRUE,NA,"0.1.4"
"15310","646",2023-02-07 11:15:00,975,1006,31,0,TRUE,NA,"0.1.4"
"15311","646",2023-02-07 11:30:00,975,1006,31,0,TRUE,NA,"0.1.4"
"15312","646",2023-02-07 11:45:00,975,1006,31,0,TRUE,NA,"0.1.4"
"15313","646",2023-02-07 12:00:00,975,1006,31,0,TRUE,NA,"0.1.4"
"15314","646",2023-02-07 12:15:00,975,1006,31,0,TRUE,NA,"0.1.4"
"15315","646",2023-02-07 12:30:00,975,1006,31,0,TRUE,NA,"0.1.4"
"15316","646",2023-02-07 12:45:00,975,1006,31,0,TRUE,NA,"0.1.4"
"15317","646",2023-02-07 13:00:00,975,1006,31,0,TRUE,NA,"0.1.4"
"15318","646",2023-02-07 13:15:00,975,1006,31,0,TRUE,NA,"0.1.4"
"15319","646",2023-02-07 13:30:00,975,1006,31,0,TRUE,NA,"0.1.4"
"15320","646",2023-02-07 13:45:00,975,1006,31,0,TRUE,NA,"0.1.4"
"15321","646",2023-02-07 14:00:00,975,1006,31,0,TRUE,NA,"0.1.4"
"15322","646",2023-02-07 14:15:00,975,1006,31,0,TRUE,NA,"0.1.4"
"15323","646",2023-02-07 14:30:00,975,1006,31,0,TRUE,NA,"0.1.4"
"15324","646",2023-02-07 14:45:00,975,1006,31,0,TRUE,NA,"0.1.4"
"15325","646",2023-02-07 15:00:00,975,1006,31,0,TRUE,NA,"0.1.4"
"15326","646",2023-02-07 15:15:00,975,1006,31,0,TRUE,NA,"0.1.4"
"15327","646",2023-02-07 15:30:00,975,1006,31,0,TRUE,NA,"0.1.4"
"15328","646",2023-02-07 15:45:00,975,1006,31,0,TRUE,NA,"0.1.4"
"15329","646",2023-02-07 16:00:00,975,1006,31,0,TRUE,NA,"0.1.4"
"15330","646",2023-02-07 16:15:00,975,1006,31,0,TRUE,NA,"0.1.4"
"15331","646",2023-02-07 16:30:00,975,1006,31,0,TRUE,NA,"0.1.4"
"15332","646",2023-02-07 16:45:00,975,1006,31,0,TRUE,NA,"0.1.4"
"15333","646",2023-02-07 17:00:00,975,1006,31,0,TRUE,NA,"0.1.4"
"15334","646",2023-02-07 17:15:00,975,1006,31,0,TRUE,NA,"0.1.4"
"15335","646",2023-02-07 17:30:00,975,1006,31,0,TRUE,NA,"0.1.4"
"15336","646",2023-02-07 17:45:00,975,1006,31,0,TRUE,NA,"0.1.4"
"15337","646",2023-02-07 18:00:00,975,1006,31,0,TRUE,NA,"0.1.4"
"15338","646",2023-02-07 18:15:00,975,1006,31,0,TRUE,NA,"0.1.4"
"15339","646",2023-02-07 18:30:00,975,1006,31,0,TRUE,NA,"0.1.4"
"15340","646",2023-02-07 18:45:00,975,1006,31,0,TRUE,NA,"0.1.4"
"15341","646",2023-02-07 19:00:00,975,1006,31,0,TRUE,NA,"0.1.4"
"15342","646",2023-02-07 19:15:00,975,1006,31,0,TRUE,NA,"0.1.4"
"15343","646",2023-02-07 19:30:00,975,1006,31,0,TRUE,NA,"0.1.4"
"15344","646",2023-02-07 19:45:00,974,1006,32,0,TRUE,NA,"0.1.4"
"15345","646",2023-02-07 20:00:00,974,1006,32,0,TRUE,NA,"0.1.4"
"15346","646",2023-02-07 20:15:00,974,1006,32,0,TRUE,NA,"0.1.4"
"15347","646",2023-02-07 20:30:00,974,1006,32,0,TRUE,NA,"0.1.4"
"15348","646",2023-02-07 20:45:00,974,1006,32,0,TRUE,NA,"0.1.4"
"15349","646",2023-02-07 21:00:00,974,1006,32,0,TRUE,NA,"0.1.4"
"15350","646",2023-02-07 21:15:00,974,1006,32,0,TRUE,NA,"0.1.4"
"15351","646",2023-02-07 21:30:00,974,1006,32,0,TRUE,NA,"0.1.4"
"15352","646",2023-02-07 21:45:00,974,1006,32,0,TRUE,NA,"0.1.4"
"15353","646",2023-02-07 22:00:00,974,1006,32,0,TRUE,NA,"0.1.4"
"15354","646",2023-02-07 22:15:00,974,1006,32,0,TRUE,NA,"0.1.4"
"15355","646",2023-02-07 22:30:00,974,1006,32,0,TRUE,NA,"0.1.4"
"15356","646",2023-02-07 22:45:00,974,1006,32,0,TRUE,NA,"0.1.4"
"15357","646",2023-02-07 23:00:00,974,1006,32,0,TRUE,NA,"0.1.4"
"15358","646",2023-02-07 23:15:00,974,1006,32,0,TRUE,NA,"0.1.4"
"15359","646",2023-02-07 23:30:00,974,1006,32,0,TRUE,NA,"0.1.4"
"15360","646",2023-02-07 23:45:00,974,1006,32,0,TRUE,NA,"0.1.4"
"15361","646",2023-02-08,974,1006,32,0,TRUE,NA,"0.1.4"
"15362","646",2023-02-08 00:15:00,974,1006,32,0,TRUE,NA,"0.1.4"
"15363","646",2023-02-08 00:30:00,974,1006,32,0,TRUE,NA,"0.1.4"
"15364","646",2023-02-08 00:45:00,974,1006,32,0,TRUE,NA,"0.1.4"
"15365","646",2023-02-08 01:00:00,974,1006,32,0,TRUE,NA,"0.1.4"
"15366","646",2023-02-08 01:15:00,974,1006,32,0,TRUE,NA,"0.1.4"
"15367","646",2023-02-08 01:30:00,974,1006,32,0,TRUE,NA,"0.1.4"
"15368","646",2023-02-08 01:45:00,974,1006,32,0,TRUE,NA,"0.1.4"
"15369","646",2023-02-08 02:00:00,974,1006,32,0,TRUE,NA,"0.1.4"
"15370","646",2023-02-08 02:15:00,974,1006,32,0,TRUE,NA,"0.1.4"
"15371","646",2023-02-08 02:30:00,974,1006,32,0,TRUE,NA,"0.1.4"
"15372","646",2023-02-08 02:45:00,974,1006,32,0,TRUE,NA,"0.1.4"
"15373","646",2023-02-08 03:00:00,974,1006,32,0,TRUE,NA,"0.1.4"
"15374","646",2023-02-08 03:15:00,974,1006,32,0,TRUE,NA,"0.1.4"
"15375","646",2023-02-08 03:30:00,974,1006,32,0,TRUE,NA,"0.1.4"
"15376","646",2023-02-08 03:45:00,974,1006,32,0,TRUE,NA,"0.1.4"
"15377","646",2023-02-08 04:00:00,974,1006,32,0,TRUE,NA,"0.1.4"
"15378","646",2023-02-08 04:15:00,974,1006,32,0,TRUE,NA,"0.1.4"
"15379","646",2023-02-08 04:30:00,974,1006,32,0,TRUE,NA,"0.1.4"
"15380","646",2023-02-08 04:45:00,974,1006,32,0,TRUE,NA,"0.1.4"
"15381","646",2023-02-08 05:00:00,974,1006,32,0,TRUE,NA,"0.1.4"
"15382","646",2023-02-08 05:15:00,974,1006,32,0,TRUE,NA,"0.1.4"
"15383","646",2023-02-08 05:30:00,974,1006,32,0,TRUE,NA,"0.1.4"
"15384","646",2023-02-08 05:45:00,974,1006,32,0,TRUE,NA,"0.1.4"
"15385","646",2023-02-08 06:00:00,974,1006,32,0,TRUE,NA,"0.1.4"
"15386","646",2023-02-08 06:15:00,974,1006,32,0,TRUE,NA,"0.1.4"
"15387","646",2023-02-08 06:30:00,974,1006,32,0,TRUE,NA,"0.1.4"
"15388","646",2023-02-08 06:45:00,974,1006,32,0,TRUE,NA,"0.1.4"
"15389","646",2023-02-08 07:00:00,974,1006,32,0,TRUE,NA,"0.1.4"
"15390","646",2023-02-08 07:15:00,974,1006,32,0,TRUE,NA,"0.1.4"
"15391","646",2023-02-08 07:30:00,975,1006,31,0,TRUE,NA,"0.1.4"
"15392","646",2023-02-08 07:45:00,974,1006,32,0,TRUE,NA,"0.1.4"
"15393","646",2023-02-08 08:00:00,974,1006,32,0,TRUE,NA,"0.1.4"
"15394","646",2023-02-08 08:15:00,974,1006,32,0,TRUE,NA,"0.1.4"
"15395","646",2023-02-08 08:30:00,974,1006,32,0,TRUE,NA,"0.1.4"
"15396","646",2023-02-08 08:45:00,974,1006,32,0,TRUE,NA,"0.1.4"
"15397","646",2023-02-08 09:00:00,974,1006,32,0,TRUE,NA,"0.1.4"
"15398","646",2023-02-08 09:15:00,974,1006,32,0,TRUE,NA,"0.1.4"
"15399","646",2023-02-08 09:30:00,975,1006,31,0,TRUE,NA,"0.1.4"
"15400","646",2023-02-08 09:45:00,974,1006,32,0,TRUE,NA,"0.1.4"
"15401","646",2023-02-08 10:00:00,975,1006,31,0,TRUE,NA,"0.1.4"
"15402","646",2023-02-08 10:15:00,974,1006,32,0,TRUE,NA,"0.1.4"
"15403","646",2023-02-08 10:30:00,974,1006,32,0,TRUE,NA,"0.1.4"
"15404","646",2023-02-08 10:45:00,974,1006,32,0,TRUE,NA,"0.1.4"
"15405","646",2023-02-08 11:00:00,974,1006,32,0,TRUE,NA,"0.1.4"
"15406","646",2023-02-08 11:15:00,974,1006,32,0,TRUE,NA,"0.1.4"
"15407","646",2023-02-08 11:30:00,974,1006,32,0,TRUE,NA,"0.1.4"
"15408","646",2023-02-08 11:45:00,974,1006,32,0,TRUE,NA,"0.1.4"
"15409","646",2023-02-08 12:00:00,974,1006,32,0,TRUE,NA,"0.1.4"
"15410","646",2023-02-08 12:15:00,974,1006,32,0,TRUE,NA,"0.1.4"
"15411","646",2023-02-08 12:30:00,974,1006,32,0,TRUE,NA,"0.1.4"
"15412","646",2023-02-08 12:45:00,974,1006,32,0,TRUE,NA,"0.1.4"
"15413","646",2023-02-08 13:00:00,974,1006,32,0,TRUE,NA,"0.1.4"
"15414","646",2023-02-08 13:15:00,974,1006,32,0,TRUE,NA,"0.1.4"
"15415","646",2023-02-08 13:30:00,974,1006,32,0,TRUE,NA,"0.1.4"
"15416","646",2023-02-08 13:45:00,974,1006,32,0,TRUE,NA,"0.1.4"
"15417","646",2023-02-08 14:00:00,974,1006,32,0,TRUE,NA,"0.1.4"
"15418","646",2023-02-08 14:15:00,974,1006,32,0,TRUE,NA,"0.1.4"
"15419","646",2023-02-08 14:30:00,974,1006,32,0,TRUE,NA,"0.1.4"
"15420","646",2023-02-08 14:45:00,974,1006,32,0,TRUE,NA,"0.1.4"
"15421","646",2023-02-08 15:00:00,974,1006,32,0,TRUE,NA,"0.1.4"
"15422","646",2023-02-08 15:15:00,974,1006,32,0,TRUE,NA,"0.1.4"
"15423","646",2023-02-08 15:30:00,974,1006,32,0,TRUE,NA,"0.1.4"
"15424","646",2023-02-08 15:45:00,974,1006,32,0,TRUE,NA,"0.1.4"
"15425","646",2023-02-08 16:00:00,974,1006,32,0,TRUE,NA,"0.1.4"
"15426","646",2023-02-08 16:15:00,974,1006,32,0,TRUE,NA,"0.1.4"
"15427","646",2023-02-08 16:30:00,974,1006,32,0,TRUE,NA,"0.1.4"
"15428","646",2023-02-08 16:45:00,974,1006,32,0,TRUE,NA,"0.1.4"
"15429","646",2023-02-08 17:00:00,974,1006,32,0,TRUE,NA,"0.1.4"
"15430","646",2023-02-08 17:15:00,974,1006,32,0,TRUE,NA,"0.1.4"
"15431","646",2023-02-08 17:30:00,975,1006,31,0,TRUE,NA,"0.1.4"
"15432","646",2023-02-08 17:45:00,974,1006,32,0,TRUE,NA,"0.1.4"
"15433","646",2023-02-08 18:00:00,974,1006,32,0,TRUE,NA,"0.1.4"
"15434","646",2023-02-08 18:15:00,974,1006,32,0,TRUE,NA,"0.1.4"
"15435","646",2023-02-08 18:30:00,974,1006,32,0,TRUE,NA,"0.1.4"
"15436","646",2023-02-08 18:45:00,974,1006,32,0,TRUE,NA,"0.1.4"
"15437","646",2023-02-08 19:00:00,974,1006,32,0,TRUE,NA,"0.1.4"
"15438","646",2023-02-08 19:15:00,974,1006,32,0,TRUE,NA,"0.1.4"
"15439","646",2023-02-08 19:30:00,974,1006,32,0,TRUE,NA,"0.1.4"
"15440","646",2023-02-08 19:45:00,974,1006,32,0,TRUE,NA,"0.1.4"
"15441","646",2023-02-08 20:00:00,974,1006,32,0,TRUE,NA,"0.1.4"
"15442","646",2023-02-08 20:15:00,974,1006,32,0,TRUE,NA,"0.1.4"
"15443","646",2023-02-08 20:30:00,974,1006,32,0,TRUE,NA,"0.1.4"
"15444","646",2023-02-08 20:45:00,974,1006,32,0,TRUE,NA,"0.1.4"
"15445","646",2023-02-08 21:00:00,974,1006,32,0,TRUE,NA,"0.1.4"
"15446","646",2023-02-08 21:15:00,975,1006,31,0,TRUE,NA,"0.1.4"
"15447","646",2023-02-08 21:30:00,975,1006,31,0,TRUE,NA,"0.1.4"
"15448","646",2023-02-08 21:45:00,974,1006,32,0,TRUE,NA,"0.1.4"
"15449","646",2023-02-08 22:00:00,974,1006,32,0,TRUE,NA,"0.1.4"
"15450","646",2023-02-08 22:15:00,974,1006,32,0,TRUE,NA,"0.1.4"
"15451","646",2023-02-08 22:30:00,974,1006,32,0,TRUE,NA,"0.1.4"
"15452","646",2023-02-08 22:45:00,974,1006,32,0,TRUE,NA,"0.1.4"
"15453","646",2023-02-08 23:00:00,974,1006,32,0,TRUE,NA,"0.1.4"
"15454","646",2023-02-08 23:15:00,974,1006,32,0,TRUE,NA,"0.1.4"
"15455","646",2023-02-08 23:30:00,974,1006,32,0,TRUE,NA,"0.1.4"
"15456","646",2023-02-08 23:45:00,974,1006,32,0,TRUE,NA,"0.1.4"
"15457","646",2023-02-09,974,1006,32,0,FALSE,NA,"0.1.4"
"15458","646",2023-02-09 00:15:00,974,1006,32,0,TRUE,NA,"0.1.4"
"15459","646",2023-02-09 00:30:00,974,1006,32,0,TRUE,NA,"0.1.4"
"15460","646",2023-02-09 00:45:00,975,1006,31,0,TRUE,NA,"0.1.4"
"15461","646",2023-02-09 01:00:00,975,1006,31,0,TRUE,NA,"0.1.4"
"15462","646",2023-02-09 01:15:00,975,1006,31,0,TRUE,NA,"0.1.4"
"15463","646",2023-02-09 01:30:00,975,1006,31,0,TRUE,NA,"0.1.4"
"15464","646",2023-02-09 01:45:00,975,1006,31,0,TRUE,NA,"0.1.4"
"15465","646",2023-02-09 02:00:00,975,1006,31,0,TRUE,NA,"0.1.4"
"15466","646",2023-02-09 02:15:00,975,1006,31,0,TRUE,NA,"0.1.4"
"15467","646",2023-02-09 02:30:00,975,1006,31,0,TRUE,NA,"0.1.4"
"15468","646",2023-02-09 02:45:00,975,1006,31,0,TRUE,NA,"0.1.4"
"15469","646",2023-02-09 03:00:00,975,1006,31,0,TRUE,NA,"0.1.4"
"15470","646",2023-02-09 03:15:00,975,1006,31,0,TRUE,NA,"0.1.4"
"15471","646",2023-02-09 03:30:00,975,1006,31,0,TRUE,NA,"0.1.4"
"15472","646",2023-02-09 03:45:00,975,1006,31,0,TRUE,NA,"0.1.4"
"15473","646",2023-02-09 04:00:00,975,1006,31,0,TRUE,NA,"0.1.4"
"15474","646",2023-02-09 04:15:00,975,1006,31,0,TRUE,NA,"0.1.4"
"15475","646",2023-02-09 04:30:00,975,1006,31,0,TRUE,NA,"0.1.4"
"15476","646",2023-02-09 04:45:00,975,1006,31,0,TRUE,NA,"0.1.4"
"15477","646",2023-02-09 05:00:00,975,1006,31,0,TRUE,NA,"0.1.4"
"15478","646",2023-02-09 05:15:00,975,1006,31,0,TRUE,NA,"0.1.4"
"15479","646",2023-02-09 05:30:00,975,1006,31,0,TRUE,NA,"0.1.4"
"15480","646",2023-02-09 05:45:00,975,1006,31,0,TRUE,NA,"0.1.4"
"15481","646",2023-02-09 06:00:00,975,1006,31,0,TRUE,NA,"0.1.4"
"15482","646",2023-02-09 06:15:00,975,1006,31,0,TRUE,NA,"0.1.4"
"15483","646",2023-02-09 06:30:00,975,1006,31,0,TRUE,NA,"0.1.4"
"15484","646",2023-02-09 06:45:00,975,1006,31,0,TRUE,NA,"0.1.4"
"15485","646",2023-02-09 07:00:00,975,1006,31,0,TRUE,NA,"0.1.4"
"15486","646",2023-02-09 07:15:00,975,1006,31,0,TRUE,NA,"0.1.4"
"15487","646",2023-02-09 07:30:00,975,1006,31,0,TRUE,NA,"0.1.4"
"15488","646",2023-02-09 07:45:00,975,1006,31,0,TRUE,NA,"0.1.4"
"15489","646",2023-02-09 08:00:00,975,1006,31,0,TRUE,NA,"0.1.4"
"15490","646",2023-02-09 08:15:00,975,1006,31,0,TRUE,NA,"0.1.4"
"15491","646",2023-02-09 08:30:00,975,1006,31,0,TRUE,NA,"0.1.4"
"15492","646",2023-02-09 08:45:00,975,1006,31,0,TRUE,NA,"0.1.4"
"15493","646",2023-02-09 09:00:00,975,1006,31,0,TRUE,NA,"0.1.4"
"15494","646",2023-02-09 09:15:00,975,1006,31,0,TRUE,NA,"0.1.4"
"15495","646",2023-02-09 09:30:00,975,1006,31,0,TRUE,NA,"0.1.4"
"15496","646",2023-02-09 09:45:00,975,1006,31,0,TRUE,NA,"0.1.4"
"15497","646",2023-02-09 10:00:00,975,1006,31,0,TRUE,NA,"0.1.4"
"15498","646",2023-02-09 10:15:00,975,1006,31,0,TRUE,NA,"0.1.4"
"15499","646",2023-02-09 10:30:00,975,1006,31,0,TRUE,NA,"0.1.4"
"15500","646",2023-02-09 10:45:00,975,1006,31,0,TRUE,NA,"0.1.4"
"15501","646",2023-02-09 11:00:00,975,1006,31,0,TRUE,NA,"0.1.4"
"15502","646",2023-02-09 11:15:00,975,1006,31,0,TRUE,NA,"0.1.4"
"15503","646",2023-02-09 11:30:00,975,1006,31,0,TRUE,NA,"0.1.4"
"15504","646",2023-02-09 11:45:00,975,1006,31,0,TRUE,NA,"0.1.4"
"15505","646",2023-02-09 12:00:00,975,1006,31,0,TRUE,NA,"0.1.4"
"15506","646",2023-02-09 12:15:00,975,1006,31,0,TRUE,NA,"0.1.4"
"15507","646",2023-02-09 12:30:00,975,1006,31,0,TRUE,NA,"0.1.4"
"15508","646",2023-02-09 12:45:00,975,1006,31,0,TRUE,NA,"0.1.4"
"15509","646",2023-02-09 13:00:00,975,1006,31,0,TRUE,NA,"0.1.4"
"15510","646",2023-02-09 13:15:00,975,1006,31,0,TRUE,NA,"0.1.4"
"15511","646",2023-02-09 13:30:00,975,1006,31,0,TRUE,NA,"0.1.4"
"15512","646",2023-02-09 13:45:00,975,1006,31,0,TRUE,NA,"0.1.4"
"15513","646",2023-02-09 14:00:00,975,1006,31,0,TRUE,NA,"0.1.4"
"15514","646",2023-02-09 14:15:00,975,1006,31,0,TRUE,NA,"0.1.4"
"15515","646",2023-02-09 14:30:00,975,1006,31,0,TRUE,NA,"0.1.4"
"15516","646",2023-02-09 14:45:00,975,1006,31,0,TRUE,NA,"0.1.4"
"15517","646",2023-02-09 15:00:00,975,1006,31,0,TRUE,NA,"0.1.4"
"15518","646",2023-02-09 15:15:00,975,1006,31,0,TRUE,NA,"0.1.4"
"15519","646",2023-02-09 15:30:00,975,1006,31,0,TRUE,NA,"0.1.4"
"15520","646",2023-02-09 15:45:00,975,1006,31,0,TRUE,NA,"0.1.4"
"15521","646",2023-02-09 16:00:00,975,1006,31,0,TRUE,NA,"0.1.4"
"15522","646",2023-02-09 16:15:00,975,1006,31,0,TRUE,NA,"0.1.4"
"15523","646",2023-02-09 16:30:00,975,1006,31,0,TRUE,NA,"0.1.4"
"15524","646",2023-02-09 16:45:00,975,1006,31,0,TRUE,NA,"0.1.4"
"15525","646",2023-02-09 17:00:00,975,1006,31,0,TRUE,NA,"0.1.4"
"15526","646",2023-02-09 17:15:00,975,1006,31,0,TRUE,NA,"0.1.4"
"15527","646",2023-02-09 17:30:00,975,1006,31,0,TRUE,NA,"0.1.4"
"15528","646",2023-02-09 17:45:00,975,1006,31,0,TRUE,NA,"0.1.4"
"15529","646",2023-02-09 18:00:00,975,1006,31,0,TRUE,NA,"0.1.4"
"15530","646",2023-02-09 18:15:00,975,1006,31,0,TRUE,NA,"0.1.4"
"15531","646",2023-02-09 18:30:00,975,1006,31,0,TRUE,NA,"0.1.4"
"15532","646",2023-02-09 18:45:00,975,1006,31,0,TRUE,NA,"0.1.4"
"15533","646",2023-02-09 19:00:00,975,1006,31,0,TRUE,NA,"0.1.4"
"15534","646",2023-02-09 19:15:00,975,1006,31,0,TRUE,NA,"0.1.4"
"15535","646",2023-02-09 19:30:00,975,1006,31,0,TRUE,NA,"0.1.4"
"15536","646",2023-02-09 19:45:00,975,1006,31,0,TRUE,NA,"0.1.4"
"15537","646",2023-02-09 20:00:00,975,1006,31,0,TRUE,NA,"0.1.4"
"15538","646",2023-02-09 20:15:00,975,1006,31,0,TRUE,NA,"0.1.4"
"15539","646",2023-02-09 20:30:00,975,1006,31,0,TRUE,NA,"0.1.4"
"15540","646",2023-02-09 20:45:00,975,1006,31,0,TRUE,NA,"0.1.4"
"15541","646",2023-02-09 21:00:00,975,1006,31,0,TRUE,NA,"0.1.4"
"15542","646",2023-02-09 21:15:00,975,1006,31,0,TRUE,NA,"0.1.4"
"15543","646",2023-02-09 21:30:00,975,1006,31,0,TRUE,NA,"0.1.4"
"15544","646",2023-02-09 21:45:00,975,1006,31,0,TRUE,NA,"0.1.4"
"15545","646",2023-02-09 22:00:00,975,1006,31,0,FALSE,NA,"0.1.4"
"15546","646",2023-02-09 22:15:00,975,1006,31,0,FALSE,NA,"0.1.4"
"15547","646",2023-02-09 22:30:00,975,1006,31,0,FALSE,NA,"0.1.4"
"15548","646",2023-02-09 22:45:00,975,1006,31,0,FALSE,NA,"0.1.4"
"15549","646",2023-02-09 23:00:00,975,1006,31,0,FALSE,NA,"0.1.4"
"15550","646",2023-02-09 23:15:00,975,1006,31,0,FALSE,NA,"0.1.4"
"15551","646",2023-02-09 23:30:00,975,1006,31,0,FALSE,NA,"0.1.4"
"15552","646",2023-02-09 23:45:00,975,1006,31,0,FALSE,NA,"0.1.4"
"15553","646",2023-02-10,975,1006,31,0,FALSE,NA,"0.1.4"
"15554","646",2023-02-10 00:15:00,975,1006,31,0,FALSE,NA,"0.1.4"
"15555","646",2023-02-10 00:30:00,975,1006,31,0,FALSE,NA,"0.1.4"
"15556","646",2023-02-10 00:45:00,975,1006,31,0,FALSE,NA,"0.1.4"
"15557","646",2023-02-10 01:00:00,975,1006,31,0,FALSE,NA,"0.1.4"
"15558","646",2023-02-10 01:15:00,975,1006,31,0,FALSE,NA,"0.1.4"
"15559","646",2023-02-10 01:30:00,975,1006,31,0,TRUE,NA,"0.1.4"
"15560","646",2023-02-10 01:45:00,975,1006,31,0,TRUE,NA,"0.1.4"
"15561","646",2023-02-10 02:00:00,975,1006,31,0,TRUE,NA,"0.1.4"
"15562","646",2023-02-10 02:15:00,975,1006,31,0,TRUE,NA,"0.1.4"
"15563","646",2023-02-10 02:30:00,975,1006,31,0,TRUE,NA,"0.1.4"
"15564","646",2023-02-10 02:45:00,975,1006,31,0,TRUE,NA,"0.1.4"
"15565","646",2023-02-10 03:00:00,975,1006,31,0,TRUE,NA,"0.1.4"
"15566","646",2023-02-10 03:15:00,975,1006,31,0,TRUE,NA,"0.1.4"
"15567","646",2023-02-10 03:30:00,975,1006,31,0,TRUE,NA,"0.1.4"
"15568","646",2023-02-10 03:45:00,975,1006,31,0,TRUE,NA,"0.1.4"
"15569","646",2023-02-10 04:00:00,975,1006,31,0,TRUE,NA,"0.1.4"
"15570","646",2023-02-10 04:15:00,975,1006,31,0,TRUE,NA,"0.1.4"
"15571","646",2023-02-10 04:30:00,975,1006,31,0,TRUE,NA,"0.1.4"
"15572","646",2023-02-10 04:45:00,975,1006,31,0,TRUE,NA,"0.1.4"
"15573","646",2023-02-10 05:00:00,975,1006,31,0,TRUE,NA,"0.1.4"
"15574","646",2023-02-10 05:15:00,975,1006,31,0,TRUE,NA,"0.1.4"
"15575","646",2023-02-10 05:30:00,975,1006,31,0,TRUE,NA,"0.1.4"
"15576","646",2023-02-10 05:45:00,975,1006,31,0,TRUE,NA,"0.1.4"
"15577","646",2023-02-10 06:00:00,975,1006,31,0,TRUE,NA,"0.1.4"
"15578","646",2023-02-10 06:15:00,976,1006,30,0,TRUE,NA,"0.1.4"
"15579","646",2023-02-10 06:30:00,975,1006,31,0,TRUE,NA,"0.1.4"
"15580","646",2023-02-10 06:45:00,975,1006,31,0,TRUE,NA,"0.1.4"
"15581","646",2023-02-10 07:00:00,975,1006,31,0,TRUE,NA,"0.1.4"
"15582","646",2023-02-10 07:15:00,975,1006,31,0,TRUE,NA,"0.1.4"
"15583","646",2023-02-10 07:30:00,975,1006,31,0,TRUE,NA,"0.1.4"
"15584","646",2023-02-10 07:45:00,975,1006,31,0,TRUE,NA,"0.1.4"
"15585","646",2023-02-10 08:00:00,975,1006,31,0,TRUE,NA,"0.1.4"
"15586","646",2023-02-10 08:15:00,975,1006,31,0,TRUE,NA,"0.1.4"
"15587","646",2023-02-10 08:30:00,975,1006,31,0,TRUE,NA,"0.1.4"
"15588","646",2023-02-10 08:45:00,975,1006,31,0,TRUE,NA,"0.1.4"
"15589","646",2023-02-10 09:00:00,975,1006,31,0,TRUE,NA,"0.1.4"
"15590","646",2023-02-10 09:15:00,975,1006,31,0,TRUE,NA,"0.1.4"
"15591","646",2023-02-10 09:30:00,975,1006,31,0,TRUE,NA,"0.1.4"
"15592","646",2023-02-10 09:45:00,975,1006,31,0,TRUE,NA,"0.1.4"
"15593","646",2023-02-10 10:00:00,975,1006,31,0,TRUE,NA,"0.1.4"
"15594","646",2023-02-10 10:15:00,975,1006,31,0,TRUE,NA,"0.1.4"
"15595","646",2023-02-10 10:30:00,975,1006,31,0,TRUE,NA,"0.1.4"
"15596","646",2023-02-10 10:45:00,975,1006,31,0,TRUE,NA,"0.1.4"
"15597","646",2023-02-10 11:00:00,975,1006,31,0,TRUE,NA,"0.1.4"
"15598","646",2023-02-10 11:15:00,975,1006,31,0,TRUE,NA,"0.1.4"
"15599","646",2023-02-10 11:30:00,975,1006,31,0,TRUE,NA,"0.1.4"
"15600","646",2023-02-10 11:45:00,975,1006,31,0,TRUE,NA,"0.1.4"
"15601","646",2023-02-10 12:00:00,975,1006,31,0,TRUE,NA,"0.1.4"
"15602","646",2023-02-10 12:15:00,975,1006,31,0,TRUE,NA,"0.1.4"
"15603","646",2023-02-10 12:30:00,975,1006,31,0,TRUE,NA,"0.1.4"
"15604","646",2023-02-10 12:45:00,975,1006,31,0,TRUE,NA,"0.1.4"
"15605","646",2023-02-10 13:00:00,975,1006,31,0,TRUE,NA,"0.1.4"
"15606","646",2023-02-10 13:15:00,975,1006,31,0,TRUE,NA,"0.1.4"
"15607","646",2023-02-10 13:30:00,975,1006,31,0,TRUE,NA,"0.1.4"
"15608","646",2023-02-10 13:45:00,975,1006,31,0,TRUE,NA,"0.1.4"
"15609","646",2023-02-10 14:00:00,975,1006,31,0,TRUE,NA,"0.1.4"
"15610","646",2023-02-10 14:15:00,975,1006,31,0,TRUE,NA,"0.1.4"
"15611","646",2023-02-10 14:30:00,975,1006,31,0,TRUE,NA,"0.1.4"
"15612","646",2023-02-10 14:45:00,975,1006,31,0,TRUE,NA,"0.1.4"
"15613","646",2023-02-10 15:00:00,975,1006,31,0,TRUE,NA,"0.1.4"
"15614","646",2023-02-10 15:15:00,975,1006,31,0,TRUE,NA,"0.1.4"
"15615","646",2023-02-10 15:30:00,975,1006,31,0,TRUE,NA,"0.1.4"
"15616","646",2023-02-10 15:45:00,975,1006,31,0,TRUE,NA,"0.1.4"
"15617","646",2023-02-10 16:00:00,975,1006,31,0,TRUE,NA,"0.1.4"
"15618","646",2023-02-10 16:15:00,975,1006,31,0,TRUE,NA,"0.1.4"
"15619","646",2023-02-10 16:30:00,975,1006,31,0,TRUE,NA,"0.1.4"
"15620","646",2023-02-10 16:45:00,975,1006,31,0,TRUE,NA,"0.1.4"
"15621","646",2023-02-10 17:00:00,975,1006,31,0,TRUE,NA,"0.1.4"
"15622","646",2023-02-10 17:15:00,975,1006,31,0,TRUE,NA,"0.1.4"
"15623","646",2023-02-10 17:30:00,975,1006,31,0,TRUE,NA,"0.1.4"
"15624","646",2023-02-10 17:45:00,975,1006,31,0,TRUE,NA,"0.1.4"
"15625","646",2023-02-10 18:00:00,975,1006,31,0,TRUE,NA,"0.1.4"
"15626","646",2023-02-10 18:15:00,975,1006,31,0,TRUE,NA,"0.1.4"
"15627","646",2023-02-10 18:30:00,975,1006,31,0,TRUE,NA,"0.1.4"
"15628","646",2023-02-10 18:45:00,975,1006,31,0,TRUE,NA,"0.1.4"
"15629","646",2023-02-10 19:00:00,975,1006,31,0,TRUE,NA,"0.1.4"
"15630","646",2023-02-10 19:15:00,975,1006,31,0,TRUE,NA,"0.1.4"
"15631","646",2023-02-10 19:30:00,975,1006,31,0,FALSE,NA,"0.1.4"
"15632","646",2023-02-10 19:45:00,975,1006,31,0,FALSE,NA,"0.1.4"
"15633","646",2023-02-10 20:00:00,975,1006,31,0,FALSE,NA,"0.1.4"
"15634","646",2023-02-10 20:15:00,975,1006,31,0,FALSE,NA,"0.1.4"
"15635","646",2023-02-10 20:30:00,975,1006,31,0,FALSE,NA,"0.1.4"
"15636","646",2023-02-10 20:45:00,975,1006,31,0,FALSE,NA,"0.1.4"
"15637","646",2023-02-10 21:00:00,975,1006,31,0,FALSE,NA,"0.1.4"
"15638","646",2023-02-10 21:15:00,975,1006,31,0,FALSE,NA,"0.1.4"
"15639","646",2023-02-10 21:30:00,975,1006,31,0,FALSE,NA,"0.1.4"
"15640","646",2023-02-10 21:45:00,975,1006,31,0,FALSE,NA,"0.1.4"
"15641","646",2023-02-10 22:00:00,975,1006,31,0,FALSE,NA,"0.1.4"
"15642","646",2023-02-10 22:15:00,975,1006,31,0,FALSE,NA,"0.1.4"
"15643","646",2023-02-10 22:30:00,975,1006,31,0,FALSE,NA,"0.1.4"
"15644","646",2023-02-10 22:45:00,975,1006,31,0,FALSE,NA,"0.1.4"
"15645","646",2023-02-10 23:00:00,975,1006,31,0,FALSE,NA,"0.1.4"
"15646","646",2023-02-10 23:15:00,975,1006,31,0,FALSE,NA,"0.1.4"
"15647","646",2023-02-10 23:30:00,975,1006,31,0,FALSE,NA,"0.1.4"
"15648","646",2023-02-10 23:45:00,975,1006,31,0,FALSE,NA,"0.1.4"
"15649","646",2023-02-11,975,1006,31,0,FALSE,NA,"0.1.4"
"15650","646",2023-02-11 00:15:00,975,1006,31,0,FALSE,NA,"0.1.4"
"15651","646",2023-02-11 00:30:00,975,1006,31,0,FALSE,NA,"0.1.4"
"15652","646",2023-02-11 00:45:00,975,1006,31,0,FALSE,NA,"0.1.4"
"15653","646",2023-02-11 01:00:00,975,1006,31,0,FALSE,NA,"0.1.4"
"15654","646",2023-02-11 01:15:00,975,1006,31,0,FALSE,NA,"0.1.4"
"15655","646",2023-02-11 01:30:00,975,1006,31,0,FALSE,NA,"0.1.4"
"15656","646",2023-02-11 01:45:00,975,1006,31,0,FALSE,NA,"0.1.4"
"15657","646",2023-02-11 02:00:00,975,1006,31,0,FALSE,NA,"0.1.4"
"15658","646",2023-02-11 02:15:00,975,1006,31,0,FALSE,NA,"0.1.4"
"15659","646",2023-02-11 02:30:00,975,1006,31,0,TRUE,NA,"0.1.4"
"15660","646",2023-02-11 02:45:00,975,1006,31,0,TRUE,NA,"0.1.4"
"15661","646",2023-02-11 03:00:00,975,1006,31,0,TRUE,NA,"0.1.4"
"15662","646",2023-02-11 03:15:00,975,1006,31,0,TRUE,NA,"0.1.4"
"15663","646",2023-02-11 03:30:00,975,1006,31,0,TRUE,NA,"0.1.4"
"15664","646",2023-02-11 03:45:00,975,1006,31,0,TRUE,NA,"0.1.4"
"15665","646",2023-02-11 04:00:00,975,1006,31,0,TRUE,NA,"0.1.4"
"15666","646",2023-02-11 04:15:00,975,1006,31,0,TRUE,NA,"0.1.4"
"15667","646",2023-02-11 04:30:00,975,1006,31,0,TRUE,NA,"0.1.4"
"15668","646",2023-02-11 04:45:00,975,1006,31,0,TRUE,NA,"0.1.4"
"15669","646",2023-02-11 05:00:00,975,1006,31,0,TRUE,NA,"0.1.4"
"15670","646",2023-02-11 05:15:00,975,1006,31,0,TRUE,NA,"0.1.4"
"15671","646",2023-02-11 05:30:00,975,1006,31,0,TRUE,NA,"0.1.4"
"15672","646",2023-02-11 05:45:00,975,1006,31,0,TRUE,NA,"0.1.4"
"15673","646",2023-02-11 06:00:00,975,1006,31,0,TRUE,NA,"0.1.4"
"15674","646",2023-02-11 06:15:00,975,1006,31,0,TRUE,NA,"0.1.4"
"15675","646",2023-02-11 06:30:00,975,1006,31,0,TRUE,NA,"0.1.4"
"15676","646",2023-02-11 06:45:00,975,1006,31,0,TRUE,NA,"0.1.4"
"15677","646",2023-02-11 07:00:00,975,1006,31,0,TRUE,NA,"0.1.4"
"15678","646",2023-02-11 07:15:00,975,1006,31,0,TRUE,NA,"0.1.4"
"15679","646",2023-02-11 07:30:00,975,1006,31,0,TRUE,NA,"0.1.4"
"15680","646",2023-02-11 07:45:00,975,1006,31,0,TRUE,NA,"0.1.4"
"15681","646",2023-02-11 08:00:00,975,1006,31,0,TRUE,NA,"0.1.4"
"15682","646",2023-02-11 08:15:00,975,1006,31,0,TRUE,NA,"0.1.4"
"15683","646",2023-02-11 08:30:00,975,1006,31,0,TRUE,NA,"0.1.4"
"15684","646",2023-02-11 08:45:00,975,1006,31,0,TRUE,NA,"0.1.4"
"15685","646",2023-02-11 09:00:00,975,1006,31,0,TRUE,NA,"0.1.4"
"15686","646",2023-02-11 09:15:00,975,1006,31,0,TRUE,NA,"0.1.4"
"15687","646",2023-02-11 09:30:00,975,1006,31,0,TRUE,NA,"0.1.4"
"15688","646",2023-02-11 09:45:00,975,1006,31,0,TRUE,NA,"0.1.4"
"15689","646",2023-02-11 10:00:00,975,1006,31,0,TRUE,NA,"0.1.4"
"15690","646",2023-02-11 10:15:00,975,1006,31,0,TRUE,NA,"0.1.4"
"15691","646",2023-02-11 10:30:00,975,1006,31,0,TRUE,NA,"0.1.4"
"15692","646",2023-02-11 10:45:00,975,1006,31,0,TRUE,NA,"0.1.4"
"15693","646",2023-02-11 11:00:00,975,1006,31,0,TRUE,NA,"0.1.4"
"15694","646",2023-02-11 11:15:00,975,1006,31,0,TRUE,NA,"0.1.4"
"15695","646",2023-02-11 11:30:00,975,1006,31,0,TRUE,NA,"0.1.4"
"15696","646",2023-02-11 11:45:00,975,1006,31,0,TRUE,NA,"0.1.4"
"15697","646",2023-02-11 12:00:00,975,1006,31,0,TRUE,NA,"0.1.4"
"15698","646",2023-02-11 12:15:00,975,1006,31,0,TRUE,NA,"0.1.4"
"15699","646",2023-02-11 12:30:00,974,1006,32,0,TRUE,NA,"0.1.4"
"15700","646",2023-02-11 12:45:00,974,1006,32,0,TRUE,NA,"0.1.4"
"15701","646",2023-02-11 13:00:00,974,1006,32,0,TRUE,NA,"0.1.4"
"15702","646",2023-02-11 13:15:00,975,1006,31,0,TRUE,NA,"0.1.4"
"15703","646",2023-02-11 13:30:00,974,1006,32,0,TRUE,NA,"0.1.4"
"15704","646",2023-02-11 13:45:00,974,1006,32,0,TRUE,NA,"0.1.4"
"15705","646",2023-02-11 14:00:00,974,1006,32,0,TRUE,NA,"0.1.4"
"15706","646",2023-02-11 14:15:00,975,1006,31,0,TRUE,NA,"0.1.4"
"15707","646",2023-02-11 14:30:00,974,1006,32,0,TRUE,NA,"0.1.4"
"15708","646",2023-02-11 14:45:00,975,1006,31,0,TRUE,NA,"0.1.4"
"15709","646",2023-02-11 15:00:00,974,1006,32,0,TRUE,NA,"0.1.4"
"15710","646",2023-02-11 15:15:00,974,1006,32,0,TRUE,NA,"0.1.4"
"15711","646",2023-02-11 15:30:00,975,1006,31,0,TRUE,NA,"0.1.4"
"15712","646",2023-02-11 15:45:00,975,1006,31,0,TRUE,NA,"0.1.4"
"15713","646",2023-02-11 16:00:00,974,1006,32,0,TRUE,NA,"0.1.4"
"15714","646",2023-02-11 16:15:00,974,1006,32,0,TRUE,NA,"0.1.4"
"15715","646",2023-02-11 16:30:00,974,1006,32,0,TRUE,NA,"0.1.4"
"15716","646",2023-02-11 16:45:00,975,1006,31,0,TRUE,NA,"0.1.4"
"15717","646",2023-02-11 17:00:00,974,1006,32,0,TRUE,NA,"0.1.4"
"15718","646",2023-02-11 17:15:00,974,1006,32,0,TRUE,NA,"0.1.4"
"15719","646",2023-02-11 17:30:00,974,1006,32,0,TRUE,NA,"0.1.4"
"15720","646",2023-02-11 17:45:00,974,1006,32,0,TRUE,NA,"0.1.4"
"15721","646",2023-02-11 18:00:00,974,1006,32,0,TRUE,NA,"0.1.4"
"15722","646",2023-02-11 18:15:00,974,1006,32,0,TRUE,NA,"0.1.4"
"15723","646",2023-02-11 18:30:00,974,1006,32,0,TRUE,NA,"0.1.4"
"15724","646",2023-02-11 18:45:00,974,1006,32,0,TRUE,NA,"0.1.4"
"15725","646",2023-02-11 19:00:00,974,1006,32,0,TRUE,NA,"0.1.4"
"15726","646",2023-02-11 19:15:00,974,1006,32,0,TRUE,NA,"0.1.4"
"15727","646",2023-02-11 19:30:00,974,1006,32,0,TRUE,NA,"0.1.4"
"15728","646",2023-02-11 19:45:00,974,1006,32,0,TRUE,NA,"0.1.4"
"15729","646",2023-02-11 20:00:00,975,1006,31,0,TRUE,NA,"0.1.4"
"15730","646",2023-02-11 20:15:00,974,1006,32,0,TRUE,NA,"0.1.4"
"15731","646",2023-02-11 20:30:00,975,1006,31,0,TRUE,NA,"0.1.4"
"15732","646",2023-02-11 20:45:00,974,1006,32,0,TRUE,NA,"0.1.4"
"15733","646",2023-02-11 21:00:00,974,1006,32,0,TRUE,NA,"0.1.4"
"15734","646",2023-02-11 21:15:00,974,1006,32,0,FALSE,NA,"0.1.4"
"15735","646",2023-02-11 21:30:00,974,1006,32,0,FALSE,NA,"0.1.4"
"15736","646",2023-02-11 21:45:00,974,1006,32,0,FALSE,NA,"0.1.4"
"15737","646",2023-02-11 22:00:00,974,1006,32,0,FALSE,NA,"0.1.4"
"15738","646",2023-02-11 22:15:00,974,1006,32,0,FALSE,NA,"0.1.4"
"15739","646",2023-02-11 22:30:00,974,1006,32,0,FALSE,NA,"0.1.4"
"15740","646",2023-02-11 22:45:00,974,1006,32,0,FALSE,NA,"0.1.4"
"15741","646",2023-02-11 23:00:00,974,1006,32,0,FALSE,NA,"0.1.4"
"15742","646",2023-02-11 23:15:00,974,1006,32,0,FALSE,NA,"0.1.4"
"15743","646",2023-02-11 23:30:00,974,1006,32,0,FALSE,NA,"0.1.4"
"15744","646",2023-02-11 23:45:00,974,1006,32,0,FALSE,NA,"0.1.4"
"15745","646",2023-02-12,974,1006,32,0,FALSE,NA,"0.1.4"
"15746","646",2023-02-12 00:15:00,974,1006,32,0,FALSE,NA,"0.1.4"
"15747","646",2023-02-12 00:30:00,974,1006,32,0,FALSE,NA,"0.1.4"
"15748","646",2023-02-12 00:45:00,974,1006,32,0,FALSE,NA,"0.1.4"
"15749","646",2023-02-12 01:00:00,974,1006,32,0,FALSE,NA,"0.1.4"
"15750","646",2023-02-12 01:15:00,974,1006,32,0,TRUE,NA,"0.1.4"
"15751","646",2023-02-12 01:30:00,974,1006,32,0,TRUE,NA,"0.1.4"
"15752","646",2023-02-12 01:45:00,974,1006,32,0,TRUE,NA,"0.1.4"
"15753","646",2023-02-12 02:00:00,974,1006,32,0,TRUE,NA,"0.1.4"
"15754","646",2023-02-12 02:15:00,974,1006,32,0,TRUE,NA,"0.1.4"
"15755","646",2023-02-12 02:30:00,974,1006,32,0,TRUE,NA,"0.1.4"
"15756","646",2023-02-12 02:45:00,974,1006,32,0,TRUE,NA,"0.1.4"
"15757","646",2023-02-12 03:00:00,974,1006,32,0,TRUE,NA,"0.1.4"
"15758","646",2023-02-12 03:15:00,974,1006,32,0,TRUE,NA,"0.1.4"
"15759","646",2023-02-12 03:30:00,974,1006,32,0,TRUE,NA,"0.1.4"
"15760","646",2023-02-12 03:45:00,974,1006,32,0,TRUE,NA,"0.1.4"
"15761","646",2023-02-12 04:00:00,974,1006,32,0,TRUE,NA,"0.1.4"
"15762","646",2023-02-12 04:15:00,974,1006,32,0,TRUE,NA,"0.1.4"
"15763","646",2023-02-12 04:30:00,974,1006,32,0,TRUE,NA,"0.1.4"
"15764","646",2023-02-12 04:45:00,974,1006,32,0,TRUE,NA,"0.1.4"
"15765","646",2023-02-12 05:00:00,974,1006,32,0,TRUE,NA,"0.1.4"
"15766","646",2023-02-12 05:15:00,974,1006,32,0,TRUE,NA,"0.1.4"
"15767","646",2023-02-12 05:30:00,974,1006,32,0,TRUE,NA,"0.1.4"
"15768","646",2023-02-12 05:45:00,974,1006,32,0,TRUE,NA,"0.1.4"
"15769","646",2023-02-12 06:00:00,974,1006,32,0,TRUE,NA,"0.1.4"
"15770","646",2023-02-12 06:15:00,974,1006,32,0,TRUE,NA,"0.1.4"
"15771","646",2023-02-12 06:30:00,974,1006,32,0,TRUE,NA,"0.1.4"
"15772","646",2023-02-12 06:45:00,974,1006,32,0,TRUE,NA,"0.1.4"
"15773","646",2023-02-12 07:00:00,974,1006,32,0,TRUE,NA,"0.1.4"
"15774","646",2023-02-12 07:15:00,974,1006,32,0,TRUE,NA,"0.1.4"
"15775","646",2023-02-12 07:30:00,974,1006,32,0,TRUE,NA,"0.1.4"
"15776","646",2023-02-12 07:45:00,974,1006,32,0,TRUE,NA,"0.1.4"
"15777","646",2023-02-12 08:00:00,974,1006,32,0,TRUE,NA,"0.1.4"
"15778","646",2023-02-12 08:15:00,974,1006,32,0,TRUE,NA,"0.1.4"
"15779","646",2023-02-12 08:30:00,975,1006,31,0,TRUE,NA,"0.1.4"
"15780","646",2023-02-12 08:45:00,974,1006,32,0,TRUE,NA,"0.1.4"
"15781","646",2023-02-12 09:00:00,975,1006,31,0,TRUE,NA,"0.1.4"
"15782","646",2023-02-12 09:15:00,975,1006,31,0,TRUE,NA,"0.1.4"
"15783","646",2023-02-12 09:30:00,975,1006,31,0,TRUE,NA,"0.1.4"
"15784","646",2023-02-12 09:45:00,975,1006,31,0,TRUE,NA,"0.1.4"
"15785","646",2023-02-12 10:00:00,975,1006,31,0,TRUE,NA,"0.1.4"
"15786","646",2023-02-12 10:15:00,975,1006,31,0,TRUE,NA,"0.1.4"
"15787","646",2023-02-12 10:30:00,975,1006,31,0,TRUE,NA,"0.1.4"
"15788","646",2023-02-12 10:45:00,975,1006,31,0,TRUE,NA,"0.1.4"
"15789","646",2023-02-12 11:00:00,975,1006,31,0,TRUE,NA,"0.1.4"
"15790","646",2023-02-12 11:15:00,975,1006,31,0,TRUE,NA,"0.1.4"
"15791","646",2023-02-12 11:30:00,975,1006,31,0,TRUE,NA,"0.1.4"
"15792","646",2023-02-12 11:45:00,975,1006,31,0,TRUE,NA,"0.1.4"
"15793","646",2023-02-12 12:00:00,975,1006,31,0,TRUE,NA,"0.1.4"
"15794","646",2023-02-12 12:15:00,975,1006,31,0,TRUE,NA,"0.1.4"
"15795","646",2023-02-12 12:30:00,975,1006,31,0,TRUE,NA,"0.1.4"
"15796","646",2023-02-12 12:45:00,975,1006,31,0,TRUE,NA,"0.1.4"
"15797","646",2023-02-12 13:00:00,975,1006,31,0,TRUE,NA,"0.1.4"
"15798","646",2023-02-12 13:15:00,975,1006,31,0,TRUE,NA,"0.1.4"
"15799","646",2023-02-12 13:30:00,975,1006,31,0,TRUE,NA,"0.1.4"
"15800","646",2023-02-12 13:45:00,975,1006,31,0,TRUE,NA,"0.1.4"
"15801","646",2023-02-12 14:00:00,975,1006,31,0,TRUE,NA,"0.1.4"
"15802","646",2023-02-12 14:15:00,975,1006,31,0,TRUE,NA,"0.1.4"
"15803","646",2023-02-12 14:30:00,975,1006,31,0,TRUE,NA,"0.1.4"
"15804","646",2023-02-12 14:45:00,975,1006,31,0,TRUE,NA,"0.1.4"
"15805","646",2023-02-12 15:00:00,975,1006,31,0,TRUE,NA,"0.1.4"
"15806","646",2023-02-12 15:15:00,975,1006,31,0,TRUE,NA,"0.1.4"
"15807","646",2023-02-12 15:30:00,975,1006,31,0,TRUE,NA,"0.1.4"
"15808","646",2023-02-12 15:45:00,975,1006,31,0,TRUE,NA,"0.1.4"
"15809","646",2023-02-12 16:00:00,975,1006,31,0,TRUE,NA,"0.1.4"
"15810","646",2023-02-12 16:15:00,974,1006,32,0,TRUE,NA,"0.1.4"
"15811","646",2023-02-12 16:30:00,975,1006,31,0,TRUE,NA,"0.1.4"
"15812","646",2023-02-12 16:45:00,975,1006,31,0,TRUE,NA,"0.1.4"
"15813","646",2023-02-12 17:00:00,974,1006,32,0,TRUE,NA,"0.1.4"
"15814","646",2023-02-12 17:15:00,975,1006,31,0,TRUE,NA,"0.1.4"
"15815","646",2023-02-12 17:30:00,975,1006,31,0,TRUE,NA,"0.1.4"
"15816","646",2023-02-12 17:45:00,975,1006,31,0,TRUE,NA,"0.1.4"
"15817","646",2023-02-12 18:00:00,975,1006,31,0,TRUE,NA,"0.1.4"
"15818","646",2023-02-12 18:15:00,975,1006,31,0,TRUE,NA,"0.1.4"
"15819","646",2023-02-12 18:30:00,975,1006,31,0,TRUE,NA,"0.1.4"
"15820","646",2023-02-12 18:45:00,975,1006,31,0,TRUE,NA,"0.1.4"
"15821","646",2023-02-12 19:00:00,975,1006,31,0,TRUE,NA,"0.1.4"
"15822","646",2023-02-12 19:15:00,975,1006,31,0,TRUE,NA,"0.1.4"
"15823","646",2023-02-12 19:30:00,975,1006,31,0,TRUE,NA,"0.1.4"
"15824","646",2023-02-12 19:45:00,975,1006,31,0,TRUE,NA,"0.1.4"
"15825","646",2023-02-12 20:00:00,975,1006,31,0,TRUE,NA,"0.1.4"
"15826","646",2023-02-12 20:15:00,975,1006,31,0,TRUE,NA,"0.1.4"
"15827","646",2023-02-12 20:30:00,975,1006,31,0,TRUE,NA,"0.1.4"
"15828","646",2023-02-12 20:45:00,975,1006,31,0,TRUE,NA,"0.1.4"
"15829","646",2023-02-12 21:00:00,975,1006,31,0,TRUE,NA,"0.1.4"
"15830","646",2023-02-12 21:15:00,975,1006,31,0,TRUE,NA,"0.1.4"
"15831","646",2023-02-12 21:30:00,975,1006,31,0,TRUE,NA,"0.1.4"
"15832","646",2023-02-12 21:45:00,975,1006,31,0,TRUE,NA,"0.1.4"
"15833","646",2023-02-12 22:00:00,975,1006,31,0,TRUE,NA,"0.1.4"
"15834","646",2023-02-12 22:15:00,975,1006,31,0,TRUE,NA,"0.1.4"
"15835","646",2023-02-12 22:30:00,975,1006,31,0,TRUE,NA,"0.1.4"
"15836","646",2023-02-12 22:45:00,975,1006,31,0,TRUE,NA,"0.1.4"
"15837","646",2023-02-12 23:00:00,975,1006,31,0,FALSE,NA,"0.1.4"
"15838","646",2023-02-12 23:15:00,975,1006,31,0,FALSE,NA,"0.1.4"
"15839","646",2023-02-12 23:30:00,975,1006,31,0,FALSE,NA,"0.1.4"
"15840","646",2023-02-12 23:45:00,975,1006,31,0,FALSE,NA,"0.1.4"
"15841","646",2023-02-13,975,1006,31,0,FALSE,NA,"0.1.4"
"15842","646",2023-02-13 00:15:00,975,1006,31,0,FALSE,NA,"0.1.4"
"15843","646",2023-02-13 00:30:00,976,1006,30,0,FALSE,NA,"0.1.4"
"15844","646",2023-02-13 00:45:00,976,1006,30,0,TRUE,NA,"0.1.4"
"15845","646",2023-02-13 01:00:00,976,1006,30,0,TRUE,NA,"0.1.4"
"15846","646",2023-02-13 01:15:00,976,1006,30,0,TRUE,NA,"0.1.4"
"15847","646",2023-02-13 01:30:00,976,1006,30,0,TRUE,NA,"0.1.4"
"15848","646",2023-02-13 01:45:00,976,1006,30,0,TRUE,NA,"0.1.4"
"15849","646",2023-02-13 02:00:00,976,1006,30,0,TRUE,NA,"0.1.4"
"15850","646",2023-02-13 02:15:00,976,1006,30,0,TRUE,NA,"0.1.4"
"15851","646",2023-02-13 02:30:00,976,1006,30,0,TRUE,NA,"0.1.4"
"15852","646",2023-02-13 02:45:00,976,1006,30,0,TRUE,NA,"0.1.4"
"15853","646",2023-02-13 03:00:00,976,1006,30,0,TRUE,NA,"0.1.4"
"15854","646",2023-02-13 03:15:00,976,1006,30,0,TRUE,NA,"0.1.4"
"15855","646",2023-02-13 03:30:00,976,1006,30,0,TRUE,NA,"0.1.4"
"15856","646",2023-02-13 03:45:00,976,1006,30,0,TRUE,NA,"0.1.4"
"15857","646",2023-02-13 04:00:00,976,1006,30,0,TRUE,NA,"0.1.4"
"15858","646",2023-02-13 04:15:00,976,1006,30,0,TRUE,NA,"0.1.4"
"15859","646",2023-02-13 04:30:00,976,1006,30,0,TRUE,NA,"0.1.4"
"15860","646",2023-02-13 04:45:00,976,1006,30,0,TRUE,NA,"0.1.4"
"15861","646",2023-02-13 05:00:00,976,1006,30,0,TRUE,NA,"0.1.4"
"15862","646",2023-02-13 05:15:00,976,1006,30,0,TRUE,NA,"0.1.4"
"15863","646",2023-02-13 05:30:00,976,1006,30,0,TRUE,NA,"0.1.4"
"15864","646",2023-02-13 05:45:00,976,1006,30,0,TRUE,NA,"0.1.4"
"15865","646",2023-02-13 06:00:00,976,1006,30,0,TRUE,NA,"0.1.4"
"15866","646",2023-02-13 06:15:00,976,1006,30,0,TRUE,NA,"0.1.4"
"15867","646",2023-02-13 06:30:00,975,1006,31,0,TRUE,NA,"0.1.4"
"15868","646",2023-02-13 06:45:00,975,1006,31,0,TRUE,NA,"0.1.4"
"15869","646",2023-02-13 07:00:00,975,1006,31,0,TRUE,NA,"0.1.4"
"15870","646",2023-02-13 07:15:00,975,1006,31,0,TRUE,NA,"0.1.4"
"15871","646",2023-02-13 07:30:00,975,1006,31,0,TRUE,NA,"0.1.4"
"15872","646",2023-02-13 07:45:00,975,1006,31,0,TRUE,NA,"0.1.4"
"15873","646",2023-02-13 08:00:00,976,1006,30,0,TRUE,NA,"0.1.4"
"15874","646",2023-02-13 08:15:00,975,1006,31,0,TRUE,NA,"0.1.4"
"15875","646",2023-02-13 08:30:00,975,1006,31,0,TRUE,NA,"0.1.4"
"15876","646",2023-02-13 08:45:00,976,1006,30,0,TRUE,NA,"0.1.4"
"15877","646",2023-02-13 09:00:00,976,1006,30,0,TRUE,NA,"0.1.4"
"15878","646",2023-02-13 09:15:00,976,1006,30,0,TRUE,NA,"0.1.4"
"15879","646",2023-02-13 09:30:00,976,1006,30,0,TRUE,NA,"0.1.4"
"15880","646",2023-02-13 09:45:00,976,1006,30,0,TRUE,NA,"0.1.4"
"15881","646",2023-02-13 10:00:00,976,1006,30,0,TRUE,NA,"0.1.4"
"15882","646",2023-02-13 10:15:00,976,1006,30,0,TRUE,NA,"0.1.4"
"15883","646",2023-02-13 10:30:00,976,1006,30,0,TRUE,NA,"0.1.4"
"15884","646",2023-02-13 10:45:00,976,1006,30,0,TRUE,NA,"0.1.4"
"15885","646",2023-02-13 11:00:00,976,1006,30,0,TRUE,NA,"0.1.4"
"15886","646",2023-02-13 11:15:00,976,1006,30,0,TRUE,NA,"0.1.4"
"15887","646",2023-02-13 11:30:00,976,1006,30,0,TRUE,NA,"0.1.4"
"15888","646",2023-02-13 11:45:00,976,1006,30,0,TRUE,NA,"0.1.4"
"15889","646",2023-02-13 12:00:00,976,1006,30,0,TRUE,NA,"0.1.4"
"15890","646",2023-02-13 12:15:00,976,1006,30,0,TRUE,NA,"0.1.4"
"15891","646",2023-02-13 12:30:00,976,1006,30,0,TRUE,NA,"0.1.4"
"15892","646",2023-02-13 12:45:00,976,1006,30,0,TRUE,NA,"0.1.4"
"15893","646",2023-02-13 13:00:00,976,1006,30,0,TRUE,NA,"0.1.4"
"15894","646",2023-02-13 13:15:00,976,1006,30,0,TRUE,NA,"0.1.4"
"15895","646",2023-02-13 13:30:00,976,1006,30,0,TRUE,NA,"0.1.4"
"15896","646",2023-02-13 13:45:00,976,1006,30,0,TRUE,NA,"0.1.4"
"15897","646",2023-02-13 14:00:00,976,1006,30,0,TRUE,NA,"0.1.4"
"15898","646",2023-02-13 14:15:00,976,1006,30,0,TRUE,NA,"0.1.4"
"15899","646",2023-02-13 14:30:00,976,1006,30,0,TRUE,NA,"0.1.4"
"15900","646",2023-02-13 14:45:00,976,1006,30,0,TRUE,NA,"0.1.4"
"15901","646",2023-02-13 15:00:00,976,1006,30,0,TRUE,NA,"0.1.4"
"15902","646",2023-02-13 15:15:00,976,1006,30,0,TRUE,NA,"0.1.4"
"15903","646",2023-02-13 15:30:00,976,1006,30,0,TRUE,NA,"0.1.4"
"15904","646",2023-02-13 15:45:00,976,1006,30,0,TRUE,NA,"0.1.4"
"15905","646",2023-02-13 16:00:00,976,1006,30,0,TRUE,NA,"0.1.4"
"15906","646",2023-02-13 16:15:00,976,1006,30,0,TRUE,NA,"0.1.4"
"15907","646",2023-02-13 16:30:00,976,1006,30,0,TRUE,NA,"0.1.4"
"15908","646",2023-02-13 16:45:00,976,1006,30,0,TRUE,NA,"0.1.4"
"15909","646",2023-02-13 17:00:00,976,1006,30,0,TRUE,NA,"0.1.4"
"15910","646",2023-02-13 17:15:00,976,1006,30,0,TRUE,NA,"0.1.4"
"15911","646",2023-02-13 17:30:00,976,1006,30,0,TRUE,NA,"0.1.4"
"15912","646",2023-02-13 17:45:00,976,1006,30,0,TRUE,NA,"0.1.4"
"15913","646",2023-02-13 18:00:00,976,1006,30,0,TRUE,NA,"0.1.4"
"15914","646",2023-02-13 18:15:00,976,1006,30,0,TRUE,NA,"0.1.4"
"15915","646",2023-02-13 18:30:00,976,1006,30,0,TRUE,NA,"0.1.4"
"15916","646",2023-02-13 18:45:00,976,1006,30,0,TRUE,NA,"0.1.4"
"15917","646",2023-02-13 19:00:00,976,1006,30,0,TRUE,NA,"0.1.4"
"15918","646",2023-02-13 19:15:00,976,1006,30,0,TRUE,NA,"0.1.4"
"15919","646",2023-02-13 19:30:00,976,1006,30,0,TRUE,NA,"0.1.4"
"15920","646",2023-02-13 19:45:00,976,1006,30,0,TRUE,NA,"0.1.4"
"15921","646",2023-02-13 20:00:00,976,1006,30,0,TRUE,NA,"0.1.4"
"15922","646",2023-02-13 20:15:00,976,1006,30,0,TRUE,NA,"0.1.4"
"15923","646",2023-02-13 20:30:00,976,1006,30,0,TRUE,NA,"0.1.4"
"15924","646",2023-02-13 20:45:00,976,1006,30,0,TRUE,NA,"0.1.4"
"15925","646",2023-02-13 21:00:00,976,1006,30,0,TRUE,NA,"0.1.4"
"15926","646",2023-02-13 21:15:00,976,1006,30,0,TRUE,NA,"0.1.4"
"15927","646",2023-02-13 21:30:00,976,1006,30,0,TRUE,NA,"0.1.4"
"15928","646",2023-02-13 21:45:00,976,1006,30,0,TRUE,NA,"0.1.4"
"15929","646",2023-02-13 22:00:00,976,1006,30,0,TRUE,NA,"0.1.4"
"15930","646",2023-02-13 22:15:00,976,1006,30,0,TRUE,NA,"0.1.4"
"15931","646",2023-02-13 22:30:00,976,1006,30,0,TRUE,NA,"0.1.4"
"15932","646",2023-02-13 22:45:00,976,1006,30,0,TRUE,NA,"0.1.4"
"15933","646",2023-02-13 23:00:00,976,1006,30,0,TRUE,NA,"0.1.4"
"15934","646",2023-02-13 23:15:00,976,1006,30,0,TRUE,NA,"0.1.4"
"15935","646",2023-02-13 23:30:00,976,1006,30,0,TRUE,NA,"0.1.4"
"15936","646",2023-02-13 23:45:00,976,1006,30,0,TRUE,NA,"0.1.4"
"15937","646",2023-02-14,976,1006,30,0,TRUE,NA,"0.1.4"
"15938","646",2023-02-14 00:15:00,976,1006,30,0,TRUE,NA,"0.1.4"
"15939","646",2023-02-14 00:30:00,976,1006,30,0,TRUE,NA,"0.1.4"
"15940","646",2023-02-14 00:45:00,976,1006,30,0,TRUE,NA,"0.1.4"
"15941","646",2023-02-14 01:00:00,976,1006,30,0,TRUE,NA,"0.1.4"
"15942","646",2023-02-14 01:15:00,976,1006,30,0,TRUE,NA,"0.1.4"
"15943","646",2023-02-14 01:30:00,976,1006,30,0,TRUE,NA,"0.1.4"
"15944","646",2023-02-14 01:45:00,976,1006,30,0,TRUE,NA,"0.1.4"
"15945","646",2023-02-14 02:00:00,976,1006,30,0,TRUE,NA,"0.1.4"
"15946","646",2023-02-14 02:15:00,976,1006,30,0,TRUE,NA,"0.1.4"
"15947","646",2023-02-14 02:30:00,976,1006,30,0,TRUE,NA,"0.1.4"
"15948","646",2023-02-14 02:45:00,976,1006,30,0,TRUE,NA,"0.1.4"
"15949","646",2023-02-14 03:00:00,976,1006,30,0,TRUE,NA,"0.1.4"
"15950","646",2023-02-14 03:15:00,976,1006,30,0,TRUE,NA,"0.1.4"
"15951","646",2023-02-14 03:30:00,976,1006,30,0,TRUE,NA,"0.1.4"
"15952","646",2023-02-14 03:45:00,976,1006,30,0,TRUE,NA,"0.1.4"
"15953","646",2023-02-14 04:00:00,976,1006,30,0,TRUE,NA,"0.1.4"
"15954","646",2023-02-14 04:15:00,976,1006,30,0,TRUE,NA,"0.1.4"
"15955","646",2023-02-14 04:30:00,976,1006,30,0,TRUE,NA,"0.1.4"
"15956","646",2023-02-14 04:45:00,976,1006,30,0,TRUE,NA,"0.1.4"
"15957","646",2023-02-14 05:00:00,976,1006,30,0,TRUE,NA,"0.1.4"
"15958","646",2023-02-14 05:15:00,976,1006,30,0,TRUE,NA,"0.1.4"
"15959","646",2023-02-14 05:30:00,976,1006,30,0,TRUE,NA,"0.1.4"
"15960","646",2023-02-14 05:45:00,976,1006,30,0,TRUE,NA,"0.1.4"
"15961","646",2023-02-14 06:00:00,976,1006,30,0,TRUE,NA,"0.1.4"
"15962","646",2023-02-14 06:15:00,976,1006,30,0,TRUE,NA,"0.1.4"
"15963","646",2023-02-14 06:30:00,976,1006,30,0,TRUE,NA,"0.1.4"
"15964","646",2023-02-14 06:45:00,976,1006,30,0,TRUE,NA,"0.1.4"
"15965","646",2023-02-14 07:00:00,976,1006,30,0,TRUE,NA,"0.1.4"
"15966","646",2023-02-14 07:15:00,976,1006,30,0,TRUE,NA,"0.1.4"
"15967","646",2023-02-14 07:30:00,976,1006,30,0,TRUE,NA,"0.1.4"
"15968","646",2023-02-14 07:45:00,976,1006,30,0,TRUE,NA,"0.1.4"
"15969","646",2023-02-14 08:00:00,976,1006,30,0,TRUE,NA,"0.1.4"
"15970","646",2023-02-14 08:15:00,976,1006,30,0,TRUE,NA,"0.1.4"
"15971","646",2023-02-14 08:30:00,976,1006,30,0,TRUE,NA,"0.1.4"
"15972","646",2023-02-14 08:45:00,976,1006,30,0,TRUE,NA,"0.1.4"
"15973","646",2023-02-14 09:00:00,976,1006,30,0,TRUE,NA,"0.1.4"
"15974","646",2023-02-14 09:15:00,976,1006,30,0,TRUE,NA,"0.1.4"
"15975","646",2023-02-14 09:30:00,976,1006,30,0,TRUE,NA,"0.1.4"
"15976","646",2023-02-14 09:45:00,976,1006,30,0,TRUE,NA,"0.1.4"
"15977","646",2023-02-14 10:00:00,976,1006,30,0,TRUE,NA,"0.1.4"
"15978","646",2023-02-14 10:15:00,976,1006,30,0,TRUE,NA,"0.1.4"
"15979","646",2023-02-14 10:30:00,976,1006,30,0,TRUE,NA,"0.1.4"
"15980","646",2023-02-14 10:45:00,976,1006,30,0,TRUE,NA,"0.1.4"
"15981","646",2023-02-14 11:00:00,976,1006,30,0,TRUE,NA,"0.1.4"
"15982","646",2023-02-14 11:15:00,976,1006,30,0,TRUE,NA,"0.1.4"
"15983","646",2023-02-14 11:30:00,976,1006,30,0,TRUE,NA,"0.1.4"
"15984","646",2023-02-14 11:45:00,976,1006,30,0,TRUE,NA,"0.1.4"
"15985","646",2023-02-14 12:00:00,976,1006,30,0,TRUE,NA,"0.1.4"
"15986","646",2023-02-14 12:15:00,976,1006,30,0,TRUE,NA,"0.1.4"
"15987","646",2023-02-14 12:30:00,976,1006,30,0,TRUE,NA,"0.1.4"
"15988","646",2023-02-14 12:45:00,976,1006,30,0,TRUE,NA,"0.1.4"
"15989","646",2023-02-14 13:00:00,976,1006,30,0,TRUE,NA,"0.1.4"
"15990","646",2023-02-14 13:15:00,976,1006,30,0,TRUE,NA,"0.1.4"
"15991","646",2023-02-14 13:30:00,976,1006,30,0,TRUE,NA,"0.1.4"
"15992","646",2023-02-14 13:45:00,976,1006,30,0,TRUE,NA,"0.1.4"
"15993","646",2023-02-14 14:00:00,976,1006,30,0,TRUE,NA,"0.1.4"
"15994","646",2023-02-14 14:15:00,976,1006,30,0,TRUE,NA,"0.1.4"
"15995","646",2023-02-14 14:30:00,976,1006,30,0,TRUE,NA,"0.1.4"
"15996","646",2023-02-14 14:45:00,976,1006,30,0,TRUE,NA,"0.1.4"
"15997","646",2023-02-14 15:00:00,976,1006,30,0,TRUE,NA,"0.1.4"
"15998","646",2023-02-14 15:15:00,976,1006,30,0,TRUE,NA,"0.1.4"
"15999","646",2023-02-14 15:30:00,976,1006,30,0,TRUE,NA,"0.1.4"
"16000","646",2023-02-14 15:45:00,976,1006,30,0,TRUE,NA,"0.1.4"
"16001","646",2023-02-14 16:00:00,976,1006,30,0,TRUE,NA,"0.1.4"
"16002","646",2023-02-14 16:15:00,976,1006,30,0,TRUE,NA,"0.1.4"
"16003","646",2023-02-14 16:30:00,976,1006,30,0,TRUE,NA,"0.1.4"
"16004","646",2023-02-14 16:45:00,976,1006,30,0,TRUE,NA,"0.1.4"
"16005","646",2023-02-14 17:00:00,976,1006,30,0,TRUE,NA,"0.1.4"
"16006","646",2023-02-14 17:15:00,976,1006,30,0,TRUE,NA,"0.1.4"
"16007","646",2023-02-14 17:30:00,976,1006,30,0,TRUE,NA,"0.1.4"
"16008","646",2023-02-14 17:45:00,976,1006,30,0,TRUE,NA,"0.1.4"
"16009","646",2023-02-14 18:00:00,976,1006,30,0,TRUE,NA,"0.1.4"
"16010","646",2023-02-14 18:15:00,976,1006,30,0,TRUE,NA,"0.1.4"
"16011","646",2023-02-14 18:30:00,976,1006,30,0,TRUE,NA,"0.1.4"
"16012","646",2023-02-14 18:45:00,976,1006,30,0,TRUE,NA,"0.1.4"
"16013","646",2023-02-14 19:00:00,976,1006,30,0,TRUE,NA,"0.1.4"
"16014","646",2023-02-14 19:15:00,976,1006,30,0,TRUE,NA,"0.1.4"
"16015","646",2023-02-14 19:30:00,976,1006,30,0,TRUE,NA,"0.1.4"
"16016","646",2023-02-14 19:45:00,976,1006,30,0,TRUE,NA,"0.1.4"
"16017","646",2023-02-14 20:00:00,976,1006,30,0,TRUE,NA,"0.1.4"
"16018","646",2023-02-14 20:15:00,976,1006,30,0,TRUE,NA,"0.1.4"
"16019","646",2023-02-14 20:30:00,976,1006,30,0,TRUE,NA,"0.1.4"
"16020","646",2023-02-14 20:45:00,976,1006,30,0,TRUE,NA,"0.1.4"
"16021","646",2023-02-14 21:00:00,976,1006,30,0,TRUE,NA,"0.1.4"
"16022","646",2023-02-14 21:15:00,976,1006,30,0,TRUE,NA,"0.1.4"
"16023","646",2023-02-14 21:30:00,976,1006,30,0,TRUE,NA,"0.1.4"
"16024","646",2023-02-14 21:45:00,976,1006,30,0,TRUE,NA,"0.1.4"
"16025","646",2023-02-14 22:00:00,976,1006,30,0,TRUE,NA,"0.1.4"
"16026","646",2023-02-14 22:15:00,976,1006,30,0,TRUE,NA,"0.1.4"
"16027","646",2023-02-14 22:30:00,976,1006,30,0,TRUE,NA,"0.1.4"
"16028","646",2023-02-14 22:45:00,976,1006,30,0,TRUE,NA,"0.1.4"
"16029","646",2023-02-14 23:00:00,976,1006,30,0,TRUE,NA,"0.1.4"
"16030","646",2023-02-14 23:15:00,976,1006,30,0,TRUE,NA,"0.1.4"
"16031","646",2023-02-14 23:30:00,976,1006,30,0,TRUE,NA,"0.1.4"
"16032","646",2023-02-14 23:45:00,976,1006,30,0,TRUE,NA,"0.1.4"
"16033","646",2023-02-15,976,1006,30,0,TRUE,NA,"0.1.4"
"16034","646",2023-02-15 00:15:00,976,1006,30,0,TRUE,NA,"0.1.4"
"16035","646",2023-02-15 00:30:00,976,1006,30,0,TRUE,NA,"0.1.4"
"16036","646",2023-02-15 00:45:00,976,1006,30,0,TRUE,NA,"0.1.4"
"16037","646",2023-02-15 01:00:00,976,1006,30,0,TRUE,NA,"0.1.4"
"16038","646",2023-02-15 01:15:00,976,1006,30,0,TRUE,NA,"0.1.4"
"16039","646",2023-02-15 01:30:00,976,1006,30,0,TRUE,NA,"0.1.4"
"16040","646",2023-02-15 01:45:00,976,1006,30,0,TRUE,NA,"0.1.4"
"16041","646",2023-02-15 02:00:00,976,1006,30,0,TRUE,NA,"0.1.4"
"16042","646",2023-02-15 02:15:00,976,1006,30,0,TRUE,NA,"0.1.4"
"16043","646",2023-02-15 02:30:00,976,1006,30,0,TRUE,NA,"0.1.4"
"16044","646",2023-02-15 02:45:00,976,1006,30,0,TRUE,NA,"0.1.4"
"16045","646",2023-02-15 03:00:00,976,1006,30,0,TRUE,NA,"0.1.4"
"16046","646",2023-02-15 03:15:00,976,1006,30,0,TRUE,NA,"0.1.4"
"16047","646",2023-02-15 03:30:00,976,1006,30,0,TRUE,NA,"0.1.4"
"16048","646",2023-02-15 03:45:00,976,1006,30,0,TRUE,NA,"0.1.4"
"16049","646",2023-02-15 04:00:00,976,1006,30,0,TRUE,NA,"0.1.4"
"16050","646",2023-02-15 04:15:00,976,1006,30,0,TRUE,NA,"0.1.4"
"16051","646",2023-02-15 04:30:00,976,1006,30,0,TRUE,NA,"0.1.4"
"16052","646",2023-02-15 04:45:00,976,1006,30,0,TRUE,NA,"0.1.4"
"16053","646",2023-02-15 05:00:00,976,1006,30,0,TRUE,NA,"0.1.4"
"16054","646",2023-02-15 05:15:00,976,1006,30,0,TRUE,NA,"0.1.4"
"16055","646",2023-02-15 05:30:00,976,1006,30,0,TRUE,NA,"0.1.4"
"16056","646",2023-02-15 05:45:00,976,1006,30,0,TRUE,NA,"0.1.4"
"16057","646",2023-02-15 06:00:00,976,1006,30,0,TRUE,NA,"0.1.4"
"16058","646",2023-02-15 06:15:00,975,1006,31,0,TRUE,NA,"0.1.4"
"16059","646",2023-02-15 06:30:00,975,1006,31,0,TRUE,NA,"0.1.4"
"16060","646",2023-02-15 06:45:00,975,1006,31,0,TRUE,NA,"0.1.4"
"16061","646",2023-02-15 07:00:00,976,1006,30,0,TRUE,NA,"0.1.4"
"16062","646",2023-02-15 07:15:00,975,1006,31,0,TRUE,NA,"0.1.4"
"16063","646",2023-02-15 07:30:00,975,1006,31,0,TRUE,NA,"0.1.4"
"16064","646",2023-02-15 07:45:00,976,1006,30,0,TRUE,NA,"0.1.4"
"16065","646",2023-02-15 08:00:00,976,1006,30,0,TRUE,NA,"0.1.4"
"16066","646",2023-02-15 08:15:00,976,1006,30,0,TRUE,NA,"0.1.4"
"16067","646",2023-02-15 08:30:00,976,1006,30,0,TRUE,NA,"0.1.4"
"16068","646",2023-02-15 08:45:00,976,1006,30,0,TRUE,NA,"0.1.4"
"16069","646",2023-02-15 09:00:00,976,1006,30,0,TRUE,NA,"0.1.4"
"16070","646",2023-02-15 09:15:00,976,1006,30,0,TRUE,NA,"0.1.4"
"16071","646",2023-02-15 09:30:00,976,1006,30,0,TRUE,NA,"0.1.4"
"16072","646",2023-02-15 09:45:00,976,1006,30,0,TRUE,NA,"0.1.4"
"16073","646",2023-02-15 10:00:00,976,1006,30,0,TRUE,NA,"0.1.4"
"16074","646",2023-02-15 10:15:00,976,1006,30,0,TRUE,NA,"0.1.4"
"16075","646",2023-02-15 10:30:00,976,1006,30,0,TRUE,NA,"0.1.4"
"16076","646",2023-02-15 10:45:00,976,1006,30,0,TRUE,NA,"0.1.4"
"16077","646",2023-02-15 11:00:00,976,1006,30,0,TRUE,NA,"0.1.4"
"16078","646",2023-02-15 11:15:00,976,1006,30,0,TRUE,NA,"0.1.4"
"16079","646",2023-02-15 11:30:00,976,1006,30,0,TRUE,NA,"0.1.4"
"16080","646",2023-02-15 11:45:00,976,1006,30,0,TRUE,NA,"0.1.4"
"16081","646",2023-02-15 12:00:00,976,1006,30,0,TRUE,NA,"0.1.4"
"16082","646",2023-02-15 12:15:00,976,1006,30,0,TRUE,NA,"0.1.4"
"16083","646",2023-02-15 12:30:00,976,1006,30,0,TRUE,NA,"0.1.4"
"16084","646",2023-02-15 12:45:00,976,1006,30,0,TRUE,NA,"0.1.4"
"16085","646",2023-02-15 13:00:00,976,1006,30,0,TRUE,NA,"0.1.4"
"16086","646",2023-02-15 13:15:00,976,1006,30,0,TRUE,NA,"0.1.4"
"16087","646",2023-02-15 13:30:00,976,1006,30,0,TRUE,NA,"0.1.4"
"16088","646",2023-02-15 13:45:00,976,1006,30,0,TRUE,NA,"0.1.4"
"16089","646",2023-02-15 14:00:00,976,1006,30,0,TRUE,NA,"0.1.4"
"16090","646",2023-02-15 14:15:00,976,1006,30,0,TRUE,NA,"0.1.4"
"16091","646",2023-02-15 14:30:00,976,1006,30,0,TRUE,NA,"0.1.4"
"16092","646",2023-02-15 14:45:00,976,1006,30,0,TRUE,NA,"0.1.4"
"16093","646",2023-02-15 15:00:00,976,1006,30,0,TRUE,NA,"0.1.4"
"16094","646",2023-02-15 15:15:00,976,1006,30,0,TRUE,NA,"0.1.4"
"16095","646",2023-02-15 15:30:00,976,1006,30,0,TRUE,NA,"0.1.4"
"16096","646",2023-02-15 15:45:00,976,1006,30,0,TRUE,NA,"0.1.4"
"16097","646",2023-02-15 16:00:00,976,1006,30,0,TRUE,NA,"0.1.4"
"16098","646",2023-02-15 16:15:00,976,1006,30,0,TRUE,NA,"0.1.4"
"16099","646",2023-02-15 16:30:00,976,1006,30,0,TRUE,NA,"0.1.4"
"16100","646",2023-02-15 16:45:00,976,1006,30,0,TRUE,NA,"0.1.4"
"16101","646",2023-02-15 17:00:00,976,1006,30,0,TRUE,NA,"0.1.4"
"16102","646",2023-02-15 17:15:00,976,1006,30,0,TRUE,NA,"0.1.4"
"16103","646",2023-02-15 17:30:00,976,1006,30,0,TRUE,NA,"0.1.4"
"16104","646",2023-02-15 17:45:00,976,1006,30,0,TRUE,NA,"0.1.4"
"16105","646",2023-02-15 18:00:00,976,1006,30,0,TRUE,NA,"0.1.4"
"16106","646",2023-02-15 18:15:00,976,1006,30,0,TRUE,NA,"0.1.4"
"16107","646",2023-02-15 18:30:00,976,1006,30,0,TRUE,NA,"0.1.4"
"16108","646",2023-02-15 18:45:00,976,1006,30,0,TRUE,NA,"0.1.4"
"16109","646",2023-02-15 19:00:00,976,1006,30,0,TRUE,NA,"0.1.4"
"16110","646",2023-02-15 19:15:00,976,1006,30,0,TRUE,NA,"0.1.4"
"16111","646",2023-02-15 19:30:00,976,1006,30,0,TRUE,NA,"0.1.4"
"16112","646",2023-02-15 19:45:00,976,1006,30,0,TRUE,NA,"0.1.4"
"16113","646",2023-02-15 20:00:00,976,1006,30,0,TRUE,NA,"0.1.4"
"16114","646",2023-02-15 20:15:00,976,1006,30,0,TRUE,NA,"0.1.4"
"16115","646",2023-02-15 20:30:00,976,1006,30,0,TRUE,NA,"0.1.4"
"16116","646",2023-02-15 20:45:00,976,1006,30,0,TRUE,NA,"0.1.4"
"16117","646",2023-02-15 21:00:00,976,1006,30,0,TRUE,NA,"0.1.4"
"16118","646",2023-02-15 21:15:00,976,1006,30,0,TRUE,NA,"0.1.4"
"16119","646",2023-02-15 21:30:00,976,1006,30,0,TRUE,NA,"0.1.4"
"16120","646",2023-02-15 21:45:00,976,1006,30,0,TRUE,NA,"0.1.4"
"16121","646",2023-02-15 22:00:00,976,1006,30,0,TRUE,NA,"0.1.4"
"16122","646",2023-02-15 22:15:00,976,1006,30,0,TRUE,NA,"0.1.4"
"16123","646",2023-02-15 22:30:00,976,1006,30,0,TRUE,NA,"0.1.4"
"16124","646",2023-02-15 22:45:00,976,1006,30,0,TRUE,NA,"0.1.4"
"16125","646",2023-02-15 23:00:00,976,1006,30,0,TRUE,NA,"0.1.4"
"16126","646",2023-02-15 23:15:00,976,1006,30,0,TRUE,NA,"0.1.4"
"16127","646",2023-02-15 23:30:00,976,1006,30,0,TRUE,NA,"0.1.4"
"16128","646",2023-02-15 23:45:00,976,1006,30,0,TRUE,NA,"0.1.4"
"16129","646",2023-02-16,976,1006,30,0,TRUE,NA,"0.1.4"
"16130","646",2023-02-16 00:15:00,976,1006,30,0,TRUE,NA,"0.1.4"
"16131","646",2023-02-16 00:30:00,976,1006,30,0,TRUE,NA,"0.1.4"
"16132","646",2023-02-16 00:45:00,976,1006,30,0,TRUE,NA,"0.1.4"
"16133","646",2023-02-16 01:00:00,976,1006,30,0,TRUE,NA,"0.1.4"
"16134","646",2023-02-16 01:15:00,976,1006,30,0,TRUE,NA,"0.1.4"
"16135","646",2023-02-16 01:30:00,976,1006,30,0,TRUE,NA,"0.1.4"
"16136","646",2023-02-16 01:45:00,976,1006,30,0,TRUE,NA,"0.1.4"
"16137","646",2023-02-16 02:00:00,976,1006,30,0,TRUE,NA,"0.1.4"
"16138","646",2023-02-16 02:15:00,976,1006,30,0,TRUE,NA,"0.1.4"
"16139","646",2023-02-16 02:30:00,976,1006,30,0,TRUE,NA,"0.1.4"
"16140","646",2023-02-16 02:45:00,976,1006,30,0,TRUE,NA,"0.1.4"
"16141","646",2023-02-16 03:00:00,976,1006,30,0,TRUE,NA,"0.1.4"
"16142","646",2023-02-16 03:15:00,976,1006,30,0,TRUE,NA,"0.1.4"
"16143","646",2023-02-16 03:30:00,977,1006,29,0,TRUE,NA,"0.1.4"
"16144","646",2023-02-16 03:45:00,976,1006,30,0,TRUE,NA,"0.1.4"
"16145","646",2023-02-16 04:00:00,977,1006,29,0,TRUE,NA,"0.1.4"
"16146","646",2023-02-16 04:15:00,976,1006,30,0,TRUE,NA,"0.1.4"
"16147","646",2023-02-16 04:30:00,976,1006,30,0,TRUE,NA,"0.1.4"
"16148","646",2023-02-16 04:45:00,976,1006,30,0,TRUE,NA,"0.1.4"
"16149","646",2023-02-16 05:00:00,977,1006,29,0,TRUE,NA,"0.1.4"
"16150","646",2023-02-16 05:15:00,976,1006,30,0,TRUE,NA,"0.1.4"
"16151","646",2023-02-16 05:30:00,976,1006,30,0,TRUE,NA,"0.1.4"
"16152","646",2023-02-16 05:45:00,976,1006,30,0,TRUE,NA,"0.1.4"
"16153","646",2023-02-16 06:00:00,976,1006,30,0,TRUE,NA,"0.1.4"
"16154","646",2023-02-16 06:15:00,976,1006,30,0,TRUE,NA,"0.1.4"
"16155","646",2023-02-16 06:30:00,976,1006,30,0,TRUE,NA,"0.1.4"
"16156","646",2023-02-16 06:45:00,976,1006,30,0,TRUE,NA,"0.1.4"
"16157","646",2023-02-16 07:00:00,976,1006,30,0,TRUE,NA,"0.1.4"
"16158","646",2023-02-16 07:15:00,976,1006,30,0,TRUE,NA,"0.1.4"
"16159","646",2023-02-16 07:30:00,976,1006,30,0,TRUE,NA,"0.1.4"
"16160","646",2023-02-16 07:45:00,976,1006,30,0,TRUE,NA,"0.1.4"
"16161","646",2023-02-16 08:00:00,976,1006,30,0,TRUE,NA,"0.1.4"
"16162","646",2023-02-16 08:15:00,976,1006,30,0,TRUE,NA,"0.1.4"
"16163","646",2023-02-16 08:30:00,976,1006,30,0,TRUE,NA,"0.1.4"
"16164","646",2023-02-16 08:45:00,976,1006,30,0,TRUE,NA,"0.1.4"
"16165","646",2023-02-16 09:00:00,976,1006,30,0,TRUE,NA,"0.1.4"
"16166","646",2023-02-16 09:15:00,976,1006,30,0,TRUE,NA,"0.1.4"
"16167","646",2023-02-16 09:30:00,977,1006,29,0,TRUE,NA,"0.1.4"
"16168","646",2023-02-16 09:45:00,977,1006,29,0,TRUE,NA,"0.1.4"
"16169","646",2023-02-16 10:00:00,977,1006,29,0,TRUE,NA,"0.1.4"
"16170","646",2023-02-16 10:15:00,977,1006,29,0,TRUE,NA,"0.1.4"
"16171","646",2023-02-16 10:30:00,977,1006,29,0,TRUE,NA,"0.1.4"
"16172","646",2023-02-16 10:45:00,977,1006,29,0,TRUE,NA,"0.1.4"
"16173","646",2023-02-16 11:00:00,977,1006,29,0,TRUE,NA,"0.1.4"
"16174","646",2023-02-16 11:15:00,977,1006,29,0,TRUE,NA,"0.1.4"
"16175","646",2023-02-16 11:30:00,977,1006,29,0,TRUE,NA,"0.1.4"
"16176","646",2023-02-16 11:45:00,977,1006,29,0,TRUE,NA,"0.1.4"
"16177","646",2023-02-16 12:00:00,977,1006,29,0,TRUE,NA,"0.1.4"
"16178","646",2023-02-16 12:15:00,977,1006,29,0,TRUE,NA,"0.1.4"
"16179","646",2023-02-16 12:30:00,977,1006,29,0,TRUE,NA,"0.1.4"
"16180","646",2023-02-16 12:45:00,977,1006,29,0,TRUE,NA,"0.1.4"
"16181","646",2023-02-16 13:00:00,977,1006,29,0,TRUE,NA,"0.1.4"
"16182","646",2023-02-16 13:15:00,977,1006,29,0,TRUE,NA,"0.1.4"
"16183","646",2023-02-16 13:30:00,977,1006,29,0,TRUE,NA,"0.1.4"
"16184","646",2023-02-16 13:45:00,977,1006,29,0,TRUE,NA,"0.1.4"
"16185","646",2023-02-16 14:00:00,977,1006,29,0,TRUE,NA,"0.1.4"
"16186","646",2023-02-16 14:15:00,977,1006,29,0,TRUE,NA,"0.1.4"
"16187","646",2023-02-16 14:30:00,977,1006,29,0,TRUE,NA,"0.1.4"
"16188","646",2023-02-16 14:45:00,977,1006,29,0,TRUE,NA,"0.1.4"
"16189","646",2023-02-16 15:00:00,977,1006,29,0,TRUE,NA,"0.1.4"
"16190","646",2023-02-16 15:15:00,977,1006,29,0,TRUE,NA,"0.1.4"
"16191","646",2023-02-16 15:30:00,977,1006,29,0,TRUE,NA,"0.1.4"
"16192","646",2023-02-16 15:45:00,977,1006,29,0,TRUE,NA,"0.1.4"
"16193","646",2023-02-16 16:00:00,977,1006,29,0,TRUE,NA,"0.1.4"
"16194","646",2023-02-16 16:15:00,977,1006,29,0,TRUE,NA,"0.1.4"
"16195","646",2023-02-16 16:30:00,977,1006,29,0,TRUE,NA,"0.1.4"
"16196","646",2023-02-16 16:45:00,977,1006,29,0,TRUE,NA,"0.1.4"
"16197","646",2023-02-16 17:00:00,977,1006,29,0,TRUE,NA,"0.1.4"
"16198","646",2023-02-16 17:15:00,977,1006,29,0,TRUE,NA,"0.1.4"
"16199","646",2023-02-16 17:30:00,977,1006,29,0,TRUE,NA,"0.1.4"
"16200","646",2023-02-16 17:45:00,977,1006,29,0,TRUE,NA,"0.1.4"
"16201","646",2023-02-16 18:00:00,976,1006,30,0,TRUE,NA,"0.1.4"
"16202","646",2023-02-16 18:15:00,977,1006,29,0,TRUE,NA,"0.1.4"
"16203","646",2023-02-16 18:30:00,977,1006,29,0,TRUE,NA,"0.1.4"
"16204","646",2023-02-16 18:45:00,976,1006,30,0,TRUE,NA,"0.1.4"
"16205","646",2023-02-16 19:00:00,976,1006,30,0,TRUE,NA,"0.1.4"
"16206","646",2023-02-16 19:15:00,976,1006,30,0,TRUE,NA,"0.1.4"
"16207","646",2023-02-16 19:30:00,976,1006,30,0,TRUE,NA,"0.1.4"
"16208","646",2023-02-16 19:45:00,976,1006,30,0,TRUE,NA,"0.1.4"
"16209","646",2023-02-16 20:00:00,976,1006,30,0,TRUE,NA,"0.1.4"
"16210","646",2023-02-16 20:15:00,976,1006,30,0,TRUE,NA,"0.1.4"
"16211","646",2023-02-16 20:30:00,976,1006,30,0,TRUE,NA,"0.1.4"
"16212","646",2023-02-16 20:45:00,976,1006,30,0,TRUE,NA,"0.1.4"
"16213","646",2023-02-16 21:00:00,976,1006,30,0,TRUE,NA,"0.1.4"
"16214","646",2023-02-16 21:15:00,976,1006,30,0,TRUE,NA,"0.1.4"
"16215","646",2023-02-16 21:30:00,977,1006,29,0,TRUE,NA,"0.1.4"
"16216","646",2023-02-16 21:45:00,977,1006,29,0,TRUE,NA,"0.1.4"
"16217","646",2023-02-16 22:00:00,977,1006,29,0,TRUE,NA,"0.1.4"
"16218","646",2023-02-16 22:15:00,977,1006,29,0,TRUE,NA,"0.1.4"
"16219","646",2023-02-16 22:30:00,977,1006,29,0,TRUE,NA,"0.1.4"
"16220","646",2023-02-16 22:45:00,977,1006,29,0,TRUE,NA,"0.1.4"
"16221","646",2023-02-16 23:00:00,977,1006,29,0,TRUE,NA,"0.1.4"
"16222","646",2023-02-16 23:15:00,977,1006,29,0,TRUE,NA,"0.1.4"
"16223","646",2023-02-16 23:30:00,977,1006,29,0,TRUE,NA,"0.1.4"
"16224","646",2023-02-16 23:45:00,977,1006,29,0,TRUE,NA,"0.1.4"
"16225","646",2023-02-17,977,1006,29,0,TRUE,NA,"0.1.4"
"16226","646",2023-02-17 00:15:00,977,1006,29,0,TRUE,NA,"0.1.4"
"16227","646",2023-02-17 00:30:00,977,1006,29,0,TRUE,NA,"0.1.4"
"16228","646",2023-02-17 00:45:00,977,1006,29,0,TRUE,NA,"0.1.4"
"16229","646",2023-02-17 01:00:00,977,1006,29,0,TRUE,NA,"0.1.4"
"16230","646",2023-02-17 01:15:00,977,1006,29,0,TRUE,NA,"0.1.4"
"16231","646",2023-02-17 01:30:00,977,1006,29,0,TRUE,NA,"0.1.4"
"16232","646",2023-02-17 01:45:00,977,1006,29,0,TRUE,NA,"0.1.4"
"16233","646",2023-02-17 02:00:00,977,1006,29,0,TRUE,NA,"0.1.4"
"16234","646",2023-02-17 02:15:00,977,1006,29,0,TRUE,NA,"0.1.4"
"16235","646",2023-02-17 02:30:00,977,1006,29,0,TRUE,NA,"0.1.4"
"16236","646",2023-02-17 02:45:00,977,1006,29,0,TRUE,NA,"0.1.4"
"16237","646",2023-02-17 03:00:00,977,1006,29,0,TRUE,NA,"0.1.4"
"16238","646",2023-02-17 03:15:00,977,1006,29,0,TRUE,NA,"0.1.4"
"16239","646",2023-02-17 03:30:00,977,1006,29,0,TRUE,NA,"0.1.4"
"16240","646",2023-02-17 03:45:00,977,1006,29,0,TRUE,NA,"0.1.4"
"16241","646",2023-02-17 04:00:00,977,1006,29,0,TRUE,NA,"0.1.4"
"16242","646",2023-02-17 04:15:00,977,1006,29,0,TRUE,NA,"0.1.4"
"16243","646",2023-02-17 04:30:00,977,1006,29,0,TRUE,NA,"0.1.4"
"16244","646",2023-02-17 04:45:00,977,1006,29,0,TRUE,NA,"0.1.4"
"16245","646",2023-02-17 05:00:00,977,1006,29,0,TRUE,NA,"0.1.4"
"16246","646",2023-02-17 05:15:00,977,1006,29,0,TRUE,NA,"0.1.4"
"16247","646",2023-02-17 05:30:00,977,1006,29,0,TRUE,NA,"0.1.4"
"16248","646",2023-02-17 05:45:00,977,1006,29,0,TRUE,NA,"0.1.4"
"16249","646",2023-02-17 06:00:00,977,1006,29,0,TRUE,NA,"0.1.4"
"16250","646",2023-02-17 06:15:00,977,1006,29,0,TRUE,NA,"0.1.4"
"16251","646",2023-02-17 06:30:00,977,1006,29,0,TRUE,NA,"0.1.4"
"16252","646",2023-02-17 06:45:00,977,1006,29,0,TRUE,NA,"0.1.4"
"16253","646",2023-02-17 07:00:00,977,1006,29,0,TRUE,NA,"0.1.4"
"16254","646",2023-02-17 07:15:00,977,1006,29,0,TRUE,NA,"0.1.4"
"16255","646",2023-02-17 07:30:00,977,1006,29,0,TRUE,NA,"0.1.4"
"16256","646",2023-02-17 07:45:00,977,1006,29,0,TRUE,NA,"0.1.4"
"16257","646",2023-02-17 08:00:00,977,1006,29,0,TRUE,NA,"0.1.4"
"16258","646",2023-02-17 08:15:00,977,1006,29,0,TRUE,NA,"0.1.4"
"16259","646",2023-02-17 08:30:00,977,1006,29,0,TRUE,NA,"0.1.4"
"16260","646",2023-02-17 08:45:00,977,1006,29,0,TRUE,NA,"0.1.4"
"16261","646",2023-02-17 09:00:00,977,1006,29,0,TRUE,NA,"0.1.4"
"16262","646",2023-02-17 09:15:00,977,1006,29,0,TRUE,NA,"0.1.4"
"16263","646",2023-02-17 09:30:00,977,1006,29,0,TRUE,NA,"0.1.4"
"16264","646",2023-02-17 09:45:00,977,1006,29,0,TRUE,NA,"0.1.4"
"16265","646",2023-02-17 10:00:00,977,1006,29,0,TRUE,NA,"0.1.4"
"16266","646",2023-02-17 10:15:00,977,1006,29,0,TRUE,NA,"0.1.4"
"16267","646",2023-02-17 10:30:00,977,1006,29,0,TRUE,NA,"0.1.4"
"16268","646",2023-02-17 10:45:00,977,1006,29,0,TRUE,NA,"0.1.4"
"16269","646",2023-02-17 11:00:00,977,1006,29,0,TRUE,NA,"0.1.4"
"16270","646",2023-02-17 11:15:00,977,1006,29,0,TRUE,NA,"0.1.4"
"16271","646",2023-02-17 11:30:00,977,1006,29,0,TRUE,NA,"0.1.4"
"16272","646",2023-02-17 11:45:00,977,1006,29,0,TRUE,NA,"0.1.4"
"16273","646",2023-02-17 12:00:00,977,1006,29,0,TRUE,NA,"0.1.4"
"16274","646",2023-02-17 12:15:00,977,1006,29,0,TRUE,NA,"0.1.4"
"16275","646",2023-02-17 12:30:00,977,1006,29,0,TRUE,NA,"0.1.4"
"16276","646",2023-02-17 12:45:00,977,1006,29,0,TRUE,NA,"0.1.4"
"16277","646",2023-02-17 13:00:00,977,1006,29,0,TRUE,NA,"0.1.4"
"16278","646",2023-02-17 13:15:00,977,1006,29,0,TRUE,NA,"0.1.4"
"16279","646",2023-02-17 13:30:00,977,1006,29,0,TRUE,NA,"0.1.4"
"16280","646",2023-02-17 13:45:00,977,1006,29,0,TRUE,NA,"0.1.4"
"16281","646",2023-02-17 14:00:00,977,1006,29,0,TRUE,NA,"0.1.4"
"16282","646",2023-02-17 14:15:00,977,1006,29,0,TRUE,NA,"0.1.4"
"16283","646",2023-02-17 14:30:00,977,1006,29,0,TRUE,NA,"0.1.4"
"16284","646",2023-02-17 14:45:00,977,1006,29,0,TRUE,NA,"0.1.4"
"16285","646",2023-02-17 15:00:00,977,1006,29,0,TRUE,NA,"0.1.4"
"16286","646",2023-02-17 15:15:00,978,1006,28,0,TRUE,NA,"0.1.4"
"16287","646",2023-02-17 15:30:00,978,1006,28,0,TRUE,NA,"0.1.4"
"16288","646",2023-02-17 15:45:00,978,1006,28,0,TRUE,NA,"0.1.4"
"16289","646",2023-02-17 16:00:00,978,1006,28,0,TRUE,NA,"0.1.4"
"16290","646",2023-02-17 16:15:00,978,1006,28,0,TRUE,NA,"0.1.4"
"16291","646",2023-02-17 16:30:00,978,1006,28,0,TRUE,NA,"0.1.4"
"16292","646",2023-02-17 16:45:00,978,1006,28,0,TRUE,NA,"0.1.4"
"16293","646",2023-02-17 17:00:00,978,1006,28,0,TRUE,NA,"0.1.4"
"16294","646",2023-02-17 17:15:00,978,1006,28,0,TRUE,NA,"0.1.4"
"16295","646",2023-02-17 17:30:00,978,1006,28,0,TRUE,NA,"0.1.4"
"16296","646",2023-02-17 17:45:00,977,1006,29,0,TRUE,NA,"0.1.4"
"16297","646",2023-02-17 18:00:00,977,1006,29,0,TRUE,NA,"0.1.4"
"16298","646",2023-02-17 18:15:00,977,1006,29,0,TRUE,NA,"0.1.4"
"16299","646",2023-02-17 18:30:00,977,1006,29,0,TRUE,NA,"0.1.4"
"16300","646",2023-02-17 18:45:00,977,1006,29,0,TRUE,NA,"0.1.4"
"16301","646",2023-02-17 19:00:00,978,1006,28,0,TRUE,NA,"0.1.4"
"16302","646",2023-02-17 19:15:00,977,1006,29,0,TRUE,NA,"0.1.4"
"16303","646",2023-02-17 19:30:00,978,1006,28,0,TRUE,NA,"0.1.4"
"16304","646",2023-02-17 19:45:00,978,1006,28,0,TRUE,NA,"0.1.4"
"16305","646",2023-02-17 20:00:00,977,1006,29,0,TRUE,NA,"0.1.4"
"16306","646",2023-02-17 20:15:00,978,1006,28,0,TRUE,NA,"0.1.4"
"16307","646",2023-02-17 20:30:00,978,1006,28,0,TRUE,NA,"0.1.4"
"16308","646",2023-02-17 20:45:00,978,1006,28,0,TRUE,NA,"0.1.4"
"16309","646",2023-02-17 21:00:00,978,1006,28,0,TRUE,NA,"0.1.4"
"16310","646",2023-02-17 21:15:00,978,1006,28,0,TRUE,NA,"0.1.4"
"16311","646",2023-02-17 21:30:00,978,1006,28,0,TRUE,NA,"0.1.4"
"16312","646",2023-02-17 21:45:00,978,1006,28,0,TRUE,NA,"0.1.4"
"16313","646",2023-02-17 22:00:00,978,1006,28,0,TRUE,NA,"0.1.4"
"16314","646",2023-02-17 22:15:00,978,1006,28,0,TRUE,NA,"0.1.4"
"16315","646",2023-02-17 22:30:00,977,1006,29,0,TRUE,NA,"0.1.4"
"16316","646",2023-02-17 22:45:00,977,1006,29,0,TRUE,NA,"0.1.4"
"16317","646",2023-02-17 23:00:00,977,1006,29,0,TRUE,NA,"0.1.4"
"16318","646",2023-02-17 23:15:00,977,1006,29,0,TRUE,NA,"0.1.4"
"16319","646",2023-02-17 23:30:00,978,1006,28,0,TRUE,NA,"0.1.4"
"16320","646",2023-02-17 23:45:00,978,1006,28,0,TRUE,NA,"0.1.4"
"16321","646",2023-02-18,978,1006,28,0,TRUE,NA,"0.1.4"
"16322","646",2023-02-18 00:15:00,978,1006,28,0,TRUE,NA,"0.1.4"
"16323","646",2023-02-18 00:30:00,977,1006,29,0,TRUE,NA,"0.1.4"
"16324","646",2023-02-18 00:45:00,977,1006,29,0,TRUE,NA,"0.1.4"
"16325","646",2023-02-18 01:00:00,978,1006,28,0,TRUE,NA,"0.1.4"
"16326","646",2023-02-18 01:15:00,977,1006,29,0,TRUE,NA,"0.1.4"
"16327","646",2023-02-18 01:30:00,977,1006,29,0,TRUE,NA,"0.1.4"
"16328","646",2023-02-18 01:45:00,978,1006,28,0,TRUE,NA,"0.1.4"
"16329","646",2023-02-18 02:00:00,977,1006,29,0,TRUE,NA,"0.1.4"
"16330","646",2023-02-18 02:15:00,977,1006,29,0,TRUE,NA,"0.1.4"
"16331","646",2023-02-18 02:30:00,977,1006,29,0,TRUE,NA,"0.1.4"
"16332","646",2023-02-18 02:45:00,977,1006,29,0,TRUE,NA,"0.1.4"
"16333","646",2023-02-18 03:00:00,977,1006,29,0,TRUE,NA,"0.1.4"
"16334","646",2023-02-18 03:15:00,977,1006,29,0,TRUE,NA,"0.1.4"
"16335","646",2023-02-18 03:30:00,977,1006,29,0,TRUE,NA,"0.1.4"
"16336","646",2023-02-18 03:45:00,977,1006,29,0,TRUE,NA,"0.1.4"
"16337","646",2023-02-18 04:00:00,977,1006,29,0,TRUE,NA,"0.1.4"
"16338","646",2023-02-18 04:15:00,977,1006,29,0,TRUE,NA,"0.1.4"
"16339","646",2023-02-18 04:30:00,977,1006,29,0,TRUE,NA,"0.1.4"
"16340","646",2023-02-18 04:45:00,977,1006,29,0,TRUE,NA,"0.1.4"
"16341","646",2023-02-18 05:00:00,977,1006,29,0,TRUE,NA,"0.1.4"
"16342","646",2023-02-18 05:15:00,977,1006,29,0,TRUE,NA,"0.1.4"
"16343","646",2023-02-18 05:30:00,977,1006,29,0,TRUE,NA,"0.1.4"
"16344","646",2023-02-18 05:45:00,977,1006,29,0,TRUE,NA,"0.1.4"
"16345","646",2023-02-18 06:00:00,977,1006,29,0,TRUE,NA,"0.1.4"
"16346","646",2023-02-18 06:15:00,977,1006,29,0,TRUE,NA,"0.1.4"
"16347","646",2023-02-18 06:30:00,977,1006,29,0,TRUE,NA,"0.1.4"
"16348","646",2023-02-18 06:45:00,977,1006,29,0,TRUE,NA,"0.1.4"
"16349","646",2023-02-18 07:00:00,977,1006,29,0,TRUE,NA,"0.1.4"
"16350","646",2023-02-18 07:15:00,977,1006,29,0,TRUE,NA,"0.1.4"
"16351","646",2023-02-18 07:30:00,977,1006,29,0,TRUE,NA,"0.1.4"
"16352","646",2023-02-18 07:45:00,977,1006,29,0,TRUE,NA,"0.1.4"
"16353","646",2023-02-18 08:00:00,977,1006,29,0,TRUE,NA,"0.1.4"
"16354","646",2023-02-18 08:15:00,977,1006,29,0,TRUE,NA,"0.1.4"
"16355","646",2023-02-18 08:30:00,977,1006,29,0,TRUE,NA,"0.1.4"
"16356","646",2023-02-18 08:45:00,977,1006,29,0,TRUE,NA,"0.1.4"
"16357","646",2023-02-18 09:00:00,977,1006,29,0,TRUE,NA,"0.1.4"
"16358","646",2023-02-18 09:15:00,977,1006,29,0,TRUE,NA,"0.1.4"
"16359","646",2023-02-18 09:30:00,977,1006,29,0,TRUE,NA,"0.1.4"
"16360","646",2023-02-18 09:45:00,977,1006,29,0,TRUE,NA,"0.1.4"
"16361","646",2023-02-18 10:00:00,977,1006,29,0,TRUE,NA,"0.1.4"
"16362","646",2023-02-18 10:15:00,977,1006,29,0,TRUE,NA,"0.1.4"
"16363","646",2023-02-18 10:30:00,977,1006,29,0,TRUE,NA,"0.1.4"
"16364","646",2023-02-18 10:45:00,977,1006,29,0,TRUE,NA,"0.1.4"
"16365","646",2023-02-18 11:00:00,977,1006,29,0,TRUE,NA,"0.1.4"
"16366","646",2023-02-18 11:15:00,977,1006,29,0,TRUE,NA,"0.1.4"
"16367","646",2023-02-18 11:30:00,977,1006,29,0,TRUE,NA,"0.1.4"
"16368","646",2023-02-18 11:45:00,977,1006,29,0,TRUE,NA,"0.1.4"
"16369","646",2023-02-18 12:00:00,977,1006,29,0,TRUE,NA,"0.1.4"
"16370","646",2023-02-18 12:15:00,977,1006,29,0,TRUE,NA,"0.1.4"
"16371","646",2023-02-18 12:30:00,977,1006,29,0,TRUE,NA,"0.1.4"
"16372","646",2023-02-18 12:45:00,977,1006,29,0,TRUE,NA,"0.1.4"
"16373","646",2023-02-18 13:00:00,977,1006,29,0,TRUE,NA,"0.1.4"
"16374","646",2023-02-18 13:15:00,977,1006,29,0,TRUE,NA,"0.1.4"
"16375","646",2023-02-18 13:30:00,977,1006,29,0,TRUE,NA,"0.1.4"
"16376","646",2023-02-18 13:45:00,977,1006,29,0,TRUE,NA,"0.1.4"
"16377","646",2023-02-18 14:00:00,977,1006,29,0,TRUE,NA,"0.1.4"
"16378","646",2023-02-18 14:15:00,977,1006,29,0,TRUE,NA,"0.1.4"
"16379","646",2023-02-18 14:30:00,977,1006,29,0,TRUE,NA,"0.1.4"
"16380","646",2023-02-18 14:45:00,978,1006,28,0,TRUE,NA,"0.1.4"
"16381","646",2023-02-18 15:00:00,977,1006,29,0,TRUE,NA,"0.1.4"
"16382","646",2023-02-18 15:15:00,977,1006,29,0,TRUE,NA,"0.1.4"
"16383","646",2023-02-18 15:30:00,977,1006,29,0,TRUE,NA,"0.1.4"
"16384","646",2023-02-18 15:45:00,977,1006,29,0,TRUE,NA,"0.1.4"
"16385","646",2023-02-18 16:00:00,978,1006,28,0,TRUE,NA,"0.1.4"
"16386","646",2023-02-18 16:15:00,977,1006,29,0,TRUE,NA,"0.1.4"
"16387","646",2023-02-18 16:30:00,977,1006,29,0,TRUE,NA,"0.1.4"
"16388","646",2023-02-18 16:45:00,977,1006,29,0,TRUE,NA,"0.1.4"
"16389","646",2023-02-18 17:00:00,977,1006,29,0,TRUE,NA,"0.1.4"
"16390","646",2023-02-18 17:15:00,977,1006,29,0,TRUE,NA,"0.1.4"
"16391","646",2023-02-18 17:30:00,977,1006,29,0,TRUE,NA,"0.1.4"
"16392","646",2023-02-18 17:45:00,978,1006,28,0,TRUE,NA,"0.1.4"
"16393","646",2023-02-18 18:00:00,978,1006,28,0,TRUE,NA,"0.1.4"
"16394","646",2023-02-18 18:15:00,978,1006,28,0,TRUE,NA,"0.1.4"
"16395","646",2023-02-18 18:30:00,978,1006,28,0,TRUE,NA,"0.1.4"
"16396","646",2023-02-18 18:45:00,977,1006,29,0,TRUE,NA,"0.1.4"
"16397","646",2023-02-18 19:00:00,978,1006,28,0,TRUE,NA,"0.1.4"
"16398","646",2023-02-18 19:15:00,978,1006,28,0,TRUE,NA,"0.1.4"
"16399","646",2023-02-18 19:30:00,977,1006,29,0,TRUE,NA,"0.1.4"
"16400","646",2023-02-18 19:45:00,977,1006,29,0,TRUE,NA,"0.1.4"
"16401","646",2023-02-18 20:00:00,978,1006,28,0,TRUE,NA,"0.1.4"
"16402","646",2023-02-18 20:15:00,977,1006,29,0,TRUE,NA,"0.1.4"
"16403","646",2023-02-18 20:30:00,978,1006,28,0,TRUE,NA,"0.1.4"
"16404","646",2023-02-18 20:45:00,977,1006,29,0,TRUE,NA,"0.1.4"
"16405","646",2023-02-18 21:00:00,977,1006,29,0,TRUE,NA,"0.1.4"
"16406","646",2023-02-18 21:15:00,977,1006,29,0,TRUE,NA,"0.1.4"
"16407","646",2023-02-18 21:30:00,977,1006,29,0,TRUE,NA,"0.1.4"
"16408","646",2023-02-18 21:45:00,977,1006,29,0,TRUE,NA,"0.1.4"
"16409","646",2023-02-18 22:00:00,977,1006,29,0,TRUE,NA,"0.1.4"
"16410","646",2023-02-18 22:15:00,977,1006,29,0,TRUE,NA,"0.1.4"
"16411","646",2023-02-18 22:30:00,977,1006,29,0,TRUE,NA,"0.1.4"
"16412","646",2023-02-18 22:45:00,977,1006,29,0,TRUE,NA,"0.1.4"
"16413","646",2023-02-18 23:00:00,977,1006,29,0,TRUE,NA,"0.1.4"
"16414","646",2023-02-18 23:15:00,977,1006,29,0,TRUE,NA,"0.1.4"
"16415","646",2023-02-18 23:30:00,977,1006,29,0,TRUE,NA,"0.1.4"
"16416","646",2023-02-18 23:45:00,977,1006,29,0,TRUE,NA,"0.1.4"
"16417","646",2023-02-19,977,1006,29,0,TRUE,NA,"0.1.4"
"16418","646",2023-02-19 00:15:00,977,1006,29,0,TRUE,NA,"0.1.4"
"16419","646",2023-02-19 00:30:00,977,1006,29,0,TRUE,NA,"0.1.4"
"16420","646",2023-02-19 00:45:00,977,1006,29,0,TRUE,NA,"0.1.4"
"16421","646",2023-02-19 01:00:00,977,1006,29,0,TRUE,NA,"0.1.4"
"16422","646",2023-02-19 01:15:00,977,1006,29,0,TRUE,NA,"0.1.4"
"16423","646",2023-02-19 01:30:00,977,1006,29,0,TRUE,NA,"0.1.4"
"16424","646",2023-02-19 01:45:00,977,1006,29,0,TRUE,NA,"0.1.4"
"16425","646",2023-02-19 02:00:00,977,1006,29,0,TRUE,NA,"0.1.4"
"16426","646",2023-02-19 02:15:00,977,1006,29,0,TRUE,NA,"0.1.4"
"16427","646",2023-02-19 02:30:00,977,1006,29,0,TRUE,NA,"0.1.4"
"16428","646",2023-02-19 02:45:00,977,1006,29,0,TRUE,NA,"0.1.4"
"16429","646",2023-02-19 03:00:00,977,1006,29,0,TRUE,NA,"0.1.4"
"16430","646",2023-02-19 03:15:00,977,1006,29,0,TRUE,NA,"0.1.4"
"16431","646",2023-02-19 03:30:00,977,1006,29,0,TRUE,NA,"0.1.4"
"16432","646",2023-02-19 03:45:00,977,1006,29,0,TRUE,NA,"0.1.4"
"16433","646",2023-02-19 04:00:00,977,1006,29,0,TRUE,NA,"0.1.4"
"16434","646",2023-02-19 04:15:00,977,1006,29,0,TRUE,NA,"0.1.4"
"16435","646",2023-02-19 04:30:00,977,1006,29,0,TRUE,NA,"0.1.4"
"16436","646",2023-02-19 04:45:00,977,1006,29,0,TRUE,NA,"0.1.4"
"16437","646",2023-02-19 05:00:00,977,1006,29,0,TRUE,NA,"0.1.4"
"16438","646",2023-02-19 05:15:00,977,1006,29,0,TRUE,NA,"0.1.4"
"16439","646",2023-02-19 05:30:00,977,1006,29,0,TRUE,NA,"0.1.4"
"16440","646",2023-02-19 05:45:00,977,1006,29,0,TRUE,NA,"0.1.4"
"16441","646",2023-02-19 06:00:00,977,1006,29,0,TRUE,NA,"0.1.4"
"16442","646",2023-02-19 06:15:00,977,1006,29,0,TRUE,NA,"0.1.4"
"16443","646",2023-02-19 06:30:00,977,1006,29,0,TRUE,NA,"0.1.4"
"16444","646",2023-02-19 06:45:00,977,1006,29,0,TRUE,NA,"0.1.4"
"16445","646",2023-02-19 07:00:00,977,1006,29,0,TRUE,NA,"0.1.4"
"16446","646",2023-02-19 07:15:00,977,1006,29,0,TRUE,NA,"0.1.4"
"16447","646",2023-02-19 07:30:00,977,1006,29,0,TRUE,NA,"0.1.4"
"16448","646",2023-02-19 07:45:00,977,1006,29,0,TRUE,NA,"0.1.4"
"16449","646",2023-02-19 08:00:00,977,1006,29,0,TRUE,NA,"0.1.4"
"16450","646",2023-02-19 08:15:00,976,1006,30,0,TRUE,NA,"0.1.4"
"16451","646",2023-02-19 08:30:00,976,1006,30,0,TRUE,NA,"0.1.4"
"16452","646",2023-02-19 08:45:00,977,1006,29,0,TRUE,NA,"0.1.4"
"16453","646",2023-02-19 09:00:00,976,1006,30,0,TRUE,NA,"0.1.4"
"16454","646",2023-02-19 09:15:00,977,1006,29,0,TRUE,NA,"0.1.4"
"16455","646",2023-02-19 09:30:00,977,1006,29,0,TRUE,NA,"0.1.4"
"16456","646",2023-02-19 09:45:00,976,1006,30,0,TRUE,NA,"0.1.4"
"16457","646",2023-02-19 10:00:00,976,1006,30,0,TRUE,NA,"0.1.4"
"16458","646",2023-02-19 10:15:00,976,1006,30,0,TRUE,NA,"0.1.4"
"16459","646",2023-02-19 10:30:00,977,1006,29,0,TRUE,NA,"0.1.4"
"16460","646",2023-02-19 10:45:00,977,1006,29,0,TRUE,NA,"0.1.4"
"16461","646",2023-02-19 11:00:00,977,1006,29,0,TRUE,NA,"0.1.4"
"16462","646",2023-02-19 11:15:00,977,1006,29,0,TRUE,NA,"0.1.4"
"16463","646",2023-02-19 11:30:00,977,1006,29,0,TRUE,NA,"0.1.4"
"16464","646",2023-02-19 11:45:00,977,1006,29,0,TRUE,NA,"0.1.4"
"16465","646",2023-02-19 12:00:00,977,1006,29,0,TRUE,NA,"0.1.4"
"16466","646",2023-02-19 12:15:00,976,1006,30,0,TRUE,NA,"0.1.4"
"16467","646",2023-02-19 12:30:00,977,1006,29,0,TRUE,NA,"0.1.4"
"16468","646",2023-02-19 12:45:00,976,1006,30,0,TRUE,NA,"0.1.4"
"16469","646",2023-02-19 13:00:00,976,1006,30,0,TRUE,NA,"0.1.4"
"16470","646",2023-02-19 13:15:00,977,1006,29,0,TRUE,NA,"0.1.4"
"16471","646",2023-02-19 13:30:00,977,1006,29,0,TRUE,NA,"0.1.4"
"16472","646",2023-02-19 13:45:00,977,1006,29,0,TRUE,NA,"0.1.4"
"16473","646",2023-02-19 14:00:00,977,1006,29,0,TRUE,NA,"0.1.4"
"16474","646",2023-02-19 14:15:00,977,1006,29,0,TRUE,NA,"0.1.4"
"16475","646",2023-02-19 14:30:00,977,1006,29,0,TRUE,NA,"0.1.4"
"16476","646",2023-02-19 14:45:00,977,1006,29,0,TRUE,NA,"0.1.4"
"16477","646",2023-02-19 15:00:00,977,1006,29,0,TRUE,NA,"0.1.4"
"16478","646",2023-02-19 15:15:00,977,1006,29,0,TRUE,NA,"0.1.4"
"16479","646",2023-02-19 15:30:00,977,1006,29,0,TRUE,NA,"0.1.4"
"16480","646",2023-02-19 15:45:00,977,1006,29,0,TRUE,NA,"0.1.4"
"16481","646",2023-02-19 16:00:00,977,1006,29,0,TRUE,NA,"0.1.4"
"16482","646",2023-02-19 16:15:00,977,1006,29,0,TRUE,NA,"0.1.4"
"16483","646",2023-02-19 16:30:00,977,1006,29,0,TRUE,NA,"0.1.4"
"16484","646",2023-02-19 16:45:00,977,1006,29,0,TRUE,NA,"0.1.4"
"16485","646",2023-02-19 17:00:00,977,1006,29,0,TRUE,NA,"0.1.4"
"16486","646",2023-02-19 17:15:00,977,1006,29,0,TRUE,NA,"0.1.4"
"16487","646",2023-02-19 17:30:00,977,1006,29,0,TRUE,NA,"0.1.4"
"16488","646",2023-02-19 17:45:00,977,1006,29,0,TRUE,NA,"0.1.4"
"16489","646",2023-02-19 18:00:00,977,1006,29,0,TRUE,NA,"0.1.4"
"16490","646",2023-02-19 18:15:00,977,1006,29,0,TRUE,NA,"0.1.4"
"16491","646",2023-02-19 18:30:00,977,1006,29,0,TRUE,NA,"0.1.4"
"16492","646",2023-02-19 18:45:00,977,1006,29,0,TRUE,NA,"0.1.4"
"16493","646",2023-02-19 19:00:00,977,1006,29,0,TRUE,NA,"0.1.4"
"16494","646",2023-02-19 19:15:00,977,1006,29,0,TRUE,NA,"0.1.4"
"16495","646",2023-02-19 19:30:00,977,1006,29,0,TRUE,NA,"0.1.4"
"16496","646",2023-02-19 19:45:00,977,1006,29,0,TRUE,NA,"0.1.4"
"16497","646",2023-02-19 20:00:00,977,1006,29,0,TRUE,NA,"0.1.4"
"16498","646",2023-02-19 20:15:00,977,1006,29,0,TRUE,NA,"0.1.4"
"16499","646",2023-02-19 20:30:00,977,1006,29,0,TRUE,NA,"0.1.4"
"16500","646",2023-02-19 20:45:00,976,1006,30,0,TRUE,NA,"0.1.4"
"16501","646",2023-02-19 21:00:00,977,1006,29,0,TRUE,NA,"0.1.4"
"16502","646",2023-02-19 21:15:00,976,1006,30,0,TRUE,NA,"0.1.4"
"16503","646",2023-02-19 21:30:00,976,1006,30,0,TRUE,NA,"0.1.4"
"16504","646",2023-02-19 21:45:00,976,1006,30,0,TRUE,NA,"0.1.4"
"16505","646",2023-02-19 22:00:00,977,1006,29,0,TRUE,NA,"0.1.4"
"16506","646",2023-02-19 22:15:00,976,1006,30,0,TRUE,NA,"0.1.4"
"16507","646",2023-02-19 22:30:00,976,1006,30,0,TRUE,NA,"0.1.4"
"16508","646",2023-02-19 22:45:00,976,1006,30,0,TRUE,NA,"0.1.4"
"16509","646",2023-02-19 23:00:00,976,1006,30,0,TRUE,NA,"0.1.4"
"16510","646",2023-02-19 23:15:00,976,1006,30,0,TRUE,NA,"0.1.4"
"16511","646",2023-02-19 23:30:00,976,1006,30,0,TRUE,NA,"0.1.4"
"16512","646",2023-02-19 23:45:00,976,1006,30,0,TRUE,NA,"0.1.4"
"16513","646",2023-02-20,976,1006,30,0,TRUE,NA,"0.1.4"
"16514","646",2023-02-20 00:15:00,976,1006,30,0,TRUE,NA,"0.1.4"
"16515","646",2023-02-20 00:30:00,976,1006,30,0,TRUE,NA,"0.1.4"
"16516","646",2023-02-20 00:45:00,976,1006,30,0,TRUE,NA,"0.1.4"
"16517","646",2023-02-20 01:00:00,977,1006,29,0,TRUE,NA,"0.1.4"
"16518","646",2023-02-20 01:15:00,977,1006,29,0,TRUE,NA,"0.1.4"
"16519","646",2023-02-20 01:30:00,977,1006,29,0,TRUE,NA,"0.1.4"
"16520","646",2023-02-20 01:45:00,977,1006,29,0,TRUE,NA,"0.1.4"
"16521","646",2023-02-20 02:00:00,977,1006,29,0,TRUE,NA,"0.1.4"
"16522","646",2023-02-20 02:15:00,977,1006,29,0,TRUE,NA,"0.1.4"
"16523","646",2023-02-20 02:30:00,977,1006,29,0,TRUE,NA,"0.1.4"
"16524","646",2023-02-20 02:45:00,977,1006,29,0,TRUE,NA,"0.1.4"
"16525","646",2023-02-20 03:00:00,977,1006,29,0,TRUE,NA,"0.1.4"
"16526","646",2023-02-20 03:15:00,977,1006,29,0,TRUE,NA,"0.1.4"
"16527","646",2023-02-20 03:30:00,977,1006,29,0,TRUE,NA,"0.1.4"
"16528","646",2023-02-20 03:45:00,977,1006,29,0,TRUE,NA,"0.1.4"
"16529","646",2023-02-20 04:00:00,977,1006,29,0,TRUE,NA,"0.1.4"
"16530","646",2023-02-20 04:15:00,977,1006,29,0,TRUE,NA,"0.1.4"
"16531","646",2023-02-20 04:30:00,977,1006,29,0,TRUE,NA,"0.1.4"
"16532","646",2023-02-20 04:45:00,977,1006,29,0,TRUE,NA,"0.1.4"
"16533","646",2023-02-20 05:00:00,977,1006,29,0,TRUE,NA,"0.1.4"
"16534","646",2023-02-20 05:15:00,977,1006,29,0,TRUE,NA,"0.1.4"
"16535","646",2023-02-20 05:30:00,977,1006,29,0,TRUE,NA,"0.1.4"
"16536","646",2023-02-20 05:45:00,977,1006,29,0,TRUE,NA,"0.1.4"
"16537","646",2023-02-20 06:00:00,977,1006,29,0,TRUE,NA,"0.1.4"
"16538","646",2023-02-20 06:15:00,977,1006,29,0,TRUE,NA,"0.1.4"
"16539","646",2023-02-20 06:30:00,977,1006,29,0,TRUE,NA,"0.1.4"
"16540","646",2023-02-20 06:45:00,977,1006,29,0,TRUE,NA,"0.1.4"
"16541","646",2023-02-20 07:00:00,977,1006,29,0,TRUE,NA,"0.1.4"
"16542","646",2023-02-20 07:15:00,977,1006,29,0,TRUE,NA,"0.1.4"
"16543","646",2023-02-20 07:30:00,977,1006,29,0,TRUE,NA,"0.1.4"
"16544","646",2023-02-20 07:45:00,977,1006,29,0,TRUE,NA,"0.1.4"
"16545","646",2023-02-20 08:00:00,977,1006,29,0,TRUE,NA,"0.1.4"
"16546","646",2023-02-20 08:15:00,977,1006,29,0,TRUE,NA,"0.1.4"
"16547","646",2023-02-20 08:30:00,977,1006,29,0,TRUE,NA,"0.1.4"
"16548","646",2023-02-20 08:45:00,977,1006,29,0,TRUE,NA,"0.1.4"
"16549","646",2023-02-20 09:00:00,977,1006,29,0,TRUE,NA,"0.1.4"
"16550","646",2023-02-20 09:15:00,977,1006,29,0,TRUE,NA,"0.1.4"
"16551","646",2023-02-20 09:30:00,977,1006,29,0,TRUE,NA,"0.1.4"
"16552","646",2023-02-20 09:45:00,978,1006,28,0,TRUE,NA,"0.1.4"
"16553","646",2023-02-20 10:00:00,977,1006,29,0,TRUE,NA,"0.1.4"
"16554","646",2023-02-20 10:15:00,977,1006,29,0,TRUE,NA,"0.1.4"
"16555","646",2023-02-20 10:30:00,977,1006,29,0,TRUE,NA,"0.1.4"
"16556","646",2023-02-20 10:45:00,978,1006,28,0,TRUE,NA,"0.1.4"
"16557","646",2023-02-20 11:00:00,977,1006,29,0,TRUE,NA,"0.1.4"
"16558","646",2023-02-20 11:15:00,977,1006,29,0,TRUE,NA,"0.1.4"
"16559","646",2023-02-20 11:30:00,977,1006,29,0,TRUE,NA,"0.1.4"
"16560","646",2023-02-20 11:45:00,977,1006,29,0,TRUE,NA,"0.1.4"
"16561","646",2023-02-20 12:00:00,977,1006,29,0,TRUE,NA,"0.1.4"
"16562","646",2023-02-20 12:15:00,977,1006,29,0,TRUE,NA,"0.1.4"
"16563","646",2023-02-20 12:30:00,977,1006,29,0,TRUE,NA,"0.1.4"
"16564","646",2023-02-20 12:45:00,977,1006,29,0,TRUE,NA,"0.1.4"
"16565","646",2023-02-20 13:00:00,977,1006,29,0,TRUE,NA,"0.1.4"
"16566","646",2023-02-20 13:15:00,977,1006,29,0,TRUE,NA,"0.1.4"
"16567","646",2023-02-20 13:30:00,977,1006,29,0,TRUE,NA,"0.1.4"
"16568","646",2023-02-20 13:45:00,977,1006,29,0,TRUE,NA,"0.1.4"
"16569","646",2023-02-20 14:00:00,977,1006,29,0,TRUE,NA,"0.1.4"
"16570","646",2023-02-20 14:15:00,977,1006,29,0,TRUE,NA,"0.1.4"
"16571","646",2023-02-20 14:30:00,977,1006,29,0,TRUE,NA,"0.1.4"
"16572","646",2023-02-20 14:45:00,977,1006,29,0,TRUE,NA,"0.1.4"
"16573","646",2023-02-20 15:00:00,977,1006,29,0,TRUE,NA,"0.1.4"
"16574","646",2023-02-20 15:15:00,977,1006,29,0,TRUE,NA,"0.1.4"
"16575","646",2023-02-20 15:30:00,977,1006,29,0,TRUE,NA,"0.1.4"
"16576","646",2023-02-20 15:45:00,977,1006,29,0,TRUE,NA,"0.1.4"
"16577","646",2023-02-20 16:00:00,977,1006,29,0,TRUE,NA,"0.1.4"
"16578","646",2023-02-20 16:15:00,977,1006,29,0,TRUE,NA,"0.1.4"
"16579","646",2023-02-20 16:30:00,977,1006,29,0,TRUE,NA,"0.1.4"
"16580","646",2023-02-20 16:45:00,977,1006,29,0,TRUE,NA,"0.1.4"
"16581","646",2023-02-20 17:00:00,977,1006,29,0,TRUE,NA,"0.1.4"
"16582","646",2023-02-20 17:15:00,977,1006,29,0,TRUE,NA,"0.1.4"
"16583","646",2023-02-20 17:30:00,977,1006,29,0,TRUE,NA,"0.1.4"
"16584","646",2023-02-20 17:45:00,977,1006,29,0,TRUE,NA,"0.1.4"
"16585","646",2023-02-20 18:00:00,977,1006,29,0,TRUE,NA,"0.1.4"
"16586","646",2023-02-20 18:15:00,977,1006,29,0,TRUE,NA,"0.1.4"
"16587","646",2023-02-20 18:30:00,977,1006,29,0,TRUE,NA,"0.1.4"
"16588","646",2023-02-20 18:45:00,977,1006,29,0,TRUE,NA,"0.1.4"
"16589","646",2023-02-20 19:00:00,977,1006,29,0,TRUE,NA,"0.1.4"
"16590","646",2023-02-20 19:15:00,977,1006,29,0,TRUE,NA,"0.1.4"
"16591","646",2023-02-20 19:30:00,977,1006,29,0,TRUE,NA,"0.1.4"
"16592","646",2023-02-20 19:45:00,977,1006,29,0,TRUE,NA,"0.1.4"
"16593","646",2023-02-20 20:00:00,977,1006,29,0,TRUE,NA,"0.1.4"
"16594","646",2023-02-20 20:15:00,977,1006,29,0,TRUE,NA,"0.1.4"
"16595","646",2023-02-20 20:30:00,977,1006,29,0,TRUE,NA,"0.1.4"
"16596","646",2023-02-20 20:45:00,977,1006,29,0,TRUE,NA,"0.1.4"
"16597","646",2023-02-20 21:00:00,977,1006,29,0,TRUE,NA,"0.1.4"
"16598","646",2023-02-20 21:15:00,977,1006,29,0,TRUE,NA,"0.1.4"
"16599","646",2023-02-20 21:30:00,977,1006,29,0,TRUE,NA,"0.1.4"
"16600","646",2023-02-20 21:45:00,977,1006,29,0,TRUE,NA,"0.1.4"
"16601","646",2023-02-20 22:00:00,977,1006,29,0,TRUE,NA,"0.1.4"
"16602","646",2023-02-20 22:15:00,977,1006,29,0,FALSE,NA,"0.1.4"
"16603","646",2023-02-20 22:30:00,977,1006,29,0,FALSE,NA,"0.1.4"
"16604","646",2023-02-20 22:45:00,977,1006,29,0,FALSE,NA,"0.1.4"
"16605","646",2023-02-20 23:00:00,977,1006,29,0,FALSE,NA,"0.1.4"
"16606","646",2023-02-20 23:15:00,976,1006,30,0,FALSE,NA,"0.1.4"
"16607","646",2023-02-20 23:30:00,976,1006,30,0,FALSE,NA,"0.1.4"
"16608","646",2023-02-20 23:45:00,977,1006,29,0,FALSE,NA,"0.1.4"
"16609","646",2023-02-21,976,1006,30,0,FALSE,NA,"0.1.4"
"16610","646",2023-02-21 00:15:00,976,1006,30,0,FALSE,NA,"0.1.4"
"16611","646",2023-02-21 00:30:00,976,1006,30,0,TRUE,NA,"0.1.4"
"16612","646",2023-02-21 00:45:00,976,1006,30,0,TRUE,NA,"0.1.4"
"16613","646",2023-02-21 01:00:00,976,1006,30,0,TRUE,NA,"0.1.4"
"16614","646",2023-02-21 01:15:00,976,1006,30,0,TRUE,NA,"0.1.4"
"16615","646",2023-02-21 01:30:00,976,1006,30,0,TRUE,NA,"0.1.4"
"16616","646",2023-02-21 01:45:00,976,1006,30,0,TRUE,NA,"0.1.4"
"16617","646",2023-02-21 02:00:00,976,1006,30,0,TRUE,NA,"0.1.4"
"16618","646",2023-02-21 02:15:00,976,1006,30,0,TRUE,NA,"0.1.4"
"16619","646",2023-02-21 02:30:00,976,1006,30,0,TRUE,NA,"0.1.4"
"16620","646",2023-02-21 02:45:00,976,1006,30,0,TRUE,NA,"0.1.4"
"16621","646",2023-02-21 03:00:00,976,1006,30,0,TRUE,NA,"0.1.4"
"16622","646",2023-02-21 03:15:00,976,1006,30,0,TRUE,NA,"0.1.4"
"16623","646",2023-02-21 03:30:00,976,1006,30,0,TRUE,NA,"0.1.4"
"16624","646",2023-02-21 03:45:00,976,1006,30,0,TRUE,NA,"0.1.4"
"16625","646",2023-02-21 04:00:00,976,1006,30,0,TRUE,NA,"0.1.4"
"16626","646",2023-02-21 04:15:00,976,1006,30,0,TRUE,NA,"0.1.4"
"16627","646",2023-02-21 04:30:00,976,1006,30,0,TRUE,NA,"0.1.4"
"16628","646",2023-02-21 04:45:00,976,1006,30,0,TRUE,NA,"0.1.4"
"16629","646",2023-02-21 05:00:00,976,1006,30,0,TRUE,NA,"0.1.4"
"16630","646",2023-02-21 05:15:00,976,1006,30,0,TRUE,NA,"0.1.4"
"16631","646",2023-02-21 05:30:00,976,1006,30,0,TRUE,NA,"0.1.4"
"16632","646",2023-02-21 05:45:00,976,1006,30,0,TRUE,NA,"0.1.4"
"16633","646",2023-02-21 06:00:00,976,1006,30,0,TRUE,NA,"0.1.4"
"16634","646",2023-02-21 06:15:00,976,1006,30,0,TRUE,NA,"0.1.4"
"16635","646",2023-02-21 06:30:00,976,1006,30,0,TRUE,NA,"0.1.4"
"16636","646",2023-02-21 06:45:00,976,1006,30,0,TRUE,NA,"0.1.4"
"16637","646",2023-02-21 07:00:00,976,1006,30,0,TRUE,NA,"0.1.4"
"16638","646",2023-02-21 07:15:00,976,1006,30,0,TRUE,NA,"0.1.4"
"16639","646",2023-02-21 07:30:00,977,1006,29,0,TRUE,NA,"0.1.4"
"16640","646",2023-02-21 07:45:00,977,1006,29,0,FALSE,NA,"0.1.4"
"16641","646",2023-02-21 08:00:00,977,1006,29,0,TRUE,NA,"0.1.4"
"16642","646",2023-02-21 08:15:00,977,1006,29,0,FALSE,NA,"0.1.4"
"16643","646",2023-02-21 08:30:00,977,1006,29,0,FALSE,NA,"0.1.4"
"16644","646",2023-02-21 08:45:00,977,1006,29,0,FALSE,NA,"0.1.4"
"16645","646",2023-02-21 09:00:00,977,1006,29,0,FALSE,NA,"0.1.4"
"16646","646",2023-02-21 09:15:00,977,1006,29,0,FALSE,NA,"0.1.4"
"16647","646",2023-02-21 09:30:00,977,1006,29,0,FALSE,NA,"0.1.4"
"16648","646",2023-02-21 09:45:00,977,1006,29,0,FALSE,NA,"0.1.4"
"16649","646",2023-02-21 10:00:00,977,1006,29,0,FALSE,NA,"0.1.4"
"16650","646",2023-02-21 10:15:00,977,1006,29,0,FALSE,NA,"0.1.4"
"16651","646",2023-02-21 10:30:00,977,1006,29,0,FALSE,NA,"0.1.4"
"16652","646",2023-02-21 10:45:00,977,1006,29,0,FALSE,NA,"0.1.4"
"16653","646",2023-02-21 11:00:00,978,1006,28,0,FALSE,NA,"0.1.4"
"16654","646",2023-02-21 11:15:00,978,1006,28,0,TRUE,NA,"0.1.4"
"16655","646",2023-02-21 11:30:00,978,1006,28,0,TRUE,NA,"0.1.4"
"16656","646",2023-02-21 11:45:00,978,1006,28,0,TRUE,NA,"0.1.4"
"16657","646",2023-02-21 12:00:00,978,1006,28,0,TRUE,NA,"0.1.4"
"16658","646",2023-02-21 12:15:00,978,1006,28,0,TRUE,NA,"0.1.4"
"16659","646",2023-02-21 12:30:00,978,1006,28,0,TRUE,NA,"0.1.4"
"16660","646",2023-02-21 12:45:00,978,1006,28,0,TRUE,NA,"0.1.4"
"16661","646",2023-02-21 13:00:00,978,1006,28,0,TRUE,NA,"0.1.4"
"16662","646",2023-02-21 13:15:00,977,1006,29,0,TRUE,NA,"0.1.4"
"16663","646",2023-02-21 13:30:00,977,1006,29,0,TRUE,NA,"0.1.4"
"16664","646",2023-02-21 13:45:00,977,1006,29,0,TRUE,NA,"0.1.4"
"16665","646",2023-02-21 14:00:00,978,1006,28,0,TRUE,NA,"0.1.4"
"16666","646",2023-02-21 14:15:00,978,1006,28,0,TRUE,NA,"0.1.4"
"16667","646",2023-02-21 14:30:00,978,1006,28,0,TRUE,NA,"0.1.4"
"16668","646",2023-02-21 14:45:00,978,1006,28,0,TRUE,NA,"0.1.4"
"16669","646",2023-02-21 15:00:00,978,1006,28,0,TRUE,NA,"0.1.4"
"16670","646",2023-02-21 15:15:00,978,1006,28,0,TRUE,NA,"0.1.4"
"16671","646",2023-02-21 15:30:00,978,1006,28,0,TRUE,NA,"0.1.4"
"16672","646",2023-02-21 15:45:00,978,1006,28,0,TRUE,NA,"0.1.4"
"16673","646",2023-02-21 16:00:00,978,1006,28,0,TRUE,NA,"0.1.4"
"16674","646",2023-02-21 16:15:00,978,1006,28,0,TRUE,NA,"0.1.4"
"16675","646",2023-02-21 16:30:00,978,1006,28,0,TRUE,NA,"0.1.4"
"16676","646",2023-02-21 16:45:00,978,1006,28,0,TRUE,NA,"0.1.4"
"16677","646",2023-02-21 17:00:00,978,1006,28,0,TRUE,NA,"0.1.4"
"16678","646",2023-02-21 17:15:00,978,1006,28,0,TRUE,NA,"0.1.4"
"16679","646",2023-02-21 17:30:00,978,1006,28,0,TRUE,NA,"0.1.4"
"16680","646",2023-02-21 17:45:00,978,1006,28,0,TRUE,NA,"0.1.4"
"16681","646",2023-02-21 18:00:00,978,1006,28,0,TRUE,NA,"0.1.4"
"16682","646",2023-02-21 18:15:00,978,1006,28,0,TRUE,NA,"0.1.4"
"16683","646",2023-02-21 18:30:00,978,1006,28,0,TRUE,NA,"0.1.4"
"16684","646",2023-02-21 18:45:00,978,1006,28,0,TRUE,NA,"0.1.4"
"16685","646",2023-02-21 19:00:00,978,1006,28,0,TRUE,NA,"0.1.4"
"16686","646",2023-02-21 19:15:00,978,1006,28,0,TRUE,NA,"0.1.4"
"16687","646",2023-02-21 19:30:00,978,1006,28,0,TRUE,NA,"0.1.4"
"16688","646",2023-02-21 19:45:00,978,1006,28,0,TRUE,NA,"0.1.4"
"16689","646",2023-02-21 20:00:00,978,1006,28,0,TRUE,NA,"0.1.4"
"16690","646",2023-02-21 20:15:00,978,1006,28,0,TRUE,NA,"0.1.4"
"16691","646",2023-02-21 20:30:00,978,1006,28,0,TRUE,NA,"0.1.4"
"16692","646",2023-02-21 20:45:00,978,1006,28,0,TRUE,NA,"0.1.4"
"16693","646",2023-02-21 21:00:00,978,1006,28,0,TRUE,NA,"0.1.4"
"16694","646",2023-02-21 21:15:00,978,1006,28,0,TRUE,NA,"0.1.4"
"16695","646",2023-02-21 21:30:00,979,1006,27,0,TRUE,NA,"0.1.4"
"16696","646",2023-02-21 21:45:00,979,1006,27,0,TRUE,NA,"0.1.4"
"16697","646",2023-02-21 22:00:00,979,1006,27,0,TRUE,NA,"0.1.4"
"16698","646",2023-02-21 22:15:00,979,1006,27,0,TRUE,NA,"0.1.4"
"16699","646",2023-02-21 22:30:00,979,1006,27,0,TRUE,NA,"0.1.4"
"16700","646",2023-02-21 22:45:00,979,1006,27,0,TRUE,NA,"0.1.4"
"16701","646",2023-02-21 23:00:00,979,1006,27,0,TRUE,NA,"0.1.4"
"16702","646",2023-02-21 23:15:00,979,1006,27,0,TRUE,NA,"0.1.4"
"16703","646",2023-02-21 23:30:00,979,1006,27,0,TRUE,NA,"0.1.4"
"16704","646",2023-02-21 23:45:00,979,1006,27,0,TRUE,NA,"0.1.4"
"16705","646",2023-02-22,978,1006,28,0,TRUE,NA,"0.1.4"
"16706","646",2023-02-22 00:15:00,979,1006,27,0,TRUE,NA,"0.1.4"
"16707","646",2023-02-22 00:30:00,979,1006,27,0,TRUE,NA,"0.1.4"
"16708","646",2023-02-22 00:45:00,979,1006,27,0,TRUE,NA,"0.1.4"
"16709","646",2023-02-22 01:00:00,979,1006,27,0,TRUE,NA,"0.1.4"
"16710","646",2023-02-22 01:15:00,979,1006,27,0,TRUE,NA,"0.1.4"
"16711","646",2023-02-22 01:30:00,979,1006,27,0,TRUE,NA,"0.1.4"
"16712","646",2023-02-22 01:45:00,979,1006,27,0,TRUE,NA,"0.1.4"
"16713","646",2023-02-22 02:00:00,979,1006,27,0,TRUE,NA,"0.1.4"
"16714","646",2023-02-22 02:15:00,979,1006,27,0,TRUE,NA,"0.1.4"
"16715","646",2023-02-22 02:30:00,979,1006,27,0,TRUE,NA,"0.1.4"
"16716","646",2023-02-22 02:45:00,979,1006,27,0,TRUE,NA,"0.1.4"
"16717","646",2023-02-22 03:00:00,979,1006,27,0,TRUE,NA,"0.1.4"
"16718","646",2023-02-22 03:15:00,979,1006,27,0,TRUE,NA,"0.1.4"
"16719","646",2023-02-22 03:30:00,979,1006,27,0,TRUE,NA,"0.1.4"
"16720","646",2023-02-22 03:45:00,979,1006,27,0,TRUE,NA,"0.1.4"
"16721","646",2023-02-22 04:00:00,979,1006,27,0,TRUE,NA,"0.1.4"
"16722","646",2023-02-22 04:15:00,979,1006,27,0,TRUE,NA,"0.1.4"
"16723","646",2023-02-22 04:30:00,979,1006,27,0,TRUE,NA,"0.1.4"
"16724","646",2023-02-22 04:45:00,979,1006,27,0,TRUE,NA,"0.1.4"
"16725","646",2023-02-22 05:00:00,979,1006,27,0,TRUE,NA,"0.1.4"
"16726","646",2023-02-22 05:15:00,979,1006,27,0,TRUE,NA,"0.1.4"
"16727","646",2023-02-22 05:30:00,979,1006,27,0,TRUE,NA,"0.1.4"
"16728","646",2023-02-22 05:45:00,979,1006,27,0,TRUE,NA,"0.1.4"
"16729","646",2023-02-22 06:00:00,979,1006,27,0,TRUE,NA,"0.1.4"
"16730","646",2023-02-22 06:15:00,979,1006,27,0,TRUE,NA,"0.1.4"
"16731","646",2023-02-22 06:30:00,979,1006,27,0,TRUE,NA,"0.1.4"
"16732","646",2023-02-22 06:45:00,979,1006,27,0,TRUE,NA,"0.1.4"
"16733","646",2023-02-22 07:00:00,979,1006,27,0,TRUE,NA,"0.1.4"
"16734","646",2023-02-22 07:15:00,979,1006,27,0,TRUE,NA,"0.1.4"
"16735","646",2023-02-22 07:30:00,979,1006,27,0,TRUE,NA,"0.1.4"
"16736","646",2023-02-22 07:45:00,979,1006,27,0,TRUE,NA,"0.1.4"
"16737","646",2023-02-22 08:00:00,979,1006,27,0,TRUE,NA,"0.1.4"
"16738","646",2023-02-22 08:15:00,979,1006,27,0,TRUE,NA,"0.1.4"
"16739","646",2023-02-22 08:30:00,979,1006,27,0,TRUE,NA,"0.1.4"
"16740","646",2023-02-22 08:45:00,979,1006,27,0,TRUE,NA,"0.1.4"
"16741","646",2023-02-22 09:00:00,979,1006,27,0,TRUE,NA,"0.1.4"
"16742","646",2023-02-22 09:15:00,979,1006,27,0,TRUE,NA,"0.1.4"
"16743","646",2023-02-22 09:30:00,979,1006,27,0,TRUE,NA,"0.1.4"
"16744","646",2023-02-22 09:45:00,979,1006,27,0,TRUE,NA,"0.1.4"
"16745","646",2023-02-22 10:00:00,979,1006,27,0,TRUE,NA,"0.1.4"
"16746","646",2023-02-22 10:15:00,979,1006,27,0,TRUE,NA,"0.1.4"
"16747","646",2023-02-22 10:30:00,979,1006,27,0,TRUE,NA,"0.1.4"
"16748","646",2023-02-22 10:45:00,979,1006,27,0,TRUE,NA,"0.1.4"
"16749","646",2023-02-22 11:00:00,979,1006,27,0,TRUE,NA,"0.1.4"
"16750","646",2023-02-22 11:15:00,979,1006,27,0,TRUE,NA,"0.1.4"
"16751","646",2023-02-22 11:30:00,979,1006,27,0,TRUE,NA,"0.1.4"
"16752","646",2023-02-22 11:45:00,979,1006,27,0,TRUE,NA,"0.1.4"
"16753","646",2023-02-22 12:00:00,979,1006,27,0,TRUE,NA,"0.1.4"
"16754","646",2023-02-22 12:15:00,979,1006,27,0,TRUE,NA,"0.1.4"
"16755","646",2023-02-22 12:30:00,979,1006,27,0,TRUE,NA,"0.1.4"
"16756","646",2023-02-22 12:45:00,979,1006,27,0,TRUE,NA,"0.1.4"
"16757","646",2023-02-22 13:00:00,979,1006,27,0,TRUE,NA,"0.1.4"
"16758","646",2023-02-22 13:15:00,979,1006,27,0,TRUE,NA,"0.1.4"
"16759","646",2023-02-22 13:30:00,979,1006,27,0,TRUE,NA,"0.1.4"
"16760","646",2023-02-22 13:45:00,979,1006,27,0,TRUE,NA,"0.1.4"
"16761","646",2023-02-22 14:00:00,979,1006,27,0,TRUE,NA,"0.1.4"
"16762","646",2023-02-22 14:15:00,979,1006,27,0,TRUE,NA,"0.1.4"
"16763","646",2023-02-22 14:30:00,979,1006,27,0,TRUE,NA,"0.1.4"
"16764","646",2023-02-22 14:45:00,979,1006,27,0,TRUE,NA,"0.1.4"
"16765","646",2023-02-22 15:00:00,979,1006,27,0,TRUE,NA,"0.1.4"
"16766","646",2023-02-22 15:15:00,979,1006,27,0,TRUE,NA,"0.1.4"
"16767","646",2023-02-22 15:30:00,979,1006,27,0,TRUE,NA,"0.1.4"
"16768","646",2023-02-22 15:45:00,979,1006,27,0,TRUE,NA,"0.1.4"
"16769","646",2023-02-22 16:00:00,979,1006,27,0,TRUE,NA,"0.1.4"
"16770","646",2023-02-22 16:15:00,979,1006,27,0,TRUE,NA,"0.1.4"
"16771","646",2023-02-22 16:30:00,979,1006,27,0,TRUE,NA,"0.1.4"
"16772","646",2023-02-22 16:45:00,979,1006,27,0,TRUE,NA,"0.1.4"
"16773","646",2023-02-22 17:00:00,979,1006,27,0,TRUE,NA,"0.1.4"
"16774","646",2023-02-22 17:15:00,979,1006,27,0,TRUE,NA,"0.1.4"
"16775","646",2023-02-22 17:30:00,979,1006,27,0,TRUE,NA,"0.1.4"
"16776","646",2023-02-22 17:45:00,979,1006,27,0,TRUE,NA,"0.1.4"
"16777","646",2023-02-22 18:00:00,979,1006,27,0,TRUE,NA,"0.1.4"
"16778","646",2023-02-22 18:15:00,979,1006,27,0,TRUE,NA,"0.1.4"
"16779","646",2023-02-22 18:30:00,979,1006,27,0,TRUE,NA,"0.1.4"
"16780","646",2023-02-22 18:45:00,979,1006,27,0,TRUE,NA,"0.1.4"
"16781","646",2023-02-22 19:00:00,979,1006,27,0,TRUE,NA,"0.1.4"
"16782","646",2023-02-22 19:15:00,979,1006,27,0,TRUE,NA,"0.1.4"
"16783","646",2023-02-22 19:30:00,979,1006,27,0,TRUE,NA,"0.1.4"
"16784","646",2023-02-22 19:45:00,979,1006,27,0,TRUE,NA,"0.1.4"
"16785","646",2023-02-22 20:00:00,979,1006,27,0,TRUE,NA,"0.1.4"
"16786","646",2023-02-22 20:15:00,979,1006,27,0,TRUE,NA,"0.1.4"
"16787","646",2023-02-22 20:30:00,979,1006,27,0,TRUE,NA,"0.1.4"
"16788","646",2023-02-22 20:45:00,979,1006,27,0,TRUE,NA,"0.1.4"
"16789","646",2023-02-22 21:00:00,979,1006,27,0,TRUE,NA,"0.1.4"
"16790","646",2023-02-22 21:15:00,979,1006,27,0,TRUE,NA,"0.1.4"
"16791","646",2023-02-22 21:30:00,979,1006,27,0,TRUE,NA,"0.1.4"
"16792","646",2023-02-22 21:45:00,979,1006,27,0,TRUE,NA,"0.1.4"
"16793","646",2023-02-22 22:00:00,979,1006,27,0,TRUE,NA,"0.1.4"
"16794","646",2023-02-22 22:15:00,979,1006,27,0,TRUE,NA,"0.1.4"
"16795","646",2023-02-22 22:30:00,979,1006,27,0,TRUE,NA,"0.1.4"
"16796","646",2023-02-22 22:45:00,979,1006,27,0,TRUE,NA,"0.1.4"
"16797","646",2023-02-22 23:00:00,979,1006,27,0,TRUE,NA,"0.1.4"
"16798","646",2023-02-22 23:15:00,979,1006,27,0,TRUE,NA,"0.1.4"
"16799","646",2023-02-22 23:30:00,979,1006,27,0,TRUE,NA,"0.1.4"
"16800","646",2023-02-22 23:45:00,979,1006,27,0,TRUE,NA,"0.1.4"
"16801","646",2023-02-23,979,1006,27,0,TRUE,NA,"0.1.4"
"16802","646",2023-02-23 00:15:00,979,1006,27,0,TRUE,NA,"0.1.4"
"16803","646",2023-02-23 00:30:00,979,1006,27,0,TRUE,NA,"0.1.4"
"16804","646",2023-02-23 00:45:00,979,1006,27,0,TRUE,NA,"0.1.4"
"16805","646",2023-02-23 01:00:00,979,1006,27,0,TRUE,NA,"0.1.4"
"16806","646",2023-02-23 01:15:00,978,1006,28,0,TRUE,NA,"0.1.4"
"16807","646",2023-02-23 01:30:00,978,1006,28,0,TRUE,NA,"0.1.4"
"16808","646",2023-02-23 01:45:00,978,1006,28,0,TRUE,NA,"0.1.4"
"16809","646",2023-02-23 02:00:00,978,1006,28,0,TRUE,NA,"0.1.4"
"16810","646",2023-02-23 02:15:00,978,1006,28,0,TRUE,NA,"0.1.4"
"16811","646",2023-02-23 02:30:00,978,1006,28,0,TRUE,NA,"0.1.4"
"16812","646",2023-02-23 02:45:00,978,1006,28,0,TRUE,NA,"0.1.4"
"16813","646",2023-02-23 03:00:00,978,1006,28,0,TRUE,NA,"0.1.4"
"16814","646",2023-02-23 03:15:00,978,1006,28,0,TRUE,NA,"0.1.4"
"16815","646",2023-02-23 03:30:00,978,1006,28,0,TRUE,NA,"0.1.4"
"16816","646",2023-02-23 03:45:00,978,1006,28,0,TRUE,NA,"0.1.4"
"16817","646",2023-02-23 04:00:00,978,1006,28,0,TRUE,NA,"0.1.4"
"16818","646",2023-02-23 04:15:00,978,1006,28,0,TRUE,NA,"0.1.4"
"16819","646",2023-02-23 04:30:00,978,1006,28,0,TRUE,NA,"0.1.4"
"16820","646",2023-02-23 04:45:00,978,1006,28,0,TRUE,NA,"0.1.4"
"16821","646",2023-02-23 05:00:00,978,1006,28,0,TRUE,NA,"0.1.4"
"16822","646",2023-02-23 05:15:00,979,1006,27,0,TRUE,NA,"0.1.4"
"16823","646",2023-02-23 05:30:00,978,1006,28,0,TRUE,NA,"0.1.4"
"16824","646",2023-02-23 05:45:00,978,1006,28,0,TRUE,NA,"0.1.4"
"16825","646",2023-02-23 06:00:00,979,1006,27,0,TRUE,NA,"0.1.4"
"16826","646",2023-02-23 06:15:00,978,1006,28,0,TRUE,NA,"0.1.4"
"16827","646",2023-02-23 06:30:00,979,1006,27,0,TRUE,NA,"0.1.4"
"16828","646",2023-02-23 06:45:00,979,1006,27,0,TRUE,NA,"0.1.4"
"16829","646",2023-02-23 07:00:00,979,1006,27,0,TRUE,NA,"0.1.4"
"16830","646",2023-02-23 07:15:00,979,1006,27,0,TRUE,NA,"0.1.4"
"16831","646",2023-02-23 07:30:00,979,1006,27,0,TRUE,NA,"0.1.4"
"16832","646",2023-02-23 07:45:00,978,1006,28,0,TRUE,NA,"0.1.4"
"16833","646",2023-02-23 08:00:00,979,1006,27,0,TRUE,NA,"0.1.4"
"16834","646",2023-02-23 08:15:00,978,1006,28,0,TRUE,NA,"0.1.4"
"16835","646",2023-02-23 08:30:00,978,1006,28,0,TRUE,NA,"0.1.4"
"16836","646",2023-02-23 08:45:00,978,1006,28,0,TRUE,NA,"0.1.4"
"16837","646",2023-02-23 09:00:00,979,1006,27,0,TRUE,NA,"0.1.4"
"16838","646",2023-02-23 09:15:00,979,1006,27,0,TRUE,NA,"0.1.4"
"16839","646",2023-02-23 09:30:00,979,1006,27,0,TRUE,NA,"0.1.4"
"16840","646",2023-02-23 09:45:00,979,1006,27,0,TRUE,NA,"0.1.4"
"16841","646",2023-02-23 10:00:00,979,1006,27,0,TRUE,NA,"0.1.4"
"16842","646",2023-02-23 10:15:00,979,1006,27,0,TRUE,NA,"0.1.4"
"16843","646",2023-02-23 10:30:00,979,1006,27,0,TRUE,NA,"0.1.4"
"16844","646",2023-02-23 10:45:00,979,1006,27,0,TRUE,NA,"0.1.4"
"16845","646",2023-02-23 11:00:00,979,1006,27,0,TRUE,NA,"0.1.4"
"16846","646",2023-02-23 11:15:00,979,1006,27,0,TRUE,NA,"0.1.4"
"16847","646",2023-02-23 11:30:00,979,1006,27,0,TRUE,NA,"0.1.4"
"16848","646",2023-02-23 11:45:00,979,1006,27,0,TRUE,NA,"0.1.4"
"16849","646",2023-02-23 12:00:00,979,1006,27,0,TRUE,NA,"0.1.4"
"16850","646",2023-02-23 12:15:00,979,1006,27,0,TRUE,NA,"0.1.4"
"16851","646",2023-02-23 12:30:00,979,1006,27,0,TRUE,NA,"0.1.4"
"16852","646",2023-02-23 12:45:00,979,1006,27,0,TRUE,NA,"0.1.4"
"16853","646",2023-02-23 13:00:00,979,1006,27,0,TRUE,NA,"0.1.4"
"16854","646",2023-02-23 13:15:00,979,1006,27,0,TRUE,NA,"0.1.4"
"16855","646",2023-02-23 13:30:00,979,1006,27,0,TRUE,NA,"0.1.4"
"16856","646",2023-02-23 13:45:00,979,1006,27,0,TRUE,NA,"0.1.4"
"16857","646",2023-02-23 14:00:00,979,1006,27,0,TRUE,NA,"0.1.4"
"16858","646",2023-02-23 14:15:00,979,1006,27,0,TRUE,NA,"0.1.4"
"16859","646",2023-02-23 14:30:00,979,1006,27,0,TRUE,NA,"0.1.4"
"16860","646",2023-02-23 14:45:00,979,1006,27,0,TRUE,NA,"0.1.4"
"16861","646",2023-02-23 15:00:00,979,1006,27,0,TRUE,NA,"0.1.4"
"16862","646",2023-02-23 15:15:00,979,1006,27,0,TRUE,NA,"0.1.4"
"16863","646",2023-02-23 15:30:00,979,1006,27,0,TRUE,NA,"0.1.4"
"16864","646",2023-02-23 15:45:00,979,1006,27,0,TRUE,NA,"0.1.4"
"16865","646",2023-02-23 16:00:00,979,1006,27,0,TRUE,NA,"0.1.4"
"16866","646",2023-02-23 16:15:00,979,1006,27,0,TRUE,NA,"0.1.4"
"16867","646",2023-02-23 16:30:00,979,1006,27,0,TRUE,NA,"0.1.4"
"16868","646",2023-02-23 16:45:00,979,1006,27,0,TRUE,NA,"0.1.4"
"16869","646",2023-02-23 17:00:00,979,1006,27,0,TRUE,NA,"0.1.4"
"16870","646",2023-02-23 17:15:00,979,1006,27,0,TRUE,NA,"0.1.4"
"16871","646",2023-02-23 17:30:00,979,1006,27,0,TRUE,NA,"0.1.4"
"16872","646",2023-02-23 17:45:00,979,1006,27,0,TRUE,NA,"0.1.4"
"16873","646",2023-02-23 18:00:00,979,1006,27,0,TRUE,NA,"0.1.4"
"16874","646",2023-02-23 18:15:00,979,1006,27,0,TRUE,NA,"0.1.4"
"16875","646",2023-02-23 18:30:00,979,1006,27,0,TRUE,NA,"0.1.4"
"16876","646",2023-02-23 18:45:00,979,1006,27,0,TRUE,NA,"0.1.4"
"16877","646",2023-02-23 19:00:00,979,1006,27,0,TRUE,NA,"0.1.4"
"16878","646",2023-02-23 19:15:00,979,1006,27,0,TRUE,NA,"0.1.4"
"16879","646",2023-02-23 19:30:00,979,1006,27,0,TRUE,NA,"0.1.4"
"16880","646",2023-02-23 19:45:00,979,1006,27,0,TRUE,NA,"0.1.4"
"16881","646",2023-02-23 20:00:00,979,1006,27,0,TRUE,NA,"0.1.4"
"16882","646",2023-02-23 20:15:00,979,1006,27,0,TRUE,NA,"0.1.4"
"16883","646",2023-02-23 20:30:00,979,1006,27,0,TRUE,NA,"0.1.4"
"16884","646",2023-02-23 20:45:00,979,1006,27,0,TRUE,NA,"0.1.4"
"16885","646",2023-02-23 21:00:00,979,1006,27,0,TRUE,NA,"0.1.4"
"16886","646",2023-02-23 21:15:00,979,1006,27,0,TRUE,NA,"0.1.4"
"16887","646",2023-02-23 21:30:00,979,1006,27,0,TRUE,NA,"0.1.4"
"16888","646",2023-02-23 21:45:00,979,1006,27,0,TRUE,NA,"0.1.4"
"16889","646",2023-02-23 22:00:00,979,1006,27,0,TRUE,NA,"0.1.4"
"16890","646",2023-02-23 22:15:00,979,1006,27,0,TRUE,NA,"0.1.4"
"16891","646",2023-02-23 22:30:00,979,1006,27,0,TRUE,NA,"0.1.4"
"16892","646",2023-02-23 22:45:00,979,1006,27,0,TRUE,NA,"0.1.4"
"16893","646",2023-02-23 23:00:00,978,1006,28,0,TRUE,NA,"0.1.4"
"16894","646",2023-02-23 23:15:00,978,1006,28,0,TRUE,NA,"0.1.4"
"16895","646",2023-02-23 23:30:00,978,1006,28,0,TRUE,NA,"0.1.4"
"16896","646",2023-02-23 23:45:00,978,1006,28,0,TRUE,NA,"0.1.4"
"16897","646",2023-02-24,979,1006,27,0,TRUE,NA,"0.1.4"
"16898","646",2023-02-24 00:15:00,978,1006,28,0,TRUE,NA,"0.1.4"
"16899","646",2023-02-24 00:30:00,978,1006,28,0,TRUE,NA,"0.1.4"
"16900","646",2023-02-24 00:45:00,978,1006,28,0,TRUE,NA,"0.1.4"
"16901","646",2023-02-24 01:00:00,978,1006,28,0,TRUE,NA,"0.1.4"
"16902","646",2023-02-24 01:15:00,979,1006,27,0,TRUE,NA,"0.1.4"
"16903","646",2023-02-24 01:30:00,978,1006,28,0,TRUE,NA,"0.1.4"
"16904","646",2023-02-24 01:45:00,979,1006,27,0,TRUE,NA,"0.1.4"
"16905","646",2023-02-24 02:00:00,979,1006,27,0,TRUE,NA,"0.1.4"
"16906","646",2023-02-24 02:15:00,979,1006,27,0,TRUE,NA,"0.1.4"
"16907","646",2023-02-24 02:30:00,979,1006,27,0,TRUE,NA,"0.1.4"
"16908","646",2023-02-24 02:45:00,979,1006,27,0,TRUE,NA,"0.1.4"
"16909","646",2023-02-24 03:00:00,979,1006,27,0,TRUE,NA,"0.1.4"
"16910","646",2023-02-24 03:15:00,979,1006,27,0,TRUE,NA,"0.1.4"
"16911","646",2023-02-24 03:30:00,979,1006,27,0,TRUE,NA,"0.1.4"
"16912","646",2023-02-24 03:45:00,979,1006,27,0,TRUE,NA,"0.1.4"
"16913","646",2023-02-24 04:00:00,979,1006,27,0,TRUE,NA,"0.1.4"
"16914","646",2023-02-24 04:15:00,979,1006,27,0,TRUE,NA,"0.1.4"
"16915","646",2023-02-24 04:30:00,979,1006,27,0,TRUE,NA,"0.1.4"
"16916","646",2023-02-24 04:45:00,979,1006,27,0,TRUE,NA,"0.1.4"
"16917","646",2023-02-24 05:00:00,979,1006,27,0,TRUE,NA,"0.1.4"
"16918","646",2023-02-24 05:15:00,979,1006,27,0,TRUE,NA,"0.1.4"
"16919","646",2023-02-24 05:30:00,979,1006,27,0,TRUE,NA,"0.1.4"
"16920","646",2023-02-24 05:45:00,979,1006,27,0,TRUE,NA,"0.1.4"
"16921","646",2023-02-24 06:00:00,979,1006,27,0,TRUE,NA,"0.1.4"
"16922","646",2023-02-24 06:15:00,979,1006,27,0,TRUE,NA,"0.1.4"
"16923","646",2023-02-24 06:30:00,979,1006,27,0,TRUE,NA,"0.1.4"
"16924","646",2023-02-24 06:45:00,979,1006,27,0,TRUE,NA,"0.1.4"
"16925","646",2023-02-24 07:00:00,979,1006,27,0,TRUE,NA,"0.1.4"
"16926","646",2023-02-24 07:15:00,979,1006,27,0,TRUE,NA,"0.1.4"
"16927","646",2023-02-24 07:30:00,979,1006,27,0,TRUE,NA,"0.1.4"
"16928","646",2023-02-24 07:45:00,979,1006,27,0,TRUE,NA,"0.1.4"
"16929","646",2023-02-24 08:00:00,979,1006,27,0,TRUE,NA,"0.1.4"
"16930","646",2023-02-24 08:15:00,979,1006,27,0,TRUE,NA,"0.1.4"
"16931","646",2023-02-24 08:30:00,979,1006,27,0,TRUE,NA,"0.1.4"
"16932","646",2023-02-24 08:45:00,979,1006,27,0,TRUE,NA,"0.1.4"
"16933","646",2023-02-24 09:00:00,979,1006,27,0,TRUE,NA,"0.1.4"
"16934","646",2023-02-24 09:15:00,979,1006,27,0,TRUE,NA,"0.1.4"
"16935","646",2023-02-24 09:30:00,979,1006,27,0,TRUE,NA,"0.1.4"
"16936","646",2023-02-24 09:45:00,979,1006,27,0,TRUE,NA,"0.1.4"
"16937","646",2023-02-24 10:00:00,979,1006,27,0,TRUE,NA,"0.1.4"
"16938","646",2023-02-24 10:15:00,979,1006,27,0,TRUE,NA,"0.1.4"
"16939","646",2023-02-24 10:30:00,979,1006,27,0,TRUE,NA,"0.1.4"
"16940","646",2023-02-24 10:45:00,979,1006,27,0,TRUE,NA,"0.1.4"
"16941","646",2023-02-24 11:00:00,979,1006,27,0,TRUE,NA,"0.1.4"
"16942","646",2023-02-24 11:15:00,979,1006,27,0,TRUE,NA,"0.1.4"
"16943","646",2023-02-24 11:30:00,978,1006,28,0,TRUE,NA,"0.1.4"
"16944","646",2023-02-24 11:45:00,978,1006,28,0,TRUE,NA,"0.1.4"
"16945","646",2023-02-24 12:00:00,978,1006,28,0,TRUE,NA,"0.1.4"
"16946","646",2023-02-24 12:15:00,978,1006,28,0,TRUE,NA,"0.1.4"
"16947","646",2023-02-24 12:30:00,978,1006,28,0,TRUE,NA,"0.1.4"
"16948","646",2023-02-24 12:45:00,978,1006,28,0,TRUE,NA,"0.1.4"
"16949","646",2023-02-24 13:00:00,978,1006,28,0,TRUE,NA,"0.1.4"
"16950","646",2023-02-24 13:15:00,978,1006,28,0,TRUE,NA,"0.1.4"
"16951","646",2023-02-24 13:30:00,978,1006,28,0,TRUE,NA,"0.1.4"
"16952","646",2023-02-24 13:45:00,978,1006,28,0,TRUE,NA,"0.1.4"
"16953","646",2023-02-24 14:00:00,978,1006,28,0,TRUE,NA,"0.1.4"
"16954","646",2023-02-24 14:15:00,978,1006,28,0,TRUE,NA,"0.1.4"
"16955","646",2023-02-24 14:30:00,978,1006,28,0,TRUE,NA,"0.1.4"
"16956","646",2023-02-24 14:45:00,978,1006,28,0,TRUE,NA,"0.1.4"
"16957","646",2023-02-24 15:00:00,978,1006,28,0,TRUE,NA,"0.1.4"
"16958","646",2023-02-24 15:15:00,978,1006,28,0,TRUE,NA,"0.1.4"
"16959","646",2023-02-24 15:30:00,978,1006,28,0,TRUE,NA,"0.1.4"
"16960","646",2023-02-24 15:45:00,978,1006,28,0,TRUE,NA,"0.1.4"
"16961","646",2023-02-24 16:00:00,978,1006,28,0,TRUE,NA,"0.1.4"
"16962","646",2023-02-24 16:15:00,978,1006,28,0,TRUE,NA,"0.1.4"
"16963","646",2023-02-24 16:30:00,978,1006,28,0,TRUE,NA,"0.1.4"
"16964","646",2023-02-24 16:45:00,978,1006,28,0,TRUE,NA,"0.1.4"
"16965","646",2023-02-24 17:00:00,978,1006,28,0,TRUE,NA,"0.1.4"
"16966","646",2023-02-24 17:15:00,978,1006,28,0,TRUE,NA,"0.1.4"
"16967","646",2023-02-24 17:30:00,978,1006,28,0,TRUE,NA,"0.1.4"
"16968","646",2023-02-24 17:45:00,978,1006,28,0,TRUE,NA,"0.1.4"
"16969","646",2023-02-24 18:00:00,978,1006,28,0,TRUE,NA,"0.1.4"
"16970","646",2023-02-24 18:15:00,978,1006,28,0,TRUE,NA,"0.1.4"
"16971","646",2023-02-24 18:30:00,978,1006,28,0,TRUE,NA,"0.1.4"
"16972","646",2023-02-24 18:45:00,978,1006,28,0,TRUE,NA,"0.1.4"
"16973","646",2023-02-24 19:00:00,978,1006,28,0,TRUE,NA,"0.1.4"
"16974","646",2023-02-24 19:15:00,978,1006,28,0,TRUE,NA,"0.1.4"
"16975","646",2023-02-24 19:30:00,977,1006,29,0,TRUE,NA,"0.1.4"
"16976","646",2023-02-24 19:45:00,978,1006,28,0,TRUE,NA,"0.1.4"
"16977","646",2023-02-24 20:00:00,978,1006,28,0,TRUE,NA,"0.1.4"
"16978","646",2023-02-24 20:15:00,978,1006,28,0,TRUE,NA,"0.1.4"
"16979","646",2023-02-24 20:30:00,978,1006,28,0,TRUE,NA,"0.1.4"
"16980","646",2023-02-24 20:45:00,978,1006,28,0,TRUE,NA,"0.1.4"
"16981","646",2023-02-24 21:00:00,978,1006,28,0,TRUE,NA,"0.1.4"
"16982","646",2023-02-24 21:15:00,978,1006,28,0,TRUE,NA,"0.1.4"
"16983","646",2023-02-24 21:30:00,978,1006,28,0,TRUE,NA,"0.1.4"
"16984","646",2023-02-24 21:45:00,978,1006,28,0,TRUE,NA,"0.1.4"
"16985","646",2023-02-24 22:00:00,978,1006,28,0,TRUE,NA,"0.1.4"
"16986","646",2023-02-24 22:15:00,978,1006,28,0,TRUE,NA,"0.1.4"
"16987","646",2023-02-24 22:30:00,978,1006,28,0,TRUE,NA,"0.1.4"
"16988","646",2023-02-24 22:45:00,978,1006,28,0,TRUE,NA,"0.1.4"
"16989","646",2023-02-24 23:00:00,978,1006,28,0,TRUE,NA,"0.1.4"
"16990","646",2023-02-24 23:15:00,978,1006,28,0,TRUE,NA,"0.1.4"
"16991","646",2023-02-24 23:30:00,979,1006,27,0,TRUE,NA,"0.1.4"
"16992","646",2023-02-24 23:45:00,979,1006,27,0,TRUE,NA,"0.1.4"
"16993","646",2023-02-25,979,1006,27,0,TRUE,NA,"0.1.4"
"16994","646",2023-02-25 00:15:00,979,1006,27,0,TRUE,NA,"0.1.4"
"16995","646",2023-02-25 00:30:00,979,1006,27,0,TRUE,NA,"0.1.4"
"16996","646",2023-02-25 00:45:00,979,1006,27,0,TRUE,NA,"0.1.4"
"16997","646",2023-02-25 01:00:00,979,1006,27,0,TRUE,NA,"0.1.4"
"16998","646",2023-02-25 01:15:00,978,1006,28,0,TRUE,NA,"0.1.4"
"16999","646",2023-02-25 01:30:00,979,1006,27,0,TRUE,NA,"0.1.4"
"17000","646",2023-02-25 01:45:00,979,1006,27,0,TRUE,NA,"0.1.4"
"17001","646",2023-02-25 02:00:00,979,1006,27,0,TRUE,NA,"0.1.4"
"17002","646",2023-02-25 02:15:00,978,1006,28,0,TRUE,NA,"0.1.4"
"17003","646",2023-02-25 02:30:00,979,1006,27,0,TRUE,NA,"0.1.4"
"17004","646",2023-02-25 02:45:00,979,1006,27,0,TRUE,NA,"0.1.4"
"17005","646",2023-02-25 03:00:00,979,1006,27,0,TRUE,NA,"0.1.4"
"17006","646",2023-02-25 03:15:00,979,1006,27,0,TRUE,NA,"0.1.4"
"17007","646",2023-02-25 03:30:00,979,1006,27,0,TRUE,NA,"0.1.4"
"17008","646",2023-02-25 03:45:00,979,1006,27,0,TRUE,NA,"0.1.4"
"17009","646",2023-02-25 04:00:00,978,1006,28,0,TRUE,NA,"0.1.4"
"17010","646",2023-02-25 04:15:00,979,1006,27,0,TRUE,NA,"0.1.4"
"17011","646",2023-02-25 04:30:00,979,1006,27,0,TRUE,NA,"0.1.4"
"17012","646",2023-02-25 04:45:00,979,1006,27,0,TRUE,NA,"0.1.4"
"17013","646",2023-02-25 05:00:00,979,1006,27,0,TRUE,NA,"0.1.4"
"17014","646",2023-02-25 05:15:00,979,1006,27,0,TRUE,NA,"0.1.4"
"17015","646",2023-02-25 05:30:00,979,1006,27,0,TRUE,NA,"0.1.4"
"17016","646",2023-02-25 05:45:00,979,1006,27,0,TRUE,NA,"0.1.4"
"17017","646",2023-02-25 06:00:00,979,1006,27,0,TRUE,NA,"0.1.4"
"17018","646",2023-02-25 06:15:00,979,1006,27,0,TRUE,NA,"0.1.4"
"17019","646",2023-02-25 06:30:00,979,1006,27,0,TRUE,NA,"0.1.4"
"17020","646",2023-02-25 06:45:00,979,1006,27,0,TRUE,NA,"0.1.4"
"17021","646",2023-02-25 07:00:00,979,1006,27,0,TRUE,NA,"0.1.4"
"17022","646",2023-02-25 07:15:00,979,1006,27,0,TRUE,NA,"0.1.4"
"17023","646",2023-02-25 07:30:00,978,1006,28,0,TRUE,NA,"0.1.4"
"17024","646",2023-02-25 07:45:00,978,1006,28,0,TRUE,NA,"0.1.4"
"17025","646",2023-02-25 08:00:00,979,1006,27,0,TRUE,NA,"0.1.4"
"17026","646",2023-02-25 08:15:00,979,1006,27,0,TRUE,NA,"0.1.4"
"17027","646",2023-02-25 08:30:00,979,1006,27,0,TRUE,NA,"0.1.4"
"17028","646",2023-02-25 08:45:00,979,1006,27,0,TRUE,NA,"0.1.4"
"17029","646",2023-02-25 09:00:00,979,1006,27,0,TRUE,NA,"0.1.4"
"17030","646",2023-02-25 09:15:00,979,1006,27,0,TRUE,NA,"0.1.4"
"17031","646",2023-02-25 09:30:00,979,1006,27,0,TRUE,NA,"0.1.4"
"17032","646",2023-02-25 09:45:00,979,1006,27,0,TRUE,NA,"0.1.4"
"17033","646",2023-02-25 10:00:00,979,1006,27,0,TRUE,NA,"0.1.4"
"17034","646",2023-02-25 10:15:00,979,1006,27,0,TRUE,NA,"0.1.4"
"17035","646",2023-02-25 10:30:00,979,1006,27,0,TRUE,NA,"0.1.4"
"17036","646",2023-02-25 10:45:00,979,1006,27,0,TRUE,NA,"0.1.4"
"17037","646",2023-02-25 11:00:00,979,1006,27,0,TRUE,NA,"0.1.4"
"17038","646",2023-02-25 11:15:00,979,1006,27,0,TRUE,NA,"0.1.4"
"17039","646",2023-02-25 11:30:00,979,1006,27,0,TRUE,NA,"0.1.4"
"17040","646",2023-02-25 11:45:00,979,1006,27,0,TRUE,NA,"0.1.4"
"17041","646",2023-02-25 12:00:00,979,1006,27,0,TRUE,NA,"0.1.4"
"17042","646",2023-02-25 12:15:00,979,1006,27,0,TRUE,NA,"0.1.4"
"17043","646",2023-02-25 12:30:00,979,1006,27,0,TRUE,NA,"0.1.4"
"17044","646",2023-02-25 12:45:00,979,1006,27,0,TRUE,NA,"0.1.4"
"17045","646",2023-02-25 13:00:00,979,1006,27,0,TRUE,NA,"0.1.4"
"17046","646",2023-02-25 13:15:00,979,1006,27,0,TRUE,NA,"0.1.4"
"17047","646",2023-02-25 13:30:00,979,1006,27,0,TRUE,NA,"0.1.4"
"17048","646",2023-02-25 13:45:00,979,1006,27,0,TRUE,NA,"0.1.4"
"17049","646",2023-02-25 14:00:00,979,1006,27,0,TRUE,NA,"0.1.4"
"17050","646",2023-02-25 14:15:00,979,1006,27,0,TRUE,NA,"0.1.4"
"17051","646",2023-02-25 14:30:00,979,1006,27,0,TRUE,NA,"0.1.4"
"17052","646",2023-02-25 14:45:00,979,1006,27,0,TRUE,NA,"0.1.4"
"17053","646",2023-02-25 15:00:00,979,1006,27,0,TRUE,NA,"0.1.4"
"17054","646",2023-02-25 15:15:00,979,1006,27,0,TRUE,NA,"0.1.4"
"17055","646",2023-02-25 15:30:00,979,1006,27,0,TRUE,NA,"0.1.4"
"17056","646",2023-02-25 15:45:00,979,1006,27,0,TRUE,NA,"0.1.4"
"17057","646",2023-02-25 16:00:00,979,1006,27,0,TRUE,NA,"0.1.4"
"17058","646",2023-02-25 16:15:00,979,1006,27,0,TRUE,NA,"0.1.4"
"17059","646",2023-02-25 16:30:00,979,1006,27,0,TRUE,NA,"0.1.4"
"17060","646",2023-02-25 16:45:00,979,1006,27,0,TRUE,NA,"0.1.4"
"17061","646",2023-02-25 17:00:00,979,1006,27,0,TRUE,NA,"0.1.4"
"17062","646",2023-02-25 17:15:00,979,1006,27,0,TRUE,NA,"0.1.4"
"17063","646",2023-02-25 17:30:00,979,1006,27,0,TRUE,NA,"0.1.4"
"17064","646",2023-02-25 17:45:00,979,1006,27,0,TRUE,NA,"0.1.4"
"17065","646",2023-02-25 18:00:00,979,1006,27,0,TRUE,NA,"0.1.4"
"17066","646",2023-02-25 18:15:00,979,1006,27,0,TRUE,NA,"0.1.4"
"17067","646",2023-02-25 18:30:00,979,1006,27,0,TRUE,NA,"0.1.4"
"17068","646",2023-02-25 18:45:00,979,1006,27,0,TRUE,NA,"0.1.4"
"17069","646",2023-02-25 19:00:00,979,1006,27,0,TRUE,NA,"0.1.4"
"17070","646",2023-02-25 19:15:00,979,1006,27,0,TRUE,NA,"0.1.4"
"17071","646",2023-02-25 19:30:00,979,1006,27,0,TRUE,NA,"0.1.4"
"17072","646",2023-02-25 19:45:00,979,1006,27,0,TRUE,NA,"0.1.4"
"17073","646",2023-02-25 20:00:00,980,1006,26,0,TRUE,NA,"0.1.4"
"17074","646",2023-02-25 20:15:00,980,1006,26,0,TRUE,NA,"0.1.4"
"17075","646",2023-02-25 20:30:00,980,1006,26,0,TRUE,NA,"0.1.4"
"17076","646",2023-02-25 20:45:00,980,1006,26,0,TRUE,NA,"0.1.4"
"17077","646",2023-02-25 21:00:00,980,1006,26,0,TRUE,NA,"0.1.4"
"17078","646",2023-02-25 21:15:00,980,1006,26,0,TRUE,NA,"0.1.4"
"17079","646",2023-02-25 21:30:00,980,1006,26,0,TRUE,NA,"0.1.4"
"17080","646",2023-02-25 21:45:00,980,1006,26,0,TRUE,NA,"0.1.4"
"17081","646",2023-02-25 22:00:00,980,1006,26,0,TRUE,NA,"0.1.4"
"17082","646",2023-02-25 22:15:00,980,1006,26,0,TRUE,NA,"0.1.4"
"17083","646",2023-02-25 22:30:00,980,1006,26,0,TRUE,NA,"0.1.4"
"17084","646",2023-02-25 22:45:00,979,1006,27,0,TRUE,NA,"0.1.4"
"17085","646",2023-02-25 23:00:00,979,1006,27,0,TRUE,NA,"0.1.4"
"17086","646",2023-02-25 23:15:00,979,1006,27,0,TRUE,NA,"0.1.4"
"17087","646",2023-02-25 23:30:00,979,1006,27,0,TRUE,NA,"0.1.4"
"17088","646",2023-02-25 23:45:00,979,1006,27,0,TRUE,NA,"0.1.4"
"17089","646",2023-02-26,979,1006,27,0,TRUE,NA,"0.1.4"
"17090","646",2023-02-26 00:15:00,979,1006,27,0,TRUE,NA,"0.1.4"
"17091","646",2023-02-26 00:30:00,979,1006,27,0,TRUE,NA,"0.1.4"
"17092","646",2023-02-26 00:45:00,980,1006,26,0,TRUE,NA,"0.1.4"
"17093","646",2023-02-26 01:00:00,980,1006,26,0,TRUE,NA,"0.1.4"
"17094","646",2023-02-26 01:15:00,980,1006,26,0,TRUE,NA,"0.1.4"
"17095","646",2023-02-26 01:30:00,980,1006,26,0,TRUE,NA,"0.1.4"
"17096","646",2023-02-26 01:45:00,980,1006,26,0,TRUE,NA,"0.1.4"
"17097","646",2023-02-26 02:00:00,980,1006,26,0,TRUE,NA,"0.1.4"
"17098","646",2023-02-26 02:15:00,980,1006,26,0,TRUE,NA,"0.1.4"
"17099","646",2023-02-26 02:30:00,980,1006,26,0,TRUE,NA,"0.1.4"
"17100","646",2023-02-26 02:45:00,980,1006,26,0,TRUE,NA,"0.1.4"
"17101","646",2023-02-26 03:00:00,978,1006,28,0,TRUE,NA,"0.1.4"
"17102","646",2023-02-26 03:15:00,978,1006,28,0,TRUE,NA,"0.1.4"
"17103","646",2023-02-26 03:30:00,979,1006,27,0,TRUE,NA,"0.1.4"
"17104","646",2023-02-26 03:45:00,979,1006,27,0,TRUE,NA,"0.1.4"
"17105","646",2023-02-26 04:00:00,979,1006,27,0,TRUE,NA,"0.1.4"
"17106","646",2023-02-26 04:15:00,979,1006,27,0,TRUE,NA,"0.1.4"
"17107","646",2023-02-26 04:30:00,979,1006,27,0,TRUE,NA,"0.1.4"
"17108","646",2023-02-26 04:45:00,979,1006,27,0,TRUE,NA,"0.1.4"
"17109","646",2023-02-26 05:00:00,979,1006,27,0,TRUE,NA,"0.1.4"
"17110","646",2023-02-26 05:15:00,979,1006,27,0,TRUE,NA,"0.1.4"
"17111","646",2023-02-26 05:30:00,979,1006,27,0,TRUE,NA,"0.1.4"
"17112","646",2023-02-26 05:45:00,979,1006,27,0,TRUE,NA,"0.1.4"
"17113","646",2023-02-26 06:00:00,979,1006,27,0,TRUE,NA,"0.1.4"
"17114","646",2023-02-26 06:15:00,979,1006,27,0,TRUE,NA,"0.1.4"
"17115","646",2023-02-26 06:30:00,979,1006,27,0,TRUE,NA,"0.1.4"
"17116","646",2023-02-26 06:45:00,979,1006,27,0,TRUE,NA,"0.1.4"
"17117","646",2023-02-26 07:00:00,979,1006,27,0,TRUE,NA,"0.1.4"
"17118","646",2023-02-26 07:15:00,979,1006,27,0,TRUE,NA,"0.1.4"
"17119","646",2023-02-26 07:30:00,979,1006,27,0,TRUE,NA,"0.1.4"
"17120","646",2023-02-26 07:45:00,979,1006,27,0,TRUE,NA,"0.1.4"
"17121","646",2023-02-26 08:00:00,979,1006,27,0,TRUE,NA,"0.1.4"
"17122","646",2023-02-26 08:15:00,979,1006,27,0,TRUE,NA,"0.1.4"
"17123","646",2023-02-26 08:30:00,979,1006,27,0,TRUE,NA,"0.1.4"
"17124","646",2023-02-26 08:45:00,979,1006,27,0,TRUE,NA,"0.1.4"
"17125","646",2023-02-26 09:00:00,979,1006,27,0,TRUE,NA,"0.1.4"
"17126","646",2023-02-26 09:15:00,979,1006,27,0,TRUE,NA,"0.1.4"
"17127","646",2023-02-26 09:30:00,979,1006,27,0,TRUE,NA,"0.1.4"
"17128","646",2023-02-26 09:45:00,979,1006,27,0,TRUE,NA,"0.1.4"
"17129","646",2023-02-26 10:00:00,979,1006,27,0,TRUE,NA,"0.1.4"
"17130","646",2023-02-26 10:15:00,979,1006,27,0,TRUE,NA,"0.1.4"
"17131","646",2023-02-26 10:30:00,979,1006,27,0,TRUE,NA,"0.1.4"
"17132","646",2023-02-26 10:45:00,979,1006,27,0,TRUE,NA,"0.1.4"
"17133","646",2023-02-26 11:00:00,979,1006,27,0,TRUE,NA,"0.1.4"
"17134","646",2023-02-26 11:15:00,979,1006,27,0,TRUE,NA,"0.1.4"
"17135","646",2023-02-26 11:30:00,979,1006,27,0,TRUE,NA,"0.1.4"
"17136","646",2023-02-26 11:45:00,979,1006,27,0,TRUE,NA,"0.1.4"
"17137","646",2023-02-26 12:00:00,979,1006,27,0,TRUE,NA,"0.1.4"
"17138","646",2023-02-26 12:15:00,980,1006,26,0,TRUE,NA,"0.1.4"
"17139","646",2023-02-26 12:30:00,979,1006,27,0,TRUE,NA,"0.1.4"
"17140","646",2023-02-26 12:45:00,980,1006,26,0,TRUE,NA,"0.1.4"
"17141","646",2023-02-26 13:00:00,980,1006,26,0,TRUE,NA,"0.1.4"
"17142","646",2023-02-26 13:15:00,980,1006,26,0,TRUE,NA,"0.1.4"
"17143","646",2023-02-26 13:30:00,981,1006,25,0,TRUE,NA,"0.1.4"
"17144","646",2023-02-26 13:45:00,980,1006,26,0,TRUE,NA,"0.1.4"
"17145","646",2023-02-26 14:00:00,980,1006,26,0,TRUE,NA,"0.1.4"
"17146","646",2023-02-26 14:15:00,980,1006,26,0,TRUE,NA,"0.1.4"
"17147","646",2023-02-26 14:30:00,980,1006,26,0,TRUE,NA,"0.1.4"
"17148","646",2023-02-26 14:45:00,980,1006,26,0,TRUE,NA,"0.1.4"
"17149","646",2023-02-26 15:00:00,981,1006,25,0,TRUE,NA,"0.1.4"
"17150","646",2023-02-26 15:15:00,980,1006,26,0,TRUE,NA,"0.1.4"
"17151","646",2023-02-26 15:30:00,981,1006,25,0,TRUE,NA,"0.1.4"
"17152","646",2023-02-26 15:45:00,980,1006,26,0,TRUE,NA,"0.1.4"
"17153","646",2023-02-26 16:00:00,980,1006,26,0,TRUE,NA,"0.1.4"
"17154","646",2023-02-26 16:15:00,980,1006,26,0,TRUE,NA,"0.1.4"
"17155","646",2023-02-26 16:30:00,980,1006,26,0,TRUE,NA,"0.1.4"
"17156","646",2023-02-26 16:45:00,981,1006,25,0,TRUE,NA,"0.1.4"
"17157","646",2023-02-26 17:00:00,980,1006,26,0,TRUE,NA,"0.1.4"
"17158","646",2023-02-26 17:15:00,980,1006,26,0,TRUE,NA,"0.1.4"
"17159","646",2023-02-26 17:30:00,980,1006,26,0,TRUE,NA,"0.1.4"
"17160","646",2023-02-26 17:45:00,980,1006,26,0,TRUE,NA,"0.1.4"
"17161","646",2023-02-26 18:00:00,980,1006,26,0,TRUE,NA,"0.1.4"
"17162","646",2023-02-26 18:15:00,980,1006,26,0,TRUE,NA,"0.1.4"
"17163","646",2023-02-26 18:30:00,980,1006,26,0,TRUE,NA,"0.1.4"
"17164","646",2023-02-26 18:45:00,980,1006,26,0,TRUE,NA,"0.1.4"
"17165","646",2023-02-26 19:00:00,980,1006,26,0,TRUE,NA,"0.1.4"
"17166","646",2023-02-26 19:15:00,980,1006,26,0,TRUE,NA,"0.1.4"
"17167","646",2023-02-26 19:30:00,980,1006,26,0,TRUE,NA,"0.1.4"
"17168","646",2023-02-26 19:45:00,980,1006,26,0,TRUE,NA,"0.1.4"
"17169","646",2023-02-26 20:00:00,980,1006,26,0,TRUE,NA,"0.1.4"
"17170","646",2023-02-26 20:15:00,980,1006,26,0,TRUE,NA,"0.1.4"
"17171","646",2023-02-26 20:30:00,980,1006,26,0,TRUE,NA,"0.1.4"
"17172","646",2023-02-26 20:45:00,980,1006,26,0,TRUE,NA,"0.1.4"
"17173","646",2023-02-26 21:00:00,980,1006,26,0,TRUE,NA,"0.1.4"
"17174","646",2023-02-26 21:15:00,979,1006,27,0,TRUE,NA,"0.1.4"
"17175","646",2023-02-26 21:30:00,979,1006,27,0,TRUE,NA,"0.1.4"
"17176","646",2023-02-26 21:45:00,979,1006,27,0,TRUE,NA,"0.1.4"
"17177","646",2023-02-26 22:00:00,979,1006,27,0,TRUE,NA,"0.1.4"
"17178","646",2023-02-26 22:15:00,978,1006,28,0,TRUE,NA,"0.1.4"
"17179","646",2023-02-26 22:30:00,978,1006,28,0,TRUE,NA,"0.1.4"
"17180","646",2023-02-26 22:45:00,978,1006,28,0,TRUE,NA,"0.1.4"
"17181","646",2023-02-26 23:00:00,978,1006,28,0,TRUE,NA,"0.1.4"
"17182","646",2023-02-26 23:15:00,978,1006,28,0,TRUE,NA,"0.1.4"
"17183","646",2023-02-26 23:30:00,978,1006,28,0,TRUE,NA,"0.1.4"
"17184","646",2023-02-26 23:45:00,978,1006,28,0,TRUE,NA,"0.1.4"
"17185","646",2023-02-27,978,1006,28,0,TRUE,NA,"0.1.4"
"17186","646",2023-02-27 00:15:00,978,1006,28,0,TRUE,NA,"0.1.4"
"17187","646",2023-02-27 00:30:00,978,1006,28,0,TRUE,NA,"0.1.4"
"17188","646",2023-02-27 00:45:00,978,1006,28,0,TRUE,NA,"0.1.4"
"17189","646",2023-02-27 01:00:00,978,1006,28,0,TRUE,NA,"0.1.4"
"17190","646",2023-02-27 01:15:00,977,1006,29,0,TRUE,NA,"0.1.4"
"17191","646",2023-02-27 01:30:00,978,1006,28,0,TRUE,NA,"0.1.4"
"17192","646",2023-02-27 01:45:00,977,1006,29,0,TRUE,NA,"0.1.4"
"17193","646",2023-02-27 02:00:00,978,1006,28,0,TRUE,NA,"0.1.4"
"17194","646",2023-02-27 02:15:00,978,1006,28,0,TRUE,NA,"0.1.4"
"17195","646",2023-02-27 02:30:00,978,1006,28,0,TRUE,NA,"0.1.4"
"17196","646",2023-02-27 02:45:00,978,1006,28,0,TRUE,NA,"0.1.4"
"17197","646",2023-02-27 03:00:00,978,1006,28,0,TRUE,NA,"0.1.4"
"17198","646",2023-02-27 03:15:00,978,1006,28,0,TRUE,NA,"0.1.4"
"17199","646",2023-02-27 03:30:00,978,1006,28,0,TRUE,NA,"0.1.4"
"17200","646",2023-02-27 03:45:00,978,1006,28,0,TRUE,NA,"0.1.4"
"17201","646",2023-02-27 04:00:00,978,1006,28,0,TRUE,NA,"0.1.4"
"17202","646",2023-02-27 04:15:00,978,1006,28,0,TRUE,NA,"0.1.4"
"17203","646",2023-02-27 04:30:00,978,1006,28,0,TRUE,NA,"0.1.4"
"17204","646",2023-02-27 04:45:00,978,1006,28,0,TRUE,NA,"0.1.4"
"17205","646",2023-02-27 05:00:00,978,1006,28,0,TRUE,NA,"0.1.4"
"17206","646",2023-02-27 05:15:00,978,1006,28,0,TRUE,NA,"0.1.4"
"17207","646",2023-02-27 05:30:00,978,1006,28,0,TRUE,NA,"0.1.4"
"17208","646",2023-02-27 05:45:00,978,1006,28,0,TRUE,NA,"0.1.4"
"17209","646",2023-02-27 06:00:00,978,1006,28,0,TRUE,NA,"0.1.4"
"17210","646",2023-02-27 06:15:00,978,1006,28,0,TRUE,NA,"0.1.4"
"17211","646",2023-02-27 06:30:00,978,1006,28,0,TRUE,NA,"0.1.4"
"17212","646",2023-02-27 06:45:00,978,1006,28,0,TRUE,NA,"0.1.4"
"17213","646",2023-02-27 07:00:00,978,1006,28,0,TRUE,NA,"0.1.4"
"17214","646",2023-02-27 07:15:00,978,1006,28,0,TRUE,NA,"0.1.4"
"17215","646",2023-02-27 07:30:00,978,1006,28,0,TRUE,NA,"0.1.4"
"17216","646",2023-02-27 07:45:00,978,1006,28,0,TRUE,NA,"0.1.4"
"17217","646",2023-02-27 08:00:00,978,1006,28,0,TRUE,NA,"0.1.4"
"17218","646",2023-02-27 08:15:00,979,1006,27,0,TRUE,NA,"0.1.4"
"17219","646",2023-02-27 08:30:00,978,1006,28,0,TRUE,NA,"0.1.4"
"17220","646",2023-02-27 08:45:00,978,1006,28,0,TRUE,NA,"0.1.4"
"17221","646",2023-02-27 09:00:00,978,1006,28,0,TRUE,NA,"0.1.4"
"17222","646",2023-02-27 09:15:00,978,1006,28,0,TRUE,NA,"0.1.4"
"17223","646",2023-02-27 09:30:00,977,1006,29,0,TRUE,NA,"0.1.4"
"17224","646",2023-02-27 09:45:00,977,1006,29,0,TRUE,NA,"0.1.4"
"17225","646",2023-02-27 10:00:00,977,1006,29,0,TRUE,NA,"0.1.4"
"17226","646",2023-02-27 10:15:00,977,1006,29,0,TRUE,NA,"0.1.4"
"17227","646",2023-02-27 10:30:00,977,1006,29,0,TRUE,NA,"0.1.4"
"17228","646",2023-02-27 10:45:00,977,1006,29,0,TRUE,NA,"0.1.4"
"17229","646",2023-02-27 11:00:00,977,1006,29,0,TRUE,NA,"0.1.4"
"17230","646",2023-02-27 11:15:00,977,1006,29,0,TRUE,NA,"0.1.4"
"17231","646",2023-02-27 11:30:00,977,1006,29,0,TRUE,NA,"0.1.4"
"17232","646",2023-02-27 11:45:00,977,1006,29,0,TRUE,NA,"0.1.4"
"17233","646",2023-02-27 12:00:00,977,1006,29,0,TRUE,NA,"0.1.4"
"17234","646",2023-02-27 12:15:00,977,1006,29,0,TRUE,NA,"0.1.4"
"17235","646",2023-02-27 12:30:00,977,1006,29,0,TRUE,NA,"0.1.4"
"17236","646",2023-02-27 12:45:00,977,1006,29,0,TRUE,NA,"0.1.4"
"17237","646",2023-02-27 13:00:00,977,1006,29,0,TRUE,NA,"0.1.4"
"17238","646",2023-02-27 13:15:00,977,1006,29,0,TRUE,NA,"0.1.4"
"17239","646",2023-02-27 13:30:00,977,1006,29,0,TRUE,NA,"0.1.4"
"17240","646",2023-02-27 13:45:00,977,1006,29,0,TRUE,NA,"0.1.4"
"17241","646",2023-02-27 14:00:00,977,1006,29,0,TRUE,NA,"0.1.4"
"17242","646",2023-02-27 14:15:00,977,1006,29,0,TRUE,NA,"0.1.4"
"17243","646",2023-02-27 14:30:00,977,1006,29,0,TRUE,NA,"0.1.4"
"17244","646",2023-02-27 14:45:00,977,1006,29,0,TRUE,NA,"0.1.4"
"17245","646",2023-02-27 15:00:00,977,1006,29,0,TRUE,NA,"0.1.4"
"17246","646",2023-02-27 15:15:00,977,1006,29,0,TRUE,NA,"0.1.4"
"17247","646",2023-02-27 15:30:00,977,1006,29,0,TRUE,NA,"0.1.4"
"17248","646",2023-02-27 15:45:00,977,1006,29,0,TRUE,NA,"0.1.4"
"17249","646",2023-02-27 16:00:00,977,1006,29,0,TRUE,NA,"0.1.4"
"17250","646",2023-02-27 16:15:00,977,1006,29,0,TRUE,NA,"0.1.4"
"17251","646",2023-02-27 16:30:00,977,1006,29,0,TRUE,NA,"0.1.4"
"17252","646",2023-02-27 16:45:00,977,1006,29,0,TRUE,NA,"0.1.4"
"17253","646",2023-02-27 17:00:00,977,1006,29,0,TRUE,NA,"0.1.4"
"17254","646",2023-02-27 17:15:00,977,1006,29,0,TRUE,NA,"0.1.4"
"17255","646",2023-02-27 17:30:00,977,1006,29,0,TRUE,NA,"0.1.4"
"17256","646",2023-02-27 17:45:00,977,1006,29,0,TRUE,NA,"0.1.4"
"17257","646",2023-02-27 18:00:00,977,1006,29,0,TRUE,NA,"0.1.4"
"17258","646",2023-02-27 18:15:00,977,1006,29,0,TRUE,NA,"0.1.4"
"17259","646",2023-02-27 18:30:00,977,1006,29,0,TRUE,NA,"0.1.4"
"17260","646",2023-02-27 18:45:00,977,1006,29,0,TRUE,NA,"0.1.4"
"17261","646",2023-02-27 19:00:00,977,1006,29,0,TRUE,NA,"0.1.4"
"17262","646",2023-02-27 19:15:00,977,1006,29,0,TRUE,NA,"0.1.4"
"17263","646",2023-02-27 19:30:00,977,1006,29,0,TRUE,NA,"0.1.4"
"17264","646",2023-02-27 19:45:00,977,1006,29,0,TRUE,NA,"0.1.4"
"17265","646",2023-02-27 20:00:00,977,1006,29,0,TRUE,NA,"0.1.4"
"17266","646",2023-02-27 20:15:00,977,1006,29,0,TRUE,NA,"0.1.4"
"17267","646",2023-02-27 20:30:00,977,1006,29,0,TRUE,NA,"0.1.4"
"17268","646",2023-02-27 20:45:00,977,1006,29,0,TRUE,NA,"0.1.4"
"17269","646",2023-02-27 21:00:00,977,1006,29,0,TRUE,NA,"0.1.4"
"17270","646",2023-02-27 21:15:00,977,1006,29,0,TRUE,NA,"0.1.4"
"17271","646",2023-02-27 21:30:00,977,1006,29,0,TRUE,NA,"0.1.4"
"17272","646",2023-02-27 21:45:00,977,1006,29,0,TRUE,NA,"0.1.4"
"17273","646",2023-02-27 22:00:00,977,1006,29,0,TRUE,NA,"0.1.4"
"17274","646",2023-02-27 22:15:00,977,1006,29,0,TRUE,NA,"0.1.4"
"17275","646",2023-02-27 22:30:00,977,1006,29,0,TRUE,NA,"0.1.4"
"17276","646",2023-02-27 22:45:00,977,1006,29,0,TRUE,NA,"0.1.4"
"17277","646",2023-02-27 23:00:00,977,1006,29,0,TRUE,NA,"0.1.4"
"17278","646",2023-02-27 23:15:00,977,1006,29,0,TRUE,NA,"0.1.4"
"17279","646",2023-02-27 23:30:00,977,1006,29,0,TRUE,NA,"0.1.4"
"17280","646",2023-02-27 23:45:00,978,1006,28,0,TRUE,NA,"0.1.4"
"17281","646",2023-02-28,978,1006,28,0,TRUE,NA,"0.1.4"
"17282","646",2023-02-28 00:15:00,978,1006,28,0,TRUE,NA,"0.1.4"
"17283","646",2023-02-28 00:30:00,978,1006,28,0,TRUE,NA,"0.1.4"
"17284","646",2023-02-28 00:45:00,978,1006,28,0,TRUE,NA,"0.1.4"
"17285","646",2023-02-28 01:00:00,978,1006,28,0,TRUE,NA,"0.1.4"
"17286","646",2023-02-28 01:15:00,977,1006,29,0,TRUE,NA,"0.1.4"
"17287","646",2023-02-28 01:30:00,977,1006,29,0,TRUE,NA,"0.1.4"
"17288","646",2023-02-28 01:45:00,977,1006,29,0,TRUE,NA,"0.1.4"
"17289","646",2023-02-28 02:00:00,977,1006,29,0,TRUE,NA,"0.1.4"
"17290","646",2023-02-28 02:15:00,977,1006,29,0,TRUE,NA,"0.1.4"
"17291","646",2023-02-28 02:30:00,977,1006,29,0,TRUE,NA,"0.1.4"
"17292","646",2023-02-28 02:45:00,977,1006,29,0,TRUE,NA,"0.1.4"
"17293","646",2023-02-28 03:00:00,977,1006,29,0,TRUE,NA,"0.1.4"
"17294","646",2023-02-28 03:15:00,977,1006,29,0,TRUE,NA,"0.1.4"
"17295","646",2023-02-28 03:30:00,977,1006,29,0,TRUE,NA,"0.1.4"
"17296","646",2023-02-28 03:45:00,977,1006,29,0,TRUE,NA,"0.1.4"
"17297","646",2023-02-28 04:00:00,977,1006,29,0,TRUE,NA,"0.1.4"
"17298","646",2023-02-28 04:15:00,977,1006,29,0,TRUE,NA,"0.1.4"
"17299","646",2023-02-28 04:30:00,978,1006,28,0,TRUE,NA,"0.1.4"
"17300","646",2023-02-28 04:45:00,977,1006,29,0,TRUE,NA,"0.1.4"
"17301","646",2023-02-28 05:00:00,977,1006,29,0,TRUE,NA,"0.1.4"
"17302","646",2023-02-28 05:15:00,977,1006,29,0,TRUE,NA,"0.1.4"
"17303","646",2023-02-28 05:30:00,977,1006,29,0,TRUE,NA,"0.1.4"
"17304","646",2023-02-28 05:45:00,978,1006,28,0,TRUE,NA,"0.1.4"
"17305","646",2023-02-28 06:00:00,978,1006,28,0,TRUE,NA,"0.1.4"
"17306","646",2023-02-28 06:15:00,978,1006,28,0,TRUE,NA,"0.1.4"
"17307","646",2023-02-28 06:30:00,978,1006,28,0,TRUE,NA,"0.1.4"
"17308","646",2023-02-28 06:45:00,978,1006,28,0,TRUE,NA,"0.1.4"
"17309","646",2023-02-28 07:00:00,978,1006,28,0,TRUE,NA,"0.1.4"
"17310","646",2023-02-28 07:15:00,978,1006,28,0,TRUE,NA,"0.1.4"
"17311","646",2023-02-28 07:30:00,978,1006,28,0,TRUE,NA,"0.1.4"
"17312","646",2023-02-28 07:45:00,978,1006,28,0,TRUE,NA,"0.1.4"
"17313","646",2023-02-28 08:00:00,978,1006,28,0,TRUE,NA,"0.1.4"
"17314","646",2023-02-28 08:15:00,978,1006,28,0,TRUE,NA,"0.1.4"
"17315","646",2023-02-28 08:30:00,978,1006,28,0,TRUE,NA,"0.1.4"
"17316","646",2023-02-28 08:45:00,978,1006,28,0,TRUE,NA,"0.1.4"
"17317","646",2023-02-28 09:00:00,978,1006,28,0,TRUE,NA,"0.1.4"
"17318","646",2023-02-28 09:15:00,981,1006,25,0,TRUE,NA,"0.1.4"
"17319","646",2023-02-28 09:30:00,981,1006,25,0,TRUE,NA,"0.1.4"
"17320","646",2023-02-28 09:45:00,981,1006,25,0,TRUE,NA,"0.1.4"
"17321","646",2023-02-28 10:00:00,981,1006,25,0,TRUE,NA,"0.1.4"
"17322","646",2023-02-28 10:15:00,981,1006,25,0,TRUE,NA,"0.1.4"
"17323","646",2023-02-28 10:30:00,981,1006,25,0,TRUE,NA,"0.1.4"
"17324","646",2023-02-28 10:45:00,981,1006,25,0,TRUE,NA,"0.1.4"
"17325","646",2023-02-28 11:00:00,981,1006,25,0,TRUE,NA,"0.1.4"
"17326","646",2023-02-28 11:15:00,981,1006,25,0,TRUE,NA,"0.1.4"
"17327","646",2023-02-28 11:30:00,981,1006,25,0,TRUE,NA,"0.1.4"
"17328","646",2023-02-28 11:45:00,981,1006,25,0,TRUE,NA,"0.1.4"
"17329","646",2023-02-28 12:00:00,981,1006,25,0,TRUE,NA,"0.1.4"
"17330","646",2023-02-28 12:15:00,981,1006,25,0,TRUE,NA,"0.1.4"
"17331","646",2023-02-28 12:30:00,981,1006,25,0,TRUE,NA,"0.1.4"
"17332","646",2023-02-28 12:45:00,981,1006,25,0,TRUE,NA,"0.1.4"
"17333","646",2023-02-28 13:00:00,981,1006,25,0,TRUE,NA,"0.1.4"
"17334","646",2023-02-28 13:15:00,981,1006,25,0,TRUE,NA,"0.1.4"
"17335","646",2023-02-28 13:30:00,981,1006,25,0,TRUE,NA,"0.1.4"
"17336","646",2023-02-28 13:45:00,981,1006,25,0,TRUE,NA,"0.1.4"
"17337","646",2023-02-28 14:00:00,981,1006,25,0,TRUE,NA,"0.1.4"
"17338","646",2023-02-28 14:15:00,981,1006,25,0,TRUE,NA,"0.1.4"
"17339","646",2023-02-28 14:30:00,981,1006,25,0,TRUE,NA,"0.1.4"
"17340","646",2023-02-28 14:45:00,981,1006,25,0,TRUE,NA,"0.1.4"
"17341","646",2023-02-28 15:00:00,981,1006,25,0,TRUE,NA,"0.1.4"
"17342","646",2023-02-28 15:15:00,981,1006,25,0,TRUE,NA,"0.1.4"
"17343","646",2023-02-28 15:30:00,981,1006,25,0,TRUE,NA,"0.1.4"
"17344","646",2023-02-28 15:45:00,981,1006,25,0,TRUE,NA,"0.1.4"
"17345","646",2023-02-28 16:00:00,981,1006,25,0,TRUE,NA,"0.1.4"
"17346","646",2023-02-28 16:15:00,981,1006,25,0,TRUE,NA,"0.1.4"
"17347","646",2023-02-28 16:30:00,981,1006,25,0,TRUE,NA,"0.1.4"
"17348","646",2023-02-28 16:45:00,981,1006,25,0,TRUE,NA,"0.1.4"
"17349","646",2023-02-28 17:00:00,981,1006,25,0,TRUE,NA,"0.1.4"
"17350","646",2023-02-28 17:15:00,981,1006,25,0,TRUE,NA,"0.1.4"
"17351","646",2023-02-28 17:30:00,981,1006,25,0,TRUE,NA,"0.1.4"
"17352","646",2023-02-28 17:45:00,981,1006,25,0,TRUE,NA,"0.1.4"
"17353","646",2023-02-28 18:00:00,981,1006,25,0,TRUE,NA,"0.1.4"
"17354","646",2023-02-28 18:15:00,981,1006,25,0,TRUE,NA,"0.1.4"
"17355","646",2023-02-28 18:30:00,981,1006,25,0,TRUE,NA,"0.1.4"
"17356","646",2023-02-28 18:45:00,981,1006,25,0,TRUE,NA,"0.1.4"
"17357","646",2023-02-28 19:00:00,981,1006,25,0,TRUE,NA,"0.1.4"
"17358","646",2023-02-28 19:15:00,981,1006,25,0,TRUE,NA,"0.1.4"
"17359","646",2023-02-28 19:30:00,981,1006,25,0,TRUE,NA,"0.1.4"
"17360","646",2023-02-28 19:45:00,981,1006,25,0,TRUE,NA,"0.1.4"
"17361","646",2023-02-28 20:00:00,981,1006,25,0,TRUE,NA,"0.1.4"
"17362","646",2023-02-28 20:15:00,981,1006,25,0,TRUE,NA,"0.1.4"
"17363","646",2023-02-28 20:30:00,981,1006,25,0,TRUE,NA,"0.1.4"
"17364","646",2023-02-28 20:45:00,981,1006,25,0,TRUE,NA,"0.1.4"
"17365","646",2023-02-28 21:00:00,981,1006,25,0,TRUE,NA,"0.1.4"
"17366","646",2023-02-28 21:15:00,981,1006,25,0,TRUE,NA,"0.1.4"
"17367","646",2023-02-28 21:30:00,981,1006,25,0,TRUE,NA,"0.1.4"
"17368","646",2023-02-28 21:45:00,981,1006,25,0,TRUE,NA,"0.1.4"
"17369","646",2023-02-28 22:00:00,981,1006,25,0,TRUE,NA,"0.1.4"
"17370","646",2023-02-28 22:15:00,986,1006,20,0,TRUE,NA,"0.1.4"
"17371","646",2023-02-28 22:30:00,985,1006,21,0,TRUE,NA,"0.1.4"
"17372","646",2023-02-28 22:45:00,986,1006,20,0,TRUE,NA,"0.1.4"
"17373","646",2023-02-28 23:00:00,985,1006,21,0,TRUE,NA,"0.1.4"
"17374","646",2023-02-28 23:15:00,985,1006,21,0,TRUE,NA,"0.1.4"
"17375","646",2023-02-28 23:30:00,985,1006,21,0,TRUE,NA,"0.1.4"
"17376","646",2023-02-28 23:45:00,985,1006,21,0,TRUE,NA,"0.1.4"
"17377","646",2023-03-01,985,1006,21,0,TRUE,NA,"0.1.4"
"17378","646",2023-03-01 00:15:00,985,1006,21,0,TRUE,NA,"0.1.4"
"17379","646",2023-03-01 00:30:00,986,1006,20,0,TRUE,NA,"0.1.4"
"17380","646",2023-03-01 00:45:00,985,1006,21,0,TRUE,NA,"0.1.4"
"17381","646",2023-03-01 01:00:00,985,1006,21,0,TRUE,NA,"0.1.4"
"17382","646",2023-03-01 01:15:00,985,1006,21,0,TRUE,NA,"0.1.4"
"17383","646",2023-03-01 01:30:00,985,1006,21,0,TRUE,NA,"0.1.4"
"17384","646",2023-03-01 01:45:00,986,1006,20,0,TRUE,NA,"0.1.4"
"17385","646",2023-03-01 02:00:00,985,1006,21,0,TRUE,NA,"0.1.4"
"17386","646",2023-03-01 02:15:00,985,1006,21,0,TRUE,NA,"0.1.4"
"17387","646",2023-03-01 02:30:00,985,1006,21,0,TRUE,NA,"0.1.4"
"17388","646",2023-03-01 02:45:00,985,1006,21,0,TRUE,NA,"0.1.4"
"17389","646",2023-03-01 03:00:00,985,1006,21,0,TRUE,NA,"0.1.4"
"17390","646",2023-03-01 03:15:00,985,1006,21,0,TRUE,NA,"0.1.4"
"17391","646",2023-03-01 03:30:00,985,1006,21,0,TRUE,NA,"0.1.4"
"17392","646",2023-03-01 03:45:00,985,1006,21,0,TRUE,NA,"0.1.4"
"17393","646",2023-03-01 04:00:00,985,1006,21,0,TRUE,NA,"0.1.4"
"17394","646",2023-03-01 04:15:00,985,1006,21,0,TRUE,NA,"0.1.4"
"17395","646",2023-03-01 04:30:00,985,1006,21,0,TRUE,NA,"0.1.4"
"17396","646",2023-03-01 04:45:00,985,1006,21,0,TRUE,NA,"0.1.4"
"17397","646",2023-03-01 05:00:00,985,1006,21,0,TRUE,NA,"0.1.4"
"17398","646",2023-03-01 05:15:00,985,1006,21,0,TRUE,NA,"0.1.4"
"17399","646",2023-03-01 05:30:00,985,1006,21,0,TRUE,NA,"0.1.4"
"17400","646",2023-03-01 05:45:00,985,1006,21,0,TRUE,NA,"0.1.4"
"17401","646",2023-03-01 06:00:00,985,1006,21,0,TRUE,NA,"0.1.4"
"17402","646",2023-03-01 06:15:00,985,1006,21,0,TRUE,NA,"0.1.4"
"17403","646",2023-03-01 06:30:00,985,1006,21,0,TRUE,NA,"0.1.4"
"17404","646",2023-03-01 06:45:00,985,1006,21,0,TRUE,NA,"0.1.4"
"17405","646",2023-03-01 07:00:00,985,1006,21,0,TRUE,NA,"0.1.4"
"17406","646",2023-03-01 07:15:00,985,1006,21,0,TRUE,NA,"0.1.4"
"17407","646",2023-03-01 07:30:00,985,1006,21,0,TRUE,NA,"0.1.4"
"17408","646",2023-03-01 07:45:00,985,1006,21,0,TRUE,NA,"0.1.4"
"17409","646",2023-03-01 08:00:00,985,1006,21,0,TRUE,NA,"0.1.4"
"17410","646",2023-03-01 08:15:00,985,1006,21,0,TRUE,NA,"0.1.4"
"17411","646",2023-03-01 08:30:00,985,1006,21,0,TRUE,NA,"0.1.4"
"17412","646",2023-03-01 08:45:00,985,1006,21,0,TRUE,NA,"0.1.4"
"17413","646",2023-03-01 09:00:00,985,1006,21,0,TRUE,NA,"0.1.4"
"17414","646",2023-03-01 09:15:00,985,1006,21,0,TRUE,NA,"0.1.4"
"17415","646",2023-03-01 09:30:00,985,1006,21,0,TRUE,NA,"0.1.4"
"17416","646",2023-03-01 09:45:00,985,1006,21,0,TRUE,NA,"0.1.4"
"17417","646",2023-03-01 10:00:00,985,1006,21,0,TRUE,NA,"0.1.4"
"17418","646",2023-03-01 10:15:00,985,1006,21,0,TRUE,NA,"0.1.4"
"17419","646",2023-03-01 10:30:00,985,1006,21,0,TRUE,NA,"0.1.4"
"17420","646",2023-03-01 10:45:00,985,1006,21,0,TRUE,NA,"0.1.4"
"17421","646",2023-03-01 11:00:00,985,1006,21,0,TRUE,NA,"0.1.4"
"17422","646",2023-03-01 11:15:00,985,1006,21,0,TRUE,NA,"0.1.4"
"17423","646",2023-03-01 11:30:00,985,1006,21,0,TRUE,NA,"0.1.4"
"17424","646",2023-03-01 11:45:00,985,1006,21,0,TRUE,NA,"0.1.4"
"17425","646",2023-03-01 12:00:00,985,1006,21,0,TRUE,NA,"0.1.4"
"17426","646",2023-03-01 12:15:00,985,1006,21,0,TRUE,NA,"0.1.4"
"17427","646",2023-03-01 12:30:00,985,1006,21,0,TRUE,NA,"0.1.4"
"17428","646",2023-03-01 12:45:00,985,1006,21,0,TRUE,NA,"0.1.4"
"17429","646",2023-03-01 13:00:00,985,1006,21,0,TRUE,NA,"0.1.4"
"17430","646",2023-03-01 13:15:00,985,1006,21,0,TRUE,NA,"0.1.4"
"17431","646",2023-03-01 13:30:00,985,1006,21,0,TRUE,NA,"0.1.4"
"17432","646",2023-03-01 13:45:00,985,1006,21,0,TRUE,NA,"0.1.4"
"17433","646",2023-03-01 14:00:00,985,1006,21,0,TRUE,NA,"0.1.4"
"17434","646",2023-03-01 14:15:00,985,1006,21,0,TRUE,NA,"0.1.4"
"17435","646",2023-03-01 14:30:00,985,1006,21,0,TRUE,NA,"0.1.4"
"17436","646",2023-03-01 14:45:00,985,1006,21,0,TRUE,NA,"0.1.4"
"17437","646",2023-03-01 15:00:00,985,1006,21,0,TRUE,NA,"0.1.4"
"17438","646",2023-03-01 15:15:00,985,1006,21,0,TRUE,NA,"0.1.4"
"17439","646",2023-03-01 15:30:00,985,1006,21,0,TRUE,NA,"0.1.4"
"17440","646",2023-03-01 15:45:00,985,1006,21,0,TRUE,NA,"0.1.4"
"17441","646",2023-03-01 16:00:00,985,1006,21,0,TRUE,NA,"0.1.4"
"17442","646",2023-03-01 16:15:00,985,1006,21,0,TRUE,NA,"0.1.4"
"17443","646",2023-03-01 16:30:00,985,1006,21,0,TRUE,NA,"0.1.4"
"17444","646",2023-03-01 16:45:00,985,1006,21,0,TRUE,NA,"0.1.4"
"17445","646",2023-03-01 17:00:00,985,1006,21,0,TRUE,NA,"0.1.4"
"17446","646",2023-03-01 17:15:00,985,1006,21,0,TRUE,NA,"0.1.4"
"17447","646",2023-03-01 17:30:00,985,1006,21,0,TRUE,NA,"0.1.4"
"17448","646",2023-03-01 17:45:00,985,1006,21,0,TRUE,NA,"0.1.4"
"17449","646",2023-03-01 18:00:00,985,1006,21,0,TRUE,NA,"0.1.4"
"17450","646",2023-03-01 18:15:00,985,1006,21,0,TRUE,NA,"0.1.4"
"17451","646",2023-03-01 18:30:00,985,1006,21,0,TRUE,NA,"0.1.4"
"17452","646",2023-03-01 18:45:00,985,1006,21,0,TRUE,NA,"0.1.4"
"17453","646",2023-03-01 19:00:00,986,1006,20,0,TRUE,NA,"0.1.4"
"17454","646",2023-03-01 19:15:00,986,1006,20,0,TRUE,NA,"0.1.4"
"17455","646",2023-03-01 19:30:00,985,1006,21,0,TRUE,NA,"0.1.4"
"17456","646",2023-03-01 19:45:00,986,1006,20,0,TRUE,NA,"0.1.4"
"17457","646",2023-03-01 20:00:00,985,1006,21,0,TRUE,NA,"0.1.4"
"17458","646",2023-03-01 20:15:00,985,1006,21,0,TRUE,NA,"0.1.4"
"17459","646",2023-03-01 20:30:00,986,1006,20,0,TRUE,NA,"0.1.4"
"17460","646",2023-03-01 20:45:00,985,1006,21,0,TRUE,NA,"0.1.4"
"17461","646",2023-03-01 21:00:00,985,1006,21,0,TRUE,NA,"0.1.4"
"17462","646",2023-03-01 21:15:00,985,1006,21,0,TRUE,NA,"0.1.4"
"17463","646",2023-03-01 21:30:00,985,1006,21,0,TRUE,NA,"0.1.4"
"17464","646",2023-03-01 21:45:00,985,1006,21,0,TRUE,NA,"0.1.4"
"17465","646",2023-03-01 22:00:00,985,1006,21,0,TRUE,NA,"0.1.4"
"17466","646",2023-03-01 22:15:00,985,1006,21,0,TRUE,NA,"0.1.4"
"17467","646",2023-03-01 22:30:00,985,1006,21,0,TRUE,NA,"0.1.4"
"17468","646",2023-03-01 22:45:00,985,1006,21,0,TRUE,NA,"0.1.4"
"17469","646",2023-03-01 23:00:00,985,1006,21,0,TRUE,NA,"0.1.4"
"17470","646",2023-03-01 23:15:00,985,1006,21,0,TRUE,NA,"0.1.4"
"17471","646",2023-03-01 23:30:00,985,1006,21,0,TRUE,NA,"0.1.4"
"17472","646",2023-03-01 23:45:00,985,1006,21,0,TRUE,NA,"0.1.4"
"17473","646",2023-03-02,985,1006,21,0,TRUE,NA,"0.1.4"
"17474","646",2023-03-02 00:15:00,985,1006,21,0,TRUE,NA,"0.1.4"
"17475","646",2023-03-02 00:30:00,985,1006,21,0,TRUE,NA,"0.1.4"
"17476","646",2023-03-02 00:45:00,985,1006,21,0,TRUE,NA,"0.1.4"
"17477","646",2023-03-02 01:00:00,985,1006,21,0,TRUE,NA,"0.1.4"
"17478","646",2023-03-02 01:15:00,985,1006,21,0,TRUE,NA,"0.1.4"
"17479","646",2023-03-02 01:30:00,985,1006,21,0,TRUE,NA,"0.1.4"
"17480","646",2023-03-02 01:45:00,985,1006,21,0,TRUE,NA,"0.1.4"
"17481","646",2023-03-02 02:00:00,985,1006,21,0,TRUE,NA,"0.1.4"
"17482","646",2023-03-02 02:15:00,985,1006,21,0,TRUE,NA,"0.1.4"
"17483","646",2023-03-02 02:30:00,985,1006,21,0,TRUE,NA,"0.1.4"
"17484","646",2023-03-02 02:45:00,985,1006,21,0,TRUE,NA,"0.1.4"
"17485","646",2023-03-02 03:00:00,985,1006,21,0,TRUE,NA,"0.1.4"
"17486","646",2023-03-02 03:15:00,985,1006,21,0,TRUE,NA,"0.1.4"
"17487","646",2023-03-02 03:30:00,985,1006,21,0,TRUE,NA,"0.1.4"
"17488","646",2023-03-02 03:45:00,985,1006,21,0,TRUE,NA,"0.1.4"
"17489","646",2023-03-02 04:00:00,984,1006,22,0,TRUE,NA,"0.1.4"
"17490","646",2023-03-02 04:15:00,985,1006,21,0,TRUE,NA,"0.1.4"
"17491","646",2023-03-02 04:30:00,984,1006,22,0,TRUE,NA,"0.1.4"
"17492","646",2023-03-02 04:45:00,985,1006,21,0,TRUE,NA,"0.1.4"
"17493","646",2023-03-02 05:00:00,984,1006,22,0,TRUE,NA,"0.1.4"
"17494","646",2023-03-02 05:15:00,984,1006,22,0,TRUE,NA,"0.1.4"
"17495","646",2023-03-02 05:30:00,984,1006,22,0,TRUE,NA,"0.1.4"
"17496","646",2023-03-02 05:45:00,985,1006,21,0,TRUE,NA,"0.1.4"
"17497","646",2023-03-02 06:00:00,985,1006,21,0,TRUE,NA,"0.1.4"
"17498","646",2023-03-02 06:15:00,984,1006,22,0,TRUE,NA,"0.1.4"
"17499","646",2023-03-02 06:30:00,985,1006,21,0,TRUE,NA,"0.1.4"
"17500","646",2023-03-02 06:45:00,985,1006,21,0,TRUE,NA,"0.1.4"
"17501","646",2023-03-02 07:00:00,985,1006,21,0,TRUE,NA,"0.1.4"
"17502","646",2023-03-02 07:15:00,984,1006,22,0,TRUE,NA,"0.1.4"
"17503","646",2023-03-02 07:30:00,984,1006,22,0,TRUE,NA,"0.1.4"
"17504","646",2023-03-02 07:45:00,984,1006,22,0,TRUE,NA,"0.1.4"
"17505","646",2023-03-02 08:00:00,985,1006,21,0,TRUE,NA,"0.1.4"
"17506","646",2023-03-02 08:15:00,985,1006,21,0,TRUE,NA,"0.1.4"
"17507","646",2023-03-02 08:30:00,984,1006,22,0,TRUE,NA,"0.1.4"
"17508","646",2023-03-02 08:45:00,984,1006,22,0,TRUE,NA,"0.1.4"
"17509","646",2023-03-02 09:00:00,985,1006,21,0,TRUE,NA,"0.1.4"
"17510","646",2023-03-02 09:15:00,984,1006,22,0,TRUE,NA,"0.1.4"
"17511","646",2023-03-02 09:30:00,984,1006,22,0,TRUE,NA,"0.1.4"
"17512","646",2023-03-02 09:45:00,985,1006,21,0,TRUE,NA,"0.1.4"
"17513","646",2023-03-02 10:00:00,985,1006,21,0,TRUE,NA,"0.1.4"
"17514","646",2023-03-02 10:15:00,985,1006,21,0,TRUE,NA,"0.1.4"
"17515","646",2023-03-02 10:30:00,985,1006,21,0,TRUE,NA,"0.1.4"
"17516","646",2023-03-02 10:45:00,984,1006,22,0,TRUE,NA,"0.1.4"
"17517","646",2023-03-02 11:00:00,985,1006,21,0,TRUE,NA,"0.1.4"
"17518","646",2023-03-02 11:15:00,985,1006,21,0,TRUE,NA,"0.1.4"
"17519","646",2023-03-02 11:30:00,985,1006,21,0,TRUE,NA,"0.1.4"
"17520","646",2023-03-02 11:45:00,984,1006,22,0,TRUE,NA,"0.1.4"
"17521","646",2023-03-02 12:00:00,985,1006,21,0,TRUE,NA,"0.1.4"
"17522","646",2023-03-02 12:15:00,985,1006,21,0,TRUE,NA,"0.1.4"
"17523","646",2023-03-02 12:30:00,985,1006,21,0,TRUE,NA,"0.1.4"
"17524","646",2023-03-02 12:45:00,985,1006,21,0,TRUE,NA,"0.1.4"
"17525","646",2023-03-02 13:00:00,985,1006,21,0,TRUE,NA,"0.1.4"
"17526","646",2023-03-02 13:15:00,985,1006,21,0,TRUE,NA,"0.1.4"
"17527","646",2023-03-02 13:30:00,985,1006,21,0,TRUE,NA,"0.1.4"
"17528","646",2023-03-02 13:45:00,985,1006,21,0,TRUE,NA,"0.1.4"
"17529","646",2023-03-02 14:00:00,984,1006,22,0,TRUE,NA,"0.1.4"
"17530","646",2023-03-02 14:15:00,984,1006,22,0,TRUE,NA,"0.1.4"
"17531","646",2023-03-02 14:30:00,984,1006,22,0,TRUE,NA,"0.1.4"
"17532","646",2023-03-02 14:45:00,985,1006,21,0,TRUE,NA,"0.1.4"
"17533","646",2023-03-02 15:00:00,985,1006,21,0,TRUE,NA,"0.1.4"
"17534","646",2023-03-02 15:15:00,984,1006,22,0,TRUE,NA,"0.1.4"
"17535","646",2023-03-02 15:30:00,985,1006,21,0,TRUE,NA,"0.1.4"
"17536","646",2023-03-02 15:45:00,985,1006,21,0,TRUE,NA,"0.1.4"
"17537","646",2023-03-02 16:00:00,985,1006,21,0,TRUE,NA,"0.1.4"
"17538","646",2023-03-02 16:15:00,985,1006,21,0,TRUE,NA,"0.1.4"
"17539","646",2023-03-02 16:30:00,985,1006,21,0,TRUE,NA,"0.1.4"
"17540","646",2023-03-02 16:45:00,985,1006,21,0,TRUE,NA,"0.1.4"
"17541","646",2023-03-02 17:00:00,985,1006,21,0,TRUE,NA,"0.1.4"
"17542","646",2023-03-02 17:15:00,985,1006,21,0,TRUE,NA,"0.1.4"
"17543","646",2023-03-02 17:30:00,985,1006,21,0,TRUE,NA,"0.1.4"
"17544","646",2023-03-02 17:45:00,985,1006,21,0,TRUE,NA,"0.1.4"
"17545","646",2023-03-02 18:00:00,985,1006,21,0,TRUE,NA,"0.1.4"
"17546","646",2023-03-02 18:15:00,985,1006,21,0,TRUE,NA,"0.1.4"
"17547","646",2023-03-02 18:30:00,985,1006,21,0,TRUE,NA,"0.1.4"
"17548","646",2023-03-02 18:45:00,985,1006,21,0,TRUE,NA,"0.1.4"
"17549","646",2023-03-02 19:00:00,985,1006,21,0,TRUE,NA,"0.1.4"
"17550","646",2023-03-02 19:15:00,985,1006,21,0,TRUE,NA,"0.1.4"
"17551","646",2023-03-02 19:30:00,985,1006,21,0,TRUE,NA,"0.1.4"
"17552","646",2023-03-02 19:45:00,985,1006,21,0,TRUE,NA,"0.1.4"
"17553","646",2023-03-02 20:00:00,985,1006,21,0,TRUE,NA,"0.1.4"
"17554","646",2023-03-02 20:15:00,985,1006,21,0,TRUE,NA,"0.1.4"
"17555","646",2023-03-02 20:30:00,985,1006,21,0,TRUE,NA,"0.1.4"
"17556","646",2023-03-02 20:45:00,985,1006,21,0,TRUE,NA,"0.1.4"
"17557","646",2023-03-02 21:00:00,985,1006,21,0,TRUE,NA,"0.1.4"
"17558","646",2023-03-02 21:15:00,985,1006,21,0,TRUE,NA,"0.1.4"
"17559","646",2023-03-02 21:30:00,985,1006,21,0,TRUE,NA,"0.1.4"
"17560","646",2023-03-02 21:45:00,985,1006,21,0,TRUE,NA,"0.1.4"
"17561","646",2023-03-02 22:00:00,985,1006,21,0,TRUE,NA,"0.1.4"
"17562","646",2023-03-02 22:15:00,985,1006,21,0,TRUE,NA,"0.1.4"
"17563","646",2023-03-02 22:30:00,985,1006,21,0,TRUE,NA,"0.1.4"
"17564","646",2023-03-02 22:45:00,985,1006,21,0,TRUE,NA,"0.1.4"
"17565","646",2023-03-02 23:00:00,985,1006,21,0,TRUE,NA,"0.1.4"
"17566","646",2023-03-02 23:15:00,985,1006,21,0,TRUE,NA,"0.1.4"
"17567","646",2023-03-02 23:30:00,985,1006,21,0,TRUE,NA,"0.1.4"
"17568","646",2023-03-02 23:45:00,985,1006,21,0,TRUE,NA,"0.1.4"
"17569","646",2023-03-03,985,1006,21,0,TRUE,NA,"0.1.4"
"17570","646",2023-03-03 00:15:00,985,1006,21,0,TRUE,NA,"0.1.4"
"17571","646",2023-03-03 00:30:00,985,1006,21,0,TRUE,NA,"0.1.4"
"17572","646",2023-03-03 00:45:00,985,1006,21,0,TRUE,NA,"0.1.4"
"17573","646",2023-03-03 01:00:00,985,1006,21,0,TRUE,NA,"0.1.4"
"17574","646",2023-03-03 01:15:00,985,1006,21,0,TRUE,NA,"0.1.4"
"17575","646",2023-03-03 01:30:00,985,1006,21,0,TRUE,NA,"0.1.4"
"17576","646",2023-03-03 01:45:00,985,1006,21,0,TRUE,NA,"0.1.4"
"17577","646",2023-03-03 02:00:00,985,1006,21,0,TRUE,NA,"0.1.4"
"17578","646",2023-03-03 02:15:00,985,1006,21,0,TRUE,NA,"0.1.4"
"17579","646",2023-03-03 02:30:00,985,1006,21,0,TRUE,NA,"0.1.4"
"17580","646",2023-03-03 02:45:00,985,1006,21,0,TRUE,NA,"0.1.4"
"17581","646",2023-03-03 03:00:00,985,1006,21,0,TRUE,NA,"0.1.4"
"17582","646",2023-03-03 03:15:00,985,1006,21,0,TRUE,NA,"0.1.4"
"17583","646",2023-03-03 03:30:00,985,1006,21,0,TRUE,NA,"0.1.4"
"17584","646",2023-03-03 03:45:00,985,1006,21,0,TRUE,NA,"0.1.4"
"17585","646",2023-03-03 04:00:00,985,1006,21,0,TRUE,NA,"0.1.4"
"17586","646",2023-03-03 04:15:00,985,1006,21,0,TRUE,NA,"0.1.4"
"17587","646",2023-03-03 04:30:00,985,1006,21,0,TRUE,NA,"0.1.4"
"17588","646",2023-03-03 04:45:00,985,1006,21,0,TRUE,NA,"0.1.4"
"17589","646",2023-03-03 05:00:00,985,1006,21,0,TRUE,NA,"0.1.4"
"17590","646",2023-03-03 05:15:00,985,1006,21,0,TRUE,NA,"0.1.4"
"17591","646",2023-03-03 05:30:00,985,1006,21,0,TRUE,NA,"0.1.4"
"17592","646",2023-03-03 05:45:00,985,1006,21,0,TRUE,NA,"0.1.4"
"17593","646",2023-03-03 06:00:00,985,1006,21,0,TRUE,NA,"0.1.4"
"17594","646",2023-03-03 06:15:00,985,1006,21,0,TRUE,NA,"0.1.4"
"17595","646",2023-03-03 06:30:00,985,1006,21,0,TRUE,NA,"0.1.4"
"17596","646",2023-03-03 06:45:00,985,1006,21,0,TRUE,NA,"0.1.4"
"17597","646",2023-03-03 07:00:00,985,1006,21,0,TRUE,NA,"0.1.4"
"17598","646",2023-03-03 07:15:00,985,1006,21,0,TRUE,NA,"0.1.4"
"17599","646",2023-03-03 07:30:00,985,1006,21,0,TRUE,NA,"0.1.4"
"17600","646",2023-03-03 07:45:00,985,1006,21,0,TRUE,NA,"0.1.4"
"17601","646",2023-03-03 08:00:00,985,1006,21,0,TRUE,NA,"0.1.4"
"17602","646",2023-03-03 08:15:00,985,1006,21,0,TRUE,NA,"0.1.4"
"17603","646",2023-03-03 08:30:00,985,1006,21,0,TRUE,NA,"0.1.4"
"17604","646",2023-03-03 08:45:00,985,1006,21,0,TRUE,NA,"0.1.4"
"17605","646",2023-03-03 09:00:00,985,1006,21,0,TRUE,NA,"0.1.4"
"17606","646",2023-03-03 09:15:00,985,1006,21,0,TRUE,NA,"0.1.4"
"17607","646",2023-03-03 09:30:00,985,1006,21,0,TRUE,NA,"0.1.4"
"17608","646",2023-03-03 09:45:00,985,1006,21,0,TRUE,NA,"0.1.4"
"17609","646",2023-03-03 10:00:00,985,1006,21,0,TRUE,NA,"0.1.4"
"17610","646",2023-03-03 10:15:00,985,1006,21,0,TRUE,NA,"0.1.4"
"17611","646",2023-03-03 10:30:00,985,1006,21,0,TRUE,NA,"0.1.4"
"17612","646",2023-03-03 10:45:00,985,1006,21,0,TRUE,NA,"0.1.4"
"17613","646",2023-03-03 11:00:00,985,1006,21,0,TRUE,NA,"0.1.4"
"17614","646",2023-03-03 11:15:00,985,1006,21,0,TRUE,NA,"0.1.4"
"17615","646",2023-03-03 11:30:00,985,1006,21,0,TRUE,NA,"0.1.4"
"17616","646",2023-03-03 11:45:00,985,1006,21,0,TRUE,NA,"0.1.4"
"17617","646",2023-03-03 12:00:00,985,1006,21,0,TRUE,NA,"0.1.4"
"17618","646",2023-03-03 12:15:00,985,1006,21,0,TRUE,NA,"0.1.4"
"17619","646",2023-03-03 12:30:00,985,1006,21,0,TRUE,NA,"0.1.4"
"17620","646",2023-03-03 12:45:00,985,1006,21,0,TRUE,NA,"0.1.4"
"17621","646",2023-03-03 13:00:00,985,1006,21,0,TRUE,NA,"0.1.4"
"17622","646",2023-03-03 13:15:00,985,1006,21,0,TRUE,NA,"0.1.4"
"17623","646",2023-03-03 13:30:00,985,1006,21,0,TRUE,NA,"0.1.4"
"17624","646",2023-03-03 13:45:00,985,1006,21,0,TRUE,NA,"0.1.4"
"17625","646",2023-03-03 14:00:00,985,1006,21,0,TRUE,NA,"0.1.4"
"17626","646",2023-03-03 14:15:00,985,1006,21,0,TRUE,NA,"0.1.4"
"17627","646",2023-03-03 14:30:00,985,1006,21,0,TRUE,NA,"0.1.4"
"17628","646",2023-03-03 14:45:00,985,1006,21,0,TRUE,NA,"0.1.4"
"17629","646",2023-03-03 15:00:00,985,1006,21,0,TRUE,NA,"0.1.4"
"17630","646",2023-03-03 15:15:00,985,1006,21,0,TRUE,NA,"0.1.4"
"17631","646",2023-03-03 15:30:00,985,1006,21,0,TRUE,NA,"0.1.4"
"17632","646",2023-03-03 15:45:00,985,1006,21,0,TRUE,NA,"0.1.4"
"17633","646",2023-03-03 16:00:00,985,1006,21,0,TRUE,NA,"0.1.4"
"17634","646",2023-03-03 16:15:00,985,1006,21,0,TRUE,NA,"0.1.4"
"17635","646",2023-03-03 16:30:00,985,1006,21,0,TRUE,NA,"0.1.4"
"17636","646",2023-03-03 16:45:00,985,1006,21,0,TRUE,NA,"0.1.4"
"17637","646",2023-03-03 17:00:00,985,1006,21,0,TRUE,NA,"0.1.4"
"17638","646",2023-03-03 17:15:00,985,1006,21,0,TRUE,NA,"0.1.4"
"17639","646",2023-03-03 17:30:00,985,1006,21,0,TRUE,NA,"0.1.4"
"17640","646",2023-03-03 17:45:00,985,1006,21,0,TRUE,NA,"0.1.4"
"17641","646",2023-03-03 18:00:00,985,1006,21,0,TRUE,NA,"0.1.4"
"17642","646",2023-03-03 18:15:00,985,1006,21,0,TRUE,NA,"0.1.4"
"17643","646",2023-03-03 18:30:00,985,1006,21,0,TRUE,NA,"0.1.4"
"17644","646",2023-03-03 18:45:00,985,1006,21,0,TRUE,NA,"0.1.4"
"17645","646",2023-03-03 19:00:00,985,1006,21,0,TRUE,NA,"0.1.4"
"17646","646",2023-03-03 19:15:00,985,1006,21,0,TRUE,NA,"0.1.4"
"17647","646",2023-03-03 19:30:00,985,1006,21,0,TRUE,NA,"0.1.4"
"17648","646",2023-03-03 19:45:00,985,1006,21,0,TRUE,NA,"0.1.4"
"17649","646",2023-03-03 20:00:00,985,1006,21,0,TRUE,NA,"0.1.4"
"17650","646",2023-03-03 20:15:00,985,1006,21,0,TRUE,NA,"0.1.4"
"17651","646",2023-03-03 20:30:00,985,1006,21,0,TRUE,NA,"0.1.4"
"17652","646",2023-03-03 20:45:00,985,1006,21,0,TRUE,NA,"0.1.4"
"17653","646",2023-03-03 21:00:00,985,1006,21,0,TRUE,NA,"0.1.4"
"17654","646",2023-03-03 21:15:00,985,1006,21,0,TRUE,NA,"0.1.4"
"17655","646",2023-03-03 21:30:00,985,1006,21,0,TRUE,NA,"0.1.4"
"17656","646",2023-03-03 21:45:00,985,1006,21,0,TRUE,NA,"0.1.4"
"17657","646",2023-03-03 22:00:00,985,1006,21,0,TRUE,NA,"0.1.4"
"17658","646",2023-03-03 22:15:00,985,1006,21,0,TRUE,NA,"0.1.4"
"17659","646",2023-03-03 22:30:00,985,1006,21,0,TRUE,NA,"0.1.4"
"17660","646",2023-03-03 22:45:00,985,1006,21,0,TRUE,NA,"0.1.4"
"17661","646",2023-03-03 23:00:00,985,1006,21,0,TRUE,NA,"0.1.4"
"17662","646",2023-03-03 23:15:00,985,1006,21,0,TRUE,NA,"0.1.4"
"17663","646",2023-03-03 23:30:00,985,1006,21,0,TRUE,NA,"0.1.4"
"17664","646",2023-03-03 23:45:00,985,1006,21,0,TRUE,NA,"0.1.4"
"17665","646",2023-03-04,985,1006,21,0,TRUE,NA,"0.1.4"
"17666","646",2023-03-04 00:15:00,985,1006,21,0,TRUE,NA,"0.1.4"
"17667","646",2023-03-04 00:30:00,985,1006,21,0,TRUE,NA,"0.1.4"
"17668","646",2023-03-04 00:45:00,985,1006,21,0,TRUE,NA,"0.1.4"
"17669","646",2023-03-04 01:00:00,985,1006,21,0,TRUE,NA,"0.1.4"
"17670","646",2023-03-04 01:15:00,985,1006,21,0,TRUE,NA,"0.1.4"
"17671","646",2023-03-04 01:30:00,985,1006,21,0,TRUE,NA,"0.1.4"
"17672","646",2023-03-04 01:45:00,985,1006,21,0,TRUE,NA,"0.1.4"
"17673","646",2023-03-04 02:00:00,985,1006,21,0,TRUE,NA,"0.1.4"
"17674","646",2023-03-04 02:15:00,985,1006,21,0,TRUE,NA,"0.1.4"
"17675","646",2023-03-04 02:30:00,985,1006,21,0,TRUE,NA,"0.1.4"
"17676","646",2023-03-04 02:45:00,985,1006,21,0,TRUE,NA,"0.1.4"
"17677","646",2023-03-04 03:00:00,985,1006,21,0,TRUE,NA,"0.1.4"
"17678","646",2023-03-04 03:15:00,985,1006,21,0,TRUE,NA,"0.1.4"
"17679","646",2023-03-04 03:30:00,985,1006,21,0,TRUE,NA,"0.1.4"
"17680","646",2023-03-04 03:45:00,985,1006,21,0,TRUE,NA,"0.1.4"
"17681","646",2023-03-04 04:00:00,985,1006,21,0,TRUE,NA,"0.1.4"
"17682","646",2023-03-04 04:15:00,985,1006,21,0,TRUE,NA,"0.1.4"
"17683","646",2023-03-04 04:30:00,985,1006,21,0,TRUE,NA,"0.1.4"
"17684","646",2023-03-04 04:45:00,985,1006,21,0,TRUE,NA,"0.1.4"
"17685","646",2023-03-04 05:00:00,985,1006,21,0,TRUE,NA,"0.1.4"
"17686","646",2023-03-04 05:15:00,985,1006,21,0,TRUE,NA,"0.1.4"
"17687","646",2023-03-04 05:30:00,985,1006,21,0,TRUE,NA,"0.1.4"
"17688","646",2023-03-04 05:45:00,985,1006,21,0,TRUE,NA,"0.1.4"
"17689","646",2023-03-04 06:00:00,985,1006,21,0,TRUE,NA,"0.1.4"
"17690","646",2023-03-04 06:15:00,985,1006,21,0,TRUE,NA,"0.1.4"
"17691","646",2023-03-04 06:30:00,985,1006,21,0,TRUE,NA,"0.1.4"
"17692","646",2023-03-04 06:45:00,985,1006,21,0,TRUE,NA,"0.1.4"
"17693","646",2023-03-04 07:00:00,985,1006,21,0,TRUE,NA,"0.1.4"
"17694","646",2023-03-04 07:15:00,985,1006,21,0,TRUE,NA,"0.1.4"
"17695","646",2023-03-04 07:30:00,985,1006,21,0,TRUE,NA,"0.1.4"
"17696","646",2023-03-04 07:45:00,985,1006,21,0,TRUE,NA,"0.1.4"
"17697","646",2023-03-04 08:00:00,985,1006,21,0,TRUE,NA,"0.1.4"
"17698","646",2023-03-04 08:15:00,985,1006,21,0,TRUE,NA,"0.1.4"
"17699","646",2023-03-04 08:30:00,985,1006,21,0,TRUE,NA,"0.1.4"
"17700","646",2023-03-04 08:45:00,985,1006,21,0,TRUE,NA,"0.1.4"
"17701","646",2023-03-04 09:00:00,985,1006,21,0,TRUE,NA,"0.1.4"
"17702","646",2023-03-04 09:15:00,985,1006,21,0,TRUE,NA,"0.1.4"
"17703","646",2023-03-04 09:30:00,985,1006,21,0,TRUE,NA,"0.1.4"
"17704","646",2023-03-04 09:45:00,985,1006,21,0,TRUE,NA,"0.1.4"
"17705","646",2023-03-04 10:00:00,985,1006,21,0,TRUE,NA,"0.1.4"
"17706","646",2023-03-04 10:15:00,985,1006,21,0,TRUE,NA,"0.1.4"
"17707","646",2023-03-04 10:30:00,985,1006,21,0,TRUE,NA,"0.1.4"
"17708","646",2023-03-04 10:45:00,985,1006,21,0,TRUE,NA,"0.1.4"
"17709","646",2023-03-04 11:00:00,985,1006,21,0,TRUE,NA,"0.1.4"
"17710","646",2023-03-04 11:15:00,985,1006,21,0,TRUE,NA,"0.1.4"
"17711","646",2023-03-04 11:30:00,985,1006,21,0,TRUE,NA,"0.1.4"
"17712","646",2023-03-04 11:45:00,985,1006,21,0,TRUE,NA,"0.1.4"
"17713","646",2023-03-04 12:00:00,985,1006,21,0,TRUE,NA,"0.1.4"
"17714","646",2023-03-04 12:15:00,985,1006,21,0,TRUE,NA,"0.1.4"
"17715","646",2023-03-04 12:30:00,985,1006,21,0,TRUE,NA,"0.1.4"
"17716","646",2023-03-04 12:45:00,985,1006,21,0,TRUE,NA,"0.1.4"
"17717","646",2023-03-04 13:00:00,985,1006,21,0,TRUE,NA,"0.1.4"
"17718","646",2023-03-04 13:15:00,985,1006,21,0,TRUE,NA,"0.1.4"
"17719","646",2023-03-04 13:30:00,985,1006,21,0,TRUE,NA,"0.1.4"
"17720","646",2023-03-04 13:45:00,985,1006,21,0,TRUE,NA,"0.1.4"
"17721","646",2023-03-04 14:00:00,985,1006,21,0,TRUE,NA,"0.1.4"
"17722","646",2023-03-04 14:15:00,985,1006,21,0,TRUE,NA,"0.1.4"
"17723","646",2023-03-04 14:30:00,985,1006,21,0,TRUE,NA,"0.1.4"
"17724","646",2023-03-04 14:45:00,985,1006,21,0,TRUE,NA,"0.1.4"
"17725","646",2023-03-04 15:00:00,985,1006,21,0,TRUE,NA,"0.1.4"
"17726","646",2023-03-04 15:15:00,985,1006,21,0,TRUE,NA,"0.1.4"
"17727","646",2023-03-04 15:30:00,985,1006,21,0,TRUE,NA,"0.1.4"
"17728","646",2023-03-04 15:45:00,985,1006,21,0,TRUE,NA,"0.1.4"
"17729","646",2023-03-04 16:00:00,985,1006,21,0,TRUE,NA,"0.1.4"
"17730","646",2023-03-04 16:15:00,985,1006,21,0,TRUE,NA,"0.1.4"
"17731","646",2023-03-04 16:30:00,985,1006,21,0,TRUE,NA,"0.1.4"
"17732","646",2023-03-04 16:45:00,985,1006,21,0,TRUE,NA,"0.1.4"
"17733","646",2023-03-04 17:00:00,985,1006,21,0,TRUE,NA,"0.1.4"
"17734","646",2023-03-04 17:15:00,985,1006,21,0,TRUE,NA,"0.1.4"
"17735","646",2023-03-04 17:30:00,985,1006,21,0,TRUE,NA,"0.1.4"
"17736","646",2023-03-04 17:45:00,985,1006,21,0,TRUE,NA,"0.1.4"
"17737","646",2023-03-04 18:00:00,985,1006,21,0,TRUE,NA,"0.1.4"
"17738","646",2023-03-04 18:15:00,985,1006,21,0,TRUE,NA,"0.1.4"
"17739","646",2023-03-04 18:30:00,985,1006,21,0,TRUE,NA,"0.1.4"
"17740","646",2023-03-04 18:45:00,985,1006,21,0,TRUE,NA,"0.1.4"
"17741","646",2023-03-04 19:00:00,985,1006,21,0,TRUE,NA,"0.1.4"
"17742","646",2023-03-04 19:15:00,985,1006,21,0,TRUE,NA,"0.1.4"
"17743","646",2023-03-04 19:30:00,985,1006,21,0,TRUE,NA,"0.1.4"
"17744","646",2023-03-04 19:45:00,985,1006,21,0,TRUE,NA,"0.1.4"
"17745","646",2023-03-04 20:00:00,985,1006,21,0,TRUE,NA,"0.1.4"
"17746","646",2023-03-04 20:15:00,985,1006,21,0,TRUE,NA,"0.1.4"
"17747","646",2023-03-04 20:30:00,985,1006,21,0,TRUE,NA,"0.1.4"
"17748","646",2023-03-04 20:45:00,985,1006,21,0,TRUE,NA,"0.1.4"
"17749","646",2023-03-04 21:00:00,985,1006,21,0,TRUE,NA,"0.1.4"
"17750","646",2023-03-04 21:15:00,985,1006,21,0,TRUE,NA,"0.1.4"
"17751","646",2023-03-04 21:30:00,985,1006,21,0,TRUE,NA,"0.1.4"
"17752","646",2023-03-04 21:45:00,985,1006,21,0,TRUE,NA,"0.1.4"
"17753","646",2023-03-04 22:00:00,985,1006,21,0,TRUE,NA,"0.1.4"
"17754","646",2023-03-04 22:15:00,985,1006,21,0,TRUE,NA,"0.1.4"
"17755","646",2023-03-04 22:30:00,985,1006,21,0,TRUE,NA,"0.1.4"
"17756","646",2023-03-04 22:45:00,985,1006,21,0,TRUE,NA,"0.1.4"
"17757","646",2023-03-04 23:00:00,985,1006,21,0,TRUE,NA,"0.1.4"
"17758","646",2023-03-04 23:15:00,985,1006,21,0,TRUE,NA,"0.1.4"
"17759","646",2023-03-04 23:30:00,985,1006,21,0,TRUE,NA,"0.1.4"
"17760","646",2023-03-04 23:45:00,985,1006,21,0,TRUE,NA,"0.1.4"
"17761","646",2023-03-05,985,1006,21,0,TRUE,NA,"0.1.4"
"17762","646",2023-03-05 00:15:00,985,1006,21,0,TRUE,NA,"0.1.4"
"17763","646",2023-03-05 00:30:00,985,1006,21,0,TRUE,NA,"0.1.4"
"17764","646",2023-03-05 00:45:00,985,1006,21,0,TRUE,NA,"0.1.4"
"17765","646",2023-03-05 01:00:00,985,1006,21,0,TRUE,NA,"0.1.4"
"17766","646",2023-03-05 01:15:00,985,1006,21,0,TRUE,NA,"0.1.4"
"17767","646",2023-03-05 01:30:00,985,1006,21,0,TRUE,NA,"0.1.4"
"17768","646",2023-03-05 01:45:00,985,1006,21,0,TRUE,NA,"0.1.4"
"17769","646",2023-03-05 02:00:00,985,1006,21,0,TRUE,NA,"0.1.4"
"17770","646",2023-03-05 02:15:00,985,1006,21,0,TRUE,NA,"0.1.4"
"17771","646",2023-03-05 02:30:00,985,1006,21,0,TRUE,NA,"0.1.4"
"17772","646",2023-03-05 02:45:00,985,1006,21,0,TRUE,NA,"0.1.4"
"17773","646",2023-03-05 03:00:00,985,1006,21,0,TRUE,NA,"0.1.4"
"17774","646",2023-03-05 03:15:00,985,1006,21,0,TRUE,NA,"0.1.4"
"17775","646",2023-03-05 03:30:00,985,1006,21,0,TRUE,NA,"0.1.4"
"17776","646",2023-03-05 03:45:00,985,1006,21,0,TRUE,NA,"0.1.4"
"17777","646",2023-03-05 04:00:00,985,1006,21,0,TRUE,NA,"0.1.4"
"17778","646",2023-03-05 04:15:00,985,1006,21,0,TRUE,NA,"0.1.4"
"17779","646",2023-03-05 04:30:00,985,1006,21,0,TRUE,NA,"0.1.4"
"17780","646",2023-03-05 04:45:00,985,1006,21,0,TRUE,NA,"0.1.4"
"17781","646",2023-03-05 05:00:00,985,1006,21,0,TRUE,NA,"0.1.4"
"17782","646",2023-03-05 05:15:00,985,1006,21,0,TRUE,NA,"0.1.4"
"17783","646",2023-03-05 05:30:00,985,1006,21,0,TRUE,NA,"0.1.4"
"17784","646",2023-03-05 05:45:00,985,1006,21,0,TRUE,NA,"0.1.4"
"17785","646",2023-03-05 06:00:00,985,1006,21,0,TRUE,NA,"0.1.4"
"17786","646",2023-03-05 06:15:00,985,1006,21,0,TRUE,NA,"0.1.4"
"17787","646",2023-03-05 06:30:00,985,1006,21,0,TRUE,NA,"0.1.4"
"17788","646",2023-03-05 06:45:00,985,1006,21,0,TRUE,NA,"0.1.4"
"17789","646",2023-03-05 07:00:00,985,1006,21,0,TRUE,NA,"0.1.4"
"17790","646",2023-03-05 07:15:00,985,1006,21,0,TRUE,NA,"0.1.4"
"17791","646",2023-03-05 07:30:00,985,1006,21,0,TRUE,NA,"0.1.4"
"17792","646",2023-03-05 07:45:00,985,1006,21,0,TRUE,NA,"0.1.4"
"17793","646",2023-03-05 08:00:00,985,1006,21,0,TRUE,NA,"0.1.4"
"17794","646",2023-03-05 08:15:00,985,1006,21,0,TRUE,NA,"0.1.4"
"17795","646",2023-03-05 08:30:00,985,1006,21,0,TRUE,NA,"0.1.4"
"17796","646",2023-03-05 08:45:00,985,1006,21,0,TRUE,NA,"0.1.4"
"17797","646",2023-03-05 09:00:00,985,1006,21,0,TRUE,NA,"0.1.4"
"17798","646",2023-03-05 09:15:00,985,1006,21,0,TRUE,NA,"0.1.4"
"17799","646",2023-03-05 09:30:00,985,1006,21,0,TRUE,NA,"0.1.4"
"17800","646",2023-03-05 09:45:00,985,1006,21,0,TRUE,NA,"0.1.4"
"17801","646",2023-03-05 10:00:00,985,1006,21,0,TRUE,NA,"0.1.4"
"17802","646",2023-03-05 10:15:00,985,1006,21,0,TRUE,NA,"0.1.4"
"17803","646",2023-03-05 10:30:00,985,1006,21,0,TRUE,NA,"0.1.4"
"17804","646",2023-03-05 10:45:00,985,1006,21,0,TRUE,NA,"0.1.4"
"17805","646",2023-03-05 11:00:00,985,1006,21,0,TRUE,NA,"0.1.4"
"17806","646",2023-03-05 11:15:00,985,1006,21,0,TRUE,NA,"0.1.4"
"17807","646",2023-03-05 11:30:00,985,1006,21,0,TRUE,NA,"0.1.4"
"17808","646",2023-03-05 11:45:00,985,1006,21,0,TRUE,NA,"0.1.4"
"17809","646",2023-03-05 12:00:00,985,1006,21,0,TRUE,NA,"0.1.4"
"17810","646",2023-03-05 12:15:00,985,1006,21,0,TRUE,NA,"0.1.4"
"17811","646",2023-03-05 12:30:00,985,1006,21,0,TRUE,NA,"0.1.4"
"17812","646",2023-03-05 12:45:00,985,1006,21,0,TRUE,NA,"0.1.4"
"17813","646",2023-03-05 13:00:00,985,1006,21,0,TRUE,NA,"0.1.4"
"17814","646",2023-03-05 13:15:00,985,1006,21,0,TRUE,NA,"0.1.4"
"17815","646",2023-03-05 13:30:00,985,1006,21,0,TRUE,NA,"0.1.4"
"17816","646",2023-03-05 13:45:00,985,1006,21,0,TRUE,NA,"0.1.4"
"17817","646",2023-03-05 14:00:00,985,1006,21,0,TRUE,NA,"0.1.4"
"17818","646",2023-03-05 14:15:00,985,1006,21,0,TRUE,NA,"0.1.4"
"17819","646",2023-03-05 14:30:00,985,1006,21,0,TRUE,NA,"0.1.4"
"17820","646",2023-03-05 14:45:00,985,1006,21,0,TRUE,NA,"0.1.4"
"17821","646",2023-03-05 15:00:00,985,1006,21,0,TRUE,NA,"0.1.4"
"17822","646",2023-03-05 15:15:00,985,1006,21,0,TRUE,NA,"0.1.4"
"17823","646",2023-03-05 15:30:00,985,1006,21,0,TRUE,NA,"0.1.4"
"17824","646",2023-03-05 15:45:00,985,1006,21,0,TRUE,NA,"0.1.4"
"17825","646",2023-03-05 16:00:00,985,1006,21,0,TRUE,NA,"0.1.4"
"17826","646",2023-03-05 16:15:00,985,1006,21,0,TRUE,NA,"0.1.4"
"17827","646",2023-03-05 16:30:00,985,1006,21,0,TRUE,NA,"0.1.4"
"17828","646",2023-03-05 16:45:00,985,1006,21,0,TRUE,NA,"0.1.4"
"17829","646",2023-03-05 17:00:00,985,1006,21,0,TRUE,NA,"0.1.4"
"17830","646",2023-03-05 17:15:00,985,1006,21,0,TRUE,NA,"0.1.4"
"17831","646",2023-03-05 17:30:00,985,1006,21,0,TRUE,NA,"0.1.4"
"17832","646",2023-03-05 17:45:00,985,1006,21,0,TRUE,NA,"0.1.4"
"17833","646",2023-03-05 18:00:00,985,1006,21,0,TRUE,NA,"0.1.4"
"17834","646",2023-03-05 18:15:00,985,1006,21,0,TRUE,NA,"0.1.4"
"17835","646",2023-03-05 18:30:00,985,1006,21,0,TRUE,NA,"0.1.4"
"17836","646",2023-03-05 18:45:00,985,1006,21,0,TRUE,NA,"0.1.4"
"17837","646",2023-03-05 19:00:00,985,1006,21,0,TRUE,NA,"0.1.4"
"17838","646",2023-03-05 19:15:00,985,1006,21,0,TRUE,NA,"0.1.4"
"17839","646",2023-03-05 19:30:00,985,1006,21,0,TRUE,NA,"0.1.4"
"17840","646",2023-03-05 19:45:00,985,1006,21,0,TRUE,NA,"0.1.4"
"17841","646",2023-03-05 20:00:00,985,1006,21,0,TRUE,NA,"0.1.4"
"17842","646",2023-03-05 20:15:00,985,1006,21,0,TRUE,NA,"0.1.4"
"17843","646",2023-03-05 20:30:00,985,1006,21,0,TRUE,NA,"0.1.4"
"17844","646",2023-03-05 20:45:00,985,1006,21,0,TRUE,NA,"0.1.4"
"17845","646",2023-03-05 21:00:00,985,1006,21,0,TRUE,NA,"0.1.4"
"17846","646",2023-03-05 21:15:00,985,1006,21,0,TRUE,NA,"0.1.4"
"17847","646",2023-03-05 21:30:00,985,1006,21,0,TRUE,NA,"0.1.4"
"17848","646",2023-03-05 21:45:00,985,1006,21,0,TRUE,NA,"0.1.4"
"17849","646",2023-03-05 22:00:00,985,1006,21,0,TRUE,NA,"0.1.4"
"17850","646",2023-03-05 22:15:00,985,1006,21,0,TRUE,NA,"0.1.4"
"17851","646",2023-03-05 22:30:00,985,1006,21,0,TRUE,NA,"0.1.4"
"17852","646",2023-03-05 22:45:00,985,1006,21,0,TRUE,NA,"0.1.4"
"17853","646",2023-03-05 23:00:00,985,1006,21,0,TRUE,NA,"0.1.4"
"17854","646",2023-03-05 23:15:00,985,1006,21,0,TRUE,NA,"0.1.4"
"17855","646",2023-03-05 23:30:00,985,1006,21,0,TRUE,NA,"0.1.4"
"17856","646",2023-03-05 23:45:00,985,1006,21,0,TRUE,NA,"0.1.4"
"17857","646",2023-03-06,985,1006,21,0,TRUE,NA,"0.1.4"
"17858","646",2023-03-06 00:15:00,985,1006,21,0,TRUE,NA,"0.1.4"
"17859","646",2023-03-06 00:30:00,985,1006,21,0,TRUE,NA,"0.1.4"
"17860","646",2023-03-06 00:45:00,985,1006,21,0,TRUE,NA,"0.1.4"
"17861","646",2023-03-06 01:00:00,985,1006,21,0,TRUE,NA,"0.1.4"
"17862","646",2023-03-06 01:15:00,985,1006,21,0,TRUE,NA,"0.1.4"
"17863","646",2023-03-06 01:30:00,985,1006,21,0,TRUE,NA,"0.1.4"
"17864","646",2023-03-06 01:45:00,985,1006,21,0,TRUE,NA,"0.1.4"
"17865","646",2023-03-06 02:00:00,985,1006,21,0,TRUE,NA,"0.1.4"
"17866","646",2023-03-06 02:15:00,985,1006,21,0,TRUE,NA,"0.1.4"
"17867","646",2023-03-06 02:30:00,985,1006,21,0,TRUE,NA,"0.1.4"
"17868","646",2023-03-06 02:45:00,985,1006,21,0,TRUE,NA,"0.1.4"
"17869","646",2023-03-06 03:00:00,985,1006,21,0,TRUE,NA,"0.1.4"
"17870","646",2023-03-06 03:15:00,985,1006,21,0,TRUE,NA,"0.1.4"
"17871","646",2023-03-06 03:30:00,985,1006,21,0,TRUE,NA,"0.1.4"
"17872","646",2023-03-06 03:45:00,985,1006,21,0,TRUE,NA,"0.1.4"
"17873","646",2023-03-06 04:00:00,985,1006,21,0,TRUE,NA,"0.1.4"
"17874","646",2023-03-06 04:15:00,985,1006,21,0,TRUE,NA,"0.1.4"
"17875","646",2023-03-06 04:30:00,985,1006,21,0,TRUE,NA,"0.1.4"
"17876","646",2023-03-06 04:45:00,985,1006,21,0,TRUE,NA,"0.1.4"
"17877","646",2023-03-06 05:00:00,985,1006,21,0,TRUE,NA,"0.1.4"
"17878","646",2023-03-06 05:15:00,985,1006,21,0,TRUE,NA,"0.1.4"
"17879","646",2023-03-06 05:30:00,985,1006,21,0,TRUE,NA,"0.1.4"
"17880","646",2023-03-06 05:45:00,985,1006,21,0,TRUE,NA,"0.1.4"
"17881","646",2023-03-06 06:00:00,985,1006,21,0,TRUE,NA,"0.1.4"
"17882","646",2023-03-06 06:15:00,985,1006,21,0,TRUE,NA,"0.1.4"
"17883","646",2023-03-06 06:30:00,985,1006,21,0,TRUE,NA,"0.1.4"
"17884","646",2023-03-06 06:45:00,985,1006,21,0,TRUE,NA,"0.1.4"
"17885","646",2023-03-06 07:00:00,985,1006,21,0,TRUE,NA,"0.1.4"
"17886","646",2023-03-06 07:15:00,985,1006,21,0,TRUE,NA,"0.1.4"
"17887","646",2023-03-06 07:30:00,985,1006,21,0,TRUE,NA,"0.1.4"
"17888","646",2023-03-06 07:45:00,985,1006,21,0,TRUE,NA,"0.1.4"
"17889","646",2023-03-06 08:00:00,985,1006,21,0,TRUE,NA,"0.1.4"
"17890","646",2023-03-06 08:15:00,985,1006,21,0,TRUE,NA,"0.1.4"
"17891","646",2023-03-06 08:30:00,985,1006,21,0,TRUE,NA,"0.1.4"
"17892","646",2023-03-06 08:45:00,985,1006,21,0,TRUE,NA,"0.1.4"
"17893","646",2023-03-06 09:00:00,985,1006,21,0,TRUE,NA,"0.1.4"
"17894","646",2023-03-06 09:15:00,985,1006,21,0,TRUE,NA,"0.1.4"
"17895","646",2023-03-06 09:30:00,985,1006,21,0,TRUE,NA,"0.1.4"
"17896","646",2023-03-06 09:45:00,985,1006,21,0,TRUE,NA,"0.1.4"
"17897","646",2023-03-06 10:00:00,985,1006,21,0,TRUE,NA,"0.1.4"
"17898","646",2023-03-06 10:15:00,985,1006,21,0,TRUE,NA,"0.1.4"
"17899","646",2023-03-06 10:30:00,985,1006,21,0,TRUE,NA,"0.1.4"
"17900","646",2023-03-06 10:45:00,985,1006,21,0,TRUE,NA,"0.1.4"
"17901","646",2023-03-06 11:00:00,985,1006,21,0,TRUE,NA,"0.1.4"
"17902","646",2023-03-06 11:15:00,985,1006,21,0,TRUE,NA,"0.1.4"
"17903","646",2023-03-06 11:30:00,985,1006,21,0,TRUE,NA,"0.1.4"
"17904","646",2023-03-06 11:45:00,985,1006,21,0,TRUE,NA,"0.1.4"
"17905","646",2023-03-06 12:00:00,985,1006,21,0,TRUE,NA,"0.1.4"
"17906","646",2023-03-06 12:15:00,985,1006,21,0,TRUE,NA,"0.1.4"
"17907","646",2023-03-06 12:30:00,985,1006,21,0,TRUE,NA,"0.1.4"
"17908","646",2023-03-06 12:45:00,985,1006,21,0,TRUE,NA,"0.1.4"
"17909","646",2023-03-06 13:00:00,985,1006,21,0,TRUE,NA,"0.1.4"
"17910","646",2023-03-06 13:15:00,985,1006,21,0,TRUE,NA,"0.1.4"
"17911","646",2023-03-06 13:30:00,985,1006,21,0,TRUE,NA,"0.1.4"
"17912","646",2023-03-06 13:45:00,985,1006,21,0,TRUE,NA,"0.1.4"
"17913","646",2023-03-06 14:00:00,985,1006,21,0,TRUE,NA,"0.1.4"
"17914","646",2023-03-06 14:15:00,985,1006,21,0,TRUE,NA,"0.1.4"
"17915","646",2023-03-06 14:30:00,985,1006,21,0,TRUE,NA,"0.1.4"
"17916","646",2023-03-06 14:45:00,985,1006,21,0,TRUE,NA,"0.1.4"
"17917","646",2023-03-06 15:00:00,985,1006,21,0,TRUE,NA,"0.1.4"
"17918","646",2023-03-06 15:15:00,985,1006,21,0,TRUE,NA,"0.1.4"
"17919","646",2023-03-06 15:30:00,985,1006,21,0,TRUE,NA,"0.1.4"
"17920","646",2023-03-06 15:45:00,985,1006,21,0,TRUE,NA,"0.1.4"
"17921","646",2023-03-06 16:00:00,985,1006,21,0,TRUE,NA,"0.1.4"
"17922","646",2023-03-06 16:15:00,985,1006,21,0,TRUE,NA,"0.1.4"
"17923","646",2023-03-06 16:30:00,985,1006,21,0,TRUE,NA,"0.1.4"
"17924","646",2023-03-06 16:45:00,985,1006,21,0,TRUE,NA,"0.1.4"
"17925","646",2023-03-06 17:00:00,985,1006,21,0,TRUE,NA,"0.1.4"
"17926","646",2023-03-06 17:15:00,985,1006,21,0,TRUE,NA,"0.1.4"
"17927","646",2023-03-06 17:30:00,985,1006,21,0,TRUE,NA,"0.1.4"
"17928","646",2023-03-06 17:45:00,985,1006,21,0,TRUE,NA,"0.1.4"
"17929","646",2023-03-06 18:00:00,985,1006,21,0,TRUE,NA,"0.1.4"
"17930","646",2023-03-06 18:15:00,985,1006,21,0,TRUE,NA,"0.1.4"
"17931","646",2023-03-06 18:30:00,985,1006,21,0,TRUE,NA,"0.1.4"
"17932","646",2023-03-06 18:45:00,985,1006,21,0,TRUE,NA,"0.1.4"
"17933","646",2023-03-06 19:00:00,985,1006,21,0,TRUE,NA,"0.1.4"
"17934","646",2023-03-06 19:15:00,985,1006,21,0,TRUE,NA,"0.1.4"
"17935","646",2023-03-06 19:30:00,985,1006,21,0,TRUE,NA,"0.1.4"
"17936","646",2023-03-06 19:45:00,985,1006,21,0,TRUE,NA,"0.1.4"
"17937","646",2023-03-06 20:00:00,985,1006,21,0,TRUE,NA,"0.1.4"
"17938","646",2023-03-06 20:15:00,985,1006,21,0,TRUE,NA,"0.1.4"
"17939","646",2023-03-06 20:30:00,985,1006,21,0,TRUE,NA,"0.1.4"
"17940","646",2023-03-06 20:45:00,985,1006,21,0,TRUE,NA,"0.1.4"
"17941","646",2023-03-06 21:00:00,985,1006,21,0,TRUE,NA,"0.1.4"
"17942","646",2023-03-06 21:15:00,985,1006,21,0,TRUE,NA,"0.1.4"
"17943","646",2023-03-06 21:30:00,985,1006,21,0,TRUE,NA,"0.1.4"
"17944","646",2023-03-06 21:45:00,985,1006,21,0,TRUE,NA,"0.1.4"
"17945","646",2023-03-06 22:00:00,985,1006,21,0,TRUE,NA,"0.1.4"
"17946","646",2023-03-06 22:15:00,985,1006,21,0,TRUE,NA,"0.1.4"
"17947","646",2023-03-06 22:30:00,985,1006,21,0,TRUE,NA,"0.1.4"
"17948","646",2023-03-06 22:45:00,985,1006,21,0,TRUE,NA,"0.1.4"
"17949","646",2023-03-06 23:00:00,985,1006,21,0,TRUE,NA,"0.1.4"
"17950","646",2023-03-06 23:15:00,985,1006,21,0,TRUE,NA,"0.1.4"
"17951","646",2023-03-06 23:30:00,985,1006,21,0,TRUE,NA,"0.1.4"
"17952","646",2023-03-06 23:45:00,985,1006,21,0,TRUE,NA,"0.1.4"
"17953","646",2023-03-07,985,1006,21,0,TRUE,NA,"0.1.4"
"17954","646",2023-03-07 00:15:00,985,1006,21,0,TRUE,NA,"0.1.4"
"17955","646",2023-03-07 00:30:00,985,1006,21,0,TRUE,NA,"0.1.4"
"17956","646",2023-03-07 00:45:00,985,1006,21,0,TRUE,NA,"0.1.4"
"17957","646",2023-03-07 01:00:00,985,1006,21,0,TRUE,NA,"0.1.4"
"17958","646",2023-03-07 01:15:00,985,1006,21,0,TRUE,NA,"0.1.4"
"17959","646",2023-03-07 01:30:00,985,1006,21,0,TRUE,NA,"0.1.4"
"17960","646",2023-03-07 01:45:00,985,1006,21,0,TRUE,NA,"0.1.4"
"17961","646",2023-03-07 02:00:00,985,1006,21,0,TRUE,NA,"0.1.4"
"17962","646",2023-03-07 02:15:00,985,1006,21,0,TRUE,NA,"0.1.4"
"17963","646",2023-03-07 02:30:00,985,1006,21,0,TRUE,NA,"0.1.4"
"17964","646",2023-03-07 02:45:00,985,1006,21,0,TRUE,NA,"0.1.4"
"17965","646",2023-03-07 03:00:00,985,1006,21,0,TRUE,NA,"0.1.4"
"17966","646",2023-03-07 03:15:00,985,1006,21,0,TRUE,NA,"0.1.4"
"17967","646",2023-03-07 03:30:00,985,1006,21,0,TRUE,NA,"0.1.4"
"17968","646",2023-03-07 03:45:00,985,1006,21,0,TRUE,NA,"0.1.4"
"17969","646",2023-03-07 04:00:00,985,1006,21,0,TRUE,NA,"0.1.4"
"17970","646",2023-03-07 04:15:00,985,1006,21,0,TRUE,NA,"0.1.4"
"17971","646",2023-03-07 04:30:00,985,1006,21,0,TRUE,NA,"0.1.4"
"17972","646",2023-03-07 04:45:00,985,1006,21,0,TRUE,NA,"0.1.4"
"17973","646",2023-03-07 05:00:00,985,1006,21,0,TRUE,NA,"0.1.4"
"17974","646",2023-03-07 05:15:00,985,1006,21,0,TRUE,NA,"0.1.4"
"17975","646",2023-03-07 05:30:00,985,1006,21,0,TRUE,NA,"0.1.4"
"17976","646",2023-03-07 05:45:00,985,1006,21,0,TRUE,NA,"0.1.4"
"17977","646",2023-03-07 06:00:00,985,1006,21,0,TRUE,NA,"0.1.4"
"17978","646",2023-03-07 06:15:00,985,1006,21,0,TRUE,NA,"0.1.4"
"17979","646",2023-03-07 06:30:00,985,1006,21,0,TRUE,NA,"0.1.4"
"17980","646",2023-03-07 06:45:00,985,1006,21,0,TRUE,NA,"0.1.4"
"17981","646",2023-03-07 07:00:00,985,1006,21,0,TRUE,NA,"0.1.4"
"17982","646",2023-03-07 07:15:00,985,1006,21,0,TRUE,NA,"0.1.4"
"17983","646",2023-03-07 07:30:00,985,1006,21,0,TRUE,NA,"0.1.4"
"17984","646",2023-03-07 07:45:00,985,1006,21,0,TRUE,NA,"0.1.4"
"17985","646",2023-03-07 08:00:00,985,1006,21,0,TRUE,NA,"0.1.4"
"17986","646",2023-03-07 08:15:00,985,1006,21,0,TRUE,NA,"0.1.4"
"17987","646",2023-03-07 08:30:00,985,1006,21,0,TRUE,NA,"0.1.4"
"17988","646",2023-03-07 08:45:00,985,1006,21,0,TRUE,NA,"0.1.4"
"17989","646",2023-03-07 09:00:00,985,1006,21,0,TRUE,NA,"0.1.4"
"17990","646",2023-03-07 09:15:00,985,1006,21,0,TRUE,NA,"0.1.4"
"17991","646",2023-03-07 09:30:00,985,1006,21,0,TRUE,NA,"0.1.4"
"17992","646",2023-03-07 09:45:00,985,1006,21,0,TRUE,NA,"0.1.4"
"17993","646",2023-03-07 10:00:00,985,1006,21,0,TRUE,NA,"0.1.4"
"17994","646",2023-03-07 10:15:00,985,1006,21,0,TRUE,NA,"0.1.4"
"17995","646",2023-03-07 10:30:00,985,1006,21,0,TRUE,NA,"0.1.4"
"17996","646",2023-03-07 10:45:00,985,1006,21,0,TRUE,NA,"0.1.4"
"17997","646",2023-03-07 11:00:00,985,1006,21,0,TRUE,NA,"0.1.4"
"17998","646",2023-03-07 11:15:00,985,1006,21,0,TRUE,NA,"0.1.4"
"17999","646",2023-03-07 11:30:00,985,1006,21,0,TRUE,NA,"0.1.4"
"18000","646",2023-03-07 11:45:00,985,1006,21,0,TRUE,NA,"0.1.4"
"18001","646",2023-03-07 12:00:00,985,1006,21,0,TRUE,NA,"0.1.4"
"18002","646",2023-03-07 12:15:00,985,1006,21,0,TRUE,NA,"0.1.4"
"18003","646",2023-03-07 12:30:00,985,1006,21,0,TRUE,NA,"0.1.4"
"18004","646",2023-03-07 12:45:00,985,1006,21,0,TRUE,NA,"0.1.4"
"18005","646",2023-03-07 13:00:00,985,1006,21,0,TRUE,NA,"0.1.4"
"18006","646",2023-03-07 13:15:00,985,1006,21,0,TRUE,NA,"0.1.4"
"18007","646",2023-03-07 13:30:00,985,1006,21,0,TRUE,NA,"0.1.4"
"18008","646",2023-03-07 13:45:00,985,1006,21,0,TRUE,NA,"0.1.4"
"18009","646",2023-03-07 14:00:00,985,1006,21,0,TRUE,NA,"0.1.4"
"18010","646",2023-03-07 14:15:00,985,1006,21,0,TRUE,NA,"0.1.4"
"18011","646",2023-03-07 14:30:00,985,1006,21,0,TRUE,NA,"0.1.4"
"18012","646",2023-03-07 14:45:00,985,1006,21,0,TRUE,NA,"0.1.4"
"18013","646",2023-03-07 15:00:00,985,1006,21,0,TRUE,NA,"0.1.4"
"18014","646",2023-03-07 15:15:00,985,1006,21,0,TRUE,NA,"0.1.4"
"18015","646",2023-03-07 15:30:00,985,1006,21,0,TRUE,NA,"0.1.4"
"18016","646",2023-03-07 15:45:00,985,1006,21,0,TRUE,NA,"0.1.4"
"18017","646",2023-03-07 16:00:00,985,1006,21,0,TRUE,NA,"0.1.4"
"18018","646",2023-03-07 16:15:00,985,1006,21,0,TRUE,NA,"0.1.4"
"18019","646",2023-03-07 16:30:00,985,1006,21,0,TRUE,NA,"0.1.4"
"18020","646",2023-03-07 16:45:00,985,1006,21,0,TRUE,NA,"0.1.4"
"18021","646",2023-03-07 17:00:00,985,1006,21,0,TRUE,NA,"0.1.4"
"18022","646",2023-03-07 17:15:00,985,1006,21,0,TRUE,NA,"0.1.4"
"18023","646",2023-03-07 17:30:00,985,1006,21,0,TRUE,NA,"0.1.4"
"18024","646",2023-03-07 17:45:00,985,1006,21,0,TRUE,NA,"0.1.4"
"18025","646",2023-03-07 18:00:00,985,1006,21,0,TRUE,NA,"0.1.4"
"18026","646",2023-03-07 18:15:00,985,1006,21,0,TRUE,NA,"0.1.4"
"18027","646",2023-03-07 18:30:00,985,1006,21,0,TRUE,NA,"0.1.4"
"18028","646",2023-03-07 18:45:00,985,1006,21,0,TRUE,NA,"0.1.4"
"18029","646",2023-03-07 19:00:00,985,1006,21,0,TRUE,NA,"0.1.4"
"18030","646",2023-03-07 19:15:00,985,1006,21,0,TRUE,NA,"0.1.4"
"18031","646",2023-03-07 19:30:00,985,1006,21,0,TRUE,NA,"0.1.4"
"18032","646",2023-03-07 19:45:00,985,1006,21,0,TRUE,NA,"0.1.4"
"18033","646",2023-03-07 20:00:00,985,1006,21,0,TRUE,NA,"0.1.4"
"18034","646",2023-03-07 20:15:00,985,1006,21,0,TRUE,NA,"0.1.4"
"18035","646",2023-03-07 20:30:00,985,1006,21,0,TRUE,NA,"0.1.4"
"18036","646",2023-03-07 20:45:00,985,1006,21,0,TRUE,NA,"0.1.4"
"18037","646",2023-03-07 21:00:00,985,1006,21,0,TRUE,NA,"0.1.4"
"18038","646",2023-03-07 21:15:00,985,1006,21,0,TRUE,NA,"0.1.4"
"18039","646",2023-03-07 21:30:00,985,1006,21,0,TRUE,NA,"0.1.4"
"18040","646",2023-03-07 21:45:00,985,1006,21,0,TRUE,NA,"0.1.4"
"18041","646",2023-03-07 22:00:00,985,1006,21,0,TRUE,NA,"0.1.4"
"18042","646",2023-03-07 22:15:00,985,1006,21,0,TRUE,NA,"0.1.4"
"18043","646",2023-03-07 22:30:00,985,1006,21,0,TRUE,NA,"0.1.4"
"18044","646",2023-03-07 22:45:00,985,1006,21,0,TRUE,NA,"0.1.4"
"18045","646",2023-03-07 23:00:00,985,1006,21,0,TRUE,NA,"0.1.4"
"18046","646",2023-03-07 23:15:00,985,1006,21,0,TRUE,NA,"0.1.4"
"18047","646",2023-03-07 23:30:00,985,1006,21,0,TRUE,NA,"0.1.4"
"18048","646",2023-03-07 23:45:00,985,1006,21,0,TRUE,NA,"0.1.4"
"18049","646",2023-03-08,985,1006,21,0,TRUE,NA,"0.1.4"
"18050","646",2023-03-08 00:15:00,985,1006,21,0,TRUE,NA,"0.1.4"
"18051","646",2023-03-08 00:30:00,985,1006,21,0,TRUE,NA,"0.1.4"
"18052","646",2023-03-08 00:45:00,985,1006,21,0,TRUE,NA,"0.1.4"
"18053","646",2023-03-08 01:00:00,985,1006,21,0,TRUE,NA,"0.1.4"
"18054","646",2023-03-08 01:15:00,985,1006,21,0,TRUE,NA,"0.1.4"
"18055","646",2023-03-08 01:30:00,985,1006,21,0,TRUE,NA,"0.1.4"
"18056","646",2023-03-08 01:45:00,985,1006,21,0,TRUE,NA,"0.1.4"
"18057","646",2023-03-08 02:00:00,985,1006,21,0,TRUE,NA,"0.1.4"
"18058","646",2023-03-08 02:15:00,985,1006,21,0,TRUE,NA,"0.1.4"
"18059","646",2023-03-08 02:30:00,985,1006,21,0,TRUE,NA,"0.1.4"
"18060","646",2023-03-08 02:45:00,985,1006,21,0,TRUE,NA,"0.1.4"
"18061","646",2023-03-08 03:00:00,985,1006,21,0,TRUE,NA,"0.1.4"
"18062","646",2023-03-08 03:15:00,985,1006,21,0,TRUE,NA,"0.1.4"
"18063","646",2023-03-08 03:30:00,985,1006,21,0,TRUE,NA,"0.1.4"
"18064","646",2023-03-08 03:45:00,985,1006,21,0,TRUE,NA,"0.1.4"
"18065","646",2023-03-08 04:00:00,985,1006,21,0,TRUE,NA,"0.1.4"
"18066","646",2023-03-08 04:15:00,985,1006,21,0,TRUE,NA,"0.1.4"
"18067","646",2023-03-08 04:30:00,985,1006,21,0,TRUE,NA,"0.1.4"
"18068","646",2023-03-08 04:45:00,985,1006,21,0,TRUE,NA,"0.1.4"
"18069","646",2023-03-08 05:00:00,985,1006,21,0,TRUE,NA,"0.1.4"
"18070","646",2023-03-08 05:15:00,985,1006,21,0,TRUE,NA,"0.1.4"
"18071","646",2023-03-08 05:30:00,985,1006,21,0,TRUE,NA,"0.1.4"
"18072","646",2023-03-08 05:45:00,985,1006,21,0,TRUE,NA,"0.1.4"
"18073","646",2023-03-08 06:00:00,985,1006,21,0,TRUE,NA,"0.1.4"
"18074","646",2023-03-08 06:15:00,985,1006,21,0,TRUE,NA,"0.1.4"
"18075","646",2023-03-08 06:30:00,985,1006,21,0,TRUE,NA,"0.1.4"
"18076","646",2023-03-08 06:45:00,985,1006,21,0,TRUE,NA,"0.1.4"
"18077","646",2023-03-08 07:00:00,985,1006,21,0,TRUE,NA,"0.1.4"
"18078","646",2023-03-08 07:15:00,985,1006,21,0,TRUE,NA,"0.1.4"
"18079","646",2023-03-08 07:30:00,985,1006,21,0,TRUE,NA,"0.1.4"
"18080","646",2023-03-08 07:45:00,985,1006,21,0,TRUE,NA,"0.1.4"
"18081","646",2023-03-08 08:00:00,985,1006,21,0,TRUE,NA,"0.1.4"
"18082","646",2023-03-08 08:15:00,985,1006,21,0,TRUE,NA,"0.1.4"
"18083","646",2023-03-08 08:30:00,985,1006,21,0,TRUE,NA,"0.1.4"
"18084","646",2023-03-08 08:45:00,985,1006,21,0,TRUE,NA,"0.1.4"
"18085","646",2023-03-08 09:00:00,985,1006,21,0,TRUE,NA,"0.1.4"
"18086","646",2023-03-08 09:15:00,985,1006,21,0,TRUE,NA,"0.1.4"
"18087","646",2023-03-08 09:30:00,985,1006,21,0,TRUE,NA,"0.1.4"
"18088","646",2023-03-08 09:45:00,985,1006,21,0,TRUE,NA,"0.1.4"
"18089","646",2023-03-08 10:00:00,985,1006,21,0,TRUE,NA,"0.1.4"
"18090","646",2023-03-08 10:15:00,985,1006,21,0,TRUE,NA,"0.1.4"
"18091","646",2023-03-08 10:30:00,985,1006,21,0,TRUE,NA,"0.1.4"
"18092","646",2023-03-08 10:45:00,985,1006,21,0,TRUE,NA,"0.1.4"
"18093","646",2023-03-08 11:00:00,985,1006,21,0,TRUE,NA,"0.1.4"
"18094","646",2023-03-08 11:15:00,985,1006,21,0,TRUE,NA,"0.1.4"
"18095","646",2023-03-08 11:30:00,985,1006,21,0,TRUE,NA,"0.1.4"
"18096","646",2023-03-08 11:45:00,985,1006,21,0,TRUE,NA,"0.1.4"
"18097","646",2023-03-08 12:00:00,985,1006,21,0,TRUE,NA,"0.1.4"
"18098","646",2023-03-08 12:15:00,985,1006,21,0,TRUE,NA,"0.1.4"
"18099","646",2023-03-08 12:30:00,985,1006,21,0,TRUE,NA,"0.1.4"
"18100","646",2023-03-08 12:45:00,985,1006,21,0,TRUE,NA,"0.1.4"
"18101","646",2023-03-08 13:00:00,985,1006,21,0,TRUE,NA,"0.1.4"
"18102","646",2023-03-08 13:15:00,985,1006,21,0,TRUE,NA,"0.1.4"
"18103","646",2023-03-08 13:30:00,985,1006,21,0,TRUE,NA,"0.1.4"
"18104","646",2023-03-08 13:45:00,985,1006,21,0,TRUE,NA,"0.1.4"
"18105","646",2023-03-08 14:00:00,985,1006,21,0,TRUE,NA,"0.1.4"
"18106","646",2023-03-08 14:15:00,985,1006,21,0,TRUE,NA,"0.1.4"
"18107","646",2023-03-08 14:30:00,985,1006,21,0,TRUE,NA,"0.1.4"
"18108","646",2023-03-08 14:45:00,985,1006,21,0,TRUE,NA,"0.1.4"
"18109","646",2023-03-08 15:00:00,985,1006,21,0,TRUE,NA,"0.1.4"
"18110","646",2023-03-08 15:15:00,985,1006,21,0,TRUE,NA,"0.1.4"
"18111","646",2023-03-08 15:30:00,985,1006,21,0,TRUE,NA,"0.1.4"
"18112","646",2023-03-08 15:45:00,985,1006,21,0,TRUE,NA,"0.1.4"
"18113","646",2023-03-08 16:00:00,985,1006,21,0,TRUE,NA,"0.1.4"
"18114","646",2023-03-08 16:15:00,985,1006,21,0,TRUE,NA,"0.1.4"
"18115","646",2023-03-08 16:30:00,985,1006,21,0,TRUE,NA,"0.1.4"
"18116","646",2023-03-08 16:45:00,985,1006,21,0,TRUE,NA,"0.1.4"
"18117","646",2023-03-08 17:00:00,985,1006,21,0,TRUE,NA,"0.1.4"
"18118","646",2023-03-08 17:15:00,985,1006,21,0,TRUE,NA,"0.1.4"
"18119","646",2023-03-08 17:30:00,985,1006,21,0,TRUE,NA,"0.1.4"
"18120","646",2023-03-08 17:45:00,985,1006,21,0,TRUE,NA,"0.1.4"
"18121","646",2023-03-08 18:00:00,985,1006,21,0,TRUE,NA,"0.1.4"
"18122","646",2023-03-08 18:15:00,985,1006,21,0,TRUE,NA,"0.1.4"
"18123","646",2023-03-08 18:30:00,985,1006,21,0,TRUE,NA,"0.1.4"
"18124","646",2023-03-08 18:45:00,985,1006,21,0,TRUE,NA,"0.1.4"
"18125","646",2023-03-08 19:00:00,985,1006,21,0,TRUE,NA,"0.1.4"
"18126","646",2023-03-08 19:15:00,985,1006,21,0,TRUE,NA,"0.1.4"
"18127","646",2023-03-08 19:30:00,985,1006,21,0,TRUE,NA,"0.1.4"
"18128","646",2023-03-08 19:45:00,985,1006,21,0,TRUE,NA,"0.1.4"
"18129","646",2023-03-08 20:00:00,985,1006,21,0,TRUE,NA,"0.1.4"
"18130","646",2023-03-08 20:15:00,985,1006,21,0,TRUE,NA,"0.1.4"
"18131","646",2023-03-08 20:30:00,985,1006,21,0,TRUE,NA,"0.1.4"
"18132","646",2023-03-08 20:45:00,985,1006,21,0,TRUE,NA,"0.1.4"
"18133","646",2023-03-08 21:00:00,985,1006,21,0,TRUE,NA,"0.1.4"
"18134","646",2023-03-08 21:15:00,985,1006,21,0,TRUE,NA,"0.1.4"
"18135","646",2023-03-08 21:30:00,985,1006,21,0,TRUE,NA,"0.1.4"
"18136","646",2023-03-08 21:45:00,985,1006,21,0,TRUE,NA,"0.1.4"
"18137","646",2023-03-08 22:00:00,985,1006,21,0,TRUE,NA,"0.1.4"
"18138","646",2023-03-08 22:15:00,985,1006,21,0,TRUE,NA,"0.1.4"
"18139","646",2023-03-08 22:30:00,985,1006,21,0,TRUE,NA,"0.1.4"
"18140","646",2023-03-08 22:45:00,985,1006,21,0,TRUE,NA,"0.1.4"
"18141","646",2023-03-08 23:00:00,985,1006,21,0,TRUE,NA,"0.1.4"
"18142","646",2023-03-08 23:15:00,985,1006,21,0,TRUE,NA,"0.1.4"
"18143","646",2023-03-08 23:30:00,985,1006,21,0,TRUE,NA,"0.1.4"
"18144","646",2023-03-08 23:45:00,985,1006,21,0,TRUE,NA,"0.1.4"
"18145","646",2023-03-09,985,1006,21,0,TRUE,NA,"0.1.4"
"18146","646",2023-03-09 00:15:00,985,1006,21,0,TRUE,NA,"0.1.4"
"18147","646",2023-03-09 00:30:00,985,1006,21,0,TRUE,NA,"0.1.4"
"18148","646",2023-03-09 00:45:00,985,1006,21,0,TRUE,NA,"0.1.4"
"18149","646",2023-03-09 01:00:00,985,1006,21,0,TRUE,NA,"0.1.4"
"18150","646",2023-03-09 01:15:00,985,1006,21,0,TRUE,NA,"0.1.4"
"18151","646",2023-03-09 01:30:00,985,1006,21,0,TRUE,NA,"0.1.4"
"18152","646",2023-03-09 01:45:00,985,1006,21,0,TRUE,NA,"0.1.4"
"18153","646",2023-03-09 02:00:00,985,1006,21,0,TRUE,NA,"0.1.4"
"18154","646",2023-03-09 02:15:00,985,1006,21,0,TRUE,NA,"0.1.4"
"18155","646",2023-03-09 02:30:00,985,1006,21,0,TRUE,NA,"0.1.4"
"18156","646",2023-03-09 02:45:00,985,1006,21,0,TRUE,NA,"0.1.4"
"18157","646",2023-03-09 03:00:00,985,1006,21,0,TRUE,NA,"0.1.4"
"18158","646",2023-03-09 03:15:00,985,1006,21,0,TRUE,NA,"0.1.4"
"18159","646",2023-03-09 03:30:00,985,1006,21,0,TRUE,NA,"0.1.4"
"18160","646",2023-03-09 03:45:00,985,1006,21,0,TRUE,NA,"0.1.4"
"18161","646",2023-03-09 04:00:00,985,1006,21,0,TRUE,NA,"0.1.4"
"18162","646",2023-03-09 04:15:00,985,1006,21,0,TRUE,NA,"0.1.4"
"18163","646",2023-03-09 04:30:00,985,1006,21,0,TRUE,NA,"0.1.4"
"18164","646",2023-03-09 04:45:00,985,1006,21,0,TRUE,NA,"0.1.4"
"18165","646",2023-03-09 05:00:00,985,1006,21,0,TRUE,NA,"0.1.4"
"18166","646",2023-03-09 05:15:00,985,1006,21,0,TRUE,NA,"0.1.4"
"18167","646",2023-03-09 05:30:00,985,1006,21,0,TRUE,NA,"0.1.4"
"18168","646",2023-03-09 05:45:00,985,1006,21,0,TRUE,NA,"0.1.4"
"18169","646",2023-03-09 06:00:00,985,1006,21,0,TRUE,NA,"0.1.4"
"18170","646",2023-03-09 06:15:00,985,1006,21,0,TRUE,NA,"0.1.4"
"18171","646",2023-03-09 06:30:00,985,1006,21,0,TRUE,NA,"0.1.4"
"18172","646",2023-03-09 06:45:00,985,1006,21,0,TRUE,NA,"0.1.4"
"18173","646",2023-03-09 07:00:00,985,1006,21,0,TRUE,NA,"0.1.4"
"18174","646",2023-03-09 07:15:00,985,1006,21,0,TRUE,NA,"0.1.4"
"18175","646",2023-03-09 07:30:00,985,1006,21,0,TRUE,NA,"0.1.4"
"18176","646",2023-03-09 07:45:00,985,1006,21,0,TRUE,NA,"0.1.4"
"18177","646",2023-03-09 08:00:00,985,1006,21,0,TRUE,NA,"0.1.4"
"18178","646",2023-03-09 08:15:00,985,1006,21,0,TRUE,NA,"0.1.4"
"18179","646",2023-03-09 08:30:00,985,1006,21,0,TRUE,NA,"0.1.4"
"18180","646",2023-03-09 08:45:00,985,1006,21,0,TRUE,NA,"0.1.4"
"18181","646",2023-03-09 09:00:00,985,1006,21,0,TRUE,NA,"0.1.4"
"18182","646",2023-03-09 09:15:00,985,1006,21,0,TRUE,NA,"0.1.4"
"18183","646",2023-03-09 09:30:00,985,1006,21,0,TRUE,NA,"0.1.4"
"18184","646",2023-03-09 09:45:00,985,1006,21,0,TRUE,NA,"0.1.4"
"18185","646",2023-03-09 10:00:00,985,1006,21,0,TRUE,NA,"0.1.4"
"18186","646",2023-03-09 10:15:00,985,1006,21,0,TRUE,NA,"0.1.4"
"18187","646",2023-03-09 10:30:00,985,1006,21,0,TRUE,NA,"0.1.4"
"18188","646",2023-03-09 10:45:00,985,1006,21,0,TRUE,NA,"0.1.4"
"18189","646",2023-03-09 11:00:00,985,1006,21,0,TRUE,NA,"0.1.4"
"18190","646",2023-03-09 11:15:00,985,1006,21,0,TRUE,NA,"0.1.4"
"18191","646",2023-03-09 11:30:00,985,1006,21,0,TRUE,NA,"0.1.4"
"18192","646",2023-03-09 11:45:00,985,1006,21,0,TRUE,NA,"0.1.4"
"18193","646",2023-03-09 12:00:00,985,1006,21,0,TRUE,NA,"0.1.4"
"18194","646",2023-03-09 12:15:00,985,1006,21,0,TRUE,NA,"0.1.4"
"18195","646",2023-03-09 12:30:00,985,1006,21,0,TRUE,NA,"0.1.4"
"18196","646",2023-03-09 12:45:00,985,1006,21,0,TRUE,NA,"0.1.4"
"18197","646",2023-03-09 13:00:00,985,1006,21,0,TRUE,NA,"0.1.4"
"18198","646",2023-03-09 13:15:00,985,1006,21,0,TRUE,NA,"0.1.4"
"18199","646",2023-03-09 13:30:00,985,1006,21,0,TRUE,NA,"0.1.4"
"18200","646",2023-03-09 13:45:00,985,1006,21,0,TRUE,NA,"0.1.4"
"18201","646",2023-03-09 14:00:00,985,1006,21,0,TRUE,NA,"0.1.4"
"18202","646",2023-03-09 14:15:00,985,1006,21,0,TRUE,NA,"0.1.4"
"18203","646",2023-03-09 14:30:00,985,1006,21,0,TRUE,NA,"0.1.4"
"18204","646",2023-03-09 14:45:00,985,1006,21,0,TRUE,NA,"0.1.4"
"18205","646",2023-03-09 15:00:00,985,1006,21,0,TRUE,NA,"0.1.4"
"18206","646",2023-03-09 15:15:00,985,1006,21,0,TRUE,NA,"0.1.4"
"18207","646",2023-03-09 15:30:00,985,1006,21,0,TRUE,NA,"0.1.4"
"18208","646",2023-03-09 15:45:00,985,1006,21,0,TRUE,NA,"0.1.4"
"18209","646",2023-03-09 16:00:00,985,1006,21,0,TRUE,NA,"0.1.4"
"18210","646",2023-03-09 16:15:00,985,1006,21,0,TRUE,NA,"0.1.4"
"18211","646",2023-03-09 16:30:00,985,1006,21,0,TRUE,NA,"0.1.4"
"18212","646",2023-03-09 16:45:00,985,1006,21,0,TRUE,NA,"0.1.4"
"18213","646",2023-03-09 17:00:00,985,1006,21,0,TRUE,NA,"0.1.4"
"18214","646",2023-03-09 17:15:00,985,1006,21,0,TRUE,NA,"0.1.4"
"18215","646",2023-03-09 17:30:00,985,1006,21,0,TRUE,NA,"0.1.4"
"18216","646",2023-03-09 17:45:00,985,1006,21,0,TRUE,NA,"0.1.4"
"18217","646",2023-03-09 18:00:00,985,1006,21,0,TRUE,NA,"0.1.4"
"18218","646",2023-03-09 18:15:00,985,1006,21,0,TRUE,NA,"0.1.4"
"18219","646",2023-03-09 18:30:00,985,1006,21,0,TRUE,NA,"0.1.4"
"18220","646",2023-03-09 18:45:00,985,1006,21,0,TRUE,NA,"0.1.4"
"18221","646",2023-03-09 19:00:00,985,1006,21,0,TRUE,NA,"0.1.4"
"18222","646",2023-03-09 19:15:00,985,1006,21,0,TRUE,NA,"0.1.4"
"18223","646",2023-03-09 19:30:00,985,1006,21,0,TRUE,NA,"0.1.4"
"18224","646",2023-03-09 19:45:00,985,1006,21,0,TRUE,NA,"0.1.4"
"18225","646",2023-03-09 20:00:00,985,1006,21,0,TRUE,NA,"0.1.4"
"18226","646",2023-03-09 20:15:00,985,1006,21,0,TRUE,NA,"0.1.4"
"18227","646",2023-03-09 20:30:00,985,1006,21,0,TRUE,NA,"0.1.4"
"18228","646",2023-03-09 20:45:00,985,1006,21,0,TRUE,NA,"0.1.4"
"18229","646",2023-03-09 21:00:00,985,1006,21,0,TRUE,NA,"0.1.4"
"18230","646",2023-03-09 21:15:00,985,1006,21,0,TRUE,NA,"0.1.4"
"18231","646",2023-03-09 21:30:00,985,1006,21,0,TRUE,NA,"0.1.4"
"18232","646",2023-03-09 21:45:00,985,1006,21,0,TRUE,NA,"0.1.4"
"18233","646",2023-03-09 22:00:00,985,1006,21,0,TRUE,NA,"0.1.4"
"18234","646",2023-03-09 22:15:00,985,1006,21,0,TRUE,NA,"0.1.4"
"18235","646",2023-03-09 22:30:00,985,1006,21,0,TRUE,NA,"0.1.4"
"18236","646",2023-03-09 22:45:00,985,1006,21,0,TRUE,NA,"0.1.4"
"18237","646",2023-03-09 23:00:00,985,1006,21,0,TRUE,NA,"0.1.4"
"18238","646",2023-03-09 23:15:00,985,1006,21,0,TRUE,NA,"0.1.4"
"18239","646",2023-03-09 23:30:00,985,1006,21,0,TRUE,NA,"0.1.4"
"18240","646",2023-03-09 23:45:00,985,1006,21,0,TRUE,NA,"0.1.4"
"18241","646",2023-03-10,985,1006,21,0,TRUE,NA,"0.1.4"
"18242","646",2023-03-10 00:15:00,985,1006,21,0,TRUE,NA,"0.1.4"
"18243","646",2023-03-10 00:30:00,985,1006,21,0,TRUE,NA,"0.1.4"
"18244","646",2023-03-10 00:45:00,985,1006,21,0,TRUE,NA,"0.1.4"
"18245","646",2023-03-10 01:00:00,985,1006,21,0,TRUE,NA,"0.1.4"
"18246","646",2023-03-10 01:15:00,985,1006,21,0,TRUE,NA,"0.1.4"
"18247","646",2023-03-10 01:30:00,985,1006,21,0,TRUE,NA,"0.1.4"
"18248","646",2023-03-10 01:45:00,985,1006,21,0,TRUE,NA,"0.1.4"
"18249","646",2023-03-10 02:00:00,985,1006,21,0,TRUE,NA,"0.1.4"
"18250","646",2023-03-10 02:15:00,985,1006,21,0,TRUE,NA,"0.1.4"
"18251","646",2023-03-10 02:30:00,985,1006,21,0,TRUE,NA,"0.1.4"
"18252","646",2023-03-10 02:45:00,985,1006,21,0,TRUE,NA,"0.1.4"
"18253","646",2023-03-10 03:00:00,985,1006,21,0,TRUE,NA,"0.1.4"
"18254","646",2023-03-10 03:15:00,985,1006,21,0,TRUE,NA,"0.1.4"
"18255","646",2023-03-10 03:30:00,985,1006,21,0,TRUE,NA,"0.1.4"
"18256","646",2023-03-10 03:45:00,985,1006,21,0,TRUE,NA,"0.1.4"
"18257","646",2023-03-10 04:00:00,985,1006,21,0,TRUE,NA,"0.1.4"
"18258","646",2023-03-10 04:15:00,985,1006,21,0,TRUE,NA,"0.1.4"
"18259","646",2023-03-10 04:30:00,985,1006,21,0,TRUE,NA,"0.1.4"
"18260","646",2023-03-10 04:45:00,985,1006,21,0,TRUE,NA,"0.1.4"
"18261","646",2023-03-10 05:00:00,985,1006,21,0,TRUE,NA,"0.1.4"
"18262","646",2023-03-10 05:15:00,985,1006,21,0,TRUE,NA,"0.1.4"
"18263","646",2023-03-10 05:30:00,985,1006,21,0,TRUE,NA,"0.1.4"
"18264","646",2023-03-10 05:45:00,985,1006,21,0,TRUE,NA,"0.1.4"
"18265","646",2023-03-10 06:00:00,985,1006,21,0,TRUE,NA,"0.1.4"
"18266","646",2023-03-10 06:15:00,985,1006,21,0,TRUE,NA,"0.1.4"
"18267","646",2023-03-10 06:30:00,985,1006,21,0,TRUE,NA,"0.1.4"
"18268","646",2023-03-10 06:45:00,985,1006,21,0,TRUE,NA,"0.1.4"
"18269","646",2023-03-10 07:00:00,985,1006,21,0,TRUE,NA,"0.1.4"
"18270","646",2023-03-10 07:15:00,985,1006,21,0,TRUE,NA,"0.1.4"
"18271","646",2023-03-10 07:30:00,985,1006,21,0,TRUE,NA,"0.1.4"
"18272","646",2023-03-10 07:45:00,985,1006,21,0,TRUE,NA,"0.1.4"
"18273","646",2023-03-10 08:00:00,985,1006,21,0,TRUE,NA,"0.1.4"
"18274","646",2023-03-10 08:15:00,985,1006,21,0,TRUE,NA,"0.1.4"
"18275","646",2023-03-10 08:30:00,985,1006,21,0,TRUE,NA,"0.1.4"
"18276","646",2023-03-10 08:45:00,985,1006,21,0,TRUE,NA,"0.1.4"
"18277","646",2023-03-10 09:00:00,985,1006,21,0,TRUE,NA,"0.1.4"
"18278","646",2023-03-10 09:15:00,985,1006,21,0,TRUE,NA,"0.1.4"
"18279","646",2023-03-10 09:30:00,985,1006,21,0,TRUE,NA,"0.1.4"
"18280","646",2023-03-10 09:45:00,985,1006,21,0,TRUE,NA,"0.1.4"
"18281","646",2023-03-10 10:00:00,985,1006,21,0,TRUE,NA,"0.1.4"
"18282","646",2023-03-10 10:15:00,985,1006,21,0,TRUE,NA,"0.1.4"
"18283","646",2023-03-10 10:30:00,985,1006,21,0,TRUE,NA,"0.1.4"
"18284","646",2023-03-10 10:45:00,985,1006,21,0,TRUE,NA,"0.1.4"
"18285","646",2023-03-10 11:00:00,985,1006,21,0,TRUE,NA,"0.1.4"
"18286","646",2023-03-10 11:15:00,985,1006,21,0,TRUE,NA,"0.1.4"
"18287","646",2023-03-10 11:30:00,985,1006,21,0,TRUE,NA,"0.1.4"
"18288","646",2023-03-10 11:45:00,985,1006,21,0,TRUE,NA,"0.1.4"
"18289","646",2023-03-10 12:00:00,985,1006,21,0,TRUE,NA,"0.1.4"
"18290","646",2023-03-10 12:15:00,985,1006,21,0,TRUE,NA,"0.1.4"
"18291","646",2023-03-10 12:30:00,985,1006,21,0,TRUE,NA,"0.1.4"
"18292","646",2023-03-10 12:45:00,985,1006,21,0,TRUE,NA,"0.1.4"
"18293","646",2023-03-10 13:00:00,985,1006,21,0,TRUE,NA,"0.1.4"
"18294","646",2023-03-10 13:15:00,985,1006,21,0,TRUE,NA,"0.1.4"
"18295","646",2023-03-10 13:30:00,985,1006,21,0,TRUE,NA,"0.1.4"
"18296","646",2023-03-10 13:45:00,985,1006,21,0,TRUE,NA,"0.1.4"
"18297","646",2023-03-10 14:00:00,985,1006,21,0,TRUE,NA,"0.1.4"
"18298","646",2023-03-10 14:15:00,985,1006,21,0,TRUE,NA,"0.1.4"
"18299","646",2023-03-10 14:30:00,985,1006,21,0,TRUE,NA,"0.1.4"
"18300","646",2023-03-10 14:45:00,985,1006,21,0,TRUE,NA,"0.1.4"
"18301","646",2023-03-10 15:00:00,985,1006,21,0,TRUE,NA,"0.1.4"
"18302","646",2023-03-10 15:15:00,985,1006,21,0,TRUE,NA,"0.1.4"
"18303","646",2023-03-10 15:30:00,985,1006,21,0,TRUE,NA,"0.1.4"
"18304","646",2023-03-10 15:45:00,985,1006,21,0,TRUE,NA,"0.1.4"
"18305","646",2023-03-10 16:00:00,985,1006,21,0,TRUE,NA,"0.1.4"
"18306","646",2023-03-10 16:15:00,985,1006,21,0,TRUE,NA,"0.1.4"
"18307","646",2023-03-10 16:30:00,985,1006,21,0,TRUE,NA,"0.1.4"
"18308","646",2023-03-10 16:45:00,985,1006,21,0,TRUE,NA,"0.1.4"
"18309","646",2023-03-10 17:00:00,985,1006,21,0,TRUE,NA,"0.1.4"
"18310","646",2023-03-10 17:15:00,985,1006,21,0,TRUE,NA,"0.1.4"
"18311","646",2023-03-10 17:30:00,985,1006,21,0,TRUE,NA,"0.1.4"
"18312","646",2023-03-10 17:45:00,985,1006,21,0,TRUE,NA,"0.1.4"
"18313","646",2023-03-10 18:00:00,985,1006,21,0,TRUE,NA,"0.1.4"
"18314","646",2023-03-10 18:15:00,985,1006,21,0,TRUE,NA,"0.1.4"
"18315","646",2023-03-10 18:30:00,985,1006,21,0,TRUE,NA,"0.1.4"
"18316","646",2023-03-10 18:45:00,985,1006,21,0,TRUE,NA,"0.1.4"
"18317","646",2023-03-10 19:00:00,985,1006,21,0,TRUE,NA,"0.1.4"
"18318","646",2023-03-10 19:15:00,985,1006,21,0,TRUE,NA,"0.1.4"
"18319","646",2023-03-10 19:30:00,985,1006,21,0,TRUE,NA,"0.1.4"
"18320","646",2023-03-10 19:45:00,985,1006,21,0,TRUE,NA,"0.1.4"
"18321","646",2023-03-10 20:00:00,985,1006,21,0,TRUE,NA,"0.1.4"
"18322","646",2023-03-10 20:15:00,985,1006,21,0,TRUE,NA,"0.1.4"
"18323","646",2023-03-10 20:30:00,985,1006,21,0,TRUE,NA,"0.1.4"
"18324","646",2023-03-10 20:45:00,985,1006,21,0,TRUE,NA,"0.1.4"
"18325","646",2023-03-10 21:00:00,985,1006,21,0,TRUE,NA,"0.1.4"
"18326","646",2023-03-10 21:15:00,985,1006,21,0,TRUE,NA,"0.1.4"
"18327","646",2023-03-10 21:30:00,985,1006,21,0,TRUE,NA,"0.1.4"
"18328","646",2023-03-10 21:45:00,985,1006,21,0,TRUE,NA,"0.1.4"
"18329","646",2023-03-10 22:00:00,985,1006,21,0,TRUE,NA,"0.1.4"
"18330","646",2023-03-10 22:15:00,985,1006,21,0,TRUE,NA,"0.1.4"
"18331","646",2023-03-10 22:30:00,985,1006,21,0,TRUE,NA,"0.1.4"
"18332","646",2023-03-10 22:45:00,985,1006,21,0,TRUE,NA,"0.1.4"
"18333","646",2023-03-10 23:00:00,985,1006,21,0,TRUE,NA,"0.1.4"
"18334","646",2023-03-10 23:15:00,985,1006,21,0,TRUE,NA,"0.1.4"
"18335","646",2023-03-10 23:30:00,985,1006,21,0,TRUE,NA,"0.1.4"
"18336","646",2023-03-10 23:45:00,985,1006,21,0,TRUE,NA,"0.1.4"
"18337","646",2023-03-11,985,1006,21,0,TRUE,NA,"0.1.4"
"18338","646",2023-03-11 00:15:00,985,1006,21,0,TRUE,NA,"0.1.4"
"18339","646",2023-03-11 00:30:00,985,1006,21,0,TRUE,NA,"0.1.4"
"18340","646",2023-03-11 00:45:00,985,1006,21,0,TRUE,NA,"0.1.4"
"18341","646",2023-03-11 01:00:00,985,1006,21,0,TRUE,NA,"0.1.4"
"18342","646",2023-03-11 01:15:00,985,1006,21,0,TRUE,NA,"0.1.4"
"18343","646",2023-03-11 01:30:00,985,1006,21,0,TRUE,NA,"0.1.4"
"18344","646",2023-03-11 01:45:00,985,1006,21,0,TRUE,NA,"0.1.4"
"18345","646",2023-03-11 02:00:00,985,1006,21,0,TRUE,NA,"0.1.4"
"18346","646",2023-03-11 02:15:00,985,1006,21,0,TRUE,NA,"0.1.4"
"18347","646",2023-03-11 02:30:00,985,1006,21,0,TRUE,NA,"0.1.4"
"18348","646",2023-03-11 02:45:00,985,1006,21,0,TRUE,NA,"0.1.4"
"18349","646",2023-03-11 03:00:00,985,1006,21,0,TRUE,NA,"0.1.4"
"18350","646",2023-03-11 03:15:00,985,1006,21,0,TRUE,NA,"0.1.4"
"18351","646",2023-03-11 03:30:00,985,1006,21,0,TRUE,NA,"0.1.4"
"18352","646",2023-03-11 03:45:00,985,1006,21,0,TRUE,NA,"0.1.4"
"18353","646",2023-03-11 04:00:00,985,1006,21,0,TRUE,NA,"0.1.4"
"18354","646",2023-03-11 04:15:00,985,1006,21,0,TRUE,NA,"0.1.4"
"18355","646",2023-03-11 04:30:00,985,1006,21,0,TRUE,NA,"0.1.4"
"18356","646",2023-03-11 04:45:00,985,1006,21,0,TRUE,NA,"0.1.4"
"18357","646",2023-03-11 05:00:00,985,1006,21,0,TRUE,NA,"0.1.4"
"18358","646",2023-03-11 05:15:00,985,1006,21,0,TRUE,NA,"0.1.4"
"18359","646",2023-03-11 05:30:00,985,1006,21,0,TRUE,NA,"0.1.4"
"18360","646",2023-03-11 05:45:00,985,1006,21,0,TRUE,NA,"0.1.4"
"18361","646",2023-03-11 06:00:00,985,1006,21,0,TRUE,NA,"0.1.4"
"18362","646",2023-03-11 06:15:00,985,1006,21,0,TRUE,NA,"0.1.4"
"18363","646",2023-03-11 06:30:00,985,1006,21,0,TRUE,NA,"0.1.4"
"18364","646",2023-03-11 06:45:00,985,1006,21,0,TRUE,NA,"0.1.4"
"18365","646",2023-03-11 07:00:00,985,1006,21,0,TRUE,NA,"0.1.4"
"18366","646",2023-03-11 07:15:00,985,1006,21,0,TRUE,NA,"0.1.4"
"18367","646",2023-03-11 07:30:00,985,1006,21,0,TRUE,NA,"0.1.4"
"18368","646",2023-03-11 07:45:00,985,1006,21,0,TRUE,NA,"0.1.4"
"18369","646",2023-03-11 08:00:00,985,1006,21,0,TRUE,NA,"0.1.4"
"18370","646",2023-03-11 08:15:00,985,1006,21,0,TRUE,NA,"0.1.4"
"18371","646",2023-03-11 08:30:00,985,1006,21,0,TRUE,NA,"0.1.4"
"18372","646",2023-03-11 08:45:00,985,1006,21,0,TRUE,NA,"0.1.4"
"18373","646",2023-03-11 09:00:00,985,1006,21,0,TRUE,NA,"0.1.4"
"18374","646",2023-03-11 09:15:00,985,1006,21,0,TRUE,NA,"0.1.4"
"18375","646",2023-03-11 09:30:00,985,1006,21,0,TRUE,NA,"0.1.4"
"18376","646",2023-03-11 09:45:00,985,1006,21,0,TRUE,NA,"0.1.4"
"18377","646",2023-03-11 10:00:00,985,1006,21,0,TRUE,NA,"0.1.4"
"18378","646",2023-03-11 10:15:00,985,1006,21,0,TRUE,NA,"0.1.4"
"18379","646",2023-03-11 10:30:00,985,1006,21,0,TRUE,NA,"0.1.4"
"18380","646",2023-03-11 10:45:00,985,1006,21,0,TRUE,NA,"0.1.4"
"18381","646",2023-03-11 11:00:00,985,1006,21,0,TRUE,NA,"0.1.4"
"18382","646",2023-03-11 11:15:00,985,1006,21,0,TRUE,NA,"0.1.4"
"18383","646",2023-03-11 11:30:00,985,1006,21,0,TRUE,NA,"0.1.4"
"18384","646",2023-03-11 11:45:00,985,1006,21,0,TRUE,NA,"0.1.4"
"18385","646",2023-03-11 12:00:00,985,1006,21,0,TRUE,NA,"0.1.4"
"18386","646",2023-03-11 12:15:00,985,1006,21,0,TRUE,NA,"0.1.4"
"18387","646",2023-03-11 12:30:00,985,1006,21,0,TRUE,NA,"0.1.4"
"18388","646",2023-03-11 12:45:00,985,1006,21,0,TRUE,NA,"0.1.4"
"18389","646",2023-03-11 13:00:00,985,1006,21,0,TRUE,NA,"0.1.4"
"18390","646",2023-03-11 13:15:00,985,1006,21,0,TRUE,NA,"0.1.4"
"18391","646",2023-03-11 13:30:00,985,1006,21,0,TRUE,NA,"0.1.4"
"18392","646",2023-03-11 13:45:00,985,1006,21,0,TRUE,NA,"0.1.4"
"18393","646",2023-03-11 14:00:00,985,1006,21,0,TRUE,NA,"0.1.4"
"18394","646",2023-03-11 14:15:00,985,1006,21,0,TRUE,NA,"0.1.4"
"18395","646",2023-03-11 14:30:00,985,1006,21,0,TRUE,NA,"0.1.4"
"18396","646",2023-03-11 14:45:00,985,1006,21,0,TRUE,NA,"0.1.4"
"18397","646",2023-03-11 15:00:00,985,1006,21,0,TRUE,NA,"0.1.4"
"18398","646",2023-03-11 15:15:00,985,1006,21,0,TRUE,NA,"0.1.4"
"18399","646",2023-03-11 15:30:00,985,1006,21,0,TRUE,NA,"0.1.4"
"18400","646",2023-03-11 15:45:00,985,1006,21,0,TRUE,NA,"0.1.4"
"18401","646",2023-03-11 16:00:00,985,1006,21,0,TRUE,NA,"0.1.4"
"18402","646",2023-03-11 16:15:00,985,1006,21,0,TRUE,NA,"0.1.4"
"18403","646",2023-03-11 16:30:00,985,1006,21,0,TRUE,NA,"0.1.4"
"18404","646",2023-03-11 16:45:00,985,1006,21,0,TRUE,NA,"0.1.4"
"18405","646",2023-03-11 17:00:00,985,1006,21,0,TRUE,NA,"0.1.4"
"18406","646",2023-03-11 17:15:00,985,1006,21,0,TRUE,NA,"0.1.4"
"18407","646",2023-03-11 17:30:00,985,1006,21,0,TRUE,NA,"0.1.4"
"18408","646",2023-03-11 17:45:00,985,1006,21,0,TRUE,NA,"0.1.4"
"18409","646",2023-03-11 18:00:00,985,1006,21,0,TRUE,NA,"0.1.4"
"18410","646",2023-03-11 18:15:00,985,1006,21,0,TRUE,NA,"0.1.4"
"18411","646",2023-03-11 18:30:00,985,1006,21,0,TRUE,NA,"0.1.4"
"18412","646",2023-03-11 18:45:00,985,1006,21,0,TRUE,NA,"0.1.4"
"18413","646",2023-03-11 19:00:00,985,1006,21,0,TRUE,NA,"0.1.4"
"18414","646",2023-03-11 19:15:00,985,1006,21,0,TRUE,NA,"0.1.4"
"18415","646",2023-03-11 19:30:00,985,1006,21,0,TRUE,NA,"0.1.4"
"18416","646",2023-03-11 19:45:00,985,1006,21,0,TRUE,NA,"0.1.4"
"18417","646",2023-03-11 20:00:00,985,1006,21,0,TRUE,NA,"0.1.4"
"18418","646",2023-03-11 20:15:00,985,1006,21,0,TRUE,NA,"0.1.4"
"18419","646",2023-03-11 20:30:00,985,1006,21,0,TRUE,NA,"0.1.4"
"18420","646",2023-03-11 20:45:00,985,1006,21,0,TRUE,NA,"0.1.4"
"18421","646",2023-03-11 21:00:00,985,1006,21,0,TRUE,NA,"0.1.4"
"18422","646",2023-03-11 21:15:00,985,1006,21,0,TRUE,NA,"0.1.4"
"18423","646",2023-03-11 21:30:00,985,1006,21,0,TRUE,NA,"0.1.4"
"18424","646",2023-03-11 21:45:00,985,1006,21,0,TRUE,NA,"0.1.4"
"18425","646",2023-03-11 22:00:00,985,1006,21,0,TRUE,NA,"0.1.4"
"18426","646",2023-03-11 22:15:00,985,1006,21,0,TRUE,NA,"0.1.4"
"18427","646",2023-03-11 22:30:00,985,1006,21,0,TRUE,NA,"0.1.4"
"18428","646",2023-03-11 22:45:00,985,1006,21,0,TRUE,NA,"0.1.4"
"18429","646",2023-03-11 23:00:00,985,1006,21,0,TRUE,NA,"0.1.4"
"18430","646",2023-03-11 23:15:00,985,1006,21,0,TRUE,NA,"0.1.4"
"18431","646",2023-03-11 23:30:00,985,1006,21,0,TRUE,NA,"0.1.4"
"18432","646",2023-03-11 23:45:00,985,1006,21,0,TRUE,NA,"0.1.4"
"18433","646",2023-03-12,985,1006,21,0,TRUE,NA,"0.1.4"
"18434","646",2023-03-12 00:15:00,985,1006,21,0,TRUE,NA,"0.1.4"
"18435","646",2023-03-12 00:30:00,985,1006,21,0,TRUE,NA,"0.1.4"
"18436","646",2023-03-12 00:45:00,985,1006,21,0,TRUE,NA,"0.1.4"
"18437","646",2023-03-12 01:00:00,985,1006,21,0,TRUE,NA,"0.1.4"
"18438","646",2023-03-12 01:15:00,985,1006,21,0,TRUE,NA,"0.1.4"
"18439","646",2023-03-12 01:30:00,985,1006,21,0,TRUE,NA,"0.1.4"
"18440","646",2023-03-12 01:45:00,985,1006,21,0,TRUE,NA,"0.1.4"
"18441","646",2023-03-12 02:00:00,985,1006,21,0,TRUE,NA,"0.1.4"
"18442","646",2023-03-12 02:15:00,985,1006,21,0,TRUE,NA,"0.1.4"
"18443","646",2023-03-12 02:30:00,985,1006,21,0,TRUE,NA,"0.1.4"
"18444","646",2023-03-12 02:45:00,985,1006,21,0,TRUE,NA,"0.1.4"
"18445","646",2023-03-12 03:00:00,985,1006,21,0,TRUE,NA,"0.1.4"
"18446","646",2023-03-12 03:15:00,985,1006,21,0,TRUE,NA,"0.1.4"
"18447","646",2023-03-12 03:30:00,985,1006,21,0,TRUE,NA,"0.1.4"
"18448","646",2023-03-12 03:45:00,985,1006,21,0,TRUE,NA,"0.1.4"
"18449","646",2023-03-12 04:00:00,985,1006,21,0,TRUE,NA,"0.1.4"
"18450","646",2023-03-12 04:15:00,985,1006,21,0,TRUE,NA,"0.1.4"
"18451","646",2023-03-12 04:30:00,985,1006,21,0,TRUE,NA,"0.1.4"
"18452","646",2023-03-12 04:45:00,985,1006,21,0,TRUE,NA,"0.1.4"
"18453","646",2023-03-12 05:00:00,985,1006,21,0,TRUE,NA,"0.1.4"
"18454","646",2023-03-12 05:15:00,985,1006,21,0,TRUE,NA,"0.1.4"
"18455","646",2023-03-12 05:30:00,985,1006,21,0,TRUE,NA,"0.1.4"
"18456","646",2023-03-12 05:45:00,985,1006,21,0,TRUE,NA,"0.1.4"
"18457","646",2023-03-12 06:00:00,985,1006,21,0,TRUE,NA,"0.1.4"
"18458","646",2023-03-12 06:15:00,985,1006,21,0,TRUE,NA,"0.1.4"
"18459","646",2023-03-12 06:30:00,985,1006,21,0,TRUE,NA,"0.1.4"
"18460","646",2023-03-12 06:45:00,985,1006,21,0,TRUE,NA,"0.1.4"
"18461","646",2023-03-12 07:00:00,985,1006,21,0,TRUE,NA,"0.1.4"
"18462","646",2023-03-12 07:15:00,985,1006,21,0,TRUE,NA,"0.1.4"
"18463","646",2023-03-12 07:30:00,985,1006,21,0,TRUE,NA,"0.1.4"
"18464","646",2023-03-12 07:45:00,985,1006,21,0,TRUE,NA,"0.1.4"
"18465","646",2023-03-12 08:00:00,985,1006,21,0,TRUE,NA,"0.1.4"
"18466","646",2023-03-12 08:15:00,985,1006,21,0,TRUE,NA,"0.1.4"
"18467","646",2023-03-12 08:30:00,985,1006,21,0,TRUE,NA,"0.1.4"
"18468","646",2023-03-12 08:45:00,985,1006,21,0,TRUE,NA,"0.1.4"
"18469","646",2023-03-12 09:00:00,985,1006,21,0,TRUE,NA,"0.1.4"
"18470","646",2023-03-12 09:15:00,985,1006,21,0,TRUE,NA,"0.1.4"
"18471","646",2023-03-12 09:30:00,985,1006,21,0,TRUE,NA,"0.1.4"
"18472","646",2023-03-12 09:45:00,985,1006,21,0,TRUE,NA,"0.1.4"
"18473","646",2023-03-12 10:00:00,985,1006,21,0,TRUE,NA,"0.1.4"
"18474","646",2023-03-12 10:15:00,985,1006,21,0,TRUE,NA,"0.1.4"
"18475","646",2023-03-12 10:30:00,985,1006,21,0,TRUE,NA,"0.1.4"
"18476","646",2023-03-12 10:45:00,985,1006,21,0,TRUE,NA,"0.1.4"
"18477","646",2023-03-12 11:00:00,985,1006,21,0,TRUE,NA,"0.1.4"
"18478","646",2023-03-12 11:15:00,985,1006,21,0,TRUE,NA,"0.1.4"
"18479","646",2023-03-12 11:30:00,985,1006,21,0,TRUE,NA,"0.1.4"
"18480","646",2023-03-12 11:45:00,985,1006,21,0,TRUE,NA,"0.1.4"
"18481","646",2023-03-12 12:00:00,985,1006,21,0,TRUE,NA,"0.1.4"
"18482","646",2023-03-12 12:15:00,985,1006,21,0,TRUE,NA,"0.1.4"
"18483","646",2023-03-12 12:30:00,985,1006,21,0,TRUE,NA,"0.1.4"
"18484","646",2023-03-12 12:45:00,985,1006,21,0,TRUE,NA,"0.1.4"
"18485","646",2023-03-12 13:00:00,985,1006,21,0,TRUE,NA,"0.1.4"
"18486","646",2023-03-12 13:15:00,985,1006,21,0,TRUE,NA,"0.1.4"
"18487","646",2023-03-12 13:30:00,985,1006,21,0,TRUE,NA,"0.1.4"
"18488","646",2023-03-12 13:45:00,985,1006,21,0,TRUE,NA,"0.1.4"
"18489","646",2023-03-12 14:00:00,985,1006,21,0,TRUE,NA,"0.1.4"
"18490","646",2023-03-12 14:15:00,985,1006,21,0,TRUE,NA,"0.1.4"
"18491","646",2023-03-12 14:30:00,985,1006,21,0,TRUE,NA,"0.1.4"
"18492","646",2023-03-12 14:45:00,985,1006,21,0,TRUE,NA,"0.1.4"
"18493","646",2023-03-12 15:00:00,985,1006,21,0,TRUE,NA,"0.1.4"
"18494","646",2023-03-12 15:15:00,985,1006,21,0,TRUE,NA,"0.1.4"
"18495","646",2023-03-12 15:30:00,985,1006,21,0,TRUE,NA,"0.1.4"
"18496","646",2023-03-12 15:45:00,985,1006,21,0,TRUE,NA,"0.1.4"
"18497","646",2023-03-12 16:00:00,985,1006,21,0,TRUE,NA,"0.1.4"
"18498","646",2023-03-12 16:15:00,985,1006,21,0,TRUE,NA,"0.1.4"
"18499","646",2023-03-12 16:30:00,985,1006,21,0,TRUE,NA,"0.1.4"
"18500","646",2023-03-12 16:45:00,985,1006,21,0,TRUE,NA,"0.1.4"
"18501","646",2023-03-12 17:00:00,985,1006,21,0,TRUE,NA,"0.1.4"
"18502","646",2023-03-12 17:15:00,985,1006,21,0,TRUE,NA,"0.1.4"
"18503","646",2023-03-12 17:30:00,985,1006,21,0,TRUE,NA,"0.1.4"
"18504","646",2023-03-12 17:45:00,985,1006,21,0,TRUE,NA,"0.1.4"
"18505","646",2023-03-12 18:00:00,985,1006,21,0,TRUE,NA,"0.1.4"
"18506","646",2023-03-12 18:15:00,985,1006,21,0,TRUE,NA,"0.1.4"
"18507","646",2023-03-12 18:30:00,985,1006,21,0,TRUE,NA,"0.1.4"
"18508","646",2023-03-12 18:45:00,985,1006,21,0,TRUE,NA,"0.1.4"
"18509","646",2023-03-12 19:00:00,985,1006,21,0,TRUE,NA,"0.1.4"
"18510","646",2023-03-12 19:15:00,985,1006,21,0,TRUE,NA,"0.1.4"
"18511","646",2023-03-12 19:30:00,985,1006,21,0,TRUE,NA,"0.1.4"
"18512","646",2023-03-12 19:45:00,985,1006,21,0,TRUE,NA,"0.1.4"
"18513","646",2023-03-12 20:00:00,985,1006,21,0,TRUE,NA,"0.1.4"
"18514","646",2023-03-12 20:15:00,985,1006,21,0,TRUE,NA,"0.1.4"
"18515","646",2023-03-12 20:30:00,985,1006,21,0,TRUE,NA,"0.1.4"
"18516","646",2023-03-12 20:45:00,985,1006,21,0,TRUE,NA,"0.1.4"
"18517","646",2023-03-12 21:00:00,985,1006,21,0,TRUE,NA,"0.1.4"
"18518","646",2023-03-12 21:15:00,985,1006,21,0,TRUE,NA,"0.1.4"
"18519","646",2023-03-12 21:30:00,985,1006,21,0,TRUE,NA,"0.1.4"
"18520","646",2023-03-12 21:45:00,985,1006,21,0,TRUE,NA,"0.1.4"
"18521","646",2023-03-12 22:00:00,985,1006,21,0,TRUE,NA,"0.1.4"
"18522","646",2023-03-12 22:15:00,985,1006,21,0,TRUE,NA,"0.1.4"
"18523","646",2023-03-12 22:30:00,985,1006,21,0,TRUE,NA,"0.1.4"
"18524","646",2023-03-12 22:45:00,985,1006,21,0,TRUE,NA,"0.1.4"
"18525","646",2023-03-12 23:00:00,985,1006,21,0,TRUE,NA,"0.1.4"
"18526","646",2023-03-12 23:15:00,985,1006,21,0,TRUE,NA,"0.1.4"
"18527","646",2023-03-12 23:30:00,985,1006,21,0,TRUE,NA,"0.1.4"
"18528","646",2023-03-12 23:45:00,985,1006,21,0,TRUE,NA,"0.1.4"
"18529","646",2023-03-13,985,1006,21,0,TRUE,NA,"0.1.4"
"18530","646",2023-03-13 00:15:00,985,1006,21,0,TRUE,NA,"0.1.4"
"18531","646",2023-03-13 00:30:00,985,1006,21,0,TRUE,NA,"0.1.4"
"18532","646",2023-03-13 00:45:00,985,1006,21,0,TRUE,NA,"0.1.4"
"18533","646",2023-03-13 01:00:00,985,1006,21,0,TRUE,NA,"0.1.4"
"18534","646",2023-03-13 01:15:00,985,1006,21,0,TRUE,NA,"0.1.4"
"18535","646",2023-03-13 01:30:00,985,1006,21,0,TRUE,NA,"0.1.4"
"18536","646",2023-03-13 01:45:00,985,1006,21,0,TRUE,NA,"0.1.4"
"18537","646",2023-03-13 02:00:00,985,1006,21,0,TRUE,NA,"0.1.4"
"18538","646",2023-03-13 02:15:00,985,1006,21,0,TRUE,NA,"0.1.4"
"18539","646",2023-03-13 02:30:00,985,1006,21,0,TRUE,NA,"0.1.4"
"18540","646",2023-03-13 02:45:00,985,1006,21,0,TRUE,NA,"0.1.4"
"18541","646",2023-03-13 03:00:00,985,1006,21,0,TRUE,NA,"0.1.4"
"18542","646",2023-03-13 03:15:00,985,1006,21,0,TRUE,NA,"0.1.4"
"18543","646",2023-03-13 03:30:00,985,1006,21,0,TRUE,NA,"0.1.4"
"18544","646",2023-03-13 03:45:00,985,1006,21,0,TRUE,NA,"0.1.4"
"18545","646",2023-03-13 04:00:00,985,1006,21,0,TRUE,NA,"0.1.4"
"18546","646",2023-03-13 04:15:00,985,1006,21,0,TRUE,NA,"0.1.4"
"18547","646",2023-03-13 04:30:00,985,1006,21,0,TRUE,NA,"0.1.4"
"18548","646",2023-03-13 04:45:00,985,1006,21,0,TRUE,NA,"0.1.4"
"18549","646",2023-03-13 05:00:00,985,1006,21,0,TRUE,NA,"0.1.4"
"18550","646",2023-03-13 05:15:00,985,1006,21,0,TRUE,NA,"0.1.4"
"18551","646",2023-03-13 05:30:00,985,1006,21,0,TRUE,NA,"0.1.4"
"18552","646",2023-03-13 05:45:00,985,1006,21,0,TRUE,NA,"0.1.4"
"18553","646",2023-03-13 06:00:00,985,1006,21,0,TRUE,NA,"0.1.4"
"18554","646",2023-03-13 06:15:00,985,1006,21,0,TRUE,NA,"0.1.4"
"18555","646",2023-03-13 06:30:00,985,1006,21,0,TRUE,NA,"0.1.4"
"18556","646",2023-03-13 06:45:00,985,1006,21,0,TRUE,NA,"0.1.4"
"18557","646",2023-03-13 07:00:00,985,1006,21,0,TRUE,NA,"0.1.4"
"18558","646",2023-03-13 07:15:00,985,1006,21,0,TRUE,NA,"0.1.4"
"18559","646",2023-03-13 07:30:00,985,1006,21,0,TRUE,NA,"0.1.4"
"18560","646",2023-03-13 07:45:00,985,1006,21,0,TRUE,NA,"0.1.4"
"18561","646",2023-03-13 08:00:00,985,1006,21,0,TRUE,NA,"0.1.4"
"18562","646",2023-03-13 08:15:00,985,1006,21,0,TRUE,NA,"0.1.4"
"18563","646",2023-03-13 08:30:00,985,1006,21,0,TRUE,NA,"0.1.4"
"18564","646",2023-03-13 08:45:00,985,1006,21,0,TRUE,NA,"0.1.4"
"18565","646",2023-03-13 09:00:00,985,1006,21,0,TRUE,NA,"0.1.4"
"18566","646",2023-03-13 09:15:00,985,1006,21,0,TRUE,NA,"0.1.4"
"18567","646",2023-03-13 09:30:00,985,1006,21,0,TRUE,NA,"0.1.4"
"18568","646",2023-03-13 09:45:00,985,1006,21,0,TRUE,NA,"0.1.4"
"18569","646",2023-03-13 10:00:00,985,1006,21,0,TRUE,NA,"0.1.4"
"18570","646",2023-03-13 10:15:00,985,1006,21,0,TRUE,NA,"0.1.4"
"18571","646",2023-03-13 10:30:00,985,1006,21,0,TRUE,NA,"0.1.4"
"18572","646",2023-03-13 10:45:00,985,1006,21,0,TRUE,NA,"0.1.4"
"18573","646",2023-03-13 11:00:00,985,1006,21,0,TRUE,NA,"0.1.4"
"18574","646",2023-03-13 11:15:00,985,1006,21,0,TRUE,NA,"0.1.4"
"18575","646",2023-03-13 11:30:00,985,1006,21,0,TRUE,NA,"0.1.4"
"18576","646",2023-03-13 11:45:00,985,1006,21,0,TRUE,NA,"0.1.4"
"18577","646",2023-03-13 12:00:00,985,1006,21,0,TRUE,NA,"0.1.4"
"18578","646",2023-03-13 12:15:00,985,1006,21,0,TRUE,NA,"0.1.4"
"18579","646",2023-03-13 12:30:00,985,1006,21,0,TRUE,NA,"0.1.4"
"18580","646",2023-03-13 12:45:00,985,1006,21,0,TRUE,NA,"0.1.4"
"18581","646",2023-03-13 13:00:00,985,1006,21,0,TRUE,NA,"0.1.4"
"18582","646",2023-03-13 13:15:00,985,1006,21,0,TRUE,NA,"0.1.4"
"18583","646",2023-03-13 13:30:00,985,1006,21,0,TRUE,NA,"0.1.4"
"18584","646",2023-03-13 13:45:00,985,1006,21,0,TRUE,NA,"0.1.4"
"18585","646",2023-03-13 14:00:00,985,1006,21,0,TRUE,NA,"0.1.4"
"18586","646",2023-03-13 14:15:00,985,1006,21,0,TRUE,NA,"0.1.4"
"18587","646",2023-03-13 14:30:00,985,1006,21,0,TRUE,NA,"0.1.4"
"18588","646",2023-03-13 14:45:00,985,1006,21,0,TRUE,NA,"0.1.4"
"18589","646",2023-03-13 15:00:00,985,1006,21,0,TRUE,NA,"0.1.4"
"18590","646",2023-03-13 15:15:00,985,1006,21,0,TRUE,NA,"0.1.4"
"18591","646",2023-03-13 15:30:00,985,1006,21,0,TRUE,NA,"0.1.4"
"18592","646",2023-03-13 15:45:00,985,1006,21,0,TRUE,NA,"0.1.4"
"18593","646",2023-03-13 16:00:00,985,1006,21,0,TRUE,NA,"0.1.4"
"18594","646",2023-03-13 16:15:00,985,1006,21,0,TRUE,NA,"0.1.4"
"18595","646",2023-03-13 16:30:00,985,1006,21,0,TRUE,NA,"0.1.4"
"18596","646",2023-03-13 16:45:00,985,1006,21,0,TRUE,NA,"0.1.4"
"18597","646",2023-03-13 17:00:00,985,1006,21,0,TRUE,NA,"0.1.4"
"18598","646",2023-03-13 17:15:00,985,1006,21,0,TRUE,NA,"0.1.4"
"18599","646",2023-03-13 17:30:00,985,1006,21,0,TRUE,NA,"0.1.4"
"18600","646",2023-03-13 17:45:00,985,1006,21,0,TRUE,NA,"0.1.4"
"18601","646",2023-03-13 18:00:00,985,1006,21,0,TRUE,NA,"0.1.4"
"18602","646",2023-03-13 18:15:00,985,1006,21,0,TRUE,NA,"0.1.4"
"18603","646",2023-03-13 18:30:00,985,1006,21,0,TRUE,NA,"0.1.4"
"18604","646",2023-03-13 18:45:00,985,1006,21,0,TRUE,NA,"0.1.4"
"18605","646",2023-03-13 19:00:00,985,1006,21,0,TRUE,NA,"0.1.4"
"18606","646",2023-03-13 19:15:00,985,1006,21,0,TRUE,NA,"0.1.4"
"18607","646",2023-03-13 19:30:00,985,1006,21,0,TRUE,NA,"0.1.4"
"18608","646",2023-03-13 19:45:00,985,1006,21,0,TRUE,NA,"0.1.4"
"18609","646",2023-03-13 20:00:00,985,1006,21,0,TRUE,NA,"0.1.4"
"18610","646",2023-03-13 20:15:00,985,1006,21,0,TRUE,NA,"0.1.4"
"18611","646",2023-03-13 20:30:00,985,1006,21,0,TRUE,NA,"0.1.4"
"18612","646",2023-03-13 20:45:00,985,1006,21,0,TRUE,NA,"0.1.4"
"18613","646",2023-03-13 21:00:00,985,1006,21,0,TRUE,NA,"0.1.4"
"18614","646",2023-03-13 21:15:00,985,1006,21,0,TRUE,NA,"0.1.4"
"18615","646",2023-03-13 21:30:00,985,1006,21,0,TRUE,NA,"0.1.4"
"18616","646",2023-03-13 21:45:00,985,1006,21,0,TRUE,NA,"0.1.4"
"18617","646",2023-03-13 22:00:00,985,1006,21,0,TRUE,NA,"0.1.4"
"18618","646",2023-03-13 22:15:00,985,1006,21,0,TRUE,NA,"0.1.4"
"18619","646",2023-03-13 22:30:00,985,1006,21,0,TRUE,NA,"0.1.4"
"18620","646",2023-03-13 22:45:00,985,1006,21,0,TRUE,NA,"0.1.4"
"18621","646",2023-03-13 23:00:00,985,1006,21,0,TRUE,NA,"0.1.4"
"18622","646",2023-03-13 23:15:00,985,1006,21,0,TRUE,NA,"0.1.4"
"18623","646",2023-03-13 23:30:00,985,1006,21,0,TRUE,NA,"0.1.4"
"18624","646",2023-03-13 23:45:00,985,1006,21,0,TRUE,NA,"0.1.4"
"18625","646",2023-03-14,985,1006,21,0,TRUE,NA,"0.1.4"
"18626","646",2023-03-14 00:15:00,985,1006,21,0,TRUE,NA,"0.1.4"
"18627","646",2023-03-14 00:30:00,985,1006,21,0,TRUE,NA,"0.1.4"
"18628","646",2023-03-14 00:45:00,985,1006,21,0,TRUE,NA,"0.1.4"
"18629","646",2023-03-14 01:00:00,985,1006,21,0,TRUE,NA,"0.1.4"
"18630","646",2023-03-14 01:15:00,985,1006,21,0,TRUE,NA,"0.1.4"
"18631","646",2023-03-14 01:30:00,985,1006,21,0,TRUE,NA,"0.1.4"
"18632","646",2023-03-14 01:45:00,985,1006,21,0,TRUE,NA,"0.1.4"
"18633","646",2023-03-14 02:00:00,985,1006,21,0,TRUE,NA,"0.1.4"
"18634","646",2023-03-14 02:15:00,985,1006,21,0,TRUE,NA,"0.1.4"
"18635","646",2023-03-14 02:30:00,985,1006,21,0,TRUE,NA,"0.1.4"
"18636","646",2023-03-14 02:45:00,985,1006,21,0,TRUE,NA,"0.1.4"
"18637","646",2023-03-14 03:00:00,985,1006,21,0,TRUE,NA,"0.1.4"
"18638","646",2023-03-14 03:15:00,985,1006,21,0,TRUE,NA,"0.1.4"
"18639","646",2023-03-14 03:30:00,985,1006,21,0,TRUE,NA,"0.1.4"
"18640","646",2023-03-14 03:45:00,985,1006,21,0,TRUE,NA,"0.1.4"
"18641","646",2023-03-14 04:00:00,985,1006,21,0,TRUE,NA,"0.1.4"
"18642","646",2023-03-14 04:15:00,985,1006,21,0,TRUE,NA,"0.1.4"
"18643","646",2023-03-14 04:30:00,985,1006,21,0,TRUE,NA,"0.1.4"
"18644","646",2023-03-14 04:45:00,985,1006,21,0,TRUE,NA,"0.1.4"
"18645","646",2023-03-14 05:00:00,985,1006,21,0,TRUE,NA,"0.1.4"
"18646","646",2023-03-14 05:15:00,985,1006,21,0,TRUE,NA,"0.1.4"
"18647","646",2023-03-14 05:30:00,985,1006,21,0,TRUE,NA,"0.1.4"
"18648","646",2023-03-14 05:45:00,985,1006,21,0,TRUE,NA,"0.1.4"
"18649","646",2023-03-14 06:00:00,985,1006,21,0,TRUE,NA,"0.1.4"
"18650","646",2023-03-14 06:15:00,985,1006,21,0,TRUE,NA,"0.1.4"
"18651","646",2023-03-14 06:30:00,985,1006,21,0,TRUE,NA,"0.1.4"
"18652","646",2023-03-14 06:45:00,985,1006,21,0,TRUE,NA,"0.1.4"
"18653","646",2023-03-14 07:00:00,985,1006,21,0,TRUE,NA,"0.1.4"
"18654","646",2023-03-14 07:15:00,985,1006,21,0,TRUE,NA,"0.1.4"
"18655","646",2023-03-14 07:30:00,985,1006,21,0,TRUE,NA,"0.1.4"
"18656","646",2023-03-14 07:45:00,985,1006,21,0,TRUE,NA,"0.1.4"
"18657","646",2023-03-14 08:00:00,985,1006,21,0,TRUE,NA,"0.1.4"
"18658","646",2023-03-14 08:15:00,985,1006,21,0,TRUE,NA,"0.1.4"
"18659","646",2023-03-14 08:30:00,985,1006,21,0,TRUE,NA,"0.1.4"
"18660","646",2023-03-14 08:45:00,985,1006,21,0,TRUE,NA,"0.1.4"
"18661","646",2023-03-14 09:00:00,985,1006,21,0,TRUE,NA,"0.1.4"
"18662","646",2023-03-14 09:15:00,985,1006,21,0,TRUE,NA,"0.1.4"
"18663","646",2023-03-14 09:30:00,985,1006,21,0,TRUE,NA,"0.1.4"
"18664","646",2023-03-14 09:45:00,985,1006,21,0,TRUE,NA,"0.1.4"
"18665","646",2023-03-14 10:00:00,985,1006,21,0,TRUE,NA,"0.1.4"
"18666","646",2023-03-14 10:15:00,985,1006,21,0,TRUE,NA,"0.1.4"
"18667","646",2023-03-14 10:30:00,985,1006,21,0,TRUE,NA,"0.1.4"
"18668","646",2023-03-14 10:45:00,985,1006,21,0,TRUE,NA,"0.1.4"
"18669","646",2023-03-14 11:00:00,985,1006,21,0,TRUE,NA,"0.1.4"
"18670","646",2023-03-14 11:15:00,985,1006,21,0,TRUE,NA,"0.1.4"
"18671","646",2023-03-14 11:30:00,985,1006,21,0,TRUE,NA,"0.1.4"
"18672","646",2023-03-14 11:45:00,985,1006,21,0,TRUE,NA,"0.1.4"
"18673","646",2023-03-14 12:00:00,985,1006,21,0,TRUE,NA,"0.1.4"
"18674","646",2023-03-14 12:15:00,985,1006,21,0,TRUE,NA,"0.1.4"
"18675","646",2023-03-14 12:30:00,985,1006,21,0,TRUE,NA,"0.1.4"
"18676","646",2023-03-14 12:45:00,985,1006,21,0,TRUE,NA,"0.1.4"
"18677","646",2023-03-14 13:00:00,985,1006,21,0,TRUE,NA,"0.1.4"
"18678","646",2023-03-14 13:15:00,985,1006,21,0,TRUE,NA,"0.1.4"
"18679","646",2023-03-14 13:30:00,985,1006,21,0,TRUE,NA,"0.1.4"
"18680","646",2023-03-14 13:45:00,985,1006,21,0,TRUE,NA,"0.1.4"
"18681","646",2023-03-14 14:00:00,985,1006,21,0,TRUE,NA,"0.1.4"
"18682","646",2023-03-14 14:15:00,985,1006,21,0,TRUE,NA,"0.1.4"
"18683","646",2023-03-14 14:30:00,985,1006,21,0,TRUE,NA,"0.1.4"
"18684","646",2023-03-14 14:45:00,985,1006,21,0,TRUE,NA,"0.1.4"
"18685","646",2023-03-14 15:00:00,985,1006,21,0,TRUE,NA,"0.1.4"
"18686","646",2023-03-14 15:15:00,985,1006,21,0,TRUE,NA,"0.1.4"
"18687","646",2023-03-14 15:30:00,985,1006,21,0,TRUE,NA,"0.1.4"
"18688","646",2023-03-14 15:45:00,985,1006,21,0,TRUE,NA,"0.1.4"
"18689","646",2023-03-14 16:00:00,985,1006,21,0,TRUE,NA,"0.1.4"
"18690","646",2023-03-14 16:15:00,985,1006,21,0,TRUE,NA,"0.1.4"
"18691","646",2023-03-14 16:30:00,985,1006,21,0,TRUE,NA,"0.1.4"
"18692","646",2023-03-14 16:45:00,985,1006,21,0,TRUE,NA,"0.1.4"
"18693","646",2023-03-14 17:00:00,985,1006,21,0,TRUE,NA,"0.1.4"
"18694","646",2023-03-14 17:15:00,985,1006,21,0,TRUE,NA,"0.1.4"
"18695","646",2023-03-14 17:30:00,985,1006,21,0,TRUE,NA,"0.1.4"
"18696","646",2023-03-14 17:45:00,985,1006,21,0,TRUE,NA,"0.1.4"
"18697","646",2023-03-14 18:00:00,985,1006,21,0,TRUE,NA,"0.1.4"
"18698","646",2023-03-14 18:15:00,985,1006,21,0,TRUE,NA,"0.1.4"
"18699","646",2023-03-14 18:30:00,985,1006,21,0,TRUE,NA,"0.1.4"
"18700","646",2023-03-14 18:45:00,985,1006,21,0,TRUE,NA,"0.1.4"
"18701","646",2023-03-14 19:00:00,985,1006,21,0,TRUE,NA,"0.1.4"
"18702","646",2023-03-14 19:15:00,985,1006,21,0,TRUE,NA,"0.1.4"
"18703","646",2023-03-14 19:30:00,985,1006,21,0,TRUE,NA,"0.1.4"
"18704","646",2023-03-14 19:45:00,985,1006,21,0,TRUE,NA,"0.1.4"
"18705","646",2023-03-14 20:00:00,985,1006,21,0,TRUE,NA,"0.1.4"
"18706","646",2023-03-14 20:15:00,985,1006,21,0,TRUE,NA,"0.1.4"
"18707","646",2023-03-14 20:30:00,985,1006,21,0,TRUE,NA,"0.1.4"
"18708","646",2023-03-14 20:45:00,985,1006,21,0,TRUE,NA,"0.1.4"
"18709","646",2023-03-14 21:00:00,985,1006,21,0,TRUE,NA,"0.1.4"
"18710","646",2023-03-14 21:15:00,985,1006,21,0,TRUE,NA,"0.1.4"
"18711","646",2023-03-14 21:30:00,985,1006,21,0,TRUE,NA,"0.1.4"
"18712","646",2023-03-14 21:45:00,985,1006,21,0,TRUE,NA,"0.1.4"
"18713","646",2023-03-14 22:00:00,985,1006,21,0,TRUE,NA,"0.1.4"
"18714","646",2023-03-14 22:15:00,985,1006,21,0,TRUE,NA,"0.1.4"
"18715","646",2023-03-14 22:30:00,985,1006,21,0,TRUE,NA,"0.1.4"
"18716","646",2023-03-14 22:45:00,985,1006,21,0,TRUE,NA,"0.1.4"
"18717","646",2023-03-14 23:00:00,985,1006,21,0,TRUE,NA,"0.1.4"
"18718","646",2023-03-14 23:15:00,985,1006,21,0,TRUE,NA,"0.1.4"
"18719","646",2023-03-14 23:30:00,985,1006,21,0,TRUE,NA,"0.1.4"
"18720","646",2023-03-14 23:45:00,985,1006,21,0,TRUE,NA,"0.1.4"
"18721","646",2023-03-15,985,1006,21,0,TRUE,NA,"0.1.4"
"18722","646",2023-03-15 00:15:00,985,1006,21,0,TRUE,NA,"0.1.4"
"18723","646",2023-03-15 00:30:00,985,1006,21,0,TRUE,NA,"0.1.4"
"18724","646",2023-03-15 00:45:00,985,1006,21,0,TRUE,NA,"0.1.4"
"18725","646",2023-03-15 01:00:00,985,1006,21,0,TRUE,NA,"0.1.4"
"18726","646",2023-03-15 01:15:00,985,1006,21,0,TRUE,NA,"0.1.4"
"18727","646",2023-03-15 01:30:00,985,1006,21,0,TRUE,NA,"0.1.4"
"18728","646",2023-03-15 01:45:00,985,1006,21,0,TRUE,NA,"0.1.4"
"18729","646",2023-03-15 02:00:00,985,1006,21,0,TRUE,NA,"0.1.4"
"18730","646",2023-03-15 02:15:00,985,1006,21,0,TRUE,NA,"0.1.4"
"18731","646",2023-03-15 02:30:00,985,1006,21,0,TRUE,NA,"0.1.4"
"18732","646",2023-03-15 02:45:00,985,1006,21,0,TRUE,NA,"0.1.4"
"18733","646",2023-03-15 03:00:00,985,1006,21,0,TRUE,NA,"0.1.4"
"18734","646",2023-03-15 03:15:00,985,1006,21,0,TRUE,NA,"0.1.4"
"18735","646",2023-03-15 03:30:00,985,1006,21,0,TRUE,NA,"0.1.4"
"18736","646",2023-03-15 03:45:00,985,1006,21,0,TRUE,NA,"0.1.4"
"18737","646",2023-03-15 04:00:00,985,1006,21,0,TRUE,NA,"0.1.4"
"18738","646",2023-03-15 04:15:00,985,1006,21,0,TRUE,NA,"0.1.4"
"18739","646",2023-03-15 04:30:00,985,1006,21,0,TRUE,NA,"0.1.4"
"18740","646",2023-03-15 04:45:00,985,1006,21,0,TRUE,NA,"0.1.4"
"18741","646",2023-03-15 05:00:00,985,1006,21,0,TRUE,NA,"0.1.4"
"18742","646",2023-03-15 05:15:00,985,1006,21,0,TRUE,NA,"0.1.4"
"18743","646",2023-03-15 05:30:00,985,1006,21,0,TRUE,NA,"0.1.4"
"18744","646",2023-03-15 05:45:00,985,1006,21,0,TRUE,NA,"0.1.4"
"18745","646",2023-03-15 06:00:00,985,1006,21,0,TRUE,NA,"0.1.4"
"18746","646",2023-03-15 06:15:00,985,1006,21,0,TRUE,NA,"0.1.4"
"18747","646",2023-03-15 06:30:00,985,1006,21,0,TRUE,NA,"0.1.4"
"18748","646",2023-03-15 06:45:00,985,1006,21,0,TRUE,NA,"0.1.4"
"18749","646",2023-03-15 07:00:00,985,1006,21,0,TRUE,NA,"0.1.4"
"18750","646",2023-03-15 07:15:00,985,1006,21,0,TRUE,NA,"0.1.4"
"18751","646",2023-03-15 07:30:00,985,1006,21,0,TRUE,NA,"0.1.4"
"18752","646",2023-03-15 07:45:00,985,1006,21,0,TRUE,NA,"0.1.4"
"18753","646",2023-03-15 08:00:00,985,1006,21,0,TRUE,NA,"0.1.4"
"18754","646",2023-03-15 08:15:00,985,1006,21,0,TRUE,NA,"0.1.4"
"18755","646",2023-03-15 08:30:00,985,1006,21,0,TRUE,NA,"0.1.4"
"18756","646",2023-03-15 08:45:00,985,1006,21,0,TRUE,NA,"0.1.4"
"18757","646",2023-03-15 09:00:00,985,1006,21,0,TRUE,NA,"0.1.4"
"18758","646",2023-03-15 09:15:00,985,1006,21,0,TRUE,NA,"0.1.4"
"18759","646",2023-03-15 09:30:00,985,1006,21,0,TRUE,NA,"0.1.4"
"18760","646",2023-03-15 09:45:00,985,1006,21,0,TRUE,NA,"0.1.4"
"18761","646",2023-03-15 10:00:00,985,1006,21,0,TRUE,NA,"0.1.4"
"18762","646",2023-03-15 10:15:00,985,1006,21,0,TRUE,NA,"0.1.4"
"18763","646",2023-03-15 10:30:00,985,1006,21,0,TRUE,NA,"0.1.4"
"18764","646",2023-03-15 10:45:00,985,1006,21,0,TRUE,NA,"0.1.4"
"18765","646",2023-03-15 11:00:00,985,1006,21,0,TRUE,NA,"0.1.4"
"18766","646",2023-03-15 11:15:00,985,1006,21,0,TRUE,NA,"0.1.4"
"18767","646",2023-03-15 11:30:00,985,1006,21,0,TRUE,NA,"0.1.4"
"18768","646",2023-03-15 11:45:00,985,1006,21,0,TRUE,NA,"0.1.4"
"18769","646",2023-03-15 12:00:00,985,1006,21,0,TRUE,NA,"0.1.4"
"18770","646",2023-03-15 12:15:00,985,1006,21,0,TRUE,NA,"0.1.4"
"18771","646",2023-03-15 12:30:00,985,1006,21,0,TRUE,NA,"0.1.4"
"18772","646",2023-03-15 12:45:00,985,1006,21,0,TRUE,NA,"0.1.4"
"18773","646",2023-03-15 13:00:00,985,1006,21,0,TRUE,NA,"0.1.4"
"18774","646",2023-03-15 13:15:00,985,1006,21,0,TRUE,NA,"0.1.4"
"18775","646",2023-03-15 13:30:00,985,1006,21,0,TRUE,NA,"0.1.4"
"18776","646",2023-03-15 13:45:00,985,1006,21,0,TRUE,NA,"0.1.4"
"18777","646",2023-03-15 14:00:00,985,1006,21,0,TRUE,NA,"0.1.4"
"18778","646",2023-03-15 14:15:00,985,1006,21,0,TRUE,NA,"0.1.4"
"18779","646",2023-03-15 14:30:00,985,1006,21,0,TRUE,NA,"0.1.4"
"18780","646",2023-03-15 14:45:00,985,1006,21,0,TRUE,NA,"0.1.4"
"18781","646",2023-03-15 15:00:00,985,1006,21,0,TRUE,NA,"0.1.4"
"18782","646",2023-03-15 15:15:00,985,1006,21,0,TRUE,NA,"0.1.4"
"18783","646",2023-03-15 15:30:00,985,1006,21,0,TRUE,NA,"0.1.4"
"18784","646",2023-03-15 15:45:00,985,1006,21,0,TRUE,NA,"0.1.4"
"18785","646",2023-03-15 16:00:00,985,1006,21,0,TRUE,NA,"0.1.4"
"18786","646",2023-03-15 16:15:00,985,1006,21,0,TRUE,NA,"0.1.4"
"18787","646",2023-03-15 16:30:00,985,1006,21,0,TRUE,NA,"0.1.4"
"18788","646",2023-03-15 16:45:00,985,1006,21,0,TRUE,NA,"0.1.4"
"18789","646",2023-03-15 17:00:00,985,1006,21,0,TRUE,NA,"0.1.4"
"18790","646",2023-03-15 17:15:00,985,1006,21,0,TRUE,NA,"0.1.4"
"18791","646",2023-03-15 17:30:00,985,1006,21,0,TRUE,NA,"0.1.4"
"18792","646",2023-03-15 17:45:00,985,1006,21,0,TRUE,NA,"0.1.4"
"18793","646",2023-03-15 18:00:00,985,1006,21,0,TRUE,NA,"0.1.4"
"18794","646",2023-03-15 18:15:00,985,1006,21,0,TRUE,NA,"0.1.4"
"18795","646",2023-03-15 18:30:00,985,1006,21,0,TRUE,NA,"0.1.4"
"18796","646",2023-03-15 18:45:00,985,1006,21,0,TRUE,NA,"0.1.4"
"18797","646",2023-03-15 19:00:00,985,1006,21,0,TRUE,NA,"0.1.4"
"18798","646",2023-03-15 19:15:00,985,1006,21,0,TRUE,NA,"0.1.4"
"18799","646",2023-03-15 19:30:00,985,1006,21,0,TRUE,NA,"0.1.4"
"18800","646",2023-03-15 19:45:00,985,1006,21,0,TRUE,NA,"0.1.4"
"18801","646",2023-03-15 20:00:00,985,1006,21,0,TRUE,NA,"0.1.4"
"18802","646",2023-03-15 20:15:00,985,1006,21,0,TRUE,NA,"0.1.4"
"18803","646",2023-03-15 20:30:00,985,1006,21,0,TRUE,NA,"0.1.4"
"18804","646",2023-03-15 20:45:00,985,1006,21,0,TRUE,NA,"0.1.4"
"18805","646",2023-03-15 21:00:00,985,1006,21,0,TRUE,NA,"0.1.4"
"18806","646",2023-03-15 21:15:00,985,1006,21,0,TRUE,NA,"0.1.4"
"18807","646",2023-03-15 21:30:00,985,1006,21,0,TRUE,NA,"0.1.4"
"18808","646",2023-03-15 21:45:00,985,1006,21,0,TRUE,NA,"0.1.4"
"18809","646",2023-03-15 22:00:00,985,1006,21,0,TRUE,NA,"0.1.4"
"18810","646",2023-03-15 22:15:00,985,1006,21,0,TRUE,NA,"0.1.4"
"18811","646",2023-03-15 22:30:00,985,1006,21,0,TRUE,NA,"0.1.4"
"18812","646",2023-03-15 22:45:00,985,1006,21,0,TRUE,NA,"0.1.4"
"18813","646",2023-03-15 23:00:00,985,1006,21,0,TRUE,NA,"0.1.4"
"18814","646",2023-03-15 23:15:00,985,1006,21,0,TRUE,NA,"0.1.4"
"18815","646",2023-03-15 23:30:00,985,1006,21,0,TRUE,NA,"0.1.4"
"18816","646",2023-03-15 23:45:00,985,1006,21,0,TRUE,NA,"0.1.4"
"18817","646",2023-03-16,985,1006,21,0,TRUE,NA,"0.1.4"
"18818","646",2023-03-16 00:15:00,985,1006,21,0,TRUE,NA,"0.1.4"
"18819","646",2023-03-16 00:30:00,985,1006,21,0,TRUE,NA,"0.1.4"
"18820","646",2023-03-16 00:45:00,985,1006,21,0,TRUE,NA,"0.1.4"
"18821","646",2023-03-16 01:00:00,985,1006,21,0,TRUE,NA,"0.1.4"
"18822","646",2023-03-16 01:15:00,985,1006,21,0,TRUE,NA,"0.1.4"
"18823","646",2023-03-16 01:30:00,985,1006,21,0,TRUE,NA,"0.1.4"
"18824","646",2023-03-16 01:45:00,985,1006,21,0,TRUE,NA,"0.1.4"
"18825","646",2023-03-16 02:00:00,985,1006,21,0,TRUE,NA,"0.1.4"
"18826","646",2023-03-16 02:15:00,985,1006,21,0,TRUE,NA,"0.1.4"
"18827","646",2023-03-16 02:30:00,985,1006,21,0,TRUE,NA,"0.1.4"
"18828","646",2023-03-16 02:45:00,985,1006,21,0,TRUE,NA,"0.1.4"
"18829","646",2023-03-16 03:00:00,985,1006,21,0,TRUE,NA,"0.1.4"
"18830","646",2023-03-16 03:15:00,985,1006,21,0,TRUE,NA,"0.1.4"
"18831","646",2023-03-16 03:30:00,985,1006,21,0,TRUE,NA,"0.1.4"
"18832","646",2023-03-16 03:45:00,985,1006,21,0,TRUE,NA,"0.1.4"
"18833","646",2023-03-16 04:00:00,985,1006,21,0,TRUE,NA,"0.1.4"
"18834","646",2023-03-16 04:15:00,985,1006,21,0,TRUE,NA,"0.1.4"
"18835","646",2023-03-16 04:30:00,985,1006,21,0,TRUE,NA,"0.1.4"
"18836","646",2023-03-16 04:45:00,985,1006,21,0,TRUE,NA,"0.1.4"
"18837","646",2023-03-16 05:00:00,985,1006,21,0,TRUE,NA,"0.1.4"
"18838","646",2023-03-16 05:15:00,985,1006,21,0,TRUE,NA,"0.1.4"
"18839","646",2023-03-16 05:30:00,985,1006,21,0,TRUE,NA,"0.1.4"
"18840","646",2023-03-16 05:45:00,985,1006,21,0,TRUE,NA,"0.1.4"
"18841","646",2023-03-16 06:00:00,985,1006,21,0,TRUE,NA,"0.1.4"
"18842","646",2023-03-16 06:15:00,985,1006,21,0,TRUE,NA,"0.1.4"
"18843","646",2023-03-16 06:30:00,985,1006,21,0,TRUE,NA,"0.1.4"
"18844","646",2023-03-16 06:45:00,985,1006,21,0,TRUE,NA,"0.1.4"
"18845","646",2023-03-16 07:00:00,985,1006,21,0,TRUE,NA,"0.1.4"
"18846","646",2023-03-16 07:15:00,985,1006,21,0,TRUE,NA,"0.1.4"
"18847","646",2023-03-16 07:30:00,985,1006,21,0,TRUE,NA,"0.1.4"
"18848","646",2023-03-16 07:45:00,985,1006,21,0,TRUE,NA,"0.1.4"
"18849","646",2023-03-16 08:00:00,985,1006,21,0,TRUE,NA,"0.1.4"
"18850","646",2023-03-16 08:15:00,985,1006,21,0,TRUE,NA,"0.1.4"
"18851","646",2023-03-16 08:30:00,985,1006,21,0,TRUE,NA,"0.1.4"
"18852","646",2023-03-16 08:45:00,985,1006,21,0,TRUE,NA,"0.1.4"
"18853","646",2023-03-16 09:00:00,985,1006,21,0,TRUE,NA,"0.1.4"
"18854","646",2023-03-16 09:15:00,985,1006,21,0,TRUE,NA,"0.1.4"
"18855","646",2023-03-16 09:30:00,985,1006,21,0,TRUE,NA,"0.1.4"
"18856","646",2023-03-16 09:45:00,985,1006,21,0,TRUE,NA,"0.1.4"
"18857","646",2023-03-16 10:00:00,985,1006,21,0,TRUE,NA,"0.1.4"
"18858","646",2023-03-16 10:15:00,985,1006,21,0,TRUE,NA,"0.1.4"
"18859","646",2023-03-16 10:30:00,985,1006,21,0,TRUE,NA,"0.1.4"
"18860","646",2023-03-16 10:45:00,985,1006,21,0,TRUE,NA,"0.1.4"
"18861","646",2023-03-16 11:00:00,985,1006,21,0,TRUE,NA,"0.1.4"
"18862","646",2023-03-16 11:15:00,985,1006,21,0,TRUE,NA,"0.1.4"
"18863","646",2023-03-16 11:30:00,985,1006,21,0,TRUE,NA,"0.1.4"
"18864","646",2023-03-16 11:45:00,985,1006,21,0,TRUE,NA,"0.1.4"
"18865","646",2023-03-16 12:00:00,985,1006,21,0,TRUE,NA,"0.1.4"
"18866","646",2023-03-16 12:15:00,985,1006,21,0,TRUE,NA,"0.1.4"
"18867","646",2023-03-16 12:30:00,985,1006,21,0,TRUE,NA,"0.1.4"
"18868","646",2023-03-16 12:45:00,985,1006,21,0,TRUE,NA,"0.1.4"
"18869","646",2023-03-16 13:00:00,985,1006,21,0,TRUE,NA,"0.1.4"
"18870","646",2023-03-16 13:15:00,985,1006,21,0,TRUE,NA,"0.1.4"
"18871","646",2023-03-16 13:30:00,985,1006,21,0,TRUE,NA,"0.1.4"
"18872","646",2023-03-16 13:45:00,985,1006,21,0,TRUE,NA,"0.1.4"
"18873","646",2023-03-16 14:00:00,985,1006,21,0,TRUE,NA,"0.1.4"
"18874","646",2023-03-16 14:15:00,985,1006,21,0,TRUE,NA,"0.1.4"
"18875","646",2023-03-16 14:30:00,985,1006,21,0,TRUE,NA,"0.1.4"
"18876","646",2023-03-16 14:45:00,985,1006,21,0,TRUE,NA,"0.1.4"
"18877","646",2023-03-16 15:00:00,985,1006,21,0,TRUE,NA,"0.1.4"
"18878","646",2023-03-16 15:15:00,985,1006,21,0,TRUE,NA,"0.1.4"
"18879","646",2023-03-16 15:30:00,985,1006,21,0,TRUE,NA,"0.1.4"
"18880","646",2023-03-16 15:45:00,985,1006,21,0,TRUE,NA,"0.1.4"
"18881","646",2023-03-16 16:00:00,985,1006,21,0,TRUE,NA,"0.1.4"
"18882","646",2023-03-16 16:15:00,985,1006,21,0,TRUE,NA,"0.1.4"
"18883","646",2023-03-16 16:30:00,985,1006,21,0,TRUE,NA,"0.1.4"
"18884","646",2023-03-16 16:45:00,985,1006,21,0,TRUE,NA,"0.1.4"
"18885","646",2023-03-16 17:00:00,985,1006,21,0,TRUE,NA,"0.1.4"
"18886","646",2023-03-16 17:15:00,985,1006,21,0,TRUE,NA,"0.1.4"
"18887","646",2023-03-16 17:30:00,985,1006,21,0,TRUE,NA,"0.1.4"
"18888","646",2023-03-16 17:45:00,985,1006,21,0,TRUE,NA,"0.1.4"
"18889","646",2023-03-16 18:00:00,985,1006,21,0,TRUE,NA,"0.1.4"
"18890","646",2023-03-16 18:15:00,985,1006,21,0,TRUE,NA,"0.1.4"
"18891","646",2023-03-16 18:30:00,985,1006,21,0,TRUE,NA,"0.1.4"
"18892","646",2023-03-16 18:45:00,985,1006,21,0,TRUE,NA,"0.1.4"
"18893","646",2023-03-16 19:00:00,985,1006,21,0,TRUE,NA,"0.1.4"
"18894","646",2023-03-16 19:15:00,985,1006,21,0,TRUE,NA,"0.1.4"
"18895","646",2023-03-16 19:30:00,985,1006,21,0,TRUE,NA,"0.1.4"
"18896","646",2023-03-16 19:45:00,985,1006,21,0,TRUE,NA,"0.1.4"
"18897","646",2023-03-16 20:00:00,985,1006,21,0,TRUE,NA,"0.1.4"
"18898","646",2023-03-16 20:15:00,985,1006,21,0,TRUE,NA,"0.1.4"
"18899","646",2023-03-16 20:30:00,985,1006,21,0,TRUE,NA,"0.1.4"
"18900","646",2023-03-16 20:45:00,985,1006,21,0,TRUE,NA,"0.1.4"
"18901","646",2023-03-16 21:00:00,985,1006,21,0,TRUE,NA,"0.1.4"
"18902","646",2023-03-16 21:15:00,985,1006,21,0,TRUE,NA,"0.1.4"
"18903","646",2023-03-16 21:30:00,985,1006,21,0,TRUE,NA,"0.1.4"
"18904","646",2023-03-16 21:45:00,985,1006,21,0,TRUE,NA,"0.1.4"
"18905","646",2023-03-16 22:00:00,985,1006,21,0,TRUE,NA,"0.1.4"
"18906","646",2023-03-16 22:15:00,985,1006,21,0,TRUE,NA,"0.1.4"
"18907","646",2023-03-16 22:30:00,985,1006,21,0,TRUE,NA,"0.1.4"
"18908","646",2023-03-16 22:45:00,985,1006,21,0,TRUE,NA,"0.1.4"
"18909","646",2023-03-16 23:00:00,985,1006,21,0,TRUE,NA,"0.1.4"
"18910","646",2023-03-16 23:15:00,985,1006,21,0,TRUE,NA,"0.1.4"
"18911","646",2023-03-16 23:30:00,985,1006,21,0,TRUE,NA,"0.1.4"
"18912","646",2023-03-16 23:45:00,985,1006,21,0,TRUE,NA,"0.1.4"
"18913","646",2023-03-17,985,1006,21,0,TRUE,NA,"0.1.4"
"18914","646",2023-03-17 00:15:00,985,1006,21,0,TRUE,NA,"0.1.4"
"18915","646",2023-03-17 00:30:00,985,1006,21,0,TRUE,NA,"0.1.4"
"18916","646",2023-03-17 00:45:00,985,1006,21,0,TRUE,NA,"0.1.4"
"18917","646",2023-03-17 01:00:00,985,1006,21,0,TRUE,NA,"0.1.4"
"18918","646",2023-03-17 01:15:00,985,1006,21,0,TRUE,NA,"0.1.4"
"18919","646",2023-03-17 01:30:00,985,1006,21,0,TRUE,NA,"0.1.4"
"18920","646",2023-03-17 01:45:00,985,1006,21,0,TRUE,NA,"0.1.4"
"18921","646",2023-03-17 02:00:00,985,1006,21,0,TRUE,NA,"0.1.4"
"18922","646",2023-03-17 02:15:00,985,1006,21,0,TRUE,NA,"0.1.4"
"18923","646",2023-03-17 02:30:00,985,1006,21,0,TRUE,NA,"0.1.4"
"18924","646",2023-03-17 02:45:00,985,1006,21,0,TRUE,NA,"0.1.4"
"18925","646",2023-03-17 03:00:00,985,1006,21,0,TRUE,NA,"0.1.4"
"18926","646",2023-03-17 03:15:00,985,1006,21,0,TRUE,NA,"0.1.4"
"18927","646",2023-03-17 03:30:00,985,1006,21,0,TRUE,NA,"0.1.4"
"18928","646",2023-03-17 03:45:00,985,1006,21,0,TRUE,NA,"0.1.4"
"18929","646",2023-03-17 04:00:00,985,1006,21,0,TRUE,NA,"0.1.4"
"18930","646",2023-03-17 04:15:00,985,1006,21,0,TRUE,NA,"0.1.4"
"18931","646",2023-03-17 04:30:00,985,1006,21,0,TRUE,NA,"0.1.4"
"18932","646",2023-03-17 04:45:00,985,1006,21,0,TRUE,NA,"0.1.4"
"18933","646",2023-03-17 05:00:00,985,1006,21,0,TRUE,NA,"0.1.4"
"18934","646",2023-03-17 05:15:00,985,1006,21,0,TRUE,NA,"0.1.4"
"18935","646",2023-03-17 05:30:00,985,1006,21,0,TRUE,NA,"0.1.4"
"18936","646",2023-03-17 05:45:00,985,1006,21,0,TRUE,NA,"0.1.4"
"18937","646",2023-03-17 06:00:00,985,1006,21,0,TRUE,NA,"0.1.4"
"18938","646",2023-03-17 06:15:00,985,1006,21,0,TRUE,NA,"0.1.4"
"18939","646",2023-03-17 06:30:00,985,1006,21,0,TRUE,NA,"0.1.4"
"18940","646",2023-03-17 06:45:00,985,1006,21,0,TRUE,NA,"0.1.4"
"18941","646",2023-03-17 07:00:00,985,1006,21,0,TRUE,NA,"0.1.4"
"18942","646",2023-03-17 07:15:00,985,1006,21,0,TRUE,NA,"0.1.4"
"18943","646",2023-03-17 07:30:00,985,1006,21,0,TRUE,NA,"0.1.4"
"18944","646",2023-03-17 07:45:00,985,1006,21,0,TRUE,NA,"0.1.4"
"18945","646",2023-03-17 08:00:00,985,1006,21,0,TRUE,NA,"0.1.4"
"18946","646",2023-03-17 08:15:00,985,1006,21,0,TRUE,NA,"0.1.4"
"18947","646",2023-03-17 08:30:00,985,1006,21,0,TRUE,NA,"0.1.4"
"18948","646",2023-03-17 08:45:00,985,1006,21,0,TRUE,NA,"0.1.4"
"18949","646",2023-03-17 09:00:00,985,1006,21,0,TRUE,NA,"0.1.4"
"18950","646",2023-03-17 09:15:00,985,1006,21,0,TRUE,NA,"0.1.4"
"18951","646",2023-03-17 09:30:00,985,1006,21,0,TRUE,NA,"0.1.4"
"18952","646",2023-03-17 09:45:00,985,1006,21,0,TRUE,NA,"0.1.4"
"18953","646",2023-03-17 10:00:00,985,1006,21,0,TRUE,NA,"0.1.4"
"18954","646",2023-03-17 10:15:00,985,1006,21,0,TRUE,NA,"0.1.4"
"18955","646",2023-03-17 10:30:00,985,1006,21,0,TRUE,NA,"0.1.4"
"18956","646",2023-03-17 10:45:00,985,1006,21,0,TRUE,NA,"0.1.4"
"18957","646",2023-03-17 11:00:00,985,1006,21,0,TRUE,NA,"0.1.4"
"18958","646",2023-03-17 11:15:00,985,1006,21,0,TRUE,NA,"0.1.4"
"18959","646",2023-03-17 11:30:00,985,1006,21,0,TRUE,NA,"0.1.4"
"18960","646",2023-03-17 11:45:00,985,1006,21,0,TRUE,NA,"0.1.4"
"18961","646",2023-03-17 12:00:00,985,1006,21,0,TRUE,NA,"0.1.4"
"18962","646",2023-03-17 12:15:00,985,1006,21,0,TRUE,NA,"0.1.4"
"18963","646",2023-03-17 12:30:00,985,1006,21,0,TRUE,NA,"0.1.4"
"18964","646",2023-03-17 12:45:00,985,1006,21,0,TRUE,NA,"0.1.4"
"18965","646",2023-03-17 13:00:00,985,1006,21,0,TRUE,NA,"0.1.4"
"18966","646",2023-03-17 13:15:00,985,1006,21,0,TRUE,NA,"0.1.4"
"18967","646",2023-03-17 13:30:00,985,1006,21,0,TRUE,NA,"0.1.4"
"18968","646",2023-03-17 13:45:00,985,1006,21,0,TRUE,NA,"0.1.4"
"18969","646",2023-03-17 14:00:00,985,1006,21,0,TRUE,NA,"0.1.4"
"18970","646",2023-03-17 14:15:00,985,1006,21,0,TRUE,NA,"0.1.4"
"18971","646",2023-03-17 14:30:00,985,1006,21,0,TRUE,NA,"0.1.4"
"18972","646",2023-03-17 14:45:00,985,1006,21,0,TRUE,NA,"0.1.4"
"18973","646",2023-03-17 15:00:00,985,1006,21,0,TRUE,NA,"0.1.4"
"18974","646",2023-03-17 15:15:00,985,1006,21,0,TRUE,NA,"0.1.4"
"18975","646",2023-03-17 15:30:00,985,1006,21,0,TRUE,NA,"0.1.4"
"18976","646",2023-03-17 15:45:00,985,1006,21,0,TRUE,NA,"0.1.4"
"18977","646",2023-03-17 16:00:00,985,1006,21,0,TRUE,NA,"0.1.4"
"18978","646",2023-03-17 16:15:00,985,1006,21,0,TRUE,NA,"0.1.4"
"18979","646",2023-03-17 16:30:00,985,1006,21,0,TRUE,NA,"0.1.4"
"18980","646",2023-03-17 16:45:00,985,1006,21,0,TRUE,NA,"0.1.4"
"18981","646",2023-03-17 17:00:00,985,1006,21,0,TRUE,NA,"0.1.4"
"18982","646",2023-03-17 17:15:00,985,1006,21,0,TRUE,NA,"0.1.4"
"18983","646",2023-03-17 17:30:00,985,1006,21,0,TRUE,NA,"0.1.4"
"18984","646",2023-03-17 17:45:00,985,1006,21,0,TRUE,NA,"0.1.4"
"18985","646",2023-03-17 18:00:00,985,1006,21,0,TRUE,NA,"0.1.4"
"18986","646",2023-03-17 18:15:00,985,1006,21,0,TRUE,NA,"0.1.4"
"18987","646",2023-03-17 18:30:00,985,1006,21,0,TRUE,NA,"0.1.4"
"18988","646",2023-03-17 18:45:00,985,1006,21,0,TRUE,NA,"0.1.4"
"18989","646",2023-03-17 19:00:00,985,1006,21,0,TRUE,NA,"0.1.4"
"18990","646",2023-03-17 19:15:00,985,1006,21,0,TRUE,NA,"0.1.4"
"18991","646",2023-03-17 19:30:00,985,1006,21,0,TRUE,NA,"0.1.4"
"18992","646",2023-03-17 19:45:00,985,1006,21,0,TRUE,NA,"0.1.4"
"18993","646",2023-03-17 20:00:00,985,1006,21,0,TRUE,NA,"0.1.4"
"18994","646",2023-03-17 20:15:00,985,1006,21,0,TRUE,NA,"0.1.4"
"18995","646",2023-03-17 20:30:00,985,1006,21,0,TRUE,NA,"0.1.4"
"18996","646",2023-03-17 20:45:00,985,1006,21,0,TRUE,NA,"0.1.4"
"18997","646",2023-03-17 21:00:00,985,1006,21,0,TRUE,NA,"0.1.4"
"18998","646",2023-03-17 21:15:00,985,1006,21,0,FALSE,NA,"0.1.4"
"18999","646",2023-03-17 21:30:00,985,1006,21,0,FALSE,NA,"0.1.4"
"19000","646",2023-03-17 21:45:00,985,1006,21,0,FALSE,NA,"0.1.4"
"19001","646",2023-03-17 22:00:00,985,1006,21,0,TRUE,NA,"0.1.4"
"19002","646",2023-03-17 22:15:00,985,1006,21,0,TRUE,NA,"0.1.4"
"19003","646",2023-03-17 22:30:00,985,1006,21,0,FALSE,NA,"0.1.4"
"19004","646",2023-03-17 22:45:00,985,1006,21,0,FALSE,NA,"0.1.4"
"19005","646",2023-03-17 23:00:00,985,1006,21,0,TRUE,NA,"0.1.4"
"19006","646",2023-03-17 23:15:00,985,1006,21,0,TRUE,NA,"0.1.4"
"19007","646",2023-03-17 23:30:00,985,1006,21,0,TRUE,NA,"0.1.4"
"19008","646",2023-03-17 23:45:00,985,1006,21,0,TRUE,NA,"0.1.4"
"19009","646",2023-03-18,985,1006,21,0,TRUE,NA,"0.1.4"
"19010","646",2023-03-18 00:15:00,985,1006,21,0,TRUE,NA,"0.1.4"
"19011","646",2023-03-18 00:30:00,985,1006,21,0,TRUE,NA,"0.1.4"
"19012","646",2023-03-18 00:45:00,985,1006,21,0,TRUE,NA,"0.1.4"
"19013","646",2023-03-18 01:00:00,985,1006,21,0,TRUE,NA,"0.1.4"
"19014","646",2023-03-18 01:15:00,985,1006,21,0,TRUE,NA,"0.1.4"
"19015","646",2023-03-18 01:30:00,985,1006,21,0,TRUE,NA,"0.1.4"
"19016","646",2023-03-18 01:45:00,985,1006,21,0,TRUE,NA,"0.1.4"
"19017","646",2023-03-18 02:00:00,985,1006,21,0,TRUE,NA,"0.1.4"
"19018","646",2023-03-18 02:15:00,985,1006,21,0,TRUE,NA,"0.1.4"
"19019","646",2023-03-18 02:30:00,985,1006,21,0,TRUE,NA,"0.1.4"
"19020","646",2023-03-18 02:45:00,985,1006,21,0,TRUE,NA,"0.1.4"
"19021","646",2023-03-18 03:00:00,985,1006,21,0,TRUE,NA,"0.1.4"
"19022","646",2023-03-18 03:15:00,985,1006,21,0,TRUE,NA,"0.1.4"
"19023","646",2023-03-18 03:30:00,985,1006,21,0,TRUE,NA,"0.1.4"
"19024","646",2023-03-18 03:45:00,985,1006,21,0,TRUE,NA,"0.1.4"
"19025","646",2023-03-18 04:00:00,985,1006,21,0,TRUE,NA,"0.1.4"
"19026","646",2023-03-18 04:15:00,985,1006,21,0,TRUE,NA,"0.1.4"
"19027","646",2023-03-18 04:30:00,985,1006,21,0,TRUE,NA,"0.1.4"
"19028","646",2023-03-18 04:45:00,985,1006,21,0,TRUE,NA,"0.1.4"
"19029","646",2023-03-18 05:00:00,985,1006,21,0,TRUE,NA,"0.1.4"
"19030","646",2023-03-18 05:15:00,985,1006,21,0,TRUE,NA,"0.1.4"
"19031","646",2023-03-18 05:30:00,985,1006,21,0,TRUE,NA,"0.1.4"
"19032","646",2023-03-18 05:45:00,985,1006,21,0,TRUE,NA,"0.1.4"
"19033","646",2023-03-18 06:00:00,985,1006,21,0,TRUE,NA,"0.1.4"
"19034","646",2023-03-18 06:15:00,985,1006,21,0,TRUE,NA,"0.1.4"
"19035","646",2023-03-18 06:30:00,985,1006,21,0,TRUE,NA,"0.1.4"
"19036","646",2023-03-18 06:45:00,985,1006,21,0,TRUE,NA,"0.1.4"
"19037","646",2023-03-18 07:00:00,985,1006,21,0,TRUE,NA,"0.1.4"
"19038","646",2023-03-18 07:15:00,985,1006,21,0,TRUE,NA,"0.1.4"
"19039","646",2023-03-18 07:30:00,985,1006,21,0,TRUE,NA,"0.1.4"
"19040","646",2023-03-18 07:45:00,985,1006,21,0,TRUE,NA,"0.1.4"
"19041","646",2023-03-18 08:00:00,985,1006,21,0,TRUE,NA,"0.1.4"
"19042","646",2023-03-18 08:15:00,985,1006,21,0,TRUE,NA,"0.1.4"
"19043","646",2023-03-18 08:30:00,985,1006,21,0,TRUE,NA,"0.1.4"
"19044","646",2023-03-18 08:45:00,985,1006,21,0,TRUE,NA,"0.1.4"
"19045","646",2023-03-18 09:00:00,985,1006,21,0,TRUE,NA,"0.1.4"
"19046","646",2023-03-18 09:15:00,985,1006,21,0,TRUE,NA,"0.1.4"
"19047","646",2023-03-18 09:30:00,985,1006,21,0,TRUE,NA,"0.1.4"
"19048","646",2023-03-18 09:45:00,985,1006,21,0,TRUE,NA,"0.1.4"
"19049","646",2023-03-18 10:00:00,985,1006,21,0,TRUE,NA,"0.1.4"
"19050","646",2023-03-18 10:15:00,985,1006,21,0,TRUE,NA,"0.1.4"
"19051","646",2023-03-18 10:30:00,985,1006,21,0,TRUE,NA,"0.1.4"
"19052","646",2023-03-18 10:45:00,985,1006,21,0,TRUE,NA,"0.1.4"
"19053","646",2023-03-18 11:00:00,985,1006,21,0,TRUE,NA,"0.1.4"
"19054","646",2023-03-18 11:15:00,985,1006,21,0,TRUE,NA,"0.1.4"
"19055","646",2023-03-18 11:30:00,985,1006,21,0,TRUE,NA,"0.1.4"
"19056","646",2023-03-18 11:45:00,985,1006,21,0,TRUE,NA,"0.1.4"
"19057","646",2023-03-18 12:00:00,985,1006,21,0,TRUE,NA,"0.1.4"
"19058","646",2023-03-18 12:15:00,985,1006,21,0,TRUE,NA,"0.1.4"
"19059","646",2023-03-18 12:30:00,985,1006,21,0,TRUE,NA,"0.1.4"
"19060","646",2023-03-18 12:45:00,985,1006,21,0,TRUE,NA,"0.1.4"
"19061","646",2023-03-18 13:00:00,985,1006,21,0,TRUE,NA,"0.1.4"
"19062","646",2023-03-18 13:15:00,985,1006,21,0,TRUE,NA,"0.1.4"
"19063","646",2023-03-18 13:30:00,985,1006,21,0,TRUE,NA,"0.1.4"
"19064","646",2023-03-18 13:45:00,985,1006,21,0,TRUE,NA,"0.1.4"
"19065","646",2023-03-18 14:00:00,985,1006,21,0,TRUE,NA,"0.1.4"
"19066","646",2023-03-18 14:15:00,985,1006,21,0,TRUE,NA,"0.1.4"
"19067","646",2023-03-18 14:30:00,985,1006,21,0,TRUE,NA,"0.1.4"
"19068","646",2023-03-18 14:45:00,985,1006,21,0,TRUE,NA,"0.1.4"
"19069","646",2023-03-18 15:00:00,985,1006,21,0,TRUE,NA,"0.1.4"
"19070","646",2023-03-18 15:15:00,985,1006,21,0,TRUE,NA,"0.1.4"
"19071","646",2023-03-18 15:30:00,985,1006,21,0,TRUE,NA,"0.1.4"
"19072","646",2023-03-18 15:45:00,985,1006,21,0,TRUE,NA,"0.1.4"
"19073","646",2023-03-18 16:00:00,985,1006,21,0,TRUE,NA,"0.1.4"
"19074","646",2023-03-18 16:15:00,985,1006,21,0,TRUE,NA,"0.1.4"
"19075","646",2023-03-18 16:30:00,985,1006,21,0,TRUE,NA,"0.1.4"
"19076","646",2023-03-18 16:45:00,985,1006,21,0,TRUE,NA,"0.1.4"
"19077","646",2023-03-18 17:00:00,985,1006,21,0,TRUE,NA,"0.1.4"
"19078","646",2023-03-18 17:15:00,985,1006,21,0,TRUE,NA,"0.1.4"
"19079","646",2023-03-18 17:30:00,985,1006,21,0,TRUE,NA,"0.1.4"
"19080","646",2023-03-18 17:45:00,985,1006,21,0,TRUE,NA,"0.1.4"
"19081","646",2023-03-18 18:00:00,985,1006,21,0,TRUE,NA,"0.1.4"
"19082","646",2023-03-18 18:15:00,985,1006,21,0,TRUE,NA,"0.1.4"
"19083","646",2023-03-18 18:30:00,985,1006,21,0,TRUE,NA,"0.1.4"
"19084","646",2023-03-18 18:45:00,985,1006,21,0,TRUE,NA,"0.1.4"
"19085","646",2023-03-18 19:00:00,985,1006,21,0,TRUE,NA,"0.1.4"
"19086","646",2023-03-18 19:15:00,985,1006,21,0,TRUE,NA,"0.1.4"
"19087","646",2023-03-18 19:30:00,985,1006,21,0,TRUE,NA,"0.1.4"
"19088","646",2023-03-18 19:45:00,985,1006,21,0,FALSE,NA,"0.1.4"
"19089","646",2023-03-18 20:00:00,985,1006,21,0,FALSE,NA,"0.1.4"
"19090","646",2023-03-18 20:15:00,985,1006,21,0,FALSE,NA,"0.1.4"
"19091","646",2023-03-18 20:30:00,984,1006,22,0,FALSE,NA,"0.1.4"
"19092","646",2023-03-18 20:45:00,985,1006,21,0,FALSE,NA,"0.1.4"
"19093","646",2023-03-18 21:00:00,985,1006,21,0,FALSE,NA,"0.1.4"
"19094","646",2023-03-18 21:15:00,985,1006,21,0,FALSE,NA,"0.1.4"
"19095","646",2023-03-18 21:30:00,985,1006,21,0,FALSE,NA,"0.1.4"
"19096","646",2023-03-18 21:45:00,985,1006,21,0,FALSE,NA,"0.1.4"
"19097","646",2023-03-18 22:00:00,985,1006,21,0,FALSE,NA,"0.1.4"
"19098","646",2023-03-18 22:15:00,985,1006,21,0,FALSE,NA,"0.1.4"
"19099","646",2023-03-18 22:30:00,985,1006,21,0,FALSE,NA,"0.1.4"
"19100","646",2023-03-18 22:45:00,984,1006,22,0,FALSE,NA,"0.1.4"
"19101","646",2023-03-18 23:00:00,984,1006,22,0,FALSE,NA,"0.1.4"
"19102","646",2023-03-18 23:15:00,984,1006,22,0,FALSE,NA,"0.1.4"
"19103","646",2023-03-18 23:30:00,984,1006,22,0,FALSE,NA,"0.1.4"
"19104","646",2023-03-18 23:45:00,984,1006,22,0,FALSE,NA,"0.1.4"
"19105","646",2023-03-19,984,1006,22,0,FALSE,NA,"0.1.4"
"19106","646",2023-03-19 00:15:00,984,1006,22,0,FALSE,NA,"0.1.4"
"19107","646",2023-03-19 00:30:00,984,1006,22,0,FALSE,NA,"0.1.4"
"19108","646",2023-03-19 00:45:00,984,1006,22,0,TRUE,NA,"0.1.4"
"19109","646",2023-03-19 01:00:00,984,1006,22,0,TRUE,NA,"0.1.4"
"19110","646",2023-03-19 01:15:00,984,1006,22,0,TRUE,NA,"0.1.4"
"19111","646",2023-03-19 01:30:00,984,1006,22,0,TRUE,NA,"0.1.4"
"19112","646",2023-03-19 01:45:00,984,1006,22,0,TRUE,NA,"0.1.4"
"19113","646",2023-03-19 02:00:00,984,1006,22,0,TRUE,NA,"0.1.4"
"19114","646",2023-03-19 02:15:00,984,1006,22,0,TRUE,NA,"0.1.4"
"19115","646",2023-03-19 02:30:00,984,1006,22,0,TRUE,NA,"0.1.4"
"19116","646",2023-03-19 02:45:00,984,1006,22,0,TRUE,NA,"0.1.4"
"19117","646",2023-03-19 03:00:00,984,1006,22,0,TRUE,NA,"0.1.4"
"19118","646",2023-03-19 03:15:00,984,1006,22,0,TRUE,NA,"0.1.4"
"19119","646",2023-03-19 03:30:00,984,1006,22,0,TRUE,NA,"0.1.4"
"19120","646",2023-03-19 03:45:00,984,1006,22,0,TRUE,NA,"0.1.4"
"19121","646",2023-03-19 04:00:00,984,1006,22,0,TRUE,NA,"0.1.4"
"19122","646",2023-03-19 04:15:00,984,1006,22,0,TRUE,NA,"0.1.4"
"19123","646",2023-03-19 04:30:00,984,1006,22,0,TRUE,NA,"0.1.4"
"19124","646",2023-03-19 04:45:00,984,1006,22,0,TRUE,NA,"0.1.4"
"19125","646",2023-03-19 05:00:00,984,1006,22,0,TRUE,NA,"0.1.4"
"19126","646",2023-03-19 05:15:00,984,1006,22,0,TRUE,NA,"0.1.4"
"19127","646",2023-03-19 05:30:00,984,1006,22,0,TRUE,NA,"0.1.4"
"19128","646",2023-03-19 05:45:00,984,1006,22,0,TRUE,NA,"0.1.4"
"19129","646",2023-03-19 06:00:00,984,1006,22,0,TRUE,NA,"0.1.4"
"19130","646",2023-03-19 06:15:00,984,1006,22,0,TRUE,NA,"0.1.4"
"19131","646",2023-03-19 06:30:00,984,1006,22,0,TRUE,NA,"0.1.4"
"19132","646",2023-03-19 06:45:00,984,1006,22,0,TRUE,NA,"0.1.4"
"19133","646",2023-03-19 07:00:00,984,1006,22,0,TRUE,NA,"0.1.4"
"19134","646",2023-03-19 07:15:00,984,1006,22,0,TRUE,NA,"0.1.4"
"19135","646",2023-03-19 07:30:00,984,1006,22,0,TRUE,NA,"0.1.4"
"19136","646",2023-03-19 07:45:00,984,1006,22,0,TRUE,NA,"0.1.4"
"19137","646",2023-03-19 08:00:00,984,1006,22,0,TRUE,NA,"0.1.4"
"19138","646",2023-03-19 08:15:00,984,1006,22,0,TRUE,NA,"0.1.4"
"19139","646",2023-03-19 08:30:00,984,1006,22,0,TRUE,NA,"0.1.4"
"19140","646",2023-03-19 08:45:00,984,1006,22,0,TRUE,NA,"0.1.4"
"19141","646",2023-03-19 09:00:00,984,1006,22,0,TRUE,NA,"0.1.4"
"19142","646",2023-03-19 09:15:00,984,1006,22,0,TRUE,NA,"0.1.4"
"19143","646",2023-03-19 09:30:00,984,1006,22,0,TRUE,NA,"0.1.4"
"19144","646",2023-03-19 09:45:00,984,1006,22,0,TRUE,NA,"0.1.4"
"19145","646",2023-03-19 10:00:00,984,1006,22,0,TRUE,NA,"0.1.4"
"19146","646",2023-03-19 10:15:00,984,1006,22,0,TRUE,NA,"0.1.4"
"19147","646",2023-03-19 10:30:00,984,1006,22,0,TRUE,NA,"0.1.4"
"19148","646",2023-03-19 10:45:00,984,1006,22,0,TRUE,NA,"0.1.4"
"19149","646",2023-03-19 11:00:00,984,1006,22,0,TRUE,NA,"0.1.4"
"19150","646",2023-03-19 11:15:00,984,1006,22,0,TRUE,NA,"0.1.4"
"19151","646",2023-03-19 11:30:00,984,1006,22,0,TRUE,NA,"0.1.4"
"19152","646",2023-03-19 11:45:00,984,1006,22,0,TRUE,NA,"0.1.4"
"19153","646",2023-03-19 12:00:00,984,1006,22,0,TRUE,NA,"0.1.4"
"19154","646",2023-03-19 12:15:00,984,1006,22,0,TRUE,NA,"0.1.4"
"19155","646",2023-03-19 12:30:00,984,1006,22,0,TRUE,NA,"0.1.4"
"19156","646",2023-03-19 12:45:00,984,1006,22,0,TRUE,NA,"0.1.4"
"19157","646",2023-03-19 13:00:00,984,1006,22,0,TRUE,NA,"0.1.4"
"19158","646",2023-03-19 13:15:00,984,1006,22,0,TRUE,NA,"0.1.4"
"19159","646",2023-03-19 13:30:00,984,1006,22,0,TRUE,NA,"0.1.4"
"19160","646",2023-03-19 13:45:00,984,1006,22,0,TRUE,NA,"0.1.4"
"19161","646",2023-03-19 14:00:00,984,1006,22,0,TRUE,NA,"0.1.4"
"19162","646",2023-03-19 14:15:00,984,1006,22,0,TRUE,NA,"0.1.4"
"19163","646",2023-03-19 14:30:00,984,1006,22,0,TRUE,NA,"0.1.4"
"19164","646",2023-03-19 14:45:00,984,1006,22,0,TRUE,NA,"0.1.4"
"19165","646",2023-03-19 15:00:00,984,1006,22,0,TRUE,NA,"0.1.4"
"19166","646",2023-03-19 15:15:00,984,1006,22,0,TRUE,NA,"0.1.4"
"19167","646",2023-03-19 15:30:00,984,1006,22,0,TRUE,NA,"0.1.4"
"19168","646",2023-03-19 15:45:00,984,1006,22,0,TRUE,NA,"0.1.4"
"19169","646",2023-03-19 16:00:00,984,1006,22,0,TRUE,NA,"0.1.4"
"19170","646",2023-03-19 16:15:00,984,1006,22,0,TRUE,NA,"0.1.4"
"19171","646",2023-03-19 16:30:00,984,1006,22,0,TRUE,NA,"0.1.4"
"19172","646",2023-03-19 16:45:00,984,1006,22,0,TRUE,NA,"0.1.4"
"19173","646",2023-03-19 17:00:00,984,1006,22,0,TRUE,NA,"0.1.4"
"19174","646",2023-03-19 17:15:00,984,1006,22,0,TRUE,NA,"0.1.4"
"19175","646",2023-03-19 17:30:00,984,1006,22,0,TRUE,NA,"0.1.4"
"19176","646",2023-03-19 17:45:00,984,1006,22,0,TRUE,NA,"0.1.4"
"19177","646",2023-03-19 18:00:00,984,1006,22,0,TRUE,NA,"0.1.4"
"19178","646",2023-03-19 18:15:00,984,1006,22,0,TRUE,NA,"0.1.4"
"19179","646",2023-03-19 18:30:00,984,1006,22,0,TRUE,NA,"0.1.4"
"19180","646",2023-03-19 18:45:00,984,1006,22,0,TRUE,NA,"0.1.4"
"19181","646",2023-03-19 19:00:00,984,1006,22,0,TRUE,NA,"0.1.4"
"19182","646",2023-03-19 19:15:00,984,1006,22,0,TRUE,NA,"0.1.4"
"19183","646",2023-03-19 19:30:00,984,1006,22,0,TRUE,NA,"0.1.4"
"19184","646",2023-03-19 19:45:00,984,1006,22,0,TRUE,NA,"0.1.4"
"19185","646",2023-03-19 20:00:00,984,1006,22,0,TRUE,NA,"0.1.4"
"19186","646",2023-03-19 20:15:00,984,1006,22,0,TRUE,NA,"0.1.4"
"19187","646",2023-03-19 20:30:00,984,1006,22,0,TRUE,NA,"0.1.4"
"19188","646",2023-03-19 20:45:00,984,1006,22,0,TRUE,NA,"0.1.4"
"19189","646",2023-03-19 21:00:00,984,1006,22,0,TRUE,NA,"0.1.4"
"19190","646",2023-03-19 21:15:00,984,1006,22,0,TRUE,NA,"0.1.4"
"19191","646",2023-03-19 21:30:00,984,1006,22,0,TRUE,NA,"0.1.4"
"19192","646",2023-03-19 21:45:00,984,1006,22,0,TRUE,NA,"0.1.4"
"19193","646",2023-03-19 22:00:00,984,1006,22,0,TRUE,NA,"0.1.4"
"19194","646",2023-03-19 22:15:00,984,1006,22,0,TRUE,NA,"0.1.4"
"19195","646",2023-03-19 22:30:00,984,1006,22,0,TRUE,NA,"0.1.4"
"19196","646",2023-03-19 22:45:00,984,1006,22,0,TRUE,NA,"0.1.4"
"19197","646",2023-03-19 23:00:00,984,1006,22,0,TRUE,NA,"0.1.4"
"19198","646",2023-03-19 23:15:00,984,1006,22,0,TRUE,NA,"0.1.4"
"19199","646",2023-03-19 23:30:00,984,1006,22,0,TRUE,NA,"0.1.4"
"19200","646",2023-03-19 23:45:00,984,1006,22,0,TRUE,NA,"0.1.4"
"19201","646",2023-03-20,984,1006,22,0,TRUE,NA,"0.1.4"
"19202","646",2023-03-20 00:15:00,984,1006,22,0,TRUE,NA,"0.1.4"
"19203","646",2023-03-20 00:30:00,984,1006,22,0,TRUE,NA,"0.1.4"
"19204","646",2023-03-20 00:45:00,984,1006,22,0,TRUE,NA,"0.1.4"
"19205","646",2023-03-20 01:00:00,984,1006,22,0,TRUE,NA,"0.1.4"
"19206","646",2023-03-20 01:15:00,984,1006,22,0,TRUE,NA,"0.1.4"
"19207","646",2023-03-20 01:30:00,984,1006,22,0,TRUE,NA,"0.1.4"
"19208","646",2023-03-20 01:45:00,984,1006,22,0,TRUE,NA,"0.1.4"
"19209","646",2023-03-20 02:00:00,984,1006,22,0,TRUE,NA,"0.1.4"
"19210","646",2023-03-20 02:15:00,984,1006,22,0,TRUE,NA,"0.1.4"
"19211","646",2023-03-20 02:30:00,984,1006,22,0,TRUE,NA,"0.1.4"
"19212","646",2023-03-20 02:45:00,984,1006,22,0,TRUE,NA,"0.1.4"
"19213","646",2023-03-20 03:00:00,984,1006,22,0,TRUE,NA,"0.1.4"
"19214","646",2023-03-20 03:15:00,984,1006,22,0,TRUE,NA,"0.1.4"
"19215","646",2023-03-20 03:30:00,984,1006,22,0,TRUE,NA,"0.1.4"
"19216","646",2023-03-20 03:45:00,984,1006,22,0,TRUE,NA,"0.1.4"
"19217","646",2023-03-20 04:00:00,984,1006,22,0,TRUE,NA,"0.1.4"
"19218","646",2023-03-20 04:15:00,984,1006,22,0,TRUE,NA,"0.1.4"
"19219","646",2023-03-20 04:30:00,984,1006,22,0,TRUE,NA,"0.1.4"
"19220","646",2023-03-20 04:45:00,984,1006,22,0,TRUE,NA,"0.1.4"
"19221","646",2023-03-20 05:00:00,984,1006,22,0,TRUE,NA,"0.1.4"
"19222","646",2023-03-20 05:15:00,984,1006,22,0,TRUE,NA,"0.1.4"
"19223","646",2023-03-20 05:30:00,984,1006,22,0,TRUE,NA,"0.1.4"
"19224","646",2023-03-20 05:45:00,984,1006,22,0,TRUE,NA,"0.1.4"
"19225","646",2023-03-20 06:00:00,984,1006,22,0,TRUE,NA,"0.1.4"
"19226","646",2023-03-20 06:15:00,984,1006,22,0,TRUE,NA,"0.1.4"
"19227","646",2023-03-20 06:30:00,984,1006,22,0,TRUE,NA,"0.1.4"
"19228","646",2023-03-20 06:45:00,984,1006,22,0,TRUE,NA,"0.1.4"
"19229","646",2023-03-20 07:00:00,984,1006,22,0,TRUE,NA,"0.1.4"
"19230","646",2023-03-20 07:15:00,984,1006,22,0,TRUE,NA,"0.1.4"
"19231","646",2023-03-20 07:30:00,984,1006,22,0,TRUE,NA,"0.1.4"
"19232","646",2023-03-20 07:45:00,984,1006,22,0,TRUE,NA,"0.1.4"
"19233","646",2023-03-20 08:00:00,984,1006,22,0,TRUE,NA,"0.1.4"
"19234","646",2023-03-20 08:15:00,984,1006,22,0,TRUE,NA,"0.1.4"
"19235","646",2023-03-20 08:30:00,984,1006,22,0,TRUE,NA,"0.1.4"
"19236","646",2023-03-20 08:45:00,984,1006,22,0,TRUE,NA,"0.1.4"
"19237","646",2023-03-20 09:00:00,984,1006,22,0,TRUE,NA,"0.1.4"
"19238","646",2023-03-20 09:15:00,984,1006,22,0,TRUE,NA,"0.1.4"
"19239","646",2023-03-20 09:30:00,984,1006,22,0,TRUE,NA,"0.1.4"
"19240","646",2023-03-20 09:45:00,984,1006,22,0,TRUE,NA,"0.1.4"
"19241","646",2023-03-20 10:00:00,984,1006,22,0,TRUE,NA,"0.1.4"
"19242","646",2023-03-20 10:15:00,984,1006,22,0,TRUE,NA,"0.1.4"
"19243","646",2023-03-20 10:30:00,984,1006,22,0,TRUE,NA,"0.1.4"
"19244","646",2023-03-20 10:45:00,984,1006,22,0,TRUE,NA,"0.1.4"
"19245","646",2023-03-20 11:00:00,984,1006,22,0,TRUE,NA,"0.1.4"
"19246","646",2023-03-20 11:15:00,984,1006,22,0,TRUE,NA,"0.1.4"
"19247","646",2023-03-20 11:30:00,984,1006,22,0,TRUE,NA,"0.1.4"
"19248","646",2023-03-20 11:45:00,984,1006,22,0,TRUE,NA,"0.1.4"
"19249","646",2023-03-20 12:00:00,984,1006,22,0,TRUE,NA,"0.1.4"
"19250","646",2023-03-20 12:15:00,984,1006,22,0,TRUE,NA,"0.1.4"
"19251","646",2023-03-20 12:30:00,984,1006,22,0,TRUE,NA,"0.1.4"
"19252","646",2023-03-20 12:45:00,984,1006,22,0,TRUE,NA,"0.1.4"
"19253","646",2023-03-20 13:00:00,984,1006,22,0,TRUE,NA,"0.1.4"
"19254","646",2023-03-20 13:15:00,984,1006,22,0,TRUE,NA,"0.1.4"
"19255","646",2023-03-20 13:30:00,984,1006,22,0,TRUE,NA,"0.1.4"
"19256","646",2023-03-20 13:45:00,984,1006,22,0,TRUE,NA,"0.1.4"
"19257","646",2023-03-20 14:00:00,984,1006,22,0,TRUE,NA,"0.1.4"
"19258","646",2023-03-20 14:15:00,984,1006,22,0,TRUE,NA,"0.1.4"
"19259","646",2023-03-20 14:30:00,984,1006,22,0,TRUE,NA,"0.1.4"
"19260","646",2023-03-20 14:45:00,984,1006,22,0,TRUE,NA,"0.1.4"
"19261","646",2023-03-20 15:00:00,984,1006,22,0,TRUE,NA,"0.1.4"
"19262","646",2023-03-20 15:15:00,984,1006,22,0,TRUE,NA,"0.1.4"
"19263","646",2023-03-20 15:30:00,984,1006,22,0,TRUE,NA,"0.1.4"
"19264","646",2023-03-20 15:45:00,984,1006,22,0,TRUE,NA,"0.1.4"
"19265","646",2023-03-20 16:00:00,984,1006,22,0,TRUE,NA,"0.1.4"
"19266","646",2023-03-20 16:15:00,984,1006,22,0,TRUE,NA,"0.1.4"
"19267","646",2023-03-20 16:30:00,984,1006,22,0,TRUE,NA,"0.1.4"
"19268","646",2023-03-20 16:45:00,984,1006,22,0,TRUE,NA,"0.1.4"
"19269","646",2023-03-20 17:00:00,984,1006,22,0,TRUE,NA,"0.1.4"
"19270","646",2023-03-20 17:15:00,984,1006,22,0,TRUE,NA,"0.1.4"
"19271","646",2023-03-20 17:30:00,984,1006,22,0,TRUE,NA,"0.1.4"
"19272","646",2023-03-20 17:45:00,984,1006,22,0,TRUE,NA,"0.1.4"
"19273","646",2023-03-20 18:00:00,984,1006,22,0,TRUE,NA,"0.1.4"
"19274","646",2023-03-20 18:15:00,984,1006,22,0,TRUE,NA,"0.1.4"
"19275","646",2023-03-20 18:30:00,984,1006,22,0,TRUE,NA,"0.1.4"
"19276","646",2023-03-20 18:45:00,984,1006,22,0,TRUE,NA,"0.1.4"
"19277","646",2023-03-20 19:00:00,984,1006,22,0,TRUE,NA,"0.1.4"
"19278","646",2023-03-20 19:15:00,984,1006,22,0,TRUE,NA,"0.1.4"
"19279","646",2023-03-20 19:30:00,984,1006,22,0,TRUE,NA,"0.1.4"
"19280","646",2023-03-20 19:45:00,984,1006,22,0,TRUE,NA,"0.1.4"
"19281","646",2023-03-20 20:00:00,984,1006,22,0,TRUE,NA,"0.1.4"
"19282","646",2023-03-20 20:15:00,984,1006,22,0,TRUE,NA,"0.1.4"
"19283","646",2023-03-20 20:30:00,984,1006,22,0,TRUE,NA,"0.1.4"
"19284","646",2023-03-20 20:45:00,984,1006,22,0,TRUE,NA,"0.1.4"
"19285","646",2023-03-20 21:00:00,984,1006,22,0,TRUE,NA,"0.1.4"
"19286","646",2023-03-20 21:15:00,984,1006,22,0,TRUE,NA,"0.1.4"
"19287","646",2023-03-20 21:30:00,984,1006,22,0,TRUE,NA,"0.1.4"
"19288","646",2023-03-20 21:45:00,984,1006,22,0,TRUE,NA,"0.1.4"
"19289","646",2023-03-20 22:00:00,984,1006,22,0,TRUE,NA,"0.1.4"
"19290","646",2023-03-20 22:15:00,984,1006,22,0,TRUE,NA,"0.1.4"
"19291","646",2023-03-20 22:30:00,984,1006,22,0,TRUE,NA,"0.1.4"
"19292","646",2023-03-20 22:45:00,984,1006,22,0,TRUE,NA,"0.1.4"
"19293","646",2023-03-20 23:00:00,984,1006,22,0,TRUE,NA,"0.1.4"
"19294","646",2023-03-20 23:15:00,984,1006,22,0,FALSE,NA,"0.1.4"
"19295","646",2023-03-20 23:30:00,984,1006,22,0,TRUE,NA,"0.1.4"
"19296","646",2023-03-20 23:45:00,984,1006,22,0,FALSE,NA,"0.1.4"
"19297","646",2023-03-21,984,1006,22,0,FALSE,NA,"0.1.4"
"19298","646",2023-03-21 00:15:00,984,1006,22,0,FALSE,NA,"0.1.4"
"19299","646",2023-03-21 00:30:00,984,1006,22,0,FALSE,NA,"0.1.4"
"19300","646",2023-03-21 00:45:00,984,1006,22,0,FALSE,NA,"0.1.4"
"19301","646",2023-03-21 01:00:00,984,1006,22,0,TRUE,NA,"0.1.4"
"19302","646",2023-03-21 01:15:00,984,1006,22,0,TRUE,NA,"0.1.4"
"19303","646",2023-03-21 01:30:00,984,1006,22,0,TRUE,NA,"0.1.4"
"19304","646",2023-03-21 01:45:00,984,1006,22,0,TRUE,NA,"0.1.4"
"19305","646",2023-03-21 02:00:00,984,1006,22,0,TRUE,NA,"0.1.4"
"19306","646",2023-03-21 02:15:00,984,1006,22,0,TRUE,NA,"0.1.4"
"19307","646",2023-03-21 02:30:00,984,1006,22,0,TRUE,NA,"0.1.4"
"19308","646",2023-03-21 02:45:00,984,1006,22,0,TRUE,NA,"0.1.4"
"19309","646",2023-03-21 03:00:00,984,1006,22,0,TRUE,NA,"0.1.4"
"19310","646",2023-03-21 03:15:00,984,1006,22,0,TRUE,NA,"0.1.4"
"19311","646",2023-03-21 03:30:00,984,1006,22,0,TRUE,NA,"0.1.4"
"19312","646",2023-03-21 03:45:00,984,1006,22,0,TRUE,NA,"0.1.4"
"19313","646",2023-03-21 04:00:00,984,1006,22,0,TRUE,NA,"0.1.4"
"19314","646",2023-03-21 04:15:00,984,1006,22,0,TRUE,NA,"0.1.4"
"19315","646",2023-03-21 04:30:00,984,1006,22,0,TRUE,NA,"0.1.4"
"19316","646",2023-03-21 04:45:00,984,1006,22,0,TRUE,NA,"0.1.4"
"19317","646",2023-03-21 05:00:00,984,1006,22,0,TRUE,NA,"0.1.4"
"19318","646",2023-03-21 05:15:00,984,1006,22,0,TRUE,NA,"0.1.4"
"19319","646",2023-03-21 05:30:00,984,1006,22,0,TRUE,NA,"0.1.4"
"19320","646",2023-03-21 05:45:00,984,1006,22,0,TRUE,NA,"0.1.4"
"19321","646",2023-03-21 06:00:00,984,1006,22,0,TRUE,NA,"0.1.4"
"19322","646",2023-03-21 06:15:00,984,1006,22,0,TRUE,NA,"0.1.4"
"19323","646",2023-03-21 06:30:00,984,1006,22,0,TRUE,NA,"0.1.4"
"19324","646",2023-03-21 06:45:00,984,1006,22,0,TRUE,NA,"0.1.4"
"19325","646",2023-03-21 07:00:00,984,1006,22,0,TRUE,NA,"0.1.4"
"19326","646",2023-03-21 07:15:00,984,1006,22,0,TRUE,NA,"0.1.4"
"19327","646",2023-03-21 07:30:00,984,1006,22,0,TRUE,NA,"0.1.4"
"19328","646",2023-03-21 07:45:00,984,1006,22,0,TRUE,NA,"0.1.4"
"19329","646",2023-03-21 08:00:00,984,1006,22,0,TRUE,NA,"0.1.4"
"19330","646",2023-03-21 08:15:00,984,1006,22,0,TRUE,NA,"0.1.4"
"19331","646",2023-03-21 08:30:00,984,1006,22,0,TRUE,NA,"0.1.4"
"19332","646",2023-03-21 08:45:00,984,1006,22,0,TRUE,NA,"0.1.4"
"19333","646",2023-03-21 09:00:00,984,1006,22,0,TRUE,NA,"0.1.4"
"19334","646",2023-03-21 09:15:00,984,1006,22,0,TRUE,NA,"0.1.4"
"19335","646",2023-03-21 09:30:00,984,1006,22,0,TRUE,NA,"0.1.4"
"19336","646",2023-03-21 09:45:00,984,1006,22,0,TRUE,NA,"0.1.4"
"19337","646",2023-03-21 10:00:00,984,1006,22,0,TRUE,NA,"0.1.4"
"19338","646",2023-03-21 10:15:00,984,1006,22,0,TRUE,NA,"0.1.4"
"19339","646",2023-03-21 10:30:00,984,1006,22,0,TRUE,NA,"0.1.4"
"19340","646",2023-03-21 10:45:00,984,1006,22,0,TRUE,NA,"0.1.4"
"19341","646",2023-03-21 11:00:00,984,1006,22,0,TRUE,NA,"0.1.4"
"19342","646",2023-03-21 11:15:00,984,1006,22,0,TRUE,NA,"0.1.4"
"19343","646",2023-03-21 11:30:00,984,1006,22,0,TRUE,NA,"0.1.4"
"19344","646",2023-03-21 11:45:00,984,1006,22,0,TRUE,NA,"0.1.4"
"19345","646",2023-03-21 12:00:00,984,1006,22,0,TRUE,NA,"0.1.4"
"19346","646",2023-03-21 12:15:00,984,1006,22,0,TRUE,NA,"0.1.4"
"19347","646",2023-03-21 12:30:00,984,1006,22,0,TRUE,NA,"0.1.4"
"19348","646",2023-03-21 12:45:00,984,1006,22,0,TRUE,NA,"0.1.4"
"19349","646",2023-03-21 13:00:00,984,1006,22,0,TRUE,NA,"0.1.4"
"19350","646",2023-03-21 13:15:00,984,1006,22,0,TRUE,NA,"0.1.4"
"19351","646",2023-03-21 13:30:00,984,1006,22,0,TRUE,NA,"0.1.4"
"19352","646",2023-03-21 13:45:00,984,1006,22,0,TRUE,NA,"0.1.4"
"19353","646",2023-03-21 14:00:00,984,1006,22,0,TRUE,NA,"0.1.4"
"19354","646",2023-03-21 14:15:00,984,1006,22,0,TRUE,NA,"0.1.4"
"19355","646",2023-03-21 14:30:00,984,1006,22,0,TRUE,NA,"0.1.4"
"19356","646",2023-03-21 14:45:00,984,1006,22,0,TRUE,NA,"0.1.4"
"19357","646",2023-03-21 15:00:00,984,1006,22,0,TRUE,NA,"0.1.4"
"19358","646",2023-03-21 15:15:00,984,1006,22,0,TRUE,NA,"0.1.4"
"19359","646",2023-03-21 15:30:00,984,1006,22,0,TRUE,NA,"0.1.4"
"19360","646",2023-03-21 15:45:00,984,1006,22,0,TRUE,NA,"0.1.4"
"19361","646",2023-03-21 16:00:00,984,1006,22,0,TRUE,NA,"0.1.4"
"19362","646",2023-03-21 16:15:00,984,1006,22,0,TRUE,NA,"0.1.4"
"19363","646",2023-03-21 16:30:00,984,1006,22,0,TRUE,NA,"0.1.4"
"19364","646",2023-03-21 16:45:00,984,1006,22,0,TRUE,NA,"0.1.4"
"19365","646",2023-03-21 17:00:00,984,1006,22,0,TRUE,NA,"0.1.4"
"19366","646",2023-03-21 17:15:00,984,1006,22,0,TRUE,NA,"0.1.4"
"19367","646",2023-03-21 17:30:00,984,1006,22,0,TRUE,NA,"0.1.4"
"19368","646",2023-03-21 17:45:00,984,1006,22,0,TRUE,NA,"0.1.4"
"19369","646",2023-03-21 18:00:00,984,1006,22,0,TRUE,NA,"0.1.4"
"19370","646",2023-03-21 18:15:00,984,1006,22,0,TRUE,NA,"0.1.4"
"19371","646",2023-03-21 18:30:00,984,1006,22,0,TRUE,NA,"0.1.4"
"19372","646",2023-03-21 18:45:00,984,1006,22,0,TRUE,NA,"0.1.4"
"19373","646",2023-03-21 19:00:00,984,1006,22,0,TRUE,NA,"0.1.4"
"19374","646",2023-03-21 19:15:00,984,1006,22,0,TRUE,NA,"0.1.4"
"19375","646",2023-03-21 19:30:00,984,1006,22,0,TRUE,NA,"0.1.4"
"19376","646",2023-03-21 19:45:00,984,1006,22,0,FALSE,NA,"0.1.4"
"19377","646",2023-03-21 20:00:00,984,1006,22,0,FALSE,NA,"0.1.4"
"19378","646",2023-03-21 20:15:00,984,1006,22,0,FALSE,NA,"0.1.4"
"19379","646",2023-03-21 20:30:00,984,1006,22,0,FALSE,NA,"0.1.4"
"19380","646",2023-03-21 20:45:00,984,1006,22,0,FALSE,NA,"0.1.4"
"19381","646",2023-03-21 21:00:00,984,1006,22,0,FALSE,NA,"0.1.4"
"19382","646",2023-03-21 21:15:00,984,1006,22,0,FALSE,NA,"0.1.4"
"19383","646",2023-03-21 21:30:00,984,1006,22,0,FALSE,NA,"0.1.4"
"19384","646",2023-03-21 21:45:00,984,1006,22,0,FALSE,NA,"0.1.4"
"19385","646",2023-03-21 22:00:00,984,1006,22,0,FALSE,NA,"0.1.4"
"19386","646",2023-03-21 22:15:00,984,1006,22,0,FALSE,NA,"0.1.4"
"19387","646",2023-03-21 22:30:00,984,1006,22,0,FALSE,NA,"0.1.4"
"19388","646",2023-03-21 22:45:00,984,1006,22,0,FALSE,NA,"0.1.4"
"19389","646",2023-03-21 23:00:00,984,1006,22,0,FALSE,NA,"0.1.4"
"19390","646",2023-03-21 23:15:00,984,1006,22,0,FALSE,NA,"0.1.4"
"19391","646",2023-03-21 23:30:00,984,1006,22,0,FALSE,NA,"0.1.4"
"19392","646",2023-03-21 23:45:00,984,1006,22,0,FALSE,NA,"0.1.4"
"19393","646",2023-03-22,984,1006,22,0,FALSE,NA,"0.1.4"
"19394","646",2023-03-22 00:15:00,984,1006,22,0,FALSE,NA,"0.1.4"
"19395","646",2023-03-22 00:30:00,984,1006,22,0,FALSE,NA,"0.1.4"
"19396","646",2023-03-22 00:45:00,984,1006,22,0,FALSE,NA,"0.1.4"
"19397","646",2023-03-22 01:00:00,984,1006,22,0,FALSE,NA,"0.1.4"
"19398","646",2023-03-22 01:15:00,984,1006,22,0,FALSE,NA,"0.1.4"
"19399","646",2023-03-22 01:30:00,984,1006,22,0,FALSE,NA,"0.1.4"
"19400","646",2023-03-22 01:45:00,984,1006,22,0,FALSE,NA,"0.1.4"
"19401","646",2023-03-22 02:00:00,984,1006,22,0,FALSE,NA,"0.1.4"
"19402","646",2023-03-22 02:15:00,984,1006,22,0,TRUE,NA,"0.1.4"
"19403","646",2023-03-22 02:30:00,984,1006,22,0,TRUE,NA,"0.1.4"
"19404","646",2023-03-22 02:45:00,984,1006,22,0,TRUE,NA,"0.1.4"
"19405","646",2023-03-22 03:00:00,984,1006,22,0,TRUE,NA,"0.1.4"
"19406","646",2023-03-22 03:15:00,984,1006,22,0,TRUE,NA,"0.1.4"
"19407","646",2023-03-22 03:30:00,984,1006,22,0,TRUE,NA,"0.1.4"
"19408","646",2023-03-22 03:45:00,984,1006,22,0,TRUE,NA,"0.1.4"
"19409","646",2023-03-22 04:00:00,984,1006,22,0,TRUE,NA,"0.1.4"
"19410","646",2023-03-22 04:15:00,984,1006,22,0,TRUE,NA,"0.1.4"
"19411","646",2023-03-22 04:30:00,984,1006,22,0,TRUE,NA,"0.1.4"
"19412","646",2023-03-22 04:45:00,984,1006,22,0,TRUE,NA,"0.1.4"
"19413","646",2023-03-22 05:00:00,984,1006,22,0,TRUE,NA,"0.1.4"
"19414","646",2023-03-22 05:15:00,984,1006,22,0,TRUE,NA,"0.1.4"
"19415","646",2023-03-22 05:30:00,984,1006,22,0,TRUE,NA,"0.1.4"
"19416","646",2023-03-22 05:45:00,984,1006,22,0,TRUE,NA,"0.1.4"
"19417","646",2023-03-22 06:00:00,984,1006,22,0,TRUE,NA,"0.1.4"
"19418","646",2023-03-22 06:15:00,984,1006,22,0,TRUE,NA,"0.1.4"
"19419","646",2023-03-22 06:30:00,984,1006,22,0,TRUE,NA,"0.1.4"
"19420","646",2023-03-22 06:45:00,984,1006,22,0,TRUE,NA,"0.1.4"
"19421","646",2023-03-22 07:00:00,984,1006,22,0,TRUE,NA,"0.1.4"
"19422","646",2023-03-22 07:15:00,984,1006,22,0,TRUE,NA,"0.1.4"
"19423","646",2023-03-22 07:30:00,984,1006,22,0,TRUE,NA,"0.1.4"
"19424","646",2023-03-22 07:45:00,984,1006,22,0,TRUE,NA,"0.1.4"
"19425","646",2023-03-22 08:00:00,984,1006,22,0,TRUE,NA,"0.1.4"
"19426","646",2023-03-22 08:15:00,984,1006,22,0,TRUE,NA,"0.1.4"
"19427","646",2023-03-22 08:30:00,984,1006,22,0,TRUE,NA,"0.1.4"
"19428","646",2023-03-22 08:45:00,984,1006,22,0,TRUE,NA,"0.1.4"
"19429","646",2023-03-22 09:00:00,984,1006,22,0,TRUE,NA,"0.1.4"
"19430","646",2023-03-22 09:15:00,984,1006,22,0,TRUE,NA,"0.1.4"
"19431","646",2023-03-22 09:30:00,984,1006,22,0,TRUE,NA,"0.1.4"
"19432","646",2023-03-22 09:45:00,984,1006,22,0,TRUE,NA,"0.1.4"
"19433","646",2023-03-22 10:00:00,984,1006,22,0,TRUE,NA,"0.1.4"
"19434","646",2023-03-22 10:15:00,984,1006,22,0,TRUE,NA,"0.1.4"
"19435","646",2023-03-22 10:30:00,984,1006,22,0,TRUE,NA,"0.1.4"
"19436","646",2023-03-22 10:45:00,984,1006,22,0,TRUE,NA,"0.1.4"
"19437","646",2023-03-22 11:00:00,984,1006,22,0,TRUE,NA,"0.1.4"
"19438","646",2023-03-22 11:15:00,984,1006,22,0,TRUE,NA,"0.1.4"
"19439","646",2023-03-22 11:30:00,984,1006,22,0,TRUE,NA,"0.1.4"
"19440","646",2023-03-22 11:45:00,984,1006,22,0,TRUE,NA,"0.1.4"
"19441","646",2023-03-22 12:00:00,984,1006,22,0,TRUE,NA,"0.1.4"
"19442","646",2023-03-22 12:15:00,984,1006,22,0,TRUE,NA,"0.1.4"
"19443","646",2023-03-22 12:30:00,984,1006,22,0,TRUE,NA,"0.1.4"
"19444","646",2023-03-22 12:45:00,984,1006,22,0,TRUE,NA,"0.1.4"
"19445","646",2023-03-22 13:00:00,984,1006,22,0,TRUE,NA,"0.1.4"
"19446","646",2023-03-22 13:15:00,984,1006,22,0,TRUE,NA,"0.1.4"
"19447","646",2023-03-22 13:30:00,984,1006,22,0,TRUE,NA,"0.1.4"
"19448","646",2023-03-22 13:45:00,984,1006,22,0,TRUE,NA,"0.1.4"
"19449","646",2023-03-22 14:00:00,984,1006,22,0,TRUE,NA,"0.1.4"
"19450","646",2023-03-22 14:15:00,984,1006,22,0,TRUE,NA,"0.1.4"
"19451","646",2023-03-22 14:30:00,984,1006,22,0,TRUE,NA,"0.1.4"
"19452","646",2023-03-22 14:45:00,984,1006,22,0,TRUE,NA,"0.1.4"
"19453","646",2023-03-22 15:00:00,984,1006,22,0,TRUE,NA,"0.1.4"
"19454","646",2023-03-22 15:15:00,984,1006,22,0,TRUE,NA,"0.1.4"
"19455","646",2023-03-22 15:30:00,984,1006,22,0,TRUE,NA,"0.1.4"
"19456","646",2023-03-22 15:45:00,984,1006,22,0,TRUE,NA,"0.1.4"
"19457","646",2023-03-22 16:00:00,984,1006,22,0,TRUE,NA,"0.1.4"
"19458","646",2023-03-22 16:15:00,984,1006,22,0,TRUE,NA,"0.1.4"
"19459","646",2023-03-22 16:30:00,984,1006,22,0,TRUE,NA,"0.1.4"
"19460","646",2023-03-22 16:45:00,984,1006,22,0,TRUE,NA,"0.1.4"
"19461","646",2023-03-22 17:00:00,984,1006,22,0,TRUE,NA,"0.1.4"
"19462","646",2023-03-22 17:15:00,984,1006,22,0,TRUE,NA,"0.1.4"
"19463","646",2023-03-22 17:30:00,984,1006,22,0,TRUE,NA,"0.1.4"
"19464","646",2023-03-22 17:45:00,984,1006,22,0,TRUE,NA,"0.1.4"
"19465","646",2023-03-22 18:00:00,984,1006,22,0,TRUE,NA,"0.1.4"
"19466","646",2023-03-22 18:15:00,984,1006,22,0,TRUE,NA,"0.1.4"
"19467","646",2023-03-22 18:30:00,984,1006,22,0,TRUE,NA,"0.1.4"
"19468","646",2023-03-22 18:45:00,984,1006,22,0,TRUE,NA,"0.1.4"
"19469","646",2023-03-22 19:00:00,984,1006,22,0,FALSE,NA,"0.1.4"
"19470","646",2023-03-22 19:15:00,984,1006,22,0,FALSE,NA,"0.1.4"
"19471","646",2023-03-22 19:30:00,984,1006,22,0,FALSE,NA,"0.1.4"
"19472","646",2023-03-22 19:45:00,984,1006,22,0,FALSE,NA,"0.1.4"
"19473","646",2023-03-22 20:00:00,984,1006,22,0,FALSE,NA,"0.1.4"
"19474","646",2023-03-22 20:15:00,984,1006,22,0,FALSE,NA,"0.1.4"
"19475","646",2023-03-22 20:30:00,984,1006,22,0,FALSE,NA,"0.1.4"
"19476","646",2023-03-22 20:45:00,984,1006,22,0,FALSE,NA,"0.1.4"
"19477","646",2023-03-22 21:00:00,984,1006,22,0,FALSE,NA,"0.1.4"
"19478","646",2023-03-22 21:15:00,984,1006,22,0,FALSE,NA,"0.1.4"
"19479","646",2023-03-22 21:30:00,984,1006,22,0,FALSE,NA,"0.1.4"
"19480","646",2023-03-22 21:45:00,984,1006,22,0,FALSE,NA,"0.1.4"
"19481","646",2023-03-22 22:00:00,984,1006,22,0,FALSE,NA,"0.1.4"
"19482","646",2023-03-22 22:15:00,984,1006,22,0,FALSE,NA,"0.1.4"
"19483","646",2023-03-22 22:30:00,984,1006,22,0,FALSE,NA,"0.1.4"
"19484","646",2023-03-22 22:45:00,984,1006,22,0,FALSE,NA,"0.1.4"
"19485","646",2023-03-22 23:00:00,983,1006,23,0,FALSE,NA,"0.1.4"
"19486","646",2023-03-22 23:15:00,984,1006,22,0,FALSE,NA,"0.1.4"
"19487","646",2023-03-22 23:30:00,983,1006,23,0,FALSE,NA,"0.1.4"
"19488","646",2023-03-22 23:45:00,983,1006,23,0,FALSE,NA,"0.1.4"
"19489","646",2023-03-23,983,1006,23,0,FALSE,NA,"0.1.4"
"19490","646",2023-03-23 00:15:00,982,1006,24,0,FALSE,NA,"0.1.4"
"19491","646",2023-03-23 00:30:00,983,1006,23,0,FALSE,NA,"0.1.4"
"19492","646",2023-03-23 00:45:00,983,1006,23,0,FALSE,NA,"0.1.4"
"19493","646",2023-03-23 01:00:00,983,1006,23,0,FALSE,NA,"0.1.4"
"19494","646",2023-03-23 01:15:00,983,1006,23,0,FALSE,NA,"0.1.4"
"19495","646",2023-03-23 01:30:00,983,1006,23,0,FALSE,NA,"0.1.4"
"19496","646",2023-03-23 01:45:00,983,1006,23,0,FALSE,NA,"0.1.4"
"19497","646",2023-03-23 02:00:00,983,1006,23,0,FALSE,NA,"0.1.4"
"19498","646",2023-03-23 02:15:00,983,1006,23,0,FALSE,NA,"0.1.4"
"19499","646",2023-03-23 02:30:00,983,1006,23,0,FALSE,NA,"0.1.4"
"19500","646",2023-03-23 02:45:00,983,1006,23,0,FALSE,NA,"0.1.4"
"19501","646",2023-03-23 03:00:00,983,1006,23,0,FALSE,NA,"0.1.4"
"19502","646",2023-03-23 03:15:00,983,1006,23,0,FALSE,NA,"0.1.4"
"19503","646",2023-03-23 03:30:00,983,1006,23,0,FALSE,NA,"0.1.4"
"19504","646",2023-03-23 03:45:00,983,1006,23,0,FALSE,NA,"0.1.4"
"19505","646",2023-03-23 04:00:00,983,1006,23,0,FALSE,NA,"0.1.4"
"19506","646",2023-03-23 04:15:00,983,1006,23,0,FALSE,NA,"0.1.4"
"19507","646",2023-03-23 04:30:00,983,1006,23,0,FALSE,NA,"0.1.4"
"19508","646",2023-03-23 04:45:00,983,1006,23,0,FALSE,NA,"0.1.4"
"19509","646",2023-03-23 05:00:00,983,1006,23,0,FALSE,NA,"0.1.4"
"19510","646",2023-03-23 05:15:00,983,1006,23,0,FALSE,NA,"0.1.4"
"19511","646",2023-03-23 05:30:00,983,1006,23,0,TRUE,NA,"0.1.4"
"19512","646",2023-03-23 05:45:00,983,1006,23,0,TRUE,NA,"0.1.4"
"19513","646",2023-03-23 06:00:00,983,1006,23,0,FALSE,NA,"0.1.4"
"19514","646",2023-03-23 06:15:00,983,1006,23,0,FALSE,NA,"0.1.4"
"19515","646",2023-03-23 06:30:00,983,1006,23,0,FALSE,NA,"0.1.4"
"19516","646",2023-03-23 06:45:00,983,1006,23,0,FALSE,NA,"0.1.4"
"19517","646",2023-03-23 07:00:00,983,1006,23,0,TRUE,NA,"0.1.4"
"19518","646",2023-03-23 07:15:00,983,1006,23,0,TRUE,NA,"0.1.4"
"19519","646",2023-03-23 07:30:00,983,1006,23,0,TRUE,NA,"0.1.4"
"19520","646",2023-03-23 07:45:00,983,1006,23,0,TRUE,NA,"0.1.4"
"19521","646",2023-03-23 08:00:00,983,1006,23,0,TRUE,NA,"0.1.4"
"19522","646",2023-03-23 08:15:00,983,1006,23,0,TRUE,NA,"0.1.4"
"19523","646",2023-03-23 08:30:00,983,1006,23,0,TRUE,NA,"0.1.4"
"19524","646",2023-03-23 08:45:00,983,1006,23,0,TRUE,NA,"0.1.4"
"19525","646",2023-03-23 09:00:00,983,1006,23,0,TRUE,NA,"0.1.4"
"19526","646",2023-03-23 09:15:00,983,1006,23,0,TRUE,NA,"0.1.4"
"19527","646",2023-03-23 09:30:00,983,1006,23,0,TRUE,NA,"0.1.4"
"19528","646",2023-03-23 09:45:00,983,1006,23,0,TRUE,NA,"0.1.4"
"19529","646",2023-03-23 10:00:00,983,1006,23,0,TRUE,NA,"0.1.4"
"19530","646",2023-03-23 10:15:00,983,1006,23,0,TRUE,NA,"0.1.4"
"19531","646",2023-03-23 10:30:00,983,1006,23,0,TRUE,NA,"0.1.4"
"19532","646",2023-03-23 10:45:00,983,1006,23,0,TRUE,NA,"0.1.4"
"19533","646",2023-03-23 11:00:00,983,1006,23,0,TRUE,NA,"0.1.4"
"19534","646",2023-03-23 11:15:00,983,1006,23,0,TRUE,NA,"0.1.4"
"19535","646",2023-03-23 11:30:00,983,1006,23,0,TRUE,NA,"0.1.4"
"19536","646",2023-03-23 11:45:00,983,1006,23,0,TRUE,NA,"0.1.4"
"19537","646",2023-03-23 12:00:00,983,1006,23,0,TRUE,NA,"0.1.4"
"19538","646",2023-03-23 12:15:00,983,1006,23,0,TRUE,NA,"0.1.4"
"19539","646",2023-03-23 12:30:00,983,1006,23,0,TRUE,NA,"0.1.4"
"19540","646",2023-03-23 12:45:00,983,1006,23,0,TRUE,NA,"0.1.4"
"19541","646",2023-03-23 13:00:00,983,1006,23,0,TRUE,NA,"0.1.4"
"19542","646",2023-03-23 13:15:00,983,1006,23,0,TRUE,NA,"0.1.4"
"19543","646",2023-03-23 13:30:00,983,1006,23,0,TRUE,NA,"0.1.4"
"19544","646",2023-03-23 13:45:00,983,1006,23,0,TRUE,NA,"0.1.4"
"19545","646",2023-03-23 14:00:00,983,1006,23,0,TRUE,NA,"0.1.4"
"19546","646",2023-03-23 14:15:00,983,1006,23,0,TRUE,NA,"0.1.4"
"19547","646",2023-03-23 14:30:00,983,1006,23,0,TRUE,NA,"0.1.4"
"19548","646",2023-03-23 14:45:00,983,1006,23,0,TRUE,NA,"0.1.4"
"19549","646",2023-03-23 15:00:00,983,1006,23,0,TRUE,NA,"0.1.4"
"19550","646",2023-03-23 15:15:00,983,1006,23,0,TRUE,NA,"0.1.4"
"19551","646",2023-03-23 15:30:00,983,1006,23,0,TRUE,NA,"0.1.4"
"19552","646",2023-03-23 15:45:00,983,1006,23,0,TRUE,NA,"0.1.4"
"19553","646",2023-03-23 16:00:00,983,1006,23,0,TRUE,NA,"0.1.4"
"19554","646",2023-03-23 16:15:00,983,1006,23,0,TRUE,NA,"0.1.4"
"19555","646",2023-03-23 16:30:00,983,1006,23,0,TRUE,NA,"0.1.4"
"19556","646",2023-03-23 16:45:00,983,1006,23,0,TRUE,NA,"0.1.4"
"19557","646",2023-03-23 17:00:00,983,1006,23,0,TRUE,NA,"0.1.4"
"19558","646",2023-03-23 17:15:00,983,1006,23,0,TRUE,NA,"0.1.4"
"19559","646",2023-03-23 17:30:00,983,1006,23,0,TRUE,NA,"0.1.4"
"19560","646",2023-03-23 17:45:00,983,1006,23,0,TRUE,NA,"0.1.4"
"19561","646",2023-03-23 18:00:00,983,1006,23,0,TRUE,NA,"0.1.4"
"19562","646",2023-03-23 18:15:00,983,1006,23,0,TRUE,NA,"0.1.4"
"19563","646",2023-03-23 18:30:00,983,1006,23,0,TRUE,NA,"0.1.4"
"19564","646",2023-03-23 18:45:00,983,1006,23,0,TRUE,NA,"0.1.4"
"19565","646",2023-03-23 19:00:00,983,1006,23,0,TRUE,NA,"0.1.4"
"19566","646",2023-03-23 19:15:00,983,1006,23,0,TRUE,NA,"0.1.4"
"19567","646",2023-03-23 19:30:00,983,1006,23,0,TRUE,NA,"0.1.4"
"19568","646",2023-03-23 19:45:00,983,1006,23,0,TRUE,NA,"0.1.4"
"19569","646",2023-03-23 20:00:00,983,1006,23,0,TRUE,NA,"0.1.4"
"19570","646",2023-03-23 20:15:00,983,1006,23,0,TRUE,NA,"0.1.4"
"19571","646",2023-03-23 20:30:00,983,1006,23,0,TRUE,NA,"0.1.4"
"19572","646",2023-03-23 20:45:00,983,1006,23,0,TRUE,NA,"0.1.4"
"19573","646",2023-03-23 21:00:00,983,1006,23,0,TRUE,NA,"0.1.4"
"19574","646",2023-03-23 21:15:00,983,1006,23,0,TRUE,NA,"0.1.4"
"19575","646",2023-03-23 21:30:00,983,1006,23,0,TRUE,NA,"0.1.4"
"19576","646",2023-03-23 21:45:00,983,1006,23,0,TRUE,NA,"0.1.4"
"19577","646",2023-03-23 22:00:00,983,1006,23,0,TRUE,NA,"0.1.4"
"19578","646",2023-03-23 22:15:00,983,1006,23,0,TRUE,NA,"0.1.4"
"19579","646",2023-03-23 22:30:00,983,1006,23,0,TRUE,NA,"0.1.4"
"19580","646",2023-03-23 22:45:00,983,1006,23,0,TRUE,NA,"0.1.4"
"19581","646",2023-03-23 23:00:00,983,1006,23,0,TRUE,NA,"0.1.4"
"19582","646",2023-03-23 23:15:00,983,1006,23,0,TRUE,NA,"0.1.4"
"19583","646",2023-03-23 23:30:00,983,1006,23,0,TRUE,NA,"0.1.4"
"19584","646",2023-03-23 23:45:00,983,1006,23,0,TRUE,NA,"0.1.4"
"19585","646",2023-03-24,983,1006,23,0,TRUE,NA,"0.1.4"
"19586","646",2023-03-24 00:15:00,983,1006,23,0,TRUE,NA,"0.1.4"
"19587","646",2023-03-24 00:30:00,983,1006,23,0,TRUE,NA,"0.1.4"
"19588","646",2023-03-24 00:45:00,983,1006,23,0,TRUE,NA,"0.1.4"
"19589","646",2023-03-24 01:00:00,983,1006,23,0,TRUE,NA,"0.1.4"
"19590","646",2023-03-24 01:15:00,983,1006,23,0,TRUE,NA,"0.1.4"
"19591","646",2023-03-24 01:30:00,983,1006,23,0,TRUE,NA,"0.1.4"
"19592","646",2023-03-24 01:45:00,983,1006,23,0,TRUE,NA,"0.1.4"
"19593","646",2023-03-24 02:00:00,983,1006,23,0,TRUE,NA,"0.1.4"
"19594","646",2023-03-24 02:15:00,983,1006,23,0,TRUE,NA,"0.1.4"
"19595","646",2023-03-24 02:30:00,983,1006,23,0,TRUE,NA,"0.1.4"
"19596","646",2023-03-24 02:45:00,983,1006,23,0,TRUE,NA,"0.1.4"
"19597","646",2023-03-24 03:00:00,983,1006,23,0,TRUE,NA,"0.1.4"
"19598","646",2023-03-24 03:15:00,983,1006,23,0,TRUE,NA,"0.1.4"
"19599","646",2023-03-24 03:30:00,983,1006,23,0,TRUE,NA,"0.1.4"
"19600","646",2023-03-24 03:45:00,983,1006,23,0,TRUE,NA,"0.1.4"
"19601","646",2023-03-24 04:00:00,983,1006,23,0,TRUE,NA,"0.1.4"
"19602","646",2023-03-24 04:15:00,983,1006,23,0,TRUE,NA,"0.1.4"
"19603","646",2023-03-24 04:30:00,983,1006,23,0,TRUE,NA,"0.1.4"
"19604","646",2023-03-24 04:45:00,983,1006,23,0,TRUE,NA,"0.1.4"
"19605","646",2023-03-24 05:00:00,983,1006,23,0,TRUE,NA,"0.1.4"
"19606","646",2023-03-24 05:15:00,983,1006,23,0,TRUE,NA,"0.1.4"
"19607","646",2023-03-24 05:30:00,983,1006,23,0,TRUE,NA,"0.1.4"
"19608","646",2023-03-24 05:45:00,983,1006,23,0,TRUE,NA,"0.1.4"
"19609","646",2023-03-24 06:00:00,983,1006,23,0,TRUE,NA,"0.1.4"
"19610","646",2023-03-24 06:15:00,983,1006,23,0,TRUE,NA,"0.1.4"
"19611","646",2023-03-24 06:30:00,983,1006,23,0,TRUE,NA,"0.1.4"
"19612","646",2023-03-24 06:45:00,983,1006,23,0,TRUE,NA,"0.1.4"
"19613","646",2023-03-24 07:00:00,983,1006,23,0,TRUE,NA,"0.1.4"
"19614","646",2023-03-24 07:15:00,983,1006,23,0,TRUE,NA,"0.1.4"
"19615","646",2023-03-24 07:30:00,983,1006,23,0,TRUE,NA,"0.1.4"
"19616","646",2023-03-24 07:45:00,983,1006,23,0,TRUE,NA,"0.1.4"
"19617","646",2023-03-24 08:00:00,983,1006,23,0,TRUE,NA,"0.1.4"
"19618","646",2023-03-24 08:15:00,983,1006,23,0,TRUE,NA,"0.1.4"
"19619","646",2023-03-24 08:30:00,983,1006,23,0,TRUE,NA,"0.1.4"
"19620","646",2023-03-24 08:45:00,983,1006,23,0,TRUE,NA,"0.1.4"
"19621","646",2023-03-24 09:00:00,983,1006,23,0,TRUE,NA,"0.1.4"
"19622","646",2023-03-24 09:15:00,983,1006,23,0,TRUE,NA,"0.1.4"
"19623","646",2023-03-24 09:30:00,983,1006,23,0,TRUE,NA,"0.1.4"
"19624","646",2023-03-24 09:45:00,983,1006,23,0,TRUE,NA,"0.1.4"
"19625","646",2023-03-24 10:00:00,984,1006,22,0,TRUE,NA,"0.1.4"
"19626","646",2023-03-24 10:15:00,984,1006,22,0,TRUE,NA,"0.1.4"
"19627","646",2023-03-24 10:30:00,983,1006,23,0,TRUE,NA,"0.1.4"
"19628","646",2023-03-24 10:45:00,984,1006,22,0,TRUE,NA,"0.1.4"
"19629","646",2023-03-24 11:00:00,984,1006,22,0,TRUE,NA,"0.1.4"
"19630","646",2023-03-24 11:15:00,984,1006,22,0,TRUE,NA,"0.1.4"
"19631","646",2023-03-24 11:30:00,984,1006,22,0,TRUE,NA,"0.1.4"
"19632","646",2023-03-24 11:45:00,983,1006,23,0,TRUE,NA,"0.1.4"
"19633","646",2023-03-24 12:00:00,984,1006,22,0,TRUE,NA,"0.1.4"
"19634","646",2023-03-24 12:15:00,984,1006,22,0,TRUE,NA,"0.1.4"
"19635","646",2023-03-24 12:30:00,983,1006,23,0,TRUE,NA,"0.1.4"
"19636","646",2023-03-24 12:45:00,984,1006,22,0,TRUE,NA,"0.1.4"
"19637","646",2023-03-24 13:00:00,984,1006,22,0,TRUE,NA,"0.1.4"
"19638","646",2023-03-24 13:15:00,984,1006,22,0,TRUE,NA,"0.1.4"
"19639","646",2023-03-24 13:30:00,984,1006,22,0,TRUE,NA,"0.1.4"
"19640","646",2023-03-24 13:45:00,984,1006,22,0,TRUE,NA,"0.1.4"
"19641","646",2023-03-24 14:00:00,984,1006,22,0,TRUE,NA,"0.1.4"
"19642","646",2023-03-24 14:15:00,984,1006,22,0,TRUE,NA,"0.1.4"
"19643","646",2023-03-24 14:30:00,984,1006,22,0,TRUE,NA,"0.1.4"
"19644","646",2023-03-24 14:45:00,984,1006,22,0,TRUE,NA,"0.1.4"
"19645","646",2023-03-24 15:00:00,984,1006,22,0,TRUE,NA,"0.1.4"
"19646","646",2023-03-24 15:15:00,984,1006,22,0,TRUE,NA,"0.1.4"
"19647","646",2023-03-24 15:30:00,984,1006,22,0,TRUE,NA,"0.1.4"
"19648","646",2023-03-24 15:45:00,984,1006,22,0,TRUE,NA,"0.1.4"
"19649","646",2023-03-24 16:00:00,984,1006,22,0,TRUE,NA,"0.1.4"
"19650","646",2023-03-24 16:15:00,984,1006,22,0,TRUE,NA,"0.1.4"
"19651","646",2023-03-24 16:30:00,984,1006,22,0,TRUE,NA,"0.1.4"
"19652","646",2023-03-24 16:45:00,984,1006,22,0,TRUE,NA,"0.1.4"
"19653","646",2023-03-24 17:00:00,984,1006,22,0,TRUE,NA,"0.1.4"
"19654","646",2023-03-24 17:15:00,984,1006,22,0,TRUE,NA,"0.1.4"
"19655","646",2023-03-24 17:30:00,983,1006,23,0,TRUE,NA,"0.1.4"
"19656","646",2023-03-24 17:45:00,984,1006,22,0,TRUE,NA,"0.1.4"
"19657","646",2023-03-24 18:00:00,984,1006,22,0,TRUE,NA,"0.1.4"
"19658","646",2023-03-24 18:15:00,984,1006,22,0,TRUE,NA,"0.1.4"
"19659","646",2023-03-24 18:30:00,984,1006,22,0,TRUE,NA,"0.1.4"
"19660","646",2023-03-24 18:45:00,984,1006,22,0,TRUE,NA,"0.1.4"
"19661","646",2023-03-24 19:00:00,984,1006,22,0,TRUE,NA,"0.1.4"
"19662","646",2023-03-24 19:15:00,984,1006,22,0,TRUE,NA,"0.1.4"
"19663","646",2023-03-24 19:30:00,984,1006,22,0,TRUE,NA,"0.1.4"
"19664","646",2023-03-24 19:45:00,984,1006,22,0,TRUE,NA,"0.1.4"
"19665","646",2023-03-24 20:00:00,984,1006,22,0,TRUE,NA,"0.1.4"
"19666","646",2023-03-24 20:15:00,984,1006,22,0,TRUE,NA,"0.1.4"
"19667","646",2023-03-24 20:30:00,984,1006,22,0,TRUE,NA,"0.1.4"
"19668","646",2023-03-24 20:45:00,984,1006,22,0,TRUE,NA,"0.1.4"
"19669","646",2023-03-24 21:00:00,984,1006,22,0,TRUE,NA,"0.1.4"
"19670","646",2023-03-24 21:15:00,984,1006,22,0,TRUE,NA,"0.1.4"
"19671","646",2023-03-24 21:30:00,984,1006,22,0,TRUE,NA,"0.1.4"
"19672","646",2023-03-24 21:45:00,984,1006,22,0,TRUE,NA,"0.1.4"
"19673","646",2023-03-24 22:00:00,984,1006,22,0,TRUE,NA,"0.1.4"
"19674","646",2023-03-24 22:15:00,984,1006,22,0,TRUE,NA,"0.1.4"
"19675","646",2023-03-24 22:30:00,984,1006,22,0,TRUE,NA,"0.1.4"
"19676","646",2023-03-24 22:45:00,984,1006,22,0,TRUE,NA,"0.1.4"
"19677","646",2023-03-24 23:00:00,984,1006,22,0,TRUE,NA,"0.1.4"
"19678","646",2023-03-24 23:15:00,984,1006,22,0,TRUE,NA,"0.1.4"
"19679","646",2023-03-24 23:30:00,984,1006,22,0,TRUE,NA,"0.1.4"
"19680","646",2023-03-24 23:45:00,984,1006,22,0,TRUE,NA,"0.1.4"
"19681","646",2023-03-25,984,1006,22,0,TRUE,NA,"0.1.4"
"19682","646",2023-03-25 00:15:00,984,1006,22,0,TRUE,NA,"0.1.4"
"19683","646",2023-03-25 00:30:00,984,1006,22,0,TRUE,NA,"0.1.4"
"19684","646",2023-03-25 00:45:00,984,1006,22,0,TRUE,NA,"0.1.4"
"19685","646",2023-03-25 01:00:00,984,1006,22,0,TRUE,NA,"0.1.4"
"19686","646",2023-03-25 01:15:00,984,1006,22,0,TRUE,NA,"0.1.4"
"19687","646",2023-03-25 01:30:00,984,1006,22,0,TRUE,NA,"0.1.4"
"19688","646",2023-03-25 01:45:00,984,1006,22,0,TRUE,NA,"0.1.4"
"19689","646",2023-03-25 02:00:00,984,1006,22,0,TRUE,NA,"0.1.4"
"19690","646",2023-03-25 02:15:00,984,1006,22,0,TRUE,NA,"0.1.4"
"19691","646",2023-03-25 02:30:00,984,1006,22,0,TRUE,NA,"0.1.4"
"19692","646",2023-03-25 02:45:00,984,1006,22,0,TRUE,NA,"0.1.4"
"19693","646",2023-03-25 03:00:00,984,1006,22,0,TRUE,NA,"0.1.4"
"19694","646",2023-03-25 03:15:00,984,1006,22,0,TRUE,NA,"0.1.4"
"19695","646",2023-03-25 03:30:00,984,1006,22,0,TRUE,NA,"0.1.4"
"19696","646",2023-03-25 03:45:00,984,1006,22,0,TRUE,NA,"0.1.4"
"19697","646",2023-03-25 04:00:00,984,1006,22,0,TRUE,NA,"0.1.4"
"19698","646",2023-03-25 04:15:00,984,1006,22,0,TRUE,NA,"0.1.4"
"19699","646",2023-03-25 04:30:00,984,1006,22,0,TRUE,NA,"0.1.4"
"19700","646",2023-03-25 04:45:00,984,1006,22,0,TRUE,NA,"0.1.4"
"19701","646",2023-03-25 05:00:00,984,1006,22,0,TRUE,NA,"0.1.4"
"19702","646",2023-03-25 05:15:00,984,1006,22,0,TRUE,NA,"0.1.4"
"19703","646",2023-03-25 05:30:00,984,1006,22,0,TRUE,NA,"0.1.4"
"19704","646",2023-03-25 05:45:00,984,1006,22,0,TRUE,NA,"0.1.4"
"19705","646",2023-03-25 06:00:00,984,1006,22,0,TRUE,NA,"0.1.4"
"19706","646",2023-03-25 06:15:00,984,1006,22,0,TRUE,NA,"0.1.4"
"19707","646",2023-03-25 06:30:00,984,1006,22,0,TRUE,NA,"0.1.4"
"19708","646",2023-03-25 06:45:00,984,1006,22,0,TRUE,NA,"0.1.4"
"19709","646",2023-03-25 07:00:00,984,1006,22,0,TRUE,NA,"0.1.4"
"19710","646",2023-03-25 07:15:00,984,1006,22,0,TRUE,NA,"0.1.4"
"19711","646",2023-03-25 07:30:00,984,1006,22,0,TRUE,NA,"0.1.4"
"19712","646",2023-03-25 07:45:00,984,1006,22,0,TRUE,NA,"0.1.4"
"19713","646",2023-03-25 08:00:00,984,1006,22,0,TRUE,NA,"0.1.4"
"19714","646",2023-03-25 08:15:00,984,1006,22,0,TRUE,NA,"0.1.4"
"19715","646",2023-03-25 08:30:00,984,1006,22,0,TRUE,NA,"0.1.4"
"19716","646",2023-03-25 08:45:00,984,1006,22,0,TRUE,NA,"0.1.4"
"19717","646",2023-03-25 09:00:00,984,1006,22,0,TRUE,NA,"0.1.4"
"19718","646",2023-03-25 09:15:00,984,1006,22,0,TRUE,NA,"0.1.4"
"19719","646",2023-03-25 09:30:00,984,1006,22,0,TRUE,NA,"0.1.4"
"19720","646",2023-03-25 09:45:00,984,1006,22,0,TRUE,NA,"0.1.4"
"19721","646",2023-03-25 10:00:00,984,1006,22,0,TRUE,NA,"0.1.4"
"19722","646",2023-03-25 10:15:00,984,1006,22,0,TRUE,NA,"0.1.4"
"19723","646",2023-03-25 10:30:00,984,1006,22,0,TRUE,NA,"0.1.4"
"19724","646",2023-03-25 10:45:00,984,1006,22,0,TRUE,NA,"0.1.4"
"19725","646",2023-03-25 11:00:00,984,1006,22,0,TRUE,NA,"0.1.4"
"19726","646",2023-03-25 11:15:00,984,1006,22,0,TRUE,NA,"0.1.4"
"19727","646",2023-03-25 11:30:00,984,1006,22,0,TRUE,NA,"0.1.4"
"19728","646",2023-03-25 11:45:00,984,1006,22,0,TRUE,NA,"0.1.4"
"19729","646",2023-03-25 12:00:00,984,1006,22,0,TRUE,NA,"0.1.4"
"19730","646",2023-03-25 12:15:00,984,1006,22,0,TRUE,NA,"0.1.4"
"19731","646",2023-03-25 12:30:00,984,1006,22,0,TRUE,NA,"0.1.4"
"19732","646",2023-03-25 12:45:00,984,1006,22,0,TRUE,NA,"0.1.4"
"19733","646",2023-03-25 13:00:00,984,1006,22,0,TRUE,NA,"0.1.4"
"19734","646",2023-03-25 13:15:00,984,1006,22,0,TRUE,NA,"0.1.4"
"19735","646",2023-03-25 13:30:00,984,1006,22,0,TRUE,NA,"0.1.4"
"19736","646",2023-03-25 13:45:00,984,1006,22,0,TRUE,NA,"0.1.4"
"19737","646",2023-03-25 14:00:00,984,1006,22,0,TRUE,NA,"0.1.4"
"19738","646",2023-03-25 14:15:00,984,1006,22,0,TRUE,NA,"0.1.4"
"19739","646",2023-03-25 14:30:00,984,1006,22,0,TRUE,NA,"0.1.4"
"19740","646",2023-03-25 14:45:00,984,1006,22,0,TRUE,NA,"0.1.4"
"19741","646",2023-03-25 15:00:00,984,1006,22,0,TRUE,NA,"0.1.4"
"19742","646",2023-03-25 15:15:00,984,1006,22,0,TRUE,NA,"0.1.4"
"19743","646",2023-03-25 15:30:00,984,1006,22,0,TRUE,NA,"0.1.4"
"19744","646",2023-03-25 15:45:00,984,1006,22,0,TRUE,NA,"0.1.4"
"19745","646",2023-03-25 16:00:00,984,1006,22,0,TRUE,NA,"0.1.4"
"19746","646",2023-03-25 16:15:00,984,1006,22,0,TRUE,NA,"0.1.4"
"19747","646",2023-03-25 16:30:00,984,1006,22,0,TRUE,NA,"0.1.4"
"19748","646",2023-03-25 16:45:00,984,1006,22,0,TRUE,NA,"0.1.4"
"19749","646",2023-03-25 17:00:00,984,1006,22,0,TRUE,NA,"0.1.4"
"19750","646",2023-03-25 17:15:00,984,1006,22,0,TRUE,NA,"0.1.4"
"19751","646",2023-03-25 17:30:00,984,1006,22,0,TRUE,NA,"0.1.4"
"19752","646",2023-03-25 17:45:00,984,1006,22,0,TRUE,NA,"0.1.4"
"19753","646",2023-03-25 18:00:00,984,1006,22,0,TRUE,NA,"0.1.4"
"19754","646",2023-03-25 18:15:00,984,1006,22,0,TRUE,NA,"0.1.4"
"19755","646",2023-03-25 18:30:00,984,1006,22,0,TRUE,NA,"0.1.4"
"19756","646",2023-03-25 18:45:00,984,1006,22,0,TRUE,NA,"0.1.4"
"19757","646",2023-03-25 19:00:00,984,1006,22,0,TRUE,NA,"0.1.4"
"19758","646",2023-03-25 19:15:00,984,1006,22,0,TRUE,NA,"0.1.4"
"19759","646",2023-03-25 19:30:00,984,1006,22,0,TRUE,NA,"0.1.4"
"19760","646",2023-03-25 19:45:00,987,1006,19,0,TRUE,NA,"0.1.4"
"19761","646",2023-03-25 20:00:00,986,1006,20,0,TRUE,NA,"0.1.4"
"19762","646",2023-03-25 20:15:00,986,1006,20,0,TRUE,NA,"0.1.4"
"19763","646",2023-03-25 20:30:00,986,1006,20,0,TRUE,NA,"0.1.4"
"19764","646",2023-03-25 20:45:00,986,1006,20,0,TRUE,NA,"0.1.4"
"19765","646",2023-03-25 21:00:00,986,1006,20,0,TRUE,NA,"0.1.4"
"19766","646",2023-03-25 21:15:00,987,1006,19,0,TRUE,NA,"0.1.4"
"19767","646",2023-03-25 21:30:00,986,1006,20,0,TRUE,NA,"0.1.4"
"19768","646",2023-03-25 21:45:00,987,1006,19,0,TRUE,NA,"0.1.4"
"19769","646",2023-03-25 22:00:00,987,1006,19,0,TRUE,NA,"0.1.4"
"19770","646",2023-03-25 22:15:00,987,1006,19,0,TRUE,NA,"0.1.4"
"19771","646",2023-03-25 22:30:00,986,1006,20,0,TRUE,NA,"0.1.4"
"19772","646",2023-03-25 22:45:00,987,1006,19,0,TRUE,NA,"0.1.4"
"19773","646",2023-03-25 23:00:00,987,1006,19,0,TRUE,NA,"0.1.4"
"19774","646",2023-03-25 23:15:00,987,1006,19,0,TRUE,NA,"0.1.4"
"19775","646",2023-03-25 23:30:00,987,1006,19,0,TRUE,NA,"0.1.4"
"19776","646",2023-03-25 23:45:00,987,1006,19,0,TRUE,NA,"0.1.4"
"19777","646",2023-03-26,987,1006,19,0,TRUE,NA,"0.1.4"
"19778","646",2023-03-26 00:15:00,987,1006,19,0,TRUE,NA,"0.1.4"
"19779","646",2023-03-26 00:30:00,987,1006,19,0,TRUE,NA,"0.1.4"
"19780","646",2023-03-26 00:45:00,987,1006,19,0,TRUE,NA,"0.1.4"
"19781","646",2023-03-26 01:00:00,987,1006,19,0,TRUE,NA,"0.1.4"
"19782","646",2023-03-26 01:15:00,987,1006,19,0,TRUE,NA,"0.1.4"
"19783","646",2023-03-26 01:30:00,987,1006,19,0,TRUE,NA,"0.1.4"
"19784","646",2023-03-26 01:45:00,987,1006,19,0,TRUE,NA,"0.1.4"
"19785","646",2023-03-26 02:00:00,987,1006,19,0,TRUE,NA,"0.1.4"
"19786","646",2023-03-26 02:15:00,987,1006,19,0,TRUE,NA,"0.1.4"
"19787","646",2023-03-26 02:30:00,987,1006,19,0,TRUE,NA,"0.1.4"
"19788","646",2023-03-26 02:45:00,987,1006,19,0,TRUE,NA,"0.1.4"
"19789","646",2023-03-26 03:00:00,987,1006,19,0,TRUE,NA,"0.1.4"
"19790","646",2023-03-26 03:15:00,987,1006,19,0,TRUE,NA,"0.1.4"
"19791","646",2023-03-26 03:30:00,987,1006,19,0,TRUE,NA,"0.1.4"
"19792","646",2023-03-26 03:45:00,987,1006,19,0,TRUE,NA,"0.1.4"
"19793","646",2023-03-26 04:00:00,987,1006,19,0,TRUE,NA,"0.1.4"
"19794","646",2023-03-26 04:15:00,987,1006,19,0,TRUE,NA,"0.1.4"
"19795","646",2023-03-26 04:30:00,987,1006,19,0,TRUE,NA,"0.1.4"
"19796","646",2023-03-26 04:45:00,987,1006,19,0,TRUE,NA,"0.1.4"
"19797","646",2023-03-26 05:00:00,987,1006,19,0,TRUE,NA,"0.1.4"
"19798","646",2023-03-26 05:15:00,987,1006,19,0,TRUE,NA,"0.1.4"
"19799","646",2023-03-26 05:30:00,987,1006,19,0,TRUE,NA,"0.1.4"
"19800","646",2023-03-26 05:45:00,987,1006,19,0,TRUE,NA,"0.1.4"
"19801","646",2023-03-26 06:00:00,987,1006,19,0,TRUE,NA,"0.1.4"
"19802","646",2023-03-26 06:15:00,987,1006,19,0,TRUE,NA,"0.1.4"
"19803","646",2023-03-26 06:30:00,987,1006,19,0,TRUE,NA,"0.1.4"
"19804","646",2023-03-26 06:45:00,987,1006,19,0,TRUE,NA,"0.1.4"
"19805","646",2023-03-26 07:00:00,987,1006,19,0,TRUE,NA,"0.1.4"
"19806","646",2023-03-26 07:15:00,987,1006,19,0,TRUE,NA,"0.1.4"
"19807","646",2023-03-26 07:30:00,987,1006,19,0,TRUE,NA,"0.1.4"
"19808","646",2023-03-26 07:45:00,987,1006,19,0,TRUE,NA,"0.1.4"
"19809","646",2023-03-26 08:00:00,987,1006,19,0,TRUE,NA,"0.1.4"
"19810","646",2023-03-26 08:15:00,987,1006,19,0,TRUE,NA,"0.1.4"
"19811","646",2023-03-26 08:30:00,987,1006,19,0,TRUE,NA,"0.1.4"
"19812","646",2023-03-26 08:45:00,987,1006,19,0,TRUE,NA,"0.1.4"
"19813","646",2023-03-26 09:00:00,987,1006,19,0,TRUE,NA,"0.1.4"
"19814","646",2023-03-26 09:15:00,987,1006,19,0,TRUE,NA,"0.1.4"
"19815","646",2023-03-26 09:30:00,987,1006,19,0,TRUE,NA,"0.1.4"
"19816","646",2023-03-26 09:45:00,987,1006,19,0,TRUE,NA,"0.1.4"
"19817","646",2023-03-26 10:00:00,987,1006,19,0,TRUE,NA,"0.1.4"
"19818","646",2023-03-26 10:15:00,987,1006,19,0,TRUE,NA,"0.1.4"
"19819","646",2023-03-26 10:30:00,987,1006,19,0,TRUE,NA,"0.1.4"
"19820","646",2023-03-26 10:45:00,987,1006,19,0,TRUE,NA,"0.1.4"
"19821","646",2023-03-26 11:00:00,987,1006,19,0,TRUE,NA,"0.1.4"
"19822","646",2023-03-26 11:15:00,987,1006,19,0,TRUE,NA,"0.1.4"
"19823","646",2023-03-26 11:30:00,987,1006,19,0,TRUE,NA,"0.1.4"
"19824","646",2023-03-26 11:45:00,987,1006,19,0,TRUE,NA,"0.1.4"
"19825","646",2023-03-26 12:00:00,987,1006,19,0,TRUE,NA,"0.1.4"
"19826","646",2023-03-26 12:15:00,987,1006,19,0,TRUE,NA,"0.1.4"
"19827","646",2023-03-26 12:30:00,987,1006,19,0,TRUE,NA,"0.1.4"
"19828","646",2023-03-26 12:45:00,987,1006,19,0,TRUE,NA,"0.1.4"
"19829","646",2023-03-26 13:00:00,987,1006,19,0,TRUE,NA,"0.1.4"
"19830","646",2023-03-26 13:15:00,987,1006,19,0,TRUE,NA,"0.1.4"
"19831","646",2023-03-26 13:30:00,987,1006,19,0,TRUE,NA,"0.1.4"
"19832","646",2023-03-26 13:45:00,987,1006,19,0,TRUE,NA,"0.1.4"
"19833","646",2023-03-26 14:00:00,987,1006,19,0,TRUE,NA,"0.1.4"
"19834","646",2023-03-26 14:15:00,987,1006,19,0,TRUE,NA,"0.1.4"
"19835","646",2023-03-26 14:30:00,987,1006,19,0,TRUE,NA,"0.1.4"
"19836","646",2023-03-26 14:45:00,987,1006,19,0,TRUE,NA,"0.1.4"
"19837","646",2023-03-26 15:00:00,987,1006,19,0,TRUE,NA,"0.1.4"
"19838","646",2023-03-26 15:15:00,987,1006,19,0,TRUE,NA,"0.1.4"
"19839","646",2023-03-26 15:30:00,987,1006,19,0,TRUE,NA,"0.1.4"
"19840","646",2023-03-26 15:45:00,987,1006,19,0,TRUE,NA,"0.1.4"
"19841","646",2023-03-26 16:00:00,987,1006,19,0,TRUE,NA,"0.1.4"
"19842","646",2023-03-26 16:15:00,987,1006,19,0,TRUE,NA,"0.1.4"
"19843","646",2023-03-26 16:30:00,987,1006,19,0,TRUE,NA,"0.1.4"
"19844","646",2023-03-26 16:45:00,987,1006,19,0,TRUE,NA,"0.1.4"
"19845","646",2023-03-26 17:00:00,987,1006,19,0,TRUE,NA,"0.1.4"
"19846","646",2023-03-26 17:15:00,987,1006,19,0,TRUE,NA,"0.1.4"
"19847","646",2023-03-26 17:30:00,987,1006,19,0,TRUE,NA,"0.1.4"
"19848","646",2023-03-26 17:45:00,987,1006,19,0,TRUE,NA,"0.1.4"
"19849","646",2023-03-26 18:00:00,987,1006,19,0,TRUE,NA,"0.1.4"
"19850","646",2023-03-26 18:15:00,987,1006,19,0,TRUE,NA,"0.1.4"
"19851","646",2023-03-26 18:30:00,987,1006,19,0,TRUE,NA,"0.1.4"
"19852","646",2023-03-26 18:45:00,987,1006,19,0,TRUE,NA,"0.1.4"
"19853","646",2023-03-26 19:00:00,987,1006,19,0,TRUE,NA,"0.1.4"
"19854","646",2023-03-26 19:15:00,987,1006,19,0,TRUE,NA,"0.1.4"
"19855","646",2023-03-26 19:30:00,987,1006,19,0,TRUE,NA,"0.1.4"
"19856","646",2023-03-26 19:45:00,987,1006,19,0,TRUE,NA,"0.1.4"
"19857","646",2023-03-26 20:00:00,987,1006,19,0,TRUE,NA,"0.1.4"
"19858","646",2023-03-26 20:15:00,987,1006,19,0,TRUE,NA,"0.1.4"
"19859","646",2023-03-26 20:30:00,987,1006,19,0,TRUE,NA,"0.1.4"
"19860","646",2023-03-26 20:45:00,987,1006,19,0,TRUE,NA,"0.1.4"
"19861","646",2023-03-26 21:00:00,987,1006,19,0,TRUE,NA,"0.1.4"
"19862","646",2023-03-26 21:15:00,987,1006,19,0,TRUE,NA,"0.1.4"
"19863","646",2023-03-26 21:30:00,987,1006,19,0,TRUE,NA,"0.1.4"
"19864","646",2023-03-26 21:45:00,987,1006,19,0,TRUE,NA,"0.1.4"
"19865","646",2023-03-26 22:00:00,987,1006,19,0,TRUE,NA,"0.1.4"
"19866","646",2023-03-26 22:15:00,987,1006,19,0,TRUE,NA,"0.1.4"
"19867","646",2023-03-26 22:30:00,987,1006,19,0,TRUE,NA,"0.1.4"
"19868","646",2023-03-26 22:45:00,987,1006,19,0,TRUE,NA,"0.1.4"
"19869","646",2023-03-26 23:00:00,987,1006,19,0,TRUE,NA,"0.1.4"
"19870","646",2023-03-26 23:15:00,987,1006,19,0,TRUE,NA,"0.1.4"
"19871","646",2023-03-26 23:30:00,987,1006,19,0,TRUE,NA,"0.1.4"
"19872","646",2023-03-26 23:45:00,987,1006,19,0,TRUE,NA,"0.1.4"
"19873","646",2023-03-27,987,1006,19,0,TRUE,NA,"0.1.4"
"19874","646",2023-03-27 00:15:00,987,1006,19,0,TRUE,NA,"0.1.4"
"19875","646",2023-03-27 00:30:00,987,1006,19,0,TRUE,NA,"0.1.4"
"19876","646",2023-03-27 00:45:00,987,1006,19,0,TRUE,NA,"0.1.4"
"19877","646",2023-03-27 01:00:00,987,1006,19,0,TRUE,NA,"0.1.4"
"19878","646",2023-03-27 01:15:00,987,1006,19,0,TRUE,NA,"0.1.4"
"19879","646",2023-03-27 01:30:00,987,1006,19,0,TRUE,NA,"0.1.4"
"19880","646",2023-03-27 01:45:00,987,1006,19,0,TRUE,NA,"0.1.4"
"19881","646",2023-03-27 02:00:00,987,1006,19,0,TRUE,NA,"0.1.4"
"19882","646",2023-03-27 02:15:00,987,1006,19,0,TRUE,NA,"0.1.4"
"19883","646",2023-03-27 02:30:00,987,1006,19,0,TRUE,NA,"0.1.4"
"19884","646",2023-03-27 02:45:00,987,1006,19,0,TRUE,NA,"0.1.4"
"19885","646",2023-03-27 03:00:00,987,1006,19,0,TRUE,NA,"0.1.4"
"19886","646",2023-03-27 03:15:00,987,1006,19,0,TRUE,NA,"0.1.4"
"19887","646",2023-03-27 03:30:00,987,1006,19,0,TRUE,NA,"0.1.4"
"19888","646",2023-03-27 03:45:00,987,1006,19,0,TRUE,NA,"0.1.4"
"19889","646",2023-03-27 04:00:00,987,1006,19,0,TRUE,NA,"0.1.4"
"19890","646",2023-03-27 04:15:00,987,1006,19,0,TRUE,NA,"0.1.4"
"19891","646",2023-03-27 04:30:00,987,1006,19,0,TRUE,NA,"0.1.4"
"19892","646",2023-03-27 04:45:00,987,1006,19,0,TRUE,NA,"0.1.4"
"19893","646",2023-03-27 05:00:00,987,1006,19,0,TRUE,NA,"0.1.4"
"19894","646",2023-03-27 05:15:00,987,1006,19,0,TRUE,NA,"0.1.4"
"19895","646",2023-03-27 05:30:00,987,1006,19,0,TRUE,NA,"0.1.4"
"19896","646",2023-03-27 05:45:00,987,1006,19,0,TRUE,NA,"0.1.4"
"19897","646",2023-03-27 06:00:00,987,1006,19,0,TRUE,NA,"0.1.4"
"19898","646",2023-03-27 06:15:00,987,1006,19,0,TRUE,NA,"0.1.4"
"19899","646",2023-03-27 06:30:00,987,1006,19,0,TRUE,NA,"0.1.4"
"19900","646",2023-03-27 06:45:00,987,1006,19,0,TRUE,NA,"0.1.4"
"19901","646",2023-03-27 07:00:00,987,1006,19,0,TRUE,NA,"0.1.4"
"19902","646",2023-03-27 07:15:00,987,1006,19,0,TRUE,NA,"0.1.4"
"19903","646",2023-03-27 07:30:00,987,1006,19,0,TRUE,NA,"0.1.4"
"19904","646",2023-03-27 07:45:00,987,1006,19,0,TRUE,NA,"0.1.4"
"19905","646",2023-03-27 08:00:00,987,1006,19,0,TRUE,NA,"0.1.4"
"19906","646",2023-03-27 08:15:00,987,1006,19,0,TRUE,NA,"0.1.4"
"19907","646",2023-03-27 08:30:00,987,1006,19,0,TRUE,NA,"0.1.4"
"19908","646",2023-03-27 08:45:00,987,1006,19,0,TRUE,NA,"0.1.4"
"19909","646",2023-03-27 09:00:00,987,1006,19,0,TRUE,NA,"0.1.4"
"19910","646",2023-03-27 09:15:00,987,1006,19,0,TRUE,NA,"0.1.4"
"19911","646",2023-03-27 09:30:00,987,1006,19,0,TRUE,NA,"0.1.4"
"19912","646",2023-03-27 09:45:00,987,1006,19,0,TRUE,NA,"0.1.4"
"19913","646",2023-03-27 10:00:00,987,1006,19,0,TRUE,NA,"0.1.4"
"19914","646",2023-03-27 10:15:00,987,1006,19,0,TRUE,NA,"0.1.4"
"19915","646",2023-03-27 10:30:00,987,1006,19,0,TRUE,NA,"0.1.4"
"19916","646",2023-03-27 10:45:00,987,1006,19,0,TRUE,NA,"0.1.4"
"19917","646",2023-03-27 11:00:00,987,1006,19,0,TRUE,NA,"0.1.4"
"19918","646",2023-03-27 11:15:00,987,1006,19,0,TRUE,NA,"0.1.4"
"19919","646",2023-03-27 11:30:00,987,1006,19,0,TRUE,NA,"0.1.4"
"19920","646",2023-03-27 11:45:00,987,1006,19,0,TRUE,NA,"0.1.4"
"19921","646",2023-03-27 12:00:00,987,1006,19,0,TRUE,NA,"0.1.4"
"19922","646",2023-03-27 12:15:00,987,1006,19,0,TRUE,NA,"0.1.4"
"19923","646",2023-03-27 12:30:00,987,1006,19,0,TRUE,NA,"0.1.4"
"19924","646",2023-03-27 12:45:00,987,1006,19,0,TRUE,NA,"0.1.4"
"19925","646",2023-03-27 13:00:00,987,1006,19,0,TRUE,NA,"0.1.4"
"19926","646",2023-03-27 13:15:00,987,1006,19,0,TRUE,NA,"0.1.4"
"19927","646",2023-03-27 13:30:00,987,1006,19,0,TRUE,NA,"0.1.4"
"19928","646",2023-03-27 13:45:00,987,1006,19,0,TRUE,NA,"0.1.4"
"19929","646",2023-03-27 14:00:00,987,1006,19,0,TRUE,NA,"0.1.4"
"19930","646",2023-03-27 14:15:00,987,1006,19,0,TRUE,NA,"0.1.4"
"19931","646",2023-03-27 14:30:00,987,1006,19,0,TRUE,NA,"0.1.4"
"19932","646",2023-03-27 14:45:00,988,1006,18,0,TRUE,NA,"0.1.4"
"19933","646",2023-03-27 15:00:00,987,1006,19,0,TRUE,NA,"0.1.4"
"19934","646",2023-03-27 15:15:00,987,1006,19,0,TRUE,NA,"0.1.4"
"19935","646",2023-03-27 15:30:00,987,1006,19,0,TRUE,NA,"0.1.4"
"19936","646",2023-03-27 15:45:00,987,1006,19,0,TRUE,NA,"0.1.4"
"19937","646",2023-03-27 16:00:00,987,1006,19,0,TRUE,NA,"0.1.4"
"19938","646",2023-03-27 16:15:00,987,1006,19,0,TRUE,NA,"0.1.4"
"19939","646",2023-03-27 16:30:00,988,1006,18,0,TRUE,NA,"0.1.4"
"19940","646",2023-03-27 16:45:00,987,1006,19,0,TRUE,NA,"0.1.4"
"19941","646",2023-03-27 17:00:00,988,1006,18,0,TRUE,NA,"0.1.4"
"19942","646",2023-03-27 17:15:00,988,1006,18,0,TRUE,NA,"0.1.4"
"19943","646",2023-03-27 17:30:00,987,1006,19,0,TRUE,NA,"0.1.4"
"19944","646",2023-03-27 17:45:00,987,1006,19,0,TRUE,NA,"0.1.4"
"19945","646",2023-03-27 18:00:00,987,1006,19,0,TRUE,NA,"0.1.4"
"19946","646",2023-03-27 18:15:00,987,1006,19,0,TRUE,NA,"0.1.4"
"19947","646",2023-03-27 18:30:00,987,1006,19,0,TRUE,NA,"0.1.4"
"19948","646",2023-03-27 18:45:00,987,1006,19,0,TRUE,NA,"0.1.4"
"19949","646",2023-03-27 19:00:00,987,1006,19,0,TRUE,NA,"0.1.4"
"19950","646",2023-03-27 19:15:00,987,1006,19,0,TRUE,NA,"0.1.4"
"19951","646",2023-03-27 19:30:00,987,1006,19,0,TRUE,NA,"0.1.4"
"19952","646",2023-03-27 19:45:00,987,1006,19,0,TRUE,NA,"0.1.4"
"19953","646",2023-03-27 20:00:00,987,1006,19,0,TRUE,NA,"0.1.4"
"19954","646",2023-03-27 20:15:00,987,1006,19,0,TRUE,NA,"0.1.4"
"19955","646",2023-03-27 20:30:00,987,1006,19,0,TRUE,NA,"0.1.4"
"19956","646",2023-03-27 20:45:00,987,1006,19,0,TRUE,NA,"0.1.4"
"19957","646",2023-03-27 21:00:00,987,1006,19,0,TRUE,NA,"0.1.4"
"19958","646",2023-03-27 21:15:00,987,1006,19,0,TRUE,NA,"0.1.4"
"19959","646",2023-03-27 21:30:00,988,1006,18,0,TRUE,NA,"0.1.4"
"19960","646",2023-03-27 21:45:00,987,1006,19,0,TRUE,NA,"0.1.4"
"19961","646",2023-03-27 22:00:00,987,1006,19,0,TRUE,NA,"0.1.4"
"19962","646",2023-03-27 22:15:00,987,1006,19,0,TRUE,NA,"0.1.4"
"19963","646",2023-03-27 22:30:00,987,1006,19,0,TRUE,NA,"0.1.4"
"19964","646",2023-03-27 22:45:00,987,1006,19,0,TRUE,NA,"0.1.4"
"19965","646",2023-03-27 23:00:00,988,1006,18,0,TRUE,NA,"0.1.4"
"19966","646",2023-03-27 23:15:00,988,1006,18,0,TRUE,NA,"0.1.4"
"19967","646",2023-03-27 23:30:00,987,1006,19,0,TRUE,NA,"0.1.4"
"19968","646",2023-03-27 23:45:00,987,1006,19,0,TRUE,NA,"0.1.4"
"19969","646",2023-03-28,988,1006,18,0,TRUE,NA,"0.1.4"
"19970","646",2023-03-28 00:15:00,987,1006,19,0,TRUE,NA,"0.1.4"
"19971","646",2023-03-28 00:30:00,988,1006,18,0,TRUE,NA,"0.1.4"
"19972","646",2023-03-28 00:45:00,987,1006,19,0,TRUE,NA,"0.1.4"
"19973","646",2023-03-28 01:00:00,988,1006,18,0,TRUE,NA,"0.1.4"
"19974","646",2023-03-28 01:15:00,988,1006,18,0,TRUE,NA,"0.1.4"
"19975","646",2023-03-28 01:30:00,988,1006,18,0,TRUE,NA,"0.1.4"
"19976","646",2023-03-28 01:45:00,988,1006,18,0,TRUE,NA,"0.1.4"
"19977","646",2023-03-28 02:00:00,988,1006,18,0,TRUE,NA,"0.1.4"
"19978","646",2023-03-28 02:15:00,988,1006,18,0,TRUE,NA,"0.1.4"
"19979","646",2023-03-28 02:30:00,988,1006,18,0,TRUE,NA,"0.1.4"
"19980","646",2023-03-28 02:45:00,988,1006,18,0,TRUE,NA,"0.1.4"
"19981","646",2023-03-28 03:00:00,988,1006,18,0,TRUE,NA,"0.1.4"
"19982","646",2023-03-28 03:15:00,988,1006,18,0,TRUE,NA,"0.1.4"
"19983","646",2023-03-28 03:30:00,988,1006,18,0,TRUE,NA,"0.1.4"
"19984","646",2023-03-28 03:45:00,988,1006,18,0,TRUE,NA,"0.1.4"
"19985","646",2023-03-28 04:00:00,988,1006,18,0,TRUE,NA,"0.1.4"
"19986","646",2023-03-28 04:15:00,988,1006,18,0,TRUE,NA,"0.1.4"
"19987","646",2023-03-28 04:30:00,988,1006,18,0,TRUE,NA,"0.1.4"
"19988","646",2023-03-28 04:45:00,988,1006,18,0,TRUE,NA,"0.1.4"
"19989","646",2023-03-28 05:00:00,988,1006,18,0,TRUE,NA,"0.1.4"
"19990","646",2023-03-28 05:15:00,987,1006,19,0,TRUE,NA,"0.1.4"
"19991","646",2023-03-28 05:30:00,987,1006,19,0,TRUE,NA,"0.1.4"
"19992","646",2023-03-28 05:45:00,987,1006,19,0,TRUE,NA,"0.1.4"
"19993","646",2023-03-28 06:00:00,987,1006,19,0,TRUE,NA,"0.1.4"
"19994","646",2023-03-28 06:15:00,987,1006,19,0,TRUE,NA,"0.1.4"
"19995","646",2023-03-28 06:30:00,987,1006,19,0,TRUE,NA,"0.1.4"
"19996","646",2023-03-28 06:45:00,987,1006,19,0,TRUE,NA,"0.1.4"
"19997","646",2023-03-28 07:00:00,987,1006,19,0,TRUE,NA,"0.1.4"
"19998","646",2023-03-28 07:15:00,987,1006,19,0,TRUE,NA,"0.1.4"
"19999","646",2023-03-28 07:30:00,987,1006,19,0,TRUE,NA,"0.1.4"
"20000","646",2023-03-28 07:45:00,987,1006,19,0,TRUE,NA,"0.1.4"
"20001","646",2023-03-28 08:00:00,987,1006,19,0,TRUE,NA,"0.1.4"
"20002","646",2023-03-28 08:15:00,987,1006,19,0,TRUE,NA,"0.1.4"
"20003","646",2023-03-28 08:30:00,987,1006,19,0,TRUE,NA,"0.1.4"
"20004","646",2023-03-28 08:45:00,987,1006,19,0,TRUE,NA,"0.1.4"
"20005","646",2023-03-28 09:00:00,987,1006,19,0,TRUE,NA,"0.1.4"
"20006","646",2023-03-28 09:15:00,987,1006,19,0,TRUE,NA,"0.1.4"
"20007","646",2023-03-28 09:30:00,987,1006,19,0,TRUE,NA,"0.1.4"
"20008","646",2023-03-28 09:45:00,987,1006,19,0,TRUE,NA,"0.1.4"
"20009","646",2023-03-28 10:00:00,987,1006,19,0,TRUE,NA,"0.1.4"
"20010","646",2023-03-28 10:15:00,987,1006,19,0,TRUE,NA,"0.1.4"
"20011","646",2023-03-28 10:30:00,987,1006,19,0,TRUE,NA,"0.1.4"
"20012","646",2023-03-28 10:45:00,987,1006,19,0,TRUE,NA,"0.1.4"
"20013","646",2023-03-28 11:00:00,987,1006,19,0,TRUE,NA,"0.1.4"
"20014","646",2023-03-28 11:15:00,987,1006,19,0,TRUE,NA,"0.1.4"
"20015","646",2023-03-28 11:30:00,987,1006,19,0,TRUE,NA,"0.1.4"
"20016","646",2023-03-28 11:45:00,987,1006,19,0,TRUE,NA,"0.1.4"
"20017","646",2023-03-28 12:00:00,987,1006,19,0,TRUE,NA,"0.1.4"
"20018","646",2023-03-28 12:15:00,987,1006,19,0,TRUE,NA,"0.1.4"
"20019","646",2023-03-28 12:30:00,987,1006,19,0,TRUE,NA,"0.1.4"
"20020","646",2023-03-28 12:45:00,987,1006,19,0,TRUE,NA,"0.1.4"
"20021","646",2023-03-28 13:00:00,987,1006,19,0,TRUE,NA,"0.1.4"
"20022","646",2023-03-28 13:15:00,987,1006,19,0,TRUE,NA,"0.1.4"
"20023","646",2023-03-28 13:30:00,987,1006,19,0,TRUE,NA,"0.1.4"
"20024","646",2023-03-28 13:45:00,987,1006,19,0,TRUE,NA,"0.1.4"
"20025","646",2023-03-28 14:00:00,987,1006,19,0,TRUE,NA,"0.1.4"
"20026","646",2023-03-28 14:15:00,987,1006,19,0,TRUE,NA,"0.1.4"
"20027","646",2023-03-28 14:30:00,987,1006,19,0,TRUE,NA,"0.1.4"
"20028","646",2023-03-28 14:45:00,987,1006,19,0,TRUE,NA,"0.1.4"
"20029","646",2023-03-28 15:00:00,987,1006,19,0,TRUE,NA,"0.1.4"
"20030","646",2023-03-28 15:15:00,987,1006,19,0,TRUE,NA,"0.1.4"
"20031","646",2023-03-28 15:30:00,987,1006,19,0,TRUE,NA,"0.1.4"
"20032","646",2023-03-28 15:45:00,987,1006,19,0,TRUE,NA,"0.1.4"
"20033","646",2023-03-28 16:00:00,987,1006,19,0,TRUE,NA,"0.1.4"
"20034","646",2023-03-28 16:15:00,987,1006,19,0,TRUE,NA,"0.1.4"
"20035","646",2023-03-28 16:30:00,987,1006,19,0,TRUE,NA,"0.1.4"
"20036","646",2023-03-28 16:45:00,987,1006,19,0,TRUE,NA,"0.1.4"
"20037","646",2023-03-28 17:00:00,987,1006,19,0,TRUE,NA,"0.1.4"
"20038","646",2023-03-28 17:15:00,987,1006,19,0,TRUE,NA,"0.1.4"
"20039","646",2023-03-28 17:30:00,987,1006,19,0,TRUE,NA,"0.1.4"
"20040","646",2023-03-28 17:45:00,987,1006,19,0,TRUE,NA,"0.1.4"
"20041","646",2023-03-28 18:00:00,987,1006,19,0,TRUE,NA,"0.1.4"
"20042","646",2023-03-28 18:15:00,987,1006,19,0,TRUE,NA,"0.1.4"
"20043","646",2023-03-28 18:30:00,987,1006,19,0,TRUE,NA,"0.1.4"
"20044","646",2023-03-28 18:45:00,987,1006,19,0,TRUE,NA,"0.1.4"
"20045","646",2023-03-28 19:00:00,987,1006,19,0,TRUE,NA,"0.1.4"
"20046","646",2023-03-28 19:15:00,987,1006,19,0,TRUE,NA,"0.1.4"
"20047","646",2023-03-28 19:30:00,987,1006,19,0,TRUE,NA,"0.1.4"
"20048","646",2023-03-28 19:45:00,987,1006,19,0,TRUE,NA,"0.1.4"
"20049","646",2023-03-28 20:00:00,987,1006,19,0,TRUE,NA,"0.1.4"
"20050","646",2023-03-28 20:15:00,987,1006,19,0,TRUE,NA,"0.1.4"
"20051","646",2023-03-28 20:30:00,987,1006,19,0,TRUE,NA,"0.1.4"
"20052","646",2023-03-28 20:45:00,987,1006,19,0,TRUE,NA,"0.1.4"
"20053","646",2023-03-28 21:00:00,987,1006,19,0,TRUE,NA,"0.1.4"
"20054","646",2023-03-28 21:15:00,987,1006,19,0,TRUE,NA,"0.1.4"
"20055","646",2023-03-28 21:30:00,987,1006,19,0,TRUE,NA,"0.1.4"
"20056","646",2023-03-28 21:45:00,987,1006,19,0,TRUE,NA,"0.1.4"
"20057","646",2023-03-28 22:00:00,987,1006,19,0,TRUE,NA,"0.1.4"
"20058","646",2023-03-28 22:15:00,987,1006,19,0,TRUE,NA,"0.1.4"
"20059","646",2023-03-28 22:30:00,987,1006,19,0,TRUE,NA,"0.1.4"
"20060","646",2023-03-28 22:45:00,987,1006,19,0,TRUE,NA,"0.1.4"
"20061","646",2023-03-28 23:00:00,987,1006,19,0,TRUE,NA,"0.1.4"
"20062","646",2023-03-28 23:15:00,987,1006,19,0,TRUE,NA,"0.1.4"
"20063","646",2023-03-28 23:30:00,987,1006,19,0,TRUE,NA,"0.1.4"
"20064","646",2023-03-28 23:45:00,987,1006,19,0,TRUE,NA,"0.1.4"
"20065","646",2023-03-29,987,1006,19,0,TRUE,NA,"0.1.4"
"20066","646",2023-03-29 00:15:00,987,1006,19,0,TRUE,NA,"0.1.4"
"20067","646",2023-03-29 00:30:00,987,1006,19,0,TRUE,NA,"0.1.4"
"20068","646",2023-03-29 00:45:00,987,1006,19,0,TRUE,NA,"0.1.4"
"20069","646",2023-03-29 01:00:00,987,1006,19,0,TRUE,NA,"0.1.4"
"20070","646",2023-03-29 01:15:00,987,1006,19,0,TRUE,NA,"0.1.4"
"20071","646",2023-03-29 01:30:00,987,1006,19,0,TRUE,NA,"0.1.4"
"20072","646",2023-03-29 01:45:00,987,1006,19,0,TRUE,NA,"0.1.4"
"20073","646",2023-03-29 02:00:00,987,1006,19,0,TRUE,NA,"0.1.4"
"20074","646",2023-03-29 02:15:00,987,1006,19,0,TRUE,NA,"0.1.4"
"20075","646",2023-03-29 02:30:00,987,1006,19,0,TRUE,NA,"0.1.4"
"20076","646",2023-03-29 02:45:00,987,1006,19,0,TRUE,NA,"0.1.4"
"20077","646",2023-03-29 03:00:00,987,1006,19,0,TRUE,NA,"0.1.4"
"20078","646",2023-03-29 03:15:00,987,1006,19,0,TRUE,NA,"0.1.4"
"20079","646",2023-03-29 03:30:00,987,1006,19,0,TRUE,NA,"0.1.4"
"20080","646",2023-03-29 03:45:00,987,1006,19,0,TRUE,NA,"0.1.4"
"20081","646",2023-03-29 04:00:00,987,1006,19,0,TRUE,NA,"0.1.4"
"20082","646",2023-03-29 04:15:00,987,1006,19,0,TRUE,NA,"0.1.4"
"20083","646",2023-03-29 04:30:00,987,1006,19,0,TRUE,NA,"0.1.4"
"20084","646",2023-03-29 04:45:00,987,1006,19,0,TRUE,NA,"0.1.4"
"20085","646",2023-03-29 05:00:00,987,1006,19,0,TRUE,NA,"0.1.4"
"20086","646",2023-03-29 05:15:00,987,1006,19,0,TRUE,NA,"0.1.4"
"20087","646",2023-03-29 05:30:00,987,1006,19,0,TRUE,NA,"0.1.4"
"20088","646",2023-03-29 05:45:00,987,1006,19,0,TRUE,NA,"0.1.4"
"20089","646",2023-03-29 06:00:00,987,1006,19,0,TRUE,NA,"0.1.4"
"20090","646",2023-03-29 06:15:00,987,1006,19,0,TRUE,NA,"0.1.4"
"20091","646",2023-03-29 06:30:00,987,1006,19,0,TRUE,NA,"0.1.4"
"20092","646",2023-03-29 06:45:00,987,1006,19,0,TRUE,NA,"0.1.4"
"20093","646",2023-03-29 07:00:00,987,1006,19,0,TRUE,NA,"0.1.4"
"20094","646",2023-03-29 07:15:00,987,1006,19,0,TRUE,NA,"0.1.4"
"20095","646",2023-03-29 07:30:00,987,1006,19,0,TRUE,NA,"0.1.4"
"20096","646",2023-03-29 07:45:00,987,1006,19,0,TRUE,NA,"0.1.4"
"20097","646",2023-03-29 08:00:00,987,1006,19,0,TRUE,NA,"0.1.4"
"20098","646",2023-03-29 08:15:00,987,1006,19,0,TRUE,NA,"0.1.4"
"20099","646",2023-03-29 08:30:00,987,1006,19,0,TRUE,NA,"0.1.4"
"20100","646",2023-03-29 08:45:00,987,1006,19,0,TRUE,NA,"0.1.4"
"20101","646",2023-03-29 09:00:00,987,1006,19,0,TRUE,NA,"0.1.4"
"20102","646",2023-03-29 09:15:00,987,1006,19,0,TRUE,NA,"0.1.4"
"20103","646",2023-03-29 09:30:00,987,1006,19,0,TRUE,NA,"0.1.4"
"20104","646",2023-03-29 09:45:00,987,1006,19,0,TRUE,NA,"0.1.4"
"20105","646",2023-03-29 10:00:00,987,1006,19,0,TRUE,NA,"0.1.4"
"20106","646",2023-03-29 10:15:00,987,1006,19,0,TRUE,NA,"0.1.4"
"20107","646",2023-03-29 10:30:00,987,1006,19,0,TRUE,NA,"0.1.4"
"20108","646",2023-03-29 10:45:00,987,1006,19,0,TRUE,NA,"0.1.4"
"20109","646",2023-03-29 11:00:00,987,1006,19,0,TRUE,NA,"0.1.4"
"20110","646",2023-03-29 11:15:00,988,1006,18,0,TRUE,NA,"0.1.4"
"20111","646",2023-03-29 11:30:00,987,1006,19,0,TRUE,NA,"0.1.4"
"20112","646",2023-03-29 11:45:00,987,1006,19,0,TRUE,NA,"0.1.4"
"20113","646",2023-03-29 12:00:00,988,1006,18,0,TRUE,NA,"0.1.4"
"20114","646",2023-03-29 12:15:00,988,1006,18,0,TRUE,NA,"0.1.4"
"20115","646",2023-03-29 12:30:00,988,1006,18,0,TRUE,NA,"0.1.4"
"20116","646",2023-03-29 12:45:00,988,1006,18,0,TRUE,NA,"0.1.4"
"20117","646",2023-03-29 13:00:00,988,1006,18,0,TRUE,NA,"0.1.4"
"20118","646",2023-03-29 13:15:00,988,1006,18,0,TRUE,NA,"0.1.4"
"20119","646",2023-03-29 13:30:00,988,1006,18,0,TRUE,NA,"0.1.4"
"20120","646",2023-03-29 13:45:00,988,1006,18,0,TRUE,NA,"0.1.4"
"20121","646",2023-03-29 14:00:00,988,1006,18,0,TRUE,NA,"0.1.4"
"20122","646",2023-03-29 14:15:00,988,1006,18,0,TRUE,NA,"0.1.4"
"20123","646",2023-03-29 14:30:00,988,1006,18,0,TRUE,NA,"0.1.4"
"20124","646",2023-03-29 14:45:00,988,1006,18,0,TRUE,NA,"0.1.4"
"20125","646",2023-03-29 15:00:00,988,1006,18,0,TRUE,NA,"0.1.4"
"20126","646",2023-03-29 15:15:00,988,1006,18,0,TRUE,NA,"0.1.4"
"20127","646",2023-03-29 15:30:00,988,1006,18,0,TRUE,NA,"0.1.4"
"20128","646",2023-03-29 15:45:00,987,1006,19,0,TRUE,NA,"0.1.4"
"20129","646",2023-03-29 16:00:00,987,1006,19,0,TRUE,NA,"0.1.4"
"20130","646",2023-03-29 16:15:00,987,1006,19,0,TRUE,NA,"0.1.4"
"20131","646",2023-03-29 16:30:00,987,1006,19,0,TRUE,NA,"0.1.4"
"20132","646",2023-03-29 16:45:00,987,1006,19,0,TRUE,NA,"0.1.4"
"20133","646",2023-03-29 17:00:00,987,1006,19,0,TRUE,NA,"0.1.4"
"20134","646",2023-03-29 17:15:00,987,1006,19,0,TRUE,NA,"0.1.4"
"20135","646",2023-03-29 17:30:00,987,1006,19,0,TRUE,NA,"0.1.4"
"20136","646",2023-03-29 17:45:00,987,1006,19,0,TRUE,NA,"0.1.4"
"20137","646",2023-03-29 18:00:00,987,1006,19,0,TRUE,NA,"0.1.4"
"20138","646",2023-03-29 18:15:00,987,1006,19,0,TRUE,NA,"0.1.4"
"20139","646",2023-03-29 18:30:00,987,1006,19,0,TRUE,NA,"0.1.4"
"20140","646",2023-03-29 18:45:00,987,1006,19,0,TRUE,NA,"0.1.4"
"20141","646",2023-03-29 19:00:00,987,1006,19,0,TRUE,NA,"0.1.4"
"20142","646",2023-03-29 19:15:00,987,1006,19,0,TRUE,NA,"0.1.4"
"20143","646",2023-03-29 19:30:00,987,1006,19,0,TRUE,NA,"0.1.4"
"20144","646",2023-03-29 19:45:00,987,1006,19,0,TRUE,NA,"0.1.4"
"20145","646",2023-03-29 20:00:00,987,1006,19,0,TRUE,NA,"0.1.4"
"20146","646",2023-03-29 20:15:00,987,1006,19,0,TRUE,NA,"0.1.4"
"20147","646",2023-03-29 20:30:00,987,1006,19,0,TRUE,NA,"0.1.4"
"20148","646",2023-03-29 20:45:00,987,1006,19,0,TRUE,NA,"0.1.4"
"20149","646",2023-03-29 21:00:00,987,1006,19,0,FALSE,NA,"0.1.4"
"20150","646",2023-03-29 21:15:00,987,1006,19,0,TRUE,NA,"0.1.4"
"20151","646",2023-03-29 21:30:00,987,1006,19,0,TRUE,NA,"0.1.4"
"20152","646",2023-03-29 21:45:00,987,1006,19,0,TRUE,NA,"0.1.4"
"20153","646",2023-03-29 22:00:00,987,1006,19,0,TRUE,NA,"0.1.4"
"20154","646",2023-03-29 22:15:00,987,1006,19,0,TRUE,NA,"0.1.4"
"20155","646",2023-03-29 22:30:00,987,1006,19,0,TRUE,NA,"0.1.4"
"20156","646",2023-03-29 22:45:00,987,1006,19,0,TRUE,NA,"0.1.4"
"20157","646",2023-03-29 23:00:00,987,1006,19,0,TRUE,NA,"0.1.4"
"20158","646",2023-03-29 23:15:00,987,1006,19,0,TRUE,NA,"0.1.4"
"20159","646",2023-03-29 23:30:00,987,1006,19,0,TRUE,NA,"0.1.4"
"20160","646",2023-03-29 23:45:00,987,1006,19,0,TRUE,NA,"0.1.4"
"20161","646",2023-03-30,987,1006,19,0,TRUE,NA,"0.1.4"
"20162","646",2023-03-30 00:15:00,987,1006,19,0,TRUE,NA,"0.1.4"
"20163","646",2023-03-30 00:30:00,987,1006,19,0,TRUE,NA,"0.1.4"
"20164","646",2023-03-30 00:45:00,987,1006,19,0,TRUE,NA,"0.1.4"
"20165","646",2023-03-30 01:00:00,987,1006,19,0,TRUE,NA,"0.1.4"
"20166","646",2023-03-30 01:15:00,987,1006,19,0,TRUE,NA,"0.1.4"
"20167","646",2023-03-30 01:30:00,987,1006,19,0,TRUE,NA,"0.1.4"
"20168","646",2023-03-30 01:45:00,987,1006,19,0,TRUE,NA,"0.1.4"
"20169","646",2023-03-30 02:00:00,987,1006,19,0,TRUE,NA,"0.1.4"
"20170","646",2023-03-30 02:15:00,987,1006,19,0,TRUE,NA,"0.1.4"
"20171","646",2023-03-30 02:30:00,987,1006,19,0,TRUE,NA,"0.1.4"
"20172","646",2023-03-30 02:45:00,988,1006,18,0,TRUE,NA,"0.1.4"
"20173","646",2023-03-30 03:00:00,987,1006,19,0,TRUE,NA,"0.1.4"
"20174","646",2023-03-30 03:15:00,987,1006,19,0,TRUE,NA,"0.1.4"
"20175","646",2023-03-30 03:30:00,987,1006,19,0,TRUE,NA,"0.1.4"
"20176","646",2023-03-30 03:45:00,987,1006,19,0,TRUE,NA,"0.1.4"
"20177","646",2023-03-30 04:00:00,987,1006,19,0,TRUE,NA,"0.1.4"
"20178","646",2023-03-30 04:15:00,988,1006,18,0,TRUE,NA,"0.1.4"
"20179","646",2023-03-30 04:30:00,988,1006,18,0,TRUE,NA,"0.1.4"
"20180","646",2023-03-30 04:45:00,987,1006,19,0,TRUE,NA,"0.1.4"
"20181","646",2023-03-30 05:00:00,988,1006,18,0,TRUE,NA,"0.1.4"
"20182","646",2023-03-30 05:15:00,987,1006,19,0,TRUE,NA,"0.1.4"
"20183","646",2023-03-30 05:30:00,988,1006,18,0,TRUE,NA,"0.1.4"
"20184","646",2023-03-30 05:45:00,988,1006,18,0,TRUE,NA,"0.1.4"
"20185","646",2023-03-30 06:00:00,988,1006,18,0,TRUE,NA,"0.1.4"
"20186","646",2023-03-30 06:15:00,988,1006,18,0,TRUE,NA,"0.1.4"
"20187","646",2023-03-30 06:30:00,987,1006,19,0,TRUE,NA,"0.1.4"
"20188","646",2023-03-30 06:45:00,988,1006,18,0,TRUE,NA,"0.1.4"
"20189","646",2023-03-30 07:00:00,988,1006,18,0,TRUE,NA,"0.1.4"
"20190","646",2023-03-30 07:15:00,988,1006,18,0,TRUE,NA,"0.1.4"
"20191","646",2023-03-30 07:30:00,988,1006,18,0,TRUE,NA,"0.1.4"
"20192","646",2023-03-30 07:45:00,988,1006,18,0,TRUE,NA,"0.1.4"
"20193","646",2023-03-30 08:00:00,988,1006,18,0,TRUE,NA,"0.1.4"
"20194","646",2023-03-30 08:15:00,988,1006,18,0,TRUE,NA,"0.1.4"
"20195","646",2023-03-30 08:30:00,988,1006,18,0,TRUE,NA,"0.1.4"
"20196","646",2023-03-30 08:45:00,988,1006,18,0,TRUE,NA,"0.1.4"
"20197","646",2023-03-30 09:00:00,988,1006,18,0,TRUE,NA,"0.1.4"
"20198","646",2023-03-30 09:15:00,988,1006,18,0,TRUE,NA,"0.1.4"
"20199","646",2023-03-30 09:30:00,988,1006,18,0,TRUE,NA,"0.1.4"
"20200","646",2023-03-30 09:45:00,988,1006,18,0,TRUE,NA,"0.1.4"
"20201","646",2023-03-30 10:00:00,988,1006,18,0,TRUE,NA,"0.1.4"
"20202","646",2023-03-30 10:15:00,988,1006,18,0,TRUE,NA,"0.1.4"
"20203","646",2023-03-30 10:30:00,988,1006,18,0,TRUE,NA,"0.1.4"
"20204","646",2023-03-30 10:45:00,988,1006,18,0,TRUE,NA,"0.1.4"
"20205","646",2023-03-30 11:00:00,988,1006,18,0,TRUE,NA,"0.1.4"
"20206","646",2023-03-30 11:15:00,988,1006,18,0,TRUE,NA,"0.1.4"
"20207","646",2023-03-30 11:30:00,988,1006,18,0,TRUE,NA,"0.1.4"
"20208","646",2023-03-30 11:45:00,988,1006,18,0,TRUE,NA,"0.1.4"
"20209","646",2023-03-30 12:00:00,988,1006,18,0,TRUE,NA,"0.1.4"
"20210","646",2023-03-30 12:15:00,988,1006,18,0,TRUE,NA,"0.1.4"
"20211","646",2023-03-30 12:30:00,988,1006,18,0,TRUE,NA,"0.1.4"
"20212","646",2023-03-30 12:45:00,988,1006,18,0,TRUE,NA,"0.1.4"
"20213","646",2023-03-30 13:00:00,988,1006,18,0,TRUE,NA,"0.1.4"
"20214","646",2023-03-30 13:15:00,988,1006,18,0,TRUE,NA,"0.1.4"
"20215","646",2023-03-30 13:30:00,988,1006,18,0,TRUE,NA,"0.1.4"
"20216","646",2023-03-30 13:45:00,988,1006,18,0,TRUE,NA,"0.1.4"
"20217","646",2023-03-30 14:00:00,988,1006,18,0,TRUE,NA,"0.1.4"
"20218","646",2023-03-30 14:15:00,988,1006,18,0,TRUE,NA,"0.1.4"
"20219","646",2023-03-30 14:30:00,988,1006,18,0,TRUE,NA,"0.1.4"
"20220","646",2023-03-30 14:45:00,988,1006,18,0,TRUE,NA,"0.1.4"
"20221","646",2023-03-30 15:00:00,988,1006,18,0,TRUE,NA,"0.1.4"
"20222","646",2023-03-30 15:15:00,988,1006,18,0,TRUE,NA,"0.1.4"
"20223","646",2023-03-30 15:30:00,988,1006,18,0,TRUE,NA,"0.1.4"
"20224","646",2023-03-30 15:45:00,988,1006,18,0,TRUE,NA,"0.1.4"
"20225","646",2023-03-30 16:00:00,988,1006,18,0,TRUE,NA,"0.1.4"
"20226","646",2023-03-30 16:15:00,988,1006,18,0,TRUE,NA,"0.1.4"
"20227","646",2023-03-30 16:30:00,988,1006,18,0,TRUE,NA,"0.1.4"
"20228","646",2023-03-30 16:45:00,988,1006,18,0,TRUE,NA,"0.1.4"
"20229","646",2023-03-30 17:00:00,988,1006,18,0,TRUE,NA,"0.1.4"
"20230","646",2023-03-30 17:15:00,988,1006,18,0,TRUE,NA,"0.1.4"
"20231","646",2023-03-30 17:30:00,988,1006,18,0,TRUE,NA,"0.1.4"
"20232","646",2023-03-30 17:45:00,988,1006,18,0,TRUE,NA,"0.1.4"
"20233","646",2023-03-30 18:00:00,987,1006,19,0,TRUE,NA,"0.1.4"
"20234","646",2023-03-30 18:15:00,987,1006,19,0,TRUE,NA,"0.1.4"
"20235","646",2023-03-30 18:30:00,987,1006,19,0,TRUE,NA,"0.1.4"
"20236","646",2023-03-30 18:45:00,987,1006,19,0,TRUE,NA,"0.1.4"
"20237","646",2023-03-30 19:00:00,987,1006,19,0,TRUE,NA,"0.1.4"
"20238","646",2023-03-30 19:15:00,987,1006,19,0,TRUE,NA,"0.1.4"
"20239","646",2023-03-30 19:30:00,987,1006,19,0,TRUE,NA,"0.1.4"
"20240","646",2023-03-30 19:45:00,987,1006,19,0,TRUE,NA,"0.1.4"
"20241","646",2023-03-30 20:00:00,987,1006,19,0,FALSE,NA,"0.1.4"
"20242","646",2023-03-30 20:15:00,987,1006,19,0,TRUE,NA,"0.1.4"
"20243","646",2023-03-30 20:30:00,987,1006,19,0,TRUE,NA,"0.1.4"
"20244","646",2023-03-30 20:45:00,987,1006,19,0,FALSE,NA,"0.1.4"
"20245","646",2023-03-30 21:00:00,987,1006,19,0,FALSE,NA,"0.1.4"
"20246","646",2023-03-30 21:15:00,987,1006,19,0,FALSE,NA,"0.1.4"
"20247","646",2023-03-30 21:30:00,987,1006,19,0,FALSE,NA,"0.1.4"
"20248","646",2023-03-30 21:45:00,987,1006,19,0,FALSE,NA,"0.1.4"
"20249","646",2023-03-30 22:00:00,987,1006,19,0,FALSE,NA,"0.1.4"
"20250","646",2023-03-30 22:15:00,987,1006,19,0,TRUE,NA,"0.1.4"
"20251","646",2023-03-30 22:30:00,987,1006,19,0,TRUE,NA,"0.1.4"
"20252","646",2023-03-30 22:45:00,987,1006,19,0,TRUE,NA,"0.1.4"
"20253","646",2023-03-30 23:00:00,987,1006,19,0,TRUE,NA,"0.1.4"
"20254","646",2023-03-30 23:15:00,986,1006,20,0,TRUE,NA,"0.1.4"
"20255","646",2023-03-30 23:30:00,986,1006,20,0,TRUE,NA,"0.1.4"
"20256","646",2023-03-30 23:45:00,986,1006,20,0,TRUE,NA,"0.1.4"
"20257","646",2023-03-31,986,1006,20,0,TRUE,NA,"0.1.4"
"20258","646",2023-03-31 00:15:00,986,1006,20,0,TRUE,NA,"0.1.4"
"20259","646",2023-03-31 00:30:00,986,1006,20,0,TRUE,NA,"0.1.4"
"20260","646",2023-03-31 00:45:00,986,1006,20,0,TRUE,NA,"0.1.4"
"20261","646",2023-03-31 01:00:00,986,1006,20,0,TRUE,NA,"0.1.4"
"20262","646",2023-03-31 01:15:00,986,1006,20,0,TRUE,NA,"0.1.4"
"20263","646",2023-03-31 01:30:00,986,1006,20,0,TRUE,NA,"0.1.4"
"20264","646",2023-03-31 01:45:00,986,1006,20,0,TRUE,NA,"0.1.4"
"20265","646",2023-03-31 02:00:00,986,1006,20,0,TRUE,NA,"0.1.4"
"20266","646",2023-03-31 02:15:00,986,1006,20,0,TRUE,NA,"0.1.4"
"20267","646",2023-03-31 02:30:00,986,1006,20,0,TRUE,NA,"0.1.4"
"20268","646",2023-03-31 02:45:00,986,1006,20,0,TRUE,NA,"0.1.4"
"20269","646",2023-03-31 03:00:00,986,1006,20,0,TRUE,NA,"0.1.4"
"20270","646",2023-03-31 03:15:00,986,1006,20,0,TRUE,NA,"0.1.4"
"20271","646",2023-03-31 03:30:00,986,1006,20,0,TRUE,NA,"0.1.4"
"20272","646",2023-03-31 03:45:00,986,1006,20,0,TRUE,NA,"0.1.4"
"20273","646",2023-03-31 04:00:00,986,1006,20,0,TRUE,NA,"0.1.4"
"20274","646",2023-03-31 04:15:00,986,1006,20,0,TRUE,NA,"0.1.4"
"20275","646",2023-03-31 04:30:00,986,1006,20,0,TRUE,NA,"0.1.4"
"20276","646",2023-03-31 04:45:00,986,1006,20,0,TRUE,NA,"0.1.4"
"20277","646",2023-03-31 05:00:00,986,1006,20,0,TRUE,NA,"0.1.4"
"20278","646",2023-03-31 05:15:00,986,1006,20,0,TRUE,NA,"0.1.4"
"20279","646",2023-03-31 05:30:00,986,1006,20,0,TRUE,NA,"0.1.4"
"20280","646",2023-03-31 05:45:00,986,1006,20,0,TRUE,NA,"0.1.4"
"20281","646",2023-03-31 06:00:00,986,1006,20,0,TRUE,NA,"0.1.4"
"20282","646",2023-03-31 06:15:00,986,1006,20,0,TRUE,NA,"0.1.4"
"20283","646",2023-03-31 06:30:00,986,1006,20,0,TRUE,NA,"0.1.4"
"20284","646",2023-03-31 06:45:00,986,1006,20,0,TRUE,NA,"0.1.4"
"20285","646",2023-03-31 07:00:00,986,1006,20,0,TRUE,NA,"0.1.4"
"20286","646",2023-03-31 07:15:00,986,1006,20,0,TRUE,NA,"0.1.4"
"20287","646",2023-03-31 07:30:00,986,1006,20,0,TRUE,NA,"0.1.4"
"20288","646",2023-03-31 07:45:00,986,1006,20,0,TRUE,NA,"0.1.4"
"20289","646",2023-03-31 08:00:00,986,1006,20,0,TRUE,NA,"0.1.4"
"20290","646",2023-03-31 08:15:00,986,1006,20,0,TRUE,NA,"0.1.4"
"20291","646",2023-03-31 08:30:00,986,1006,20,0,TRUE,NA,"0.1.4"
"20292","646",2023-03-31 08:45:00,986,1006,20,0,TRUE,NA,"0.1.4"
"20293","646",2023-03-31 09:00:00,986,1006,20,0,TRUE,NA,"0.1.4"
"20294","646",2023-03-31 09:15:00,986,1006,20,0,TRUE,NA,"0.1.4"
"20295","646",2023-03-31 09:30:00,986,1006,20,0,TRUE,NA,"0.1.4"
"20296","646",2023-03-31 09:45:00,986,1006,20,0,TRUE,NA,"0.1.4"
"20297","646",2023-03-31 10:00:00,986,1006,20,0,TRUE,NA,"0.1.4"
"20298","646",2023-03-31 10:15:00,986,1006,20,0,TRUE,NA,"0.1.4"
"20299","646",2023-03-31 10:30:00,986,1006,20,0,TRUE,NA,"0.1.4"
"20300","646",2023-03-31 10:45:00,986,1006,20,0,TRUE,NA,"0.1.4"
"20301","646",2023-03-31 11:00:00,986,1006,20,0,TRUE,NA,"0.1.4"
"20302","646",2023-03-31 11:15:00,986,1006,20,0,TRUE,NA,"0.1.4"
"20303","646",2023-03-31 11:30:00,986,1006,20,0,TRUE,NA,"0.1.4"
"20304","646",2023-03-31 11:45:00,986,1006,20,0,TRUE,NA,"0.1.4"
"20305","646",2023-03-31 12:00:00,986,1006,20,0,TRUE,NA,"0.1.4"
"20306","646",2023-03-31 12:15:00,986,1006,20,0,TRUE,NA,"0.1.4"
"20307","646",2023-03-31 12:30:00,986,1006,20,0,TRUE,NA,"0.1.4"
"20308","646",2023-03-31 12:45:00,986,1006,20,0,TRUE,NA,"0.1.4"
"20309","646",2023-03-31 13:00:00,986,1006,20,0,TRUE,NA,"0.1.4"
"20310","646",2023-03-31 13:15:00,986,1006,20,0,TRUE,NA,"0.1.4"
"20311","646",2023-03-31 13:30:00,986,1006,20,0,TRUE,NA,"0.1.4"
"20312","646",2023-03-31 13:45:00,986,1006,20,0,TRUE,NA,"0.1.4"
"20313","646",2023-03-31 14:00:00,986,1006,20,0,TRUE,NA,"0.1.4"
"20314","646",2023-03-31 14:15:00,986,1006,20,0,TRUE,NA,"0.1.4"
"20315","646",2023-03-31 14:30:00,986,1006,20,0,TRUE,NA,"0.1.4"
"20316","646",2023-03-31 14:45:00,986,1006,20,0,TRUE,NA,"0.1.4"
"20317","646",2023-03-31 15:00:00,986,1006,20,0,TRUE,NA,"0.1.4"
"20318","646",2023-03-31 15:15:00,986,1006,20,0,TRUE,NA,"0.1.4"
"20319","646",2023-03-31 15:30:00,986,1006,20,0,TRUE,NA,"0.1.4"
"20320","646",2023-03-31 15:45:00,986,1006,20,0,TRUE,NA,"0.1.4"
"20321","646",2023-03-31 16:00:00,986,1006,20,0,TRUE,NA,"0.1.4"
"20322","646",2023-03-31 16:15:00,986,1006,20,0,TRUE,NA,"0.1.4"
"20323","646",2023-03-31 16:30:00,986,1006,20,0,TRUE,NA,"0.1.4"
"20324","646",2023-03-31 16:45:00,986,1006,20,0,TRUE,NA,"0.1.4"
"20325","646",2023-03-31 17:00:00,986,1006,20,0,TRUE,NA,"0.1.4"
"20326","646",2023-03-31 17:15:00,986,1006,20,0,TRUE,NA,"0.1.4"
"20327","646",2023-03-31 17:30:00,986,1006,20,0,TRUE,NA,"0.1.4"
"20328","646",2023-03-31 17:45:00,986,1006,20,0,TRUE,NA,"0.1.4"
"20329","646",2023-03-31 18:00:00,986,1006,20,0,TRUE,NA,"0.1.4"
"20330","646",2023-03-31 18:15:00,986,1006,20,0,TRUE,NA,"0.1.4"
"20331","646",2023-03-31 18:30:00,986,1006,20,0,TRUE,NA,"0.1.4"
"20332","646",2023-03-31 18:45:00,986,1006,20,0,TRUE,NA,"0.1.4"
"20333","646",2023-03-31 19:00:00,986,1006,20,0,TRUE,NA,"0.1.4"
"20334","646",2023-03-31 19:15:00,986,1006,20,0,TRUE,NA,"0.1.4"
"20335","646",2023-03-31 19:30:00,986,1006,20,0,TRUE,NA,"0.1.4"
"20336","646",2023-03-31 19:45:00,986,1006,20,0,TRUE,NA,"0.1.4"
"20337","646",2023-03-31 20:00:00,986,1006,20,0,TRUE,NA,"0.1.4"
"20338","646",2023-03-31 20:15:00,986,1006,20,0,TRUE,NA,"0.1.4"
"20339","646",2023-03-31 20:30:00,986,1006,20,0,TRUE,NA,"0.1.4"
"20340","646",2023-03-31 20:45:00,986,1006,20,0,TRUE,NA,"0.1.4"
"20341","646",2023-03-31 21:00:00,986,1006,20,0,TRUE,NA,"0.1.4"
"20342","646",2023-03-31 21:15:00,986,1006,20,0,TRUE,NA,"0.1.4"
"20343","646",2023-03-31 21:30:00,986,1006,20,0,TRUE,NA,"0.1.4"
"20344","646",2023-03-31 21:45:00,986,1006,20,0,TRUE,NA,"0.1.4"
"20345","646",2023-03-31 22:00:00,986,1006,20,0,TRUE,NA,"0.1.4"
"20346","646",2023-03-31 22:15:00,986,1006,20,0,TRUE,NA,"0.1.4"
"20347","646",2023-03-31 22:30:00,986,1006,20,0,TRUE,NA,"0.1.4"
"20348","646",2023-03-31 22:45:00,986,1006,20,0,TRUE,NA,"0.1.4"
"20349","646",2023-03-31 23:00:00,986,1006,20,0,TRUE,NA,"0.1.4"
"20350","646",2023-03-31 23:15:00,986,1006,20,0,TRUE,NA,"0.1.4"
"20351","646",2023-03-31 23:30:00,986,1006,20,0,TRUE,NA,"0.1.4"
"20352","646",2023-03-31 23:45:00,986,1006,20,0,TRUE,NA,"0.1.4"
"20353","646",2023-04-01,986,1006,20,0,TRUE,NA,"0.1.4"
"20354","646",2023-04-01 00:15:00,986,1006,20,0,TRUE,NA,"0.1.4"
"20355","646",2023-04-01 00:30:00,986,1006,20,0,TRUE,NA,"0.1.4"
"20356","646",2023-04-01 00:45:00,986,1006,20,0,TRUE,NA,"0.1.4"
"20357","646",2023-04-01 01:00:00,986,1006,20,0,TRUE,NA,"0.1.4"
"20358","646",2023-04-01 01:15:00,986,1006,20,0,TRUE,NA,"0.1.4"
"20359","646",2023-04-01 01:30:00,986,1006,20,0,TRUE,NA,"0.1.4"
"20360","646",2023-04-01 01:45:00,986,1006,20,0,TRUE,NA,"0.1.4"
"20361","646",2023-04-01 02:00:00,986,1006,20,0,TRUE,NA,"0.1.4"
"20362","646",2023-04-01 02:15:00,986,1006,20,0,TRUE,NA,"0.1.4"
"20363","646",2023-04-01 02:30:00,986,1006,20,0,TRUE,NA,"0.1.4"
"20364","646",2023-04-01 02:45:00,986,1006,20,0,TRUE,NA,"0.1.4"
"20365","646",2023-04-01 03:00:00,986,1006,20,0,TRUE,NA,"0.1.4"
"20366","646",2023-04-01 03:15:00,986,1006,20,0,TRUE,NA,"0.1.4"
"20367","646",2023-04-01 03:30:00,986,1006,20,0,TRUE,NA,"0.1.4"
"20368","646",2023-04-01 03:45:00,986,1006,20,0,TRUE,NA,"0.1.4"
"20369","646",2023-04-01 04:00:00,986,1006,20,0,TRUE,NA,"0.1.4"
"20370","646",2023-04-01 04:15:00,986,1006,20,0,TRUE,NA,"0.1.4"
"20371","646",2023-04-01 04:30:00,986,1006,20,0,TRUE,NA,"0.1.4"
"20372","646",2023-04-01 04:45:00,986,1006,20,0,TRUE,NA,"0.1.4"
"20373","646",2023-04-01 05:00:00,986,1006,20,0,TRUE,NA,"0.1.4"
"20374","646",2023-04-01 05:15:00,986,1006,20,0,TRUE,NA,"0.1.4"
"20375","646",2023-04-01 05:30:00,986,1006,20,0,TRUE,NA,"0.1.4"
"20376","646",2023-04-01 05:45:00,986,1006,20,0,TRUE,NA,"0.1.4"
"20377","646",2023-04-01 06:00:00,986,1006,20,0,TRUE,NA,"0.1.4"
"20378","646",2023-04-01 06:15:00,986,1006,20,0,TRUE,NA,"0.1.4"
"20379","646",2023-04-01 06:30:00,986,1006,20,0,TRUE,NA,"0.1.4"
"20380","646",2023-04-01 06:45:00,986,1006,20,0,TRUE,NA,"0.1.4"
"20381","646",2023-04-01 07:00:00,986,1006,20,0,TRUE,NA,"0.1.4"
"20382","646",2023-04-01 07:15:00,986,1006,20,0,TRUE,NA,"0.1.4"
"20383","646",2023-04-01 07:30:00,986,1006,20,0,TRUE,NA,"0.1.4"
"20384","646",2023-04-01 07:45:00,986,1006,20,0,TRUE,NA,"0.1.4"
"20385","646",2023-04-01 08:00:00,986,1006,20,0,TRUE,NA,"0.1.4"
"20386","646",2023-04-01 08:15:00,986,1006,20,0,TRUE,NA,"0.1.4"
"20387","646",2023-04-01 08:30:00,986,1006,20,0,TRUE,NA,"0.1.4"
"20388","646",2023-04-01 08:45:00,986,1006,20,0,TRUE,NA,"0.1.4"
"20389","646",2023-04-01 09:00:00,986,1006,20,0,TRUE,NA,"0.1.4"
"20390","646",2023-04-01 09:15:00,986,1006,20,0,TRUE,NA,"0.1.4"
"20391","646",2023-04-01 09:30:00,986,1006,20,0,TRUE,NA,"0.1.4"
"20392","646",2023-04-01 09:45:00,986,1006,20,0,TRUE,NA,"0.1.4"
"20393","646",2023-04-01 10:00:00,986,1006,20,0,TRUE,NA,"0.1.4"
"20394","646",2023-04-01 10:15:00,986,1006,20,0,TRUE,NA,"0.1.4"
"20395","646",2023-04-01 10:30:00,986,1006,20,0,TRUE,NA,"0.1.4"
"20396","646",2023-04-01 10:45:00,986,1006,20,0,TRUE,NA,"0.1.4"
"20397","646",2023-04-01 11:00:00,986,1006,20,0,TRUE,NA,"0.1.4"
"20398","646",2023-04-01 11:15:00,986,1006,20,0,TRUE,NA,"0.1.4"
"20399","646",2023-04-01 11:30:00,986,1006,20,0,TRUE,NA,"0.1.4"
"20400","646",2023-04-01 11:45:00,986,1006,20,0,TRUE,NA,"0.1.4"
"20401","646",2023-04-01 12:00:00,986,1006,20,0,TRUE,NA,"0.1.4"
"20402","646",2023-04-01 12:15:00,986,1006,20,0,TRUE,NA,"0.1.4"
"20403","646",2023-04-01 12:30:00,986,1006,20,0,TRUE,NA,"0.1.4"
"20404","646",2023-04-01 12:45:00,986,1006,20,0,TRUE,NA,"0.1.4"
"20405","646",2023-04-01 13:00:00,986,1006,20,0,TRUE,NA,"0.1.4"
"20406","646",2023-04-01 13:15:00,986,1006,20,0,TRUE,NA,"0.1.4"
"20407","646",2023-04-01 13:30:00,986,1006,20,0,TRUE,NA,"0.1.4"
"20408","646",2023-04-01 13:45:00,986,1006,20,0,TRUE,NA,"0.1.4"
"20409","646",2023-04-01 14:00:00,986,1006,20,0,TRUE,NA,"0.1.4"
"20410","646",2023-04-01 14:15:00,986,1006,20,0,TRUE,NA,"0.1.4"
"20411","646",2023-04-01 14:30:00,986,1006,20,0,TRUE,NA,"0.1.4"
"20412","646",2023-04-01 14:45:00,986,1006,20,0,TRUE,NA,"0.1.4"
"20413","646",2023-04-01 15:00:00,986,1006,20,0,TRUE,NA,"0.1.4"
"20414","646",2023-04-01 15:15:00,986,1006,20,0,TRUE,NA,"0.1.4"
"20415","646",2023-04-01 15:30:00,986,1006,20,0,TRUE,NA,"0.1.4"
"20416","646",2023-04-01 15:45:00,986,1006,20,0,TRUE,NA,"0.1.4"
"20417","646",2023-04-01 16:00:00,986,1006,20,0,TRUE,NA,"0.1.4"
"20418","646",2023-04-01 16:15:00,986,1006,20,0,TRUE,NA,"0.1.4"
"20419","646",2023-04-01 16:30:00,986,1006,20,0,TRUE,NA,"0.1.4"
"20420","646",2023-04-01 16:45:00,986,1006,20,0,TRUE,NA,"0.1.4"
"20421","646",2023-04-01 17:00:00,986,1006,20,0,TRUE,NA,"0.1.4"
"20422","646",2023-04-01 17:15:00,986,1006,20,0,TRUE,NA,"0.1.4"
"20423","646",2023-04-01 17:30:00,986,1006,20,0,TRUE,NA,"0.1.4"
"20424","646",2023-04-01 17:45:00,986,1006,20,0,TRUE,NA,"0.1.4"
"20425","646",2023-04-01 18:00:00,986,1006,20,0,TRUE,NA,"0.1.4"
"20426","646",2023-04-01 18:15:00,986,1006,20,0,TRUE,NA,"0.1.4"
"20427","646",2023-04-01 18:30:00,986,1006,20,0,TRUE,NA,"0.1.4"
"20428","646",2023-04-01 18:45:00,986,1006,20,0,TRUE,NA,"0.1.4"
"20429","646",2023-04-01 19:00:00,986,1006,20,0,TRUE,NA,"0.1.4"
"20430","646",2023-04-01 19:15:00,986,1006,20,0,TRUE,NA,"0.1.4"
"20431","646",2023-04-01 19:30:00,986,1006,20,0,TRUE,NA,"0.1.4"
"20432","646",2023-04-01 19:45:00,986,1006,20,0,TRUE,NA,"0.1.4"
"20433","646",2023-04-01 20:00:00,986,1006,20,0,TRUE,NA,"0.1.4"
"20434","646",2023-04-01 20:15:00,986,1006,20,0,TRUE,NA,"0.1.4"
"20435","646",2023-04-01 20:30:00,986,1006,20,0,TRUE,NA,"0.1.4"
"20436","646",2023-04-01 20:45:00,986,1006,20,0,TRUE,NA,"0.1.4"
"20437","646",2023-04-01 21:00:00,986,1006,20,0,TRUE,NA,"0.1.4"
"20438","646",2023-04-01 21:15:00,986,1006,20,0,TRUE,NA,"0.1.4"
"20439","646",2023-04-01 21:30:00,986,1006,20,0,TRUE,NA,"0.1.4"
"20440","646",2023-04-01 21:45:00,986,1006,20,0,TRUE,NA,"0.1.4"
"20441","646",2023-04-01 22:00:00,986,1006,20,0,TRUE,NA,"0.1.4"
"20442","646",2023-04-01 22:15:00,986,1006,20,0,TRUE,NA,"0.1.4"
"20443","646",2023-04-01 22:30:00,986,1006,20,0,TRUE,NA,"0.1.4"
"20444","646",2023-04-01 22:45:00,986,1006,20,0,TRUE,NA,"0.1.4"
"20445","646",2023-04-01 23:00:00,986,1006,20,0,TRUE,NA,"0.1.4"
"20446","646",2023-04-01 23:15:00,986,1006,20,0,TRUE,NA,"0.1.4"
"20447","646",2023-04-01 23:30:00,986,1006,20,0,TRUE,NA,"0.1.4"
"20448","646",2023-04-01 23:45:00,986,1006,20,0,TRUE,NA,"0.1.4"
"20449","646",2023-04-02,986,1006,20,0,TRUE,NA,"0.1.4"
"20450","646",2023-04-02 00:15:00,986,1006,20,0,TRUE,NA,"0.1.4"
"20451","646",2023-04-02 00:30:00,986,1006,20,0,TRUE,NA,"0.1.4"
"20452","646",2023-04-02 00:45:00,986,1006,20,0,TRUE,NA,"0.1.4"
"20453","646",2023-04-02 01:00:00,986,1006,20,0,TRUE,NA,"0.1.4"
"20454","646",2023-04-02 01:15:00,986,1006,20,0,TRUE,NA,"0.1.4"
"20455","646",2023-04-02 01:30:00,986,1006,20,0,TRUE,NA,"0.1.4"
"20456","646",2023-04-02 01:45:00,986,1006,20,0,TRUE,NA,"0.1.4"
"20457","646",2023-04-02 02:00:00,986,1006,20,0,TRUE,NA,"0.1.4"
"20458","646",2023-04-02 02:15:00,986,1006,20,0,TRUE,NA,"0.1.4"
"20459","646",2023-04-02 02:30:00,986,1006,20,0,TRUE,NA,"0.1.4"
"20460","646",2023-04-02 02:45:00,986,1006,20,0,TRUE,NA,"0.1.4"
"20461","646",2023-04-02 03:00:00,986,1006,20,0,TRUE,NA,"0.1.4"
"20462","646",2023-04-02 03:15:00,986,1006,20,0,TRUE,NA,"0.1.4"
"20463","646",2023-04-02 03:30:00,986,1006,20,0,TRUE,NA,"0.1.4"
"20464","646",2023-04-02 03:45:00,986,1006,20,0,TRUE,NA,"0.1.4"
"20465","646",2023-04-02 04:00:00,986,1006,20,0,TRUE,NA,"0.1.4"
"20466","646",2023-04-02 04:15:00,986,1006,20,0,TRUE,NA,"0.1.4"
"20467","646",2023-04-02 04:30:00,986,1006,20,0,TRUE,NA,"0.1.4"
"20468","646",2023-04-02 04:45:00,986,1006,20,0,TRUE,NA,"0.1.4"
"20469","646",2023-04-02 05:00:00,986,1006,20,0,TRUE,NA,"0.1.4"
"20470","646",2023-04-02 05:15:00,986,1006,20,0,TRUE,NA,"0.1.4"
"20471","646",2023-04-02 05:30:00,986,1006,20,0,TRUE,NA,"0.1.4"
"20472","646",2023-04-02 05:45:00,986,1006,20,0,TRUE,NA,"0.1.4"
"20473","646",2023-04-02 06:00:00,986,1006,20,0,TRUE,NA,"0.1.4"
"20474","646",2023-04-02 06:15:00,986,1006,20,0,TRUE,NA,"0.1.4"
"20475","646",2023-04-02 06:30:00,986,1006,20,0,TRUE,NA,"0.1.4"
"20476","646",2023-04-02 06:45:00,986,1006,20,0,TRUE,NA,"0.1.4"
"20477","646",2023-04-02 07:00:00,986,1006,20,0,TRUE,NA,"0.1.4"
"20478","646",2023-04-02 07:15:00,986,1006,20,0,TRUE,NA,"0.1.4"
"20479","646",2023-04-02 07:30:00,986,1006,20,0,TRUE,NA,"0.1.4"
"20480","646",2023-04-02 07:45:00,986,1006,20,0,TRUE,NA,"0.1.4"
"20481","646",2023-04-02 08:00:00,986,1006,20,0,TRUE,NA,"0.1.4"
"20482","646",2023-04-02 08:15:00,986,1006,20,0,TRUE,NA,"0.1.4"
"20483","646",2023-04-02 08:30:00,986,1006,20,0,TRUE,NA,"0.1.4"
"20484","646",2023-04-02 08:45:00,986,1006,20,0,TRUE,NA,"0.1.4"
"20485","646",2023-04-02 09:00:00,986,1006,20,0,TRUE,NA,"0.1.4"
"20486","646",2023-04-02 09:15:00,986,1006,20,0,TRUE,NA,"0.1.4"
"20487","646",2023-04-02 09:30:00,987,1006,19,0,TRUE,NA,"0.1.4"
"20488","646",2023-04-02 09:45:00,986,1006,20,0,TRUE,NA,"0.1.4"
"20489","646",2023-04-02 10:00:00,986,1006,20,0,TRUE,NA,"0.1.4"
"20490","646",2023-04-02 10:15:00,986,1006,20,0,TRUE,NA,"0.1.4"
"20491","646",2023-04-02 10:30:00,986,1006,20,0,TRUE,NA,"0.1.4"
"20492","646",2023-04-02 10:45:00,986,1006,20,0,TRUE,NA,"0.1.4"
"20493","646",2023-04-02 11:00:00,986,1006,20,0,TRUE,NA,"0.1.4"
"20494","646",2023-04-02 11:15:00,986,1006,20,0,TRUE,NA,"0.1.4"
"20495","646",2023-04-02 11:30:00,987,1006,19,0,TRUE,NA,"0.1.4"
"20496","646",2023-04-02 11:45:00,986,1006,20,0,TRUE,NA,"0.1.4"
"20497","646",2023-04-02 12:00:00,986,1006,20,0,TRUE,NA,"0.1.4"
"20498","646",2023-04-02 12:15:00,986,1006,20,0,TRUE,NA,"0.1.4"
"20499","646",2023-04-02 12:30:00,986,1006,20,0,TRUE,NA,"0.1.4"
"20500","646",2023-04-02 12:45:00,986,1006,20,0,TRUE,NA,"0.1.4"
"20501","646",2023-04-02 13:00:00,987,1006,19,0,TRUE,NA,"0.1.4"
"20502","646",2023-04-02 13:15:00,987,1006,19,0,TRUE,NA,"0.1.4"
"20503","646",2023-04-02 13:30:00,987,1006,19,0,TRUE,NA,"0.1.4"
"20504","646",2023-04-02 13:45:00,987,1006,19,0,TRUE,NA,"0.1.4"
"20505","646",2023-04-02 14:00:00,986,1006,20,0,TRUE,NA,"0.1.4"
"20506","646",2023-04-02 14:15:00,986,1006,20,0,TRUE,NA,"0.1.4"
"20507","646",2023-04-02 14:30:00,986,1006,20,0,TRUE,NA,"0.1.4"
"20508","646",2023-04-02 14:45:00,987,1006,19,0,TRUE,NA,"0.1.4"
"20509","646",2023-04-02 15:00:00,986,1006,20,0,TRUE,NA,"0.1.4"
"20510","646",2023-04-02 15:15:00,987,1006,19,0,TRUE,NA,"0.1.4"
"20511","646",2023-04-02 15:30:00,986,1006,20,0,TRUE,NA,"0.1.4"
"20512","646",2023-04-02 15:45:00,987,1006,19,0,TRUE,NA,"0.1.4"
"20513","646",2023-04-02 16:00:00,986,1006,20,0,TRUE,NA,"0.1.4"
"20514","646",2023-04-02 16:15:00,986,1006,20,0,TRUE,NA,"0.1.4"
"20515","646",2023-04-02 16:30:00,986,1006,20,0,TRUE,NA,"0.1.4"
"20516","646",2023-04-02 16:45:00,986,1006,20,0,TRUE,NA,"0.1.4"
"20517","646",2023-04-02 17:00:00,986,1006,20,0,TRUE,NA,"0.1.4"
"20518","646",2023-04-02 17:15:00,987,1006,19,0,TRUE,NA,"0.1.4"
"20519","646",2023-04-02 17:30:00,986,1006,20,0,TRUE,NA,"0.1.4"
"20520","646",2023-04-02 17:45:00,987,1006,19,0,TRUE,NA,"0.1.4"
"20521","646",2023-04-02 18:00:00,987,1006,19,0,TRUE,NA,"0.1.4"
"20522","646",2023-04-02 18:15:00,987,1006,19,0,TRUE,NA,"0.1.4"
"20523","646",2023-04-02 18:30:00,987,1006,19,0,TRUE,NA,"0.1.4"
"20524","646",2023-04-02 18:45:00,987,1006,19,0,TRUE,NA,"0.1.4"
"20525","646",2023-04-02 19:00:00,987,1006,19,0,TRUE,NA,"0.1.4"
"20526","646",2023-04-02 19:15:00,987,1006,19,0,TRUE,NA,"0.1.4"
"20527","646",2023-04-02 19:30:00,986,1006,20,0,TRUE,NA,"0.1.4"
"20528","646",2023-04-02 19:45:00,987,1006,19,0,TRUE,NA,"0.1.4"
"20529","646",2023-04-02 20:00:00,987,1006,19,0,TRUE,NA,"0.1.4"
"20530","646",2023-04-02 20:15:00,987,1006,19,0,TRUE,NA,"0.1.4"
"20531","646",2023-04-02 20:30:00,987,1006,19,0,TRUE,NA,"0.1.4"
"20532","646",2023-04-02 20:45:00,986,1006,20,0,TRUE,NA,"0.1.4"
"20533","646",2023-04-02 21:00:00,986,1006,20,0,TRUE,NA,"0.1.4"
"20534","646",2023-04-02 21:15:00,986,1006,20,0,TRUE,NA,"0.1.4"
"20535","646",2023-04-02 21:30:00,987,1006,19,0,TRUE,NA,"0.1.4"
"20536","646",2023-04-02 21:45:00,987,1006,19,0,TRUE,NA,"0.1.4"
"20537","646",2023-04-02 22:00:00,986,1006,20,0,TRUE,NA,"0.1.4"
"20538","646",2023-04-02 22:15:00,986,1006,20,0,TRUE,NA,"0.1.4"
"20539","646",2023-04-02 22:30:00,987,1006,19,0,TRUE,NA,"0.1.4"
"20540","646",2023-04-02 22:45:00,987,1006,19,0,TRUE,NA,"0.1.4"
"20541","646",2023-04-02 23:00:00,987,1006,19,0,TRUE,NA,"0.1.4"
"20542","646",2023-04-02 23:15:00,987,1006,19,0,TRUE,NA,"0.1.4"
"20543","646",2023-04-02 23:30:00,987,1006,19,0,TRUE,NA,"0.1.4"
"20544","646",2023-04-02 23:45:00,987,1006,19,0,TRUE,NA,"0.1.4"
"20545","646",2023-04-03,987,1006,19,0,TRUE,NA,"0.1.4"
"20546","646",2023-04-03 00:15:00,987,1006,19,0,TRUE,NA,"0.1.4"
"20547","646",2023-04-03 00:30:00,987,1006,19,0,TRUE,NA,"0.1.4"
"20548","646",2023-04-03 00:45:00,987,1006,19,0,TRUE,NA,"0.1.4"
"20549","646",2023-04-03 01:00:00,987,1006,19,0,TRUE,NA,"0.1.4"
"20550","646",2023-04-03 01:15:00,987,1006,19,0,TRUE,NA,"0.1.4"
"20551","646",2023-04-03 01:30:00,987,1006,19,0,TRUE,NA,"0.1.4"
"20552","646",2023-04-03 01:45:00,987,1006,19,0,TRUE,NA,"0.1.4"
"20553","646",2023-04-03 02:00:00,987,1006,19,0,TRUE,NA,"0.1.4"
"20554","646",2023-04-03 02:15:00,987,1006,19,0,TRUE,NA,"0.1.4"
"20555","646",2023-04-03 02:30:00,987,1006,19,0,TRUE,NA,"0.1.4"
"20556","646",2023-04-03 02:45:00,987,1006,19,0,TRUE,NA,"0.1.4"
"20557","646",2023-04-03 03:00:00,987,1006,19,0,TRUE,NA,"0.1.4"
"20558","646",2023-04-03 03:15:00,987,1006,19,0,TRUE,NA,"0.1.4"
"20559","646",2023-04-03 03:30:00,987,1006,19,0,TRUE,NA,"0.1.4"
"20560","646",2023-04-03 03:45:00,987,1006,19,0,TRUE,NA,"0.1.4"
"20561","646",2023-04-03 04:00:00,987,1006,19,0,TRUE,NA,"0.1.4"
"20562","646",2023-04-03 04:15:00,987,1006,19,0,TRUE,NA,"0.1.4"
"20563","646",2023-04-03 04:30:00,987,1006,19,0,TRUE,NA,"0.1.4"
"20564","646",2023-04-03 04:45:00,987,1006,19,0,TRUE,NA,"0.1.4"
"20565","646",2023-04-03 05:00:00,987,1006,19,0,TRUE,NA,"0.1.4"
"20566","646",2023-04-03 05:15:00,987,1006,19,0,TRUE,NA,"0.1.4"
"20567","646",2023-04-03 05:30:00,987,1006,19,0,TRUE,NA,"0.1.4"
"20568","646",2023-04-03 05:45:00,987,1006,19,0,TRUE,NA,"0.1.4"
"20569","646",2023-04-03 06:00:00,987,1006,19,0,TRUE,NA,"0.1.4"
"20570","646",2023-04-03 06:15:00,987,1006,19,0,TRUE,NA,"0.1.4"
"20571","646",2023-04-03 06:30:00,987,1006,19,0,TRUE,NA,"0.1.4"
"20572","646",2023-04-03 06:45:00,987,1006,19,0,TRUE,NA,"0.1.4"
"20573","646",2023-04-03 07:00:00,987,1006,19,0,TRUE,NA,"0.1.4"
"20574","646",2023-04-03 07:15:00,987,1006,19,0,TRUE,NA,"0.1.4"
"20575","646",2023-04-03 07:30:00,987,1006,19,0,TRUE,NA,"0.1.4"
"20576","646",2023-04-03 07:45:00,987,1006,19,0,TRUE,NA,"0.1.4"
"20577","646",2023-04-03 08:00:00,987,1006,19,0,TRUE,NA,"0.1.4"
"20578","646",2023-04-03 08:15:00,987,1006,19,0,TRUE,NA,"0.1.4"
"20579","646",2023-04-03 08:30:00,987,1006,19,0,TRUE,NA,"0.1.4"
"20580","646",2023-04-03 08:45:00,987,1006,19,0,TRUE,NA,"0.1.4"
"20581","646",2023-04-03 09:00:00,987,1006,19,0,TRUE,NA,"0.1.4"
"20582","646",2023-04-03 09:15:00,987,1006,19,0,TRUE,NA,"0.1.4"
"20583","646",2023-04-03 09:30:00,987,1006,19,0,TRUE,NA,"0.1.4"
"20584","646",2023-04-03 09:45:00,987,1006,19,0,TRUE,NA,"0.1.4"
"20585","646",2023-04-03 10:00:00,987,1006,19,0,TRUE,NA,"0.1.4"
"20586","646",2023-04-03 10:15:00,987,1006,19,0,TRUE,NA,"0.1.4"
"20587","646",2023-04-03 10:30:00,987,1006,19,0,TRUE,NA,"0.1.4"
"20588","646",2023-04-03 10:45:00,987,1006,19,0,TRUE,NA,"0.1.4"
"20589","646",2023-04-03 11:00:00,987,1006,19,0,TRUE,NA,"0.1.4"
"20590","646",2023-04-03 11:15:00,987,1006,19,0,TRUE,NA,"0.1.4"
"20591","646",2023-04-03 11:30:00,987,1006,19,0,TRUE,NA,"0.1.4"
"20592","646",2023-04-03 11:45:00,987,1006,19,0,TRUE,NA,"0.1.4"
"20593","646",2023-04-03 12:00:00,987,1006,19,0,TRUE,NA,"0.1.4"
"20594","646",2023-04-03 12:15:00,987,1006,19,0,TRUE,NA,"0.1.4"
"20595","646",2023-04-03 12:30:00,987,1006,19,0,TRUE,NA,"0.1.4"
"20596","646",2023-04-03 12:45:00,987,1006,19,0,TRUE,NA,"0.1.4"
"20597","646",2023-04-03 13:00:00,987,1006,19,0,TRUE,NA,"0.1.4"
"20598","646",2023-04-03 13:15:00,987,1006,19,0,TRUE,NA,"0.1.4"
"20599","646",2023-04-03 13:30:00,987,1006,19,0,TRUE,NA,"0.1.4"
"20600","646",2023-04-03 13:45:00,987,1006,19,0,TRUE,NA,"0.1.4"
"20601","646",2023-04-03 14:00:00,987,1006,19,0,TRUE,NA,"0.1.4"
"20602","646",2023-04-03 14:15:00,987,1006,19,0,TRUE,NA,"0.1.4"
"20603","646",2023-04-03 14:30:00,987,1006,19,0,TRUE,NA,"0.1.4"
"20604","646",2023-04-03 14:45:00,987,1006,19,0,TRUE,NA,"0.1.4"
"20605","646",2023-04-03 15:00:00,987,1006,19,0,TRUE,NA,"0.1.4"
"20606","646",2023-04-03 15:15:00,987,1006,19,0,TRUE,NA,"0.1.4"
"20607","646",2023-04-03 15:30:00,987,1006,19,0,TRUE,NA,"0.1.4"
"20608","646",2023-04-03 15:45:00,987,1006,19,0,TRUE,NA,"0.1.4"
"20609","646",2023-04-03 16:00:00,987,1006,19,0,TRUE,NA,"0.1.4"
"20610","646",2023-04-03 16:15:00,987,1006,19,0,TRUE,NA,"0.1.4"
"20611","646",2023-04-03 16:30:00,987,1006,19,0,TRUE,NA,"0.1.4"
"20612","646",2023-04-03 16:45:00,987,1006,19,0,TRUE,NA,"0.1.4"
"20613","646",2023-04-03 17:00:00,987,1006,19,0,TRUE,NA,"0.1.4"
"20614","646",2023-04-03 17:15:00,987,1006,19,0,TRUE,NA,"0.1.4"
"20615","646",2023-04-03 17:30:00,987,1006,19,0,TRUE,NA,"0.1.4"
"20616","646",2023-04-03 17:45:00,987,1006,19,0,TRUE,NA,"0.1.4"
"20617","646",2023-04-03 18:00:00,987,1006,19,0,TRUE,NA,"0.1.4"
"20618","646",2023-04-03 18:15:00,987,1006,19,0,TRUE,NA,"0.1.4"
"20619","646",2023-04-03 18:30:00,987,1006,19,0,TRUE,NA,"0.1.4"
"20620","646",2023-04-03 18:45:00,987,1006,19,0,TRUE,NA,"0.1.4"
"20621","646",2023-04-03 19:00:00,987,1006,19,0,TRUE,NA,"0.1.4"
"20622","646",2023-04-03 19:15:00,987,1006,19,0,TRUE,NA,"0.1.4"
"20623","646",2023-04-03 19:30:00,987,1006,19,0,TRUE,NA,"0.1.4"
"20624","646",2023-04-03 19:45:00,987,1006,19,0,TRUE,NA,"0.1.4"
"20625","646",2023-04-03 20:00:00,987,1006,19,0,TRUE,NA,"0.1.4"
"20626","646",2023-04-03 20:15:00,987,1006,19,0,TRUE,NA,"0.1.4"
"20627","646",2023-04-03 20:30:00,987,1006,19,0,TRUE,NA,"0.1.4"
"20628","646",2023-04-03 20:45:00,987,1006,19,0,TRUE,NA,"0.1.4"
"20629","646",2023-04-03 21:00:00,987,1006,19,0,TRUE,NA,"0.1.4"
"20630","646",2023-04-03 21:15:00,987,1006,19,0,TRUE,NA,"0.1.4"
"20631","646",2023-04-03 21:30:00,987,1006,19,0,TRUE,NA,"0.1.4"
"20632","646",2023-04-03 21:45:00,987,1006,19,0,TRUE,NA,"0.1.4"
"20633","646",2023-04-03 22:00:00,987,1006,19,0,TRUE,NA,"0.1.4"
"20634","646",2023-04-03 22:15:00,987,1006,19,0,TRUE,NA,"0.1.4"
"20635","646",2023-04-03 22:30:00,987,1006,19,0,TRUE,NA,"0.1.4"
"20636","646",2023-04-03 22:45:00,987,1006,19,0,TRUE,NA,"0.1.4"
"20637","646",2023-04-03 23:00:00,987,1006,19,0,TRUE,NA,"0.1.4"
"20638","646",2023-04-03 23:15:00,987,1006,19,0,TRUE,NA,"0.1.4"
"20639","646",2023-04-03 23:30:00,987,1006,19,0,TRUE,NA,"0.1.4"
"20640","646",2023-04-03 23:45:00,987,1006,19,0,TRUE,NA,"0.1.4"
"20641","646",2023-04-04,987,1006,19,0,TRUE,NA,"0.1.4"
"20642","646",2023-04-04 00:15:00,987,1006,19,0,TRUE,NA,"0.1.4"
"20643","646",2023-04-04 00:30:00,987,1006,19,0,TRUE,NA,"0.1.4"
"20644","646",2023-04-04 00:45:00,987,1006,19,0,TRUE,NA,"0.1.4"
"20645","646",2023-04-04 01:00:00,987,1006,19,0,TRUE,NA,"0.1.4"
"20646","646",2023-04-04 01:15:00,987,1006,19,0,TRUE,NA,"0.1.4"
"20647","646",2023-04-04 01:30:00,987,1006,19,0,TRUE,NA,"0.1.4"
"20648","646",2023-04-04 01:45:00,987,1006,19,0,TRUE,NA,"0.1.4"
"20649","646",2023-04-04 02:00:00,987,1006,19,0,TRUE,NA,"0.1.4"
"20650","646",2023-04-04 02:15:00,987,1006,19,0,TRUE,NA,"0.1.4"
"20651","646",2023-04-04 02:30:00,987,1006,19,0,TRUE,NA,"0.1.4"
"20652","646",2023-04-04 02:45:00,987,1006,19,0,TRUE,NA,"0.1.4"
"20653","646",2023-04-04 03:00:00,987,1006,19,0,TRUE,NA,"0.1.4"
"20654","646",2023-04-04 03:15:00,987,1006,19,0,TRUE,NA,"0.1.4"
"20655","646",2023-04-04 03:30:00,987,1006,19,0,TRUE,NA,"0.1.4"
"20656","646",2023-04-04 03:45:00,987,1006,19,0,TRUE,NA,"0.1.4"
"20657","646",2023-04-04 04:00:00,987,1006,19,0,TRUE,NA,"0.1.4"
"20658","646",2023-04-04 04:15:00,987,1006,19,0,TRUE,NA,"0.1.4"
"20659","646",2023-04-04 04:30:00,987,1006,19,0,TRUE,NA,"0.1.4"
"20660","646",2023-04-04 04:45:00,987,1006,19,0,TRUE,NA,"0.1.4"
"20661","646",2023-04-04 05:00:00,987,1006,19,0,TRUE,NA,"0.1.4"
"20662","646",2023-04-04 05:15:00,987,1006,19,0,TRUE,NA,"0.1.4"
"20663","646",2023-04-04 05:30:00,987,1006,19,0,TRUE,NA,"0.1.4"
"20664","646",2023-04-04 05:45:00,987,1006,19,0,TRUE,NA,"0.1.4"
"20665","646",2023-04-04 06:00:00,987,1006,19,0,TRUE,NA,"0.1.4"
"20666","646",2023-04-04 06:15:00,987,1006,19,0,TRUE,NA,"0.1.4"
"20667","646",2023-04-04 06:30:00,987,1006,19,0,TRUE,NA,"0.1.4"
"20668","646",2023-04-04 06:45:00,987,1006,19,0,TRUE,NA,"0.1.4"
"20669","646",2023-04-04 07:00:00,987,1006,19,0,TRUE,NA,"0.1.4"
"20670","646",2023-04-04 07:15:00,987,1006,19,0,TRUE,NA,"0.1.4"
"20671","646",2023-04-04 07:30:00,987,1006,19,0,TRUE,NA,"0.1.4"
"20672","646",2023-04-04 07:45:00,987,1006,19,0,TRUE,NA,"0.1.4"
"20673","646",2023-04-04 08:00:00,987,1006,19,0,TRUE,NA,"0.1.4"
"20674","646",2023-04-04 08:15:00,987,1006,19,0,TRUE,NA,"0.1.4"
"20675","646",2023-04-04 08:30:00,987,1006,19,0,TRUE,NA,"0.1.4"
"20676","646",2023-04-04 08:45:00,987,1006,19,0,TRUE,NA,"0.1.4"
"20677","646",2023-04-04 09:00:00,987,1006,19,0,TRUE,NA,"0.1.4"
"20678","646",2023-04-04 09:15:00,987,1006,19,0,TRUE,NA,"0.1.4"
"20679","646",2023-04-04 09:30:00,987,1006,19,0,TRUE,NA,"0.1.4"
"20680","646",2023-04-04 09:45:00,987,1006,19,0,TRUE,NA,"0.1.4"
"20681","646",2023-04-04 10:00:00,987,1006,19,0,TRUE,NA,"0.1.4"
"20682","646",2023-04-04 10:15:00,987,1006,19,0,TRUE,NA,"0.1.4"
"20683","646",2023-04-04 10:30:00,987,1006,19,0,TRUE,NA,"0.1.4"
"20684","646",2023-04-04 10:45:00,987,1006,19,0,TRUE,NA,"0.1.4"
"20685","646",2023-04-04 11:00:00,987,1006,19,0,TRUE,NA,"0.1.4"
"20686","646",2023-04-04 11:15:00,987,1006,19,0,TRUE,NA,"0.1.4"
"20687","646",2023-04-04 11:30:00,987,1006,19,0,TRUE,NA,"0.1.4"
"20688","646",2023-04-04 11:45:00,987,1006,19,0,TRUE,NA,"0.1.4"
"20689","646",2023-04-04 12:00:00,987,1006,19,0,TRUE,NA,"0.1.4"
"20690","646",2023-04-04 12:15:00,987,1006,19,0,TRUE,NA,"0.1.4"
"20691","646",2023-04-04 12:30:00,987,1006,19,0,TRUE,NA,"0.1.4"
"20692","646",2023-04-04 12:45:00,987,1006,19,0,TRUE,NA,"0.1.4"
"20693","646",2023-04-04 13:00:00,987,1006,19,0,TRUE,NA,"0.1.4"
"20694","646",2023-04-04 13:15:00,987,1006,19,0,TRUE,NA,"0.1.4"
"20695","646",2023-04-04 13:30:00,987,1006,19,0,TRUE,NA,"0.1.4"
"20696","646",2023-04-04 13:45:00,987,1006,19,0,TRUE,NA,"0.1.4"
"20697","646",2023-04-04 14:00:00,987,1006,19,0,TRUE,NA,"0.1.4"
"20698","646",2023-04-04 14:15:00,987,1006,19,0,TRUE,NA,"0.1.4"
"20699","646",2023-04-04 14:30:00,987,1006,19,0,TRUE,NA,"0.1.4"
"20700","646",2023-04-04 14:45:00,987,1006,19,0,TRUE,NA,"0.1.4"
"20701","646",2023-04-04 15:00:00,987,1006,19,0,TRUE,NA,"0.1.4"
"20702","646",2023-04-04 15:15:00,987,1006,19,0,TRUE,NA,"0.1.4"
"20703","646",2023-04-04 15:30:00,987,1006,19,0,TRUE,NA,"0.1.4"
"20704","646",2023-04-04 15:45:00,987,1006,19,0,TRUE,NA,"0.1.4"
"20705","646",2023-04-04 16:00:00,987,1006,19,0,TRUE,NA,"0.1.4"
"20706","646",2023-04-04 16:15:00,987,1006,19,0,TRUE,NA,"0.1.4"
"20707","646",2023-04-04 16:30:00,987,1006,19,0,TRUE,NA,"0.1.4"
"20708","646",2023-04-04 16:45:00,987,1006,19,0,TRUE,NA,"0.1.4"
"20709","646",2023-04-04 17:00:00,987,1006,19,0,TRUE,NA,"0.1.4"
"20710","646",2023-04-04 17:15:00,987,1006,19,0,TRUE,NA,"0.1.4"
"20711","646",2023-04-04 17:30:00,987,1006,19,0,TRUE,NA,"0.1.4"
"20712","646",2023-04-04 17:45:00,987,1006,19,0,TRUE,NA,"0.1.4"
"20713","646",2023-04-04 18:00:00,987,1006,19,0,TRUE,NA,"0.1.4"
"20714","646",2023-04-04 18:15:00,987,1006,19,0,TRUE,NA,"0.1.4"
"20715","646",2023-04-04 18:30:00,987,1006,19,0,TRUE,NA,"0.1.4"
"20716","646",2023-04-04 18:45:00,987,1006,19,0,TRUE,NA,"0.1.4"
"20717","646",2023-04-04 19:00:00,987,1006,19,0,TRUE,NA,"0.1.4"
"20718","646",2023-04-04 19:15:00,987,1006,19,0,TRUE,NA,"0.1.4"
"20719","646",2023-04-04 19:30:00,987,1006,19,0,TRUE,NA,"0.1.4"
"20720","646",2023-04-04 19:45:00,987,1006,19,0,TRUE,NA,"0.1.4"
"20721","646",2023-04-04 20:00:00,987,1006,19,0,TRUE,NA,"0.1.4"
"20722","646",2023-04-04 20:15:00,987,1006,19,0,TRUE,NA,"0.1.4"
"20723","646",2023-04-04 20:30:00,987,1006,19,0,TRUE,NA,"0.1.4"
"20724","646",2023-04-04 20:45:00,987,1006,19,0,TRUE,NA,"0.1.4"
"20725","646",2023-04-04 21:00:00,987,1006,19,0,TRUE,NA,"0.1.4"
"20726","646",2023-04-04 21:15:00,987,1006,19,0,TRUE,NA,"0.1.4"
"20727","646",2023-04-04 21:30:00,987,1006,19,0,TRUE,NA,"0.1.4"
"20728","646",2023-04-04 21:45:00,987,1006,19,0,TRUE,NA,"0.1.4"
"20729","646",2023-04-04 22:00:00,987,1006,19,0,TRUE,NA,"0.1.4"
"20730","646",2023-04-04 22:15:00,987,1006,19,0,TRUE,NA,"0.1.4"
"20731","646",2023-04-04 22:30:00,987,1006,19,0,TRUE,NA,"0.1.4"
"20732","646",2023-04-04 22:45:00,987,1006,19,0,TRUE,NA,"0.1.4"
"20733","646",2023-04-04 23:00:00,987,1006,19,0,TRUE,NA,"0.1.4"
"20734","646",2023-04-04 23:15:00,987,1006,19,0,TRUE,NA,"0.1.4"
"20735","646",2023-04-04 23:30:00,987,1006,19,0,TRUE,NA,"0.1.4"
"20736","646",2023-04-04 23:45:00,987,1006,19,0,TRUE,NA,"0.1.4"
"20737","646",2023-04-05,987,1006,19,0,TRUE,NA,"0.1.4"
"20738","646",2023-04-05 00:15:00,987,1006,19,0,TRUE,NA,"0.1.4"
"20739","646",2023-04-05 00:30:00,987,1006,19,0,TRUE,NA,"0.1.4"
"20740","646",2023-04-05 00:45:00,987,1006,19,0,TRUE,NA,"0.1.4"
"20741","646",2023-04-05 01:00:00,987,1006,19,0,TRUE,NA,"0.1.4"
"20742","646",2023-04-05 01:15:00,987,1006,19,0,TRUE,NA,"0.1.4"
"20743","646",2023-04-05 01:30:00,987,1006,19,0,TRUE,NA,"0.1.4"
"20744","646",2023-04-05 01:45:00,987,1006,19,0,TRUE,NA,"0.1.4"
"20745","646",2023-04-05 02:00:00,987,1006,19,0,TRUE,NA,"0.1.4"
"20746","646",2023-04-05 02:15:00,987,1006,19,0,TRUE,NA,"0.1.4"
"20747","646",2023-04-05 02:30:00,987,1006,19,0,TRUE,NA,"0.1.4"
"20748","646",2023-04-05 02:45:00,987,1006,19,0,TRUE,NA,"0.1.4"
"20749","646",2023-04-05 03:00:00,987,1006,19,0,TRUE,NA,"0.1.4"
"20750","646",2023-04-05 03:15:00,987,1006,19,0,TRUE,NA,"0.1.4"
"20751","646",2023-04-05 03:30:00,987,1006,19,0,TRUE,NA,"0.1.4"
"20752","646",2023-04-05 03:45:00,987,1006,19,0,TRUE,NA,"0.1.4"
"20753","646",2023-04-05 04:00:00,987,1006,19,0,TRUE,NA,"0.1.4"
"20754","646",2023-04-05 04:15:00,987,1006,19,0,TRUE,NA,"0.1.4"
"20755","646",2023-04-05 04:30:00,987,1006,19,0,TRUE,NA,"0.1.4"
"20756","646",2023-04-05 04:45:00,987,1006,19,0,TRUE,NA,"0.1.4"
"20757","646",2023-04-05 05:00:00,987,1006,19,0,TRUE,NA,"0.1.4"
"20758","646",2023-04-05 05:15:00,987,1006,19,0,TRUE,NA,"0.1.4"
"20759","646",2023-04-05 05:30:00,987,1006,19,0,TRUE,NA,"0.1.4"
"20760","646",2023-04-05 05:45:00,987,1006,19,0,TRUE,NA,"0.1.4"
"20761","646",2023-04-05 06:00:00,987,1006,19,0,TRUE,NA,"0.1.4"
"20762","646",2023-04-05 06:15:00,987,1006,19,0,TRUE,NA,"0.1.4"
"20763","646",2023-04-05 06:30:00,987,1006,19,0,TRUE,NA,"0.1.4"
"20764","646",2023-04-05 06:45:00,987,1006,19,0,TRUE,NA,"0.1.4"
"20765","646",2023-04-05 07:00:00,987,1006,19,0,TRUE,NA,"0.1.4"
"20766","646",2023-04-05 07:15:00,987,1006,19,0,TRUE,NA,"0.1.4"
"20767","646",2023-04-05 07:30:00,987,1006,19,0,TRUE,NA,"0.1.4"
"20768","646",2023-04-05 07:45:00,987,1006,19,0,TRUE,NA,"0.1.4"
"20769","646",2023-04-05 08:00:00,987,1006,19,0,TRUE,NA,"0.1.4"
"20770","646",2023-04-05 08:15:00,987,1006,19,0,TRUE,NA,"0.1.4"
"20771","646",2023-04-05 08:30:00,987,1006,19,0,TRUE,NA,"0.1.4"
"20772","646",2023-04-05 08:45:00,987,1006,19,0,TRUE,NA,"0.1.4"
"20773","646",2023-04-05 09:00:00,987,1006,19,0,TRUE,NA,"0.1.4"
"20774","646",2023-04-05 09:15:00,987,1006,19,0,TRUE,NA,"0.1.4"
"20775","646",2023-04-05 09:30:00,987,1006,19,0,TRUE,NA,"0.1.4"
"20776","646",2023-04-05 09:45:00,987,1006,19,0,TRUE,NA,"0.1.4"
"20777","646",2023-04-05 10:00:00,987,1006,19,0,TRUE,NA,"0.1.4"
"20778","646",2023-04-05 10:15:00,987,1006,19,0,TRUE,NA,"0.1.4"
"20779","646",2023-04-05 10:30:00,987,1006,19,0,TRUE,NA,"0.1.4"
"20780","646",2023-04-05 10:45:00,987,1006,19,0,TRUE,NA,"0.1.4"
"20781","646",2023-04-05 11:00:00,987,1006,19,0,TRUE,NA,"0.1.4"
"20782","646",2023-04-05 11:15:00,987,1006,19,0,TRUE,NA,"0.1.4"
"20783","646",2023-04-05 11:30:00,987,1006,19,0,TRUE,NA,"0.1.4"
"20784","646",2023-04-05 11:45:00,987,1006,19,0,TRUE,NA,"0.1.4"
"20785","646",2023-04-05 12:00:00,987,1006,19,0,TRUE,NA,"0.1.4"
"20786","646",2023-04-05 12:15:00,987,1006,19,0,TRUE,NA,"0.1.4"
"20787","646",2023-04-05 12:30:00,987,1006,19,0,TRUE,NA,"0.1.4"
"20788","646",2023-04-05 12:45:00,987,1006,19,0,TRUE,NA,"0.1.4"
"20789","646",2023-04-05 13:00:00,987,1006,19,0,TRUE,NA,"0.1.4"
"20790","646",2023-04-05 13:15:00,987,1006,19,0,TRUE,NA,"0.1.4"
"20791","646",2023-04-05 13:30:00,987,1006,19,0,TRUE,NA,"0.1.4"
"20792","646",2023-04-05 13:45:00,987,1006,19,0,TRUE,NA,"0.1.4"
"20793","646",2023-04-05 14:00:00,987,1006,19,0,TRUE,NA,"0.1.4"
"20794","646",2023-04-05 14:15:00,987,1006,19,0,TRUE,NA,"0.1.4"
"20795","646",2023-04-05 14:30:00,987,1006,19,0,TRUE,NA,"0.1.4"
"20796","646",2023-04-05 14:45:00,987,1006,19,0,TRUE,NA,"0.1.4"
"20797","646",2023-04-05 15:00:00,987,1006,19,0,TRUE,NA,"0.1.4"
"20798","646",2023-04-05 15:15:00,987,1006,19,0,TRUE,NA,"0.1.4"
"20799","646",2023-04-05 15:30:00,987,1006,19,0,TRUE,NA,"0.1.4"
"20800","646",2023-04-05 15:45:00,987,1006,19,0,TRUE,NA,"0.1.4"
"20801","646",2023-04-05 16:00:00,987,1006,19,0,TRUE,NA,"0.1.4"
"20802","646",2023-04-05 16:15:00,987,1006,19,0,TRUE,NA,"0.1.4"
"20803","646",2023-04-05 16:30:00,987,1006,19,0,TRUE,NA,"0.1.4"
"20804","646",2023-04-05 16:45:00,987,1006,19,0,TRUE,NA,"0.1.4"
"20805","646",2023-04-05 17:00:00,987,1006,19,0,TRUE,NA,"0.1.4"
"20806","646",2023-04-05 17:15:00,987,1006,19,0,TRUE,NA,"0.1.4"
"20807","646",2023-04-05 17:30:00,987,1006,19,0,TRUE,NA,"0.1.4"
"20808","646",2023-04-05 17:45:00,987,1006,19,0,TRUE,NA,"0.1.4"
"20809","646",2023-04-05 18:00:00,987,1006,19,0,TRUE,NA,"0.1.4"
"20810","646",2023-04-05 18:15:00,987,1006,19,0,TRUE,NA,"0.1.4"
"20811","646",2023-04-05 18:30:00,987,1006,19,0,TRUE,NA,"0.1.4"
"20812","646",2023-04-05 18:45:00,987,1006,19,0,TRUE,NA,"0.1.4"
"20813","646",2023-04-05 19:00:00,987,1006,19,0,TRUE,NA,"0.1.4"
"20814","646",2023-04-05 19:15:00,987,1006,19,0,TRUE,NA,"0.1.4"
"20815","646",2023-04-05 19:30:00,987,1006,19,0,TRUE,NA,"0.1.4"
"20816","646",2023-04-05 19:45:00,987,1006,19,0,TRUE,NA,"0.1.4"
"20817","646",2023-04-05 20:00:00,987,1006,19,0,TRUE,NA,"0.1.4"
"20818","646",2023-04-05 20:15:00,987,1006,19,0,TRUE,NA,"0.1.4"
"20819","646",2023-04-05 20:30:00,987,1006,19,0,TRUE,NA,"0.1.4"
"20820","646",2023-04-05 20:45:00,987,1006,19,0,TRUE,NA,"0.1.4"
"20821","646",2023-04-05 21:00:00,987,1006,19,0,TRUE,NA,"0.1.4"
"20822","646",2023-04-05 21:15:00,987,1006,19,0,TRUE,NA,"0.1.4"
"20823","646",2023-04-05 21:30:00,987,1006,19,0,TRUE,NA,"0.1.4"
"20824","646",2023-04-05 21:45:00,987,1006,19,0,TRUE,NA,"0.1.4"
"20825","646",2023-04-05 22:00:00,987,1006,19,0,TRUE,NA,"0.1.4"
"20826","646",2023-04-05 22:15:00,987,1006,19,0,TRUE,NA,"0.1.4"
"20827","646",2023-04-05 22:30:00,987,1006,19,0,TRUE,NA,"0.1.4"
"20828","646",2023-04-05 22:45:00,987,1006,19,0,TRUE,NA,"0.1.4"
"20829","646",2023-04-05 23:00:00,987,1006,19,0,TRUE,NA,"0.1.4"
"20830","646",2023-04-05 23:15:00,987,1006,19,0,TRUE,NA,"0.1.4"
"20831","646",2023-04-05 23:30:00,987,1006,19,0,TRUE,NA,"0.1.4"
"20832","646",2023-04-05 23:45:00,987,1006,19,0,TRUE,NA,"0.1.4"
"20833","646",2023-04-06,987,1006,19,0,TRUE,NA,"0.1.4"
"20834","646",2023-04-06 00:15:00,987,1006,19,0,TRUE,NA,"0.1.4"
"20835","646",2023-04-06 00:30:00,987,1006,19,0,TRUE,NA,"0.1.4"
"20836","646",2023-04-06 00:45:00,987,1006,19,0,TRUE,NA,"0.1.4"
"20837","646",2023-04-06 01:00:00,987,1006,19,0,TRUE,NA,"0.1.4"
"20838","646",2023-04-06 01:15:00,987,1006,19,0,TRUE,NA,"0.1.4"
"20839","646",2023-04-06 01:30:00,987,1006,19,0,TRUE,NA,"0.1.4"
"20840","646",2023-04-06 01:45:00,987,1006,19,0,TRUE,NA,"0.1.4"
"20841","646",2023-04-06 02:00:00,987,1006,19,0,TRUE,NA,"0.1.4"
"20842","646",2023-04-06 02:15:00,987,1006,19,0,TRUE,NA,"0.1.4"
"20843","646",2023-04-06 02:30:00,987,1006,19,0,TRUE,NA,"0.1.4"
"20844","646",2023-04-06 02:45:00,987,1006,19,0,TRUE,NA,"0.1.4"
"20845","646",2023-04-06 03:00:00,987,1006,19,0,TRUE,NA,"0.1.4"
"20846","646",2023-04-06 03:15:00,987,1006,19,0,TRUE,NA,"0.1.4"
"20847","646",2023-04-06 03:30:00,987,1006,19,0,TRUE,NA,"0.1.4"
"20848","646",2023-04-06 03:45:00,987,1006,19,0,TRUE,NA,"0.1.4"
"20849","646",2023-04-06 04:00:00,987,1006,19,0,TRUE,NA,"0.1.4"
"20850","646",2023-04-06 04:15:00,987,1006,19,0,TRUE,NA,"0.1.4"
"20851","646",2023-04-06 04:30:00,987,1006,19,0,TRUE,NA,"0.1.4"
"20852","646",2023-04-06 04:45:00,987,1006,19,0,TRUE,NA,"0.1.4"
"20853","646",2023-04-06 05:00:00,987,1006,19,0,TRUE,NA,"0.1.4"
"20854","646",2023-04-06 05:15:00,987,1006,19,0,TRUE,NA,"0.1.4"
"20855","646",2023-04-06 05:30:00,987,1006,19,0,TRUE,NA,"0.1.4"
"20856","646",2023-04-06 05:45:00,987,1006,19,0,TRUE,NA,"0.1.4"
"20857","646",2023-04-06 06:00:00,987,1006,19,0,TRUE,NA,"0.1.4"
"20858","646",2023-04-06 06:15:00,987,1006,19,0,TRUE,NA,"0.1.4"
"20859","646",2023-04-06 06:30:00,987,1006,19,0,TRUE,NA,"0.1.4"
"20860","646",2023-04-06 06:45:00,987,1006,19,0,TRUE,NA,"0.1.4"
"20861","646",2023-04-06 07:00:00,987,1006,19,0,TRUE,NA,"0.1.4"
"20862","646",2023-04-06 07:15:00,987,1006,19,0,TRUE,NA,"0.1.4"
"20863","646",2023-04-06 07:30:00,987,1006,19,0,TRUE,NA,"0.1.4"
"20864","646",2023-04-06 07:45:00,987,1006,19,0,TRUE,NA,"0.1.4"
"20865","646",2023-04-06 08:00:00,987,1006,19,0,TRUE,NA,"0.1.4"
"20866","646",2023-04-06 08:15:00,987,1006,19,0,TRUE,NA,"0.1.4"
"20867","646",2023-04-06 08:30:00,987,1006,19,0,TRUE,NA,"0.1.4"
"20868","646",2023-04-06 08:45:00,987,1006,19,0,TRUE,NA,"0.1.4"
"20869","646",2023-04-06 09:00:00,987,1006,19,0,TRUE,NA,"0.1.4"
"20870","646",2023-04-06 09:15:00,987,1006,19,0,TRUE,NA,"0.1.4"
"20871","646",2023-04-06 09:30:00,987,1006,19,0,TRUE,NA,"0.1.4"
"20872","646",2023-04-06 09:45:00,987,1006,19,0,TRUE,NA,"0.1.4"
"20873","646",2023-04-06 10:00:00,987,1006,19,0,TRUE,NA,"0.1.4"
"20874","646",2023-04-06 10:15:00,987,1006,19,0,TRUE,NA,"0.1.4"
"20875","646",2023-04-06 10:30:00,987,1006,19,0,TRUE,NA,"0.1.4"
"20876","646",2023-04-06 10:45:00,987,1006,19,0,TRUE,NA,"0.1.4"
"20877","646",2023-04-06 11:00:00,987,1006,19,0,TRUE,NA,"0.1.4"
"20878","646",2023-04-06 11:15:00,987,1006,19,0,TRUE,NA,"0.1.4"
"20879","646",2023-04-06 11:30:00,987,1006,19,0,TRUE,NA,"0.1.4"
"20880","646",2023-04-06 11:45:00,987,1006,19,0,TRUE,NA,"0.1.4"
"20881","646",2023-04-06 12:00:00,987,1006,19,0,TRUE,NA,"0.1.4"
"20882","646",2023-04-06 12:15:00,987,1006,19,0,TRUE,NA,"0.1.4"
"20883","646",2023-04-06 12:30:00,987,1006,19,0,TRUE,NA,"0.1.4"
"20884","646",2023-04-06 12:45:00,987,1006,19,0,TRUE,NA,"0.1.4"
"20885","646",2023-04-06 13:00:00,987,1006,19,0,TRUE,NA,"0.1.4"
"20886","646",2023-04-06 13:15:00,987,1006,19,0,TRUE,NA,"0.1.4"
"20887","646",2023-04-06 13:30:00,987,1006,19,0,TRUE,NA,"0.1.4"
"20888","646",2023-04-06 13:45:00,987,1006,19,0,TRUE,NA,"0.1.4"
"20889","646",2023-04-06 14:00:00,987,1006,19,0,TRUE,NA,"0.1.4"
"20890","646",2023-04-06 14:15:00,987,1006,19,0,TRUE,NA,"0.1.4"
"20891","646",2023-04-06 14:30:00,987,1006,19,0,TRUE,NA,"0.1.4"
"20892","646",2023-04-06 14:45:00,987,1006,19,0,TRUE,NA,"0.1.4"
"20893","646",2023-04-06 15:00:00,987,1006,19,0,TRUE,NA,"0.1.4"
"20894","646",2023-04-06 15:15:00,987,1006,19,0,TRUE,NA,"0.1.4"
"20895","646",2023-04-06 15:30:00,987,1006,19,0,TRUE,NA,"0.1.4"
"20896","646",2023-04-06 15:45:00,987,1006,19,0,TRUE,NA,"0.1.4"
"20897","646",2023-04-06 16:00:00,987,1006,19,0,TRUE,NA,"0.1.4"
"20898","646",2023-04-06 16:15:00,987,1006,19,0,TRUE,NA,"0.1.4"
"20899","646",2023-04-06 16:30:00,987,1006,19,0,TRUE,NA,"0.1.4"
"20900","646",2023-04-06 16:45:00,987,1006,19,0,TRUE,NA,"0.1.4"
"20901","646",2023-04-06 17:00:00,987,1006,19,0,TRUE,NA,"0.1.4"
"20902","646",2023-04-06 17:15:00,987,1006,19,0,TRUE,NA,"0.1.4"
"20903","646",2023-04-06 17:30:00,987,1006,19,0,TRUE,NA,"0.1.4"
"20904","646",2023-04-06 17:45:00,987,1006,19,0,TRUE,NA,"0.1.4"
"20905","646",2023-04-06 18:00:00,987,1006,19,0,TRUE,NA,"0.1.4"
"20906","646",2023-04-06 18:15:00,987,1006,19,0,FALSE,NA,"0.1.4"
"20907","646",2023-04-06 18:30:00,987,1006,19,0,FALSE,NA,"0.1.4"
"20908","646",2023-04-06 18:45:00,987,1006,19,0,FALSE,NA,"0.1.4"
"20909","646",2023-04-06 19:00:00,987,1006,19,0,FALSE,NA,"0.1.4"
"20910","646",2023-04-06 19:15:00,987,1006,19,0,FALSE,NA,"0.1.4"
"20911","646",2023-04-06 19:30:00,987,1006,19,0,FALSE,NA,"0.1.4"
"20912","646",2023-04-06 19:45:00,987,1006,19,0,FALSE,NA,"0.1.4"
"20913","646",2023-04-06 20:00:00,987,1006,19,0,FALSE,NA,"0.1.4"
"20914","646",2023-04-06 20:15:00,987,1006,19,0,FALSE,NA,"0.1.4"
"20915","646",2023-04-06 20:30:00,987,1006,19,0,FALSE,NA,"0.1.4"
"20916","646",2023-04-06 20:45:00,987,1006,19,0,FALSE,NA,"0.1.4"
"20917","646",2023-04-06 21:00:00,987,1006,19,0,FALSE,NA,"0.1.4"
"20918","646",2023-04-06 21:15:00,987,1006,19,0,FALSE,NA,"0.1.4"
"20919","646",2023-04-06 21:30:00,987,1006,19,0,FALSE,NA,"0.1.4"
"20920","646",2023-04-06 21:45:00,987,1006,19,0,FALSE,NA,"0.1.4"
"20921","646",2023-04-06 22:00:00,987,1006,19,0,FALSE,NA,"0.1.4"
"20922","646",2023-04-06 22:15:00,987,1006,19,0,FALSE,NA,"0.1.4"
"20923","646",2023-04-06 22:30:00,987,1006,19,0,FALSE,NA,"0.1.4"
"20924","646",2023-04-06 22:45:00,987,1006,19,0,FALSE,NA,"0.1.4"
"20925","646",2023-04-06 23:00:00,987,1006,19,0,FALSE,NA,"0.1.4"
"20926","646",2023-04-06 23:15:00,987,1006,19,0,FALSE,NA,"0.1.4"
"20927","646",2023-04-06 23:30:00,987,1006,19,0,FALSE,NA,"0.1.4"
"20928","646",2023-04-06 23:45:00,987,1006,19,0,FALSE,NA,"0.1.4"
"20929","646",2023-04-07,987,1006,19,0,FALSE,NA,"0.1.4"
"20930","646",2023-04-07 00:15:00,987,1006,19,0,FALSE,NA,"0.1.4"
"20931","646",2023-04-07 00:30:00,987,1006,19,0,FALSE,NA,"0.1.4"
"20932","646",2023-04-07 00:45:00,987,1006,19,0,FALSE,NA,"0.1.4"
"20933","646",2023-04-07 01:00:00,987,1006,19,0,FALSE,NA,"0.1.4"
"20934","646",2023-04-07 01:15:00,987,1006,19,0,TRUE,NA,"0.1.4"
"20935","646",2023-04-07 01:30:00,987,1006,19,0,TRUE,NA,"0.1.4"
"20936","646",2023-04-07 01:45:00,987,1006,19,0,TRUE,NA,"0.1.4"
"20937","646",2023-04-07 02:00:00,987,1006,19,0,TRUE,NA,"0.1.4"
"20938","646",2023-04-07 02:15:00,987,1006,19,0,TRUE,NA,"0.1.4"
"20939","646",2023-04-07 02:30:00,987,1006,19,0,TRUE,NA,"0.1.4"
"20940","646",2023-04-07 02:45:00,987,1006,19,0,TRUE,NA,"0.1.4"
"20941","646",2023-04-07 03:00:00,987,1006,19,0,TRUE,NA,"0.1.4"
"20942","646",2023-04-07 03:15:00,987,1006,19,0,TRUE,NA,"0.1.4"
"20943","646",2023-04-07 03:30:00,987,1006,19,0,TRUE,NA,"0.1.4"
"20944","646",2023-04-07 03:45:00,987,1006,19,0,TRUE,NA,"0.1.4"
"20945","646",2023-04-07 04:00:00,987,1006,19,0,TRUE,NA,"0.1.4"
"20946","646",2023-04-07 04:15:00,987,1006,19,0,TRUE,NA,"0.1.4"
"20947","646",2023-04-07 04:30:00,987,1006,19,0,TRUE,NA,"0.1.4"
"20948","646",2023-04-07 04:45:00,987,1006,19,0,TRUE,NA,"0.1.4"
"20949","646",2023-04-07 05:00:00,987,1006,19,0,TRUE,NA,"0.1.4"
"20950","646",2023-04-07 05:15:00,987,1006,19,0,TRUE,NA,"0.1.4"
"20951","646",2023-04-07 05:30:00,987,1006,19,0,TRUE,NA,"0.1.4"
"20952","646",2023-04-07 05:45:00,987,1006,19,0,TRUE,NA,"0.1.4"
"20953","646",2023-04-07 06:00:00,987,1006,19,0,TRUE,NA,"0.1.4"
"20954","646",2023-04-07 06:15:00,987,1006,19,0,TRUE,NA,"0.1.4"
"20955","646",2023-04-07 06:30:00,987,1006,19,0,TRUE,NA,"0.1.4"
"20956","646",2023-04-07 06:45:00,987,1006,19,0,TRUE,NA,"0.1.4"
"20957","646",2023-04-07 07:00:00,987,1006,19,0,TRUE,NA,"0.1.4"
"20958","646",2023-04-07 07:15:00,987,1006,19,0,TRUE,NA,"0.1.4"
"20959","646",2023-04-07 07:30:00,987,1006,19,0,TRUE,NA,"0.1.4"
"20960","646",2023-04-07 07:45:00,987,1006,19,0,TRUE,NA,"0.1.4"
"20961","646",2023-04-07 08:00:00,987,1006,19,0,TRUE,NA,"0.1.4"
"20962","646",2023-04-07 08:15:00,987,1006,19,0,TRUE,NA,"0.1.4"
"20963","646",2023-04-07 08:30:00,987,1006,19,0,TRUE,NA,"0.1.4"
"20964","646",2023-04-07 08:45:00,987,1006,19,0,TRUE,NA,"0.1.4"
"20965","646",2023-04-07 09:00:00,987,1006,19,0,TRUE,NA,"0.1.4"
"20966","646",2023-04-07 09:15:00,987,1006,19,0,TRUE,NA,"0.1.4"
"20967","646",2023-04-07 09:30:00,987,1006,19,0,TRUE,NA,"0.1.4"
"20968","646",2023-04-07 09:45:00,987,1006,19,0,TRUE,NA,"0.1.4"
"20969","646",2023-04-07 10:00:00,987,1006,19,0,TRUE,NA,"0.1.4"
"20970","646",2023-04-07 10:15:00,987,1006,19,0,TRUE,NA,"0.1.4"
"20971","646",2023-04-07 10:30:00,987,1006,19,0,TRUE,NA,"0.1.4"
"20972","646",2023-04-07 10:45:00,987,1006,19,0,TRUE,NA,"0.1.4"
"20973","646",2023-04-07 11:00:00,987,1006,19,0,TRUE,NA,"0.1.4"
"20974","646",2023-04-07 11:15:00,987,1006,19,0,TRUE,NA,"0.1.4"
"20975","646",2023-04-07 11:30:00,987,1006,19,0,TRUE,NA,"0.1.4"
"20976","646",2023-04-07 11:45:00,987,1006,19,0,TRUE,NA,"0.1.4"
"20977","646",2023-04-07 12:00:00,987,1006,19,0,TRUE,NA,"0.1.4"
"20978","646",2023-04-07 12:15:00,987,1006,19,0,TRUE,NA,"0.1.4"
"20979","646",2023-04-07 12:30:00,987,1006,19,0,TRUE,NA,"0.1.4"
"20980","646",2023-04-07 12:45:00,987,1006,19,0,TRUE,NA,"0.1.4"
"20981","646",2023-04-07 13:00:00,987,1006,19,0,TRUE,NA,"0.1.4"
"20982","646",2023-04-07 13:15:00,987,1006,19,0,TRUE,NA,"0.1.4"
"20983","646",2023-04-07 13:30:00,987,1006,19,0,TRUE,NA,"0.1.4"
"20984","646",2023-04-07 13:45:00,987,1006,19,0,TRUE,NA,"0.1.4"
"20985","646",2023-04-07 14:00:00,987,1006,19,0,TRUE,NA,"0.1.4"
"20986","646",2023-04-07 14:15:00,987,1006,19,0,TRUE,NA,"0.1.4"
"20987","646",2023-04-07 14:30:00,987,1006,19,0,TRUE,NA,"0.1.4"
"20988","646",2023-04-07 14:45:00,987,1006,19,0,TRUE,NA,"0.1.4"
"20989","646",2023-04-07 15:00:00,987,1006,19,0,TRUE,NA,"0.1.4"
"20990","646",2023-04-07 15:15:00,987,1006,19,0,TRUE,NA,"0.1.4"
"20991","646",2023-04-07 15:30:00,987,1006,19,0,TRUE,NA,"0.1.4"
"20992","646",2023-04-07 15:45:00,987,1006,19,0,TRUE,NA,"0.1.4"
"20993","646",2023-04-07 16:00:00,987,1006,19,0,TRUE,NA,"0.1.4"
"20994","646",2023-04-07 16:15:00,987,1006,19,0,TRUE,NA,"0.1.4"
"20995","646",2023-04-07 16:30:00,987,1006,19,0,TRUE,NA,"0.1.4"
"20996","646",2023-04-07 16:45:00,987,1006,19,0,TRUE,NA,"0.1.4"
"20997","646",2023-04-07 17:00:00,987,1006,19,0,TRUE,NA,"0.1.4"
"20998","646",2023-04-07 17:15:00,987,1006,19,0,FALSE,NA,"0.1.4"
"20999","646",2023-04-07 17:30:00,987,1006,19,0,FALSE,NA,"0.1.4"
"21000","646",2023-04-07 17:45:00,987,1006,19,0,FALSE,NA,"0.1.4"
"21001","646",2023-04-07 18:00:00,987,1006,19,0,FALSE,NA,"0.1.4"
"21002","646",2023-04-07 18:15:00,987,1006,19,0,FALSE,NA,"0.1.4"
"21003","646",2023-04-07 18:30:00,987,1006,19,0,FALSE,NA,"0.1.4"
"21004","646",2023-04-07 18:45:00,987,1006,19,0,FALSE,NA,"0.1.4"
"21005","646",2023-04-07 19:00:00,987,1006,19,0,FALSE,NA,"0.1.4"
"21006","646",2023-04-07 19:15:00,987,1006,19,0,FALSE,NA,"0.1.4"
"21007","646",2023-04-07 19:30:00,987,1006,19,0,FALSE,NA,"0.1.4"
"21008","646",2023-04-07 19:45:00,987,1006,19,0,FALSE,NA,"0.1.4"
"21009","646",2023-04-07 20:00:00,987,1006,19,0,FALSE,NA,"0.1.4"
"21010","646",2023-04-07 20:15:00,987,1006,19,0,FALSE,NA,"0.1.4"
"21011","646",2023-04-07 20:30:00,987,1006,19,0,FALSE,NA,"0.1.4"
"21012","646",2023-04-07 20:45:00,987,1006,19,0,FALSE,NA,"0.1.4"
"21013","646",2023-04-07 21:00:00,987,1006,19,0,FALSE,NA,"0.1.4"
"21014","646",2023-04-07 21:15:00,987,1006,19,0,FALSE,NA,"0.1.4"
"21015","646",2023-04-07 21:30:00,987,1006,19,0,FALSE,NA,"0.1.4"
"21016","646",2023-04-07 21:45:00,987,1006,19,0,FALSE,NA,"0.1.4"
"21017","646",2023-04-07 22:00:00,987,1006,19,0,FALSE,NA,"0.1.4"
"21018","646",2023-04-07 22:15:00,987,1006,19,0,FALSE,NA,"0.1.4"
"21019","646",2023-04-07 22:30:00,987,1006,19,0,FALSE,NA,"0.1.4"
"21020","646",2023-04-07 22:45:00,987,1006,19,0,FALSE,NA,"0.1.4"
"21021","646",2023-04-07 23:00:00,987,1006,19,0,FALSE,NA,"0.1.4"
"21022","646",2023-04-07 23:15:00,987,1006,19,0,FALSE,NA,"0.1.4"
"21023","646",2023-04-07 23:30:00,987,1006,19,0,FALSE,NA,"0.1.4"
"21024","646",2023-04-07 23:45:00,987,1006,19,0,FALSE,NA,"0.1.4"
"21025","646",2023-04-08,987,1006,19,0,FALSE,NA,"0.1.4"
"21026","646",2023-04-08 00:15:00,987,1006,19,0,FALSE,NA,"0.1.4"
"21027","646",2023-04-08 00:30:00,987,1006,19,0,FALSE,NA,"0.1.4"
"21028","646",2023-04-08 00:45:00,987,1006,19,0,FALSE,NA,"0.1.4"
"21029","646",2023-04-08 01:00:00,987,1006,19,0,FALSE,NA,"0.1.4"
"21030","646",2023-04-08 01:15:00,987,1006,19,0,FALSE,NA,"0.1.4"
"21031","646",2023-04-08 01:30:00,987,1006,19,0,FALSE,NA,"0.1.4"
"21032","646",2023-04-08 01:45:00,987,1006,19,0,FALSE,NA,"0.1.4"
"21033","646",2023-04-08 02:00:00,987,1006,19,0,FALSE,NA,"0.1.4"
"21034","646",2023-04-08 02:15:00,987,1006,19,0,FALSE,NA,"0.1.4"
"21035","646",2023-04-08 02:30:00,987,1006,19,0,FALSE,NA,"0.1.4"
"21036","646",2023-04-08 02:45:00,987,1006,19,0,TRUE,NA,"0.1.4"
"21037","646",2023-04-08 03:00:00,987,1006,19,0,TRUE,NA,"0.1.4"
"21038","646",2023-04-08 03:15:00,987,1006,19,0,TRUE,NA,"0.1.4"
"21039","646",2023-04-08 03:30:00,987,1006,19,0,TRUE,NA,"0.1.4"
"21040","646",2023-04-08 03:45:00,987,1006,19,0,TRUE,NA,"0.1.4"
"21041","646",2023-04-08 04:00:00,987,1006,19,0,TRUE,NA,"0.1.4"
"21042","646",2023-04-08 04:15:00,987,1006,19,0,TRUE,NA,"0.1.4"
"21043","646",2023-04-08 04:30:00,987,1006,19,0,TRUE,NA,"0.1.4"
"21044","646",2023-04-08 04:45:00,987,1006,19,0,TRUE,NA,"0.1.4"
"21045","646",2023-04-08 05:00:00,987,1006,19,0,TRUE,NA,"0.1.4"
"21046","646",2023-04-08 05:15:00,987,1006,19,0,TRUE,NA,"0.1.4"
"21047","646",2023-04-08 05:30:00,987,1006,19,0,TRUE,NA,"0.1.4"
"21048","646",2023-04-08 05:45:00,987,1006,19,0,TRUE,NA,"0.1.4"
"21049","646",2023-04-08 06:00:00,987,1006,19,0,TRUE,NA,"0.1.4"
"21050","646",2023-04-08 06:15:00,987,1006,19,0,TRUE,NA,"0.1.4"
"21051","646",2023-04-08 06:30:00,987,1006,19,0,TRUE,NA,"0.1.4"
"21052","646",2023-04-08 06:45:00,987,1006,19,0,TRUE,NA,"0.1.4"
"21053","646",2023-04-08 07:00:00,987,1006,19,0,TRUE,NA,"0.1.4"
"21054","646",2023-04-08 07:15:00,987,1006,19,0,TRUE,NA,"0.1.4"
"21055","646",2023-04-08 07:30:00,987,1006,19,0,TRUE,NA,"0.1.4"
"21056","646",2023-04-08 07:45:00,987,1006,19,0,TRUE,NA,"0.1.4"
"21057","646",2023-04-08 08:00:00,987,1006,19,0,TRUE,NA,"0.1.4"
"21058","646",2023-04-08 08:15:00,987,1006,19,0,TRUE,NA,"0.1.4"
"21059","646",2023-04-08 08:30:00,987,1006,19,0,TRUE,NA,"0.1.4"
"21060","646",2023-04-08 08:45:00,987,1006,19,0,TRUE,NA,"0.1.4"
"21061","646",2023-04-08 09:00:00,987,1006,19,0,TRUE,NA,"0.1.4"
"21062","646",2023-04-08 09:15:00,987,1006,19,0,TRUE,NA,"0.1.4"
"21063","646",2023-04-08 09:30:00,987,1006,19,0,TRUE,NA,"0.1.4"
"21064","646",2023-04-08 09:45:00,987,1006,19,0,TRUE,NA,"0.1.4"
"21065","646",2023-04-08 10:00:00,987,1006,19,0,TRUE,NA,"0.1.4"
"21066","646",2023-04-08 10:15:00,987,1006,19,0,TRUE,NA,"0.1.4"
"21067","646",2023-04-08 10:30:00,987,1006,19,0,TRUE,NA,"0.1.4"
"21068","646",2023-04-08 10:45:00,987,1006,19,0,TRUE,NA,"0.1.4"
"21069","646",2023-04-08 11:00:00,987,1006,19,0,TRUE,NA,"0.1.4"
"21070","646",2023-04-08 11:15:00,987,1006,19,0,TRUE,NA,"0.1.4"
"21071","646",2023-04-08 11:30:00,987,1006,19,0,TRUE,NA,"0.1.4"
"21072","646",2023-04-08 11:45:00,987,1006,19,0,TRUE,NA,"0.1.4"
"21073","646",2023-04-08 12:00:00,987,1006,19,0,TRUE,NA,"0.1.4"
"21074","646",2023-04-08 12:15:00,987,1006,19,0,TRUE,NA,"0.1.4"
"21075","646",2023-04-08 12:30:00,987,1006,19,0,TRUE,NA,"0.1.4"
"21076","646",2023-04-08 12:45:00,987,1006,19,0,TRUE,NA,"0.1.4"
"21077","646",2023-04-08 13:00:00,987,1006,19,0,TRUE,NA,"0.1.4"
"21078","646",2023-04-08 13:15:00,987,1006,19,0,TRUE,NA,"0.1.4"
"21079","646",2023-04-08 13:30:00,987,1006,19,0,TRUE,NA,"0.1.4"
"21080","646",2023-04-08 13:45:00,987,1006,19,0,TRUE,NA,"0.1.4"
"21081","646",2023-04-08 14:00:00,987,1006,19,0,TRUE,NA,"0.1.4"
"21082","646",2023-04-08 14:15:00,987,1006,19,0,TRUE,NA,"0.1.4"
"21083","646",2023-04-08 14:30:00,987,1006,19,0,TRUE,NA,"0.1.4"
"21084","646",2023-04-08 14:45:00,987,1006,19,0,TRUE,NA,"0.1.4"
"21085","646",2023-04-08 15:00:00,987,1006,19,0,TRUE,NA,"0.1.4"
"21086","646",2023-04-08 15:15:00,987,1006,19,0,TRUE,NA,"0.1.4"
"21087","646",2023-04-08 15:30:00,987,1006,19,0,TRUE,NA,"0.1.4"
"21088","646",2023-04-08 15:45:00,987,1006,19,0,TRUE,NA,"0.1.4"
"21089","646",2023-04-08 16:00:00,987,1006,19,0,TRUE,NA,"0.1.4"
"21090","646",2023-04-08 16:15:00,987,1006,19,0,TRUE,NA,"0.1.4"
"21091","646",2023-04-08 16:30:00,987,1006,19,0,TRUE,NA,"0.1.4"
"21092","646",2023-04-08 16:45:00,987,1006,19,0,TRUE,NA,"0.1.4"
"21093","646",2023-04-08 17:00:00,987,1006,19,0,TRUE,NA,"0.1.4"
"21094","646",2023-04-08 17:15:00,987,1006,19,0,TRUE,NA,"0.1.4"
"21095","646",2023-04-08 17:30:00,987,1006,19,0,TRUE,NA,"0.1.4"
"21096","646",2023-04-08 17:45:00,987,1006,19,0,TRUE,NA,"0.1.4"
"21097","646",2023-04-08 18:00:00,987,1006,19,0,TRUE,NA,"0.1.4"
"21098","646",2023-04-08 18:15:00,987,1006,19,0,TRUE,NA,"0.1.4"
"21099","646",2023-04-08 18:30:00,987,1006,19,0,FALSE,NA,"0.1.4"
"21100","646",2023-04-08 18:45:00,987,1006,19,0,FALSE,NA,"0.1.4"
"21101","646",2023-04-08 19:00:00,987,1006,19,0,FALSE,NA,"0.1.4"
"21102","646",2023-04-08 19:15:00,987,1006,19,0,FALSE,NA,"0.1.4"
"21103","646",2023-04-08 19:30:00,987,1006,19,0,FALSE,NA,"0.1.4"
"21104","646",2023-04-08 19:45:00,987,1006,19,0,FALSE,NA,"0.1.4"
"21105","646",2023-04-08 20:00:00,987,1006,19,0,FALSE,NA,"0.1.4"
"21106","646",2023-04-08 20:15:00,987,1006,19,0,FALSE,NA,"0.1.4"
"21107","646",2023-04-08 20:30:00,987,1006,19,0,FALSE,NA,"0.1.4"
"21108","646",2023-04-08 20:45:00,987,1006,19,0,FALSE,NA,"0.1.4"
"21109","646",2023-04-08 21:00:00,987,1006,19,0,FALSE,NA,"0.1.4"
"21110","646",2023-04-08 21:15:00,987,1006,19,0,FALSE,NA,"0.1.4"
"21111","646",2023-04-08 21:30:00,987,1006,19,0,FALSE,NA,"0.1.4"
"21112","646",2023-04-08 21:45:00,987,1006,19,0,FALSE,NA,"0.1.4"
"21113","646",2023-04-08 22:00:00,987,1006,19,0,FALSE,NA,"0.1.4"
"21114","646",2023-04-08 22:15:00,987,1006,19,0,FALSE,NA,"0.1.4"
"21115","646",2023-04-08 22:30:00,987,1006,19,0,FALSE,NA,"0.1.4"
"21116","646",2023-04-08 22:45:00,987,1006,19,0,FALSE,NA,"0.1.4"
"21117","646",2023-04-08 23:00:00,987,1006,19,0,FALSE,NA,"0.1.4"
"21118","646",2023-04-08 23:15:00,987,1006,19,0,FALSE,NA,"0.1.4"
"21119","646",2023-04-08 23:30:00,987,1006,19,0,FALSE,NA,"0.1.4"
"21120","646",2023-04-08 23:45:00,987,1006,19,0,FALSE,NA,"0.1.4"
"21121","646",2023-04-09,987,1006,19,0,FALSE,NA,"0.1.4"
"21122","646",2023-04-09 00:15:00,987,1006,19,0,FALSE,NA,"0.1.4"
"21123","646",2023-04-09 00:30:00,987,1006,19,0,FALSE,NA,"0.1.4"
"21124","646",2023-04-09 00:45:00,987,1006,19,0,FALSE,NA,"0.1.4"
"21125","646",2023-04-09 01:00:00,987,1006,19,0,FALSE,NA,"0.1.4"
"21126","646",2023-04-09 01:15:00,987,1006,19,0,FALSE,NA,"0.1.4"
"21127","646",2023-04-09 01:30:00,987,1006,19,0,FALSE,NA,"0.1.4"
"21128","646",2023-04-09 01:45:00,987,1006,19,0,FALSE,NA,"0.1.4"
"21129","646",2023-04-09 02:00:00,987,1006,19,0,FALSE,NA,"0.1.4"
"21130","646",2023-04-09 02:15:00,987,1006,19,0,FALSE,NA,"0.1.4"
"21131","646",2023-04-09 02:30:00,987,1006,19,0,FALSE,NA,"0.1.4"
"21132","646",2023-04-09 02:45:00,987,1006,19,0,FALSE,NA,"0.1.4"
"21133","646",2023-04-09 03:00:00,987,1006,19,0,FALSE,NA,"0.1.4"
"21134","646",2023-04-09 03:15:00,987,1006,19,0,FALSE,NA,"0.1.4"
"21135","646",2023-04-09 03:30:00,987,1006,19,0,FALSE,NA,"0.1.4"
"21136","646",2023-04-09 03:45:00,987,1006,19,0,FALSE,NA,"0.1.4"
"21137","646",2023-04-09 04:00:00,987,1006,19,0,FALSE,NA,"0.1.4"
"21138","646",2023-04-09 04:15:00,987,1006,19,0,FALSE,NA,"0.1.4"
"21139","646",2023-04-09 04:30:00,987,1006,19,0,FALSE,NA,"0.1.4"
"21140","646",2023-04-09 04:45:00,987,1006,19,0,FALSE,NA,"0.1.4"
"21141","646",2023-04-09 05:00:00,987,1006,19,0,FALSE,NA,"0.1.4"
"21142","646",2023-04-09 05:15:00,987,1006,19,0,FALSE,NA,"0.1.4"
"21143","646",2023-04-09 05:30:00,987,1006,19,0,TRUE,NA,"0.1.4"
"21144","646",2023-04-09 05:45:00,987,1006,19,0,TRUE,NA,"0.1.4"
"21145","646",2023-04-09 06:00:00,987,1006,19,0,TRUE,NA,"0.1.4"
"21146","646",2023-04-09 06:15:00,987,1006,19,0,TRUE,NA,"0.1.4"
"21147","646",2023-04-09 06:30:00,987,1006,19,0,TRUE,NA,"0.1.4"
"21148","646",2023-04-09 06:45:00,987,1006,19,0,TRUE,NA,"0.1.4"
"21149","646",2023-04-09 07:00:00,987,1006,19,0,TRUE,NA,"0.1.4"
"21150","646",2023-04-09 07:15:00,987,1006,19,0,TRUE,NA,"0.1.4"
"21151","646",2023-04-09 07:30:00,987,1006,19,0,TRUE,NA,"0.1.4"
"21152","646",2023-04-09 07:45:00,987,1006,19,0,TRUE,NA,"0.1.4"
"21153","646",2023-04-09 08:00:00,987,1006,19,0,TRUE,NA,"0.1.4"
"21154","646",2023-04-09 08:15:00,987,1006,19,0,TRUE,NA,"0.1.4"
"21155","646",2023-04-09 08:30:00,987,1006,19,0,TRUE,NA,"0.1.4"
"21156","646",2023-04-09 08:45:00,987,1006,19,0,TRUE,NA,"0.1.4"
"21157","646",2023-04-09 09:00:00,987,1006,19,0,TRUE,NA,"0.1.4"
"21158","646",2023-04-09 09:15:00,987,1006,19,0,TRUE,NA,"0.1.4"
"21159","646",2023-04-09 09:30:00,987,1006,19,0,TRUE,NA,"0.1.4"
"21160","646",2023-04-09 09:45:00,987,1006,19,0,TRUE,NA,"0.1.4"
"21161","646",2023-04-09 10:00:00,987,1006,19,0,TRUE,NA,"0.1.4"
"21162","646",2023-04-09 10:15:00,987,1006,19,0,TRUE,NA,"0.1.4"
"21163","646",2023-04-09 10:30:00,987,1006,19,0,TRUE,NA,"0.1.4"
"21164","646",2023-04-09 10:45:00,987,1006,19,0,TRUE,NA,"0.1.4"
"21165","646",2023-04-09 11:00:00,987,1006,19,0,TRUE,NA,"0.1.4"
"21166","646",2023-04-09 11:15:00,987,1006,19,0,TRUE,NA,"0.1.4"
"21167","646",2023-04-09 11:30:00,987,1006,19,0,TRUE,NA,"0.1.4"
"21168","646",2023-04-09 11:45:00,987,1006,19,0,TRUE,NA,"0.1.4"
"21169","646",2023-04-09 12:00:00,987,1006,19,0,TRUE,NA,"0.1.4"
"21170","646",2023-04-09 12:15:00,987,1006,19,0,TRUE,NA,"0.1.4"
"21171","646",2023-04-09 12:30:00,987,1006,19,0,TRUE,NA,"0.1.4"
"21172","646",2023-04-09 12:45:00,987,1006,19,0,TRUE,NA,"0.1.4"
"21173","646",2023-04-09 13:00:00,987,1006,19,0,TRUE,NA,"0.1.4"
"21174","646",2023-04-09 13:15:00,987,1006,19,0,TRUE,NA,"0.1.4"
"21175","646",2023-04-09 13:30:00,987,1006,19,0,TRUE,NA,"0.1.4"
"21176","646",2023-04-09 13:45:00,987,1006,19,0,TRUE,NA,"0.1.4"
"21177","646",2023-04-09 14:00:00,987,1006,19,0,TRUE,NA,"0.1.4"
"21178","646",2023-04-09 14:15:00,987,1006,19,0,TRUE,NA,"0.1.4"
"21179","646",2023-04-09 14:30:00,987,1006,19,0,TRUE,NA,"0.1.4"
"21180","646",2023-04-09 14:45:00,987,1006,19,0,TRUE,NA,"0.1.4"
"21181","646",2023-04-09 15:00:00,987,1006,19,0,TRUE,NA,"0.1.4"
"21182","646",2023-04-09 15:15:00,987,1006,19,0,TRUE,NA,"0.1.4"
"21183","646",2023-04-09 15:30:00,987,1006,19,0,TRUE,NA,"0.1.4"
"21184","646",2023-04-09 15:45:00,987,1006,19,0,TRUE,NA,"0.1.4"
"21185","646",2023-04-09 16:00:00,987,1006,19,0,TRUE,NA,"0.1.4"
"21186","646",2023-04-09 16:15:00,987,1006,19,0,TRUE,NA,"0.1.4"
"21187","646",2023-04-09 16:30:00,987,1006,19,0,TRUE,NA,"0.1.4"
"21188","646",2023-04-09 16:45:00,987,1006,19,0,TRUE,NA,"0.1.4"
"21189","646",2023-04-09 17:00:00,987,1006,19,0,FALSE,NA,"0.1.4"
"21190","646",2023-04-09 17:15:00,987,1006,19,0,FALSE,NA,"0.1.4"
"21191","646",2023-04-09 17:30:00,987,1006,19,0,FALSE,NA,"0.1.4"
"21192","646",2023-04-09 17:45:00,987,1006,19,0,FALSE,NA,"0.1.4"
"21193","646",2023-04-09 18:00:00,987,1006,19,0,FALSE,NA,"0.1.4"
"21194","646",2023-04-09 18:15:00,987,1006,19,0,FALSE,NA,"0.1.4"
"21195","646",2023-04-09 18:30:00,987,1006,19,0,FALSE,NA,"0.1.4"
"21196","646",2023-04-09 18:45:00,987,1006,19,0,FALSE,NA,"0.1.4"
"21197","646",2023-04-09 19:00:00,987,1006,19,0,FALSE,NA,"0.1.4"
"21198","646",2023-04-09 19:15:00,987,1006,19,0,FALSE,NA,"0.1.4"
"21199","646",2023-04-09 19:30:00,987,1006,19,0,FALSE,NA,"0.1.4"
"21200","646",2023-04-09 19:45:00,987,1006,19,0,FALSE,NA,"0.1.4"
"21201","646",2023-04-09 20:00:00,987,1006,19,0,FALSE,NA,"0.1.4"
"21202","646",2023-04-09 20:15:00,987,1006,19,0,FALSE,NA,"0.1.4"
"21203","646",2023-04-09 20:30:00,987,1006,19,0,FALSE,NA,"0.1.4"
"21204","646",2023-04-09 20:45:00,987,1006,19,0,FALSE,NA,"0.1.4"
"21205","646",2023-04-09 21:00:00,987,1006,19,0,FALSE,NA,"0.1.4"
"21206","646",2023-04-09 21:15:00,987,1006,19,0,FALSE,NA,"0.1.4"
"21207","646",2023-04-09 21:30:00,987,1006,19,0,FALSE,NA,"0.1.4"
"21208","646",2023-04-09 21:45:00,987,1006,19,0,FALSE,NA,"0.1.4"
"21209","646",2023-04-09 22:00:00,987,1006,19,0,FALSE,NA,"0.1.4"
"21210","646",2023-04-09 22:15:00,987,1006,19,0,FALSE,NA,"0.1.4"
"21211","646",2023-04-09 22:30:00,987,1006,19,0,FALSE,NA,"0.1.4"
"21212","646",2023-04-09 22:45:00,987,1006,19,0,FALSE,NA,"0.1.4"
"21213","646",2023-04-09 23:00:00,987,1006,19,0,FALSE,NA,"0.1.4"
"21214","646",2023-04-09 23:15:00,987,1006,19,0,FALSE,NA,"0.1.4"
"21215","646",2023-04-09 23:30:00,987,1006,19,0,FALSE,NA,"0.1.4"
"21216","646",2023-04-09 23:45:00,987,1006,19,0,FALSE,NA,"0.1.4"
"21217","646",2023-04-10,987,1006,19,0,FALSE,NA,"0.1.4"
"21218","646",2023-04-10 00:15:00,987,1006,19,0,FALSE,NA,"0.1.4"
"21219","646",2023-04-10 00:30:00,987,1006,19,0,FALSE,NA,"0.1.4"
"21220","646",2023-04-10 00:45:00,987,1006,19,0,FALSE,NA,"0.1.4"
"21221","646",2023-04-10 01:00:00,987,1006,19,0,FALSE,NA,"0.1.4"
"21222","646",2023-04-10 01:15:00,987,1006,19,0,FALSE,NA,"0.1.4"
"21223","646",2023-04-10 01:30:00,987,1006,19,0,FALSE,NA,"0.1.4"
"21224","646",2023-04-10 01:45:00,987,1006,19,0,FALSE,NA,"0.1.4"
"21225","646",2023-04-10 02:00:00,987,1006,19,0,FALSE,NA,"0.1.4"
"21226","646",2023-04-10 02:15:00,987,1006,19,0,FALSE,NA,"0.1.4"
"21227","646",2023-04-10 02:30:00,987,1006,19,0,FALSE,NA,"0.1.4"
"21228","646",2023-04-10 02:45:00,987,1006,19,0,FALSE,NA,"0.1.4"
"21229","646",2023-04-10 03:00:00,987,1006,19,0,FALSE,NA,"0.1.4"
"21230","646",2023-04-10 03:15:00,987,1006,19,0,FALSE,NA,"0.1.4"
"21231","646",2023-04-10 03:30:00,987,1006,19,0,FALSE,NA,"0.1.4"
"21232","646",2023-04-10 03:45:00,987,1006,19,0,FALSE,NA,"0.1.4"
"21233","646",2023-04-10 04:00:00,987,1006,19,0,FALSE,NA,"0.1.4"
"21234","646",2023-04-10 04:15:00,987,1006,19,0,FALSE,NA,"0.1.4"
"21235","646",2023-04-10 04:30:00,987,1006,19,0,FALSE,NA,"0.1.4"
"21236","646",2023-04-10 04:45:00,987,1006,19,0,FALSE,NA,"0.1.4"
"21237","646",2023-04-10 05:00:00,987,1006,19,0,FALSE,NA,"0.1.4"
"21238","646",2023-04-10 05:15:00,987,1006,19,0,FALSE,NA,"0.1.4"
"21239","646",2023-04-10 05:30:00,987,1006,19,0,FALSE,NA,"0.1.4"
"21240","646",2023-04-10 05:45:00,987,1006,19,0,FALSE,NA,"0.1.4"
"21241","646",2023-04-10 06:00:00,987,1006,19,0,FALSE,NA,"0.1.4"
"21242","646",2023-04-10 06:15:00,987,1006,19,0,FALSE,NA,"0.1.4"
"21243","646",2023-04-10 06:30:00,987,1006,19,0,FALSE,NA,"0.1.4"
"21244","646",2023-04-10 06:45:00,987,1006,19,0,FALSE,NA,"0.1.4"
"21245","646",2023-04-10 07:00:00,987,1006,19,0,FALSE,NA,"0.1.4"
"21246","646",2023-04-10 07:15:00,987,1006,19,0,FALSE,NA,"0.1.4"
"21247","646",2023-04-10 07:30:00,987,1006,19,0,FALSE,NA,"0.1.4"
"21248","646",2023-04-10 07:45:00,987,1006,19,0,FALSE,NA,"0.1.4"
"21249","646",2023-04-10 08:00:00,987,1006,19,0,FALSE,NA,"0.1.4"
"21250","646",2023-04-10 08:15:00,987,1006,19,0,FALSE,NA,"0.1.4"
"21251","646",2023-04-10 08:30:00,987,1006,19,0,FALSE,NA,"0.1.4"
"21252","646",2023-04-10 08:45:00,987,1006,19,0,FALSE,NA,"0.1.4"
"21253","646",2023-04-10 09:00:00,987,1006,19,0,FALSE,NA,"0.1.4"
"21254","646",2023-04-10 09:15:00,987,1006,19,0,FALSE,NA,"0.1.4"
"21255","646",2023-04-10 09:30:00,987,1006,19,0,FALSE,NA,"0.1.4"
"21256","646",2023-04-10 09:45:00,987,1006,19,0,FALSE,NA,"0.1.4"
"21257","646",2023-04-10 10:00:00,987,1006,19,0,FALSE,NA,"0.1.4"
"21258","646",2023-04-10 10:15:00,987,1006,19,0,FALSE,NA,"0.1.4"
"21259","646",2023-04-10 10:30:00,987,1006,19,0,FALSE,NA,"0.1.4"
"21260","646",2023-04-10 10:45:00,987,1006,19,0,FALSE,NA,"0.1.4"
"21261","646",2023-04-10 11:00:00,987,1006,19,0,FALSE,NA,"0.1.4"
"21262","646",2023-04-10 11:15:00,987,1006,19,0,FALSE,NA,"0.1.4"
"21263","646",2023-04-10 11:30:00,987,1006,19,0,FALSE,NA,"0.1.4"
"21264","646",2023-04-10 11:45:00,987,1006,19,0,TRUE,NA,"0.1.4"
"21265","646",2023-04-10 12:00:00,987,1006,19,0,FALSE,NA,"0.1.4"
"21266","646",2023-04-10 12:15:00,987,1006,19,0,FALSE,NA,"0.1.4"
"21267","646",2023-04-10 12:30:00,987,1006,19,0,TRUE,NA,"0.1.4"
"21268","646",2023-04-10 12:45:00,987,1006,19,0,TRUE,NA,"0.1.4"
"21269","646",2023-04-10 13:00:00,987,1006,19,0,TRUE,NA,"0.1.4"
"21270","646",2023-04-10 13:15:00,987,1006,19,0,TRUE,NA,"0.1.4"
"21271","646",2023-04-10 13:30:00,987,1006,19,0,TRUE,NA,"0.1.4"
"21272","646",2023-04-10 13:45:00,987,1006,19,0,TRUE,NA,"0.1.4"
"21273","646",2023-04-10 14:00:00,987,1006,19,0,TRUE,NA,"0.1.4"
"21274","646",2023-04-10 14:15:00,987,1006,19,0,TRUE,NA,"0.1.4"
"21275","646",2023-04-10 14:30:00,987,1006,19,0,TRUE,NA,"0.1.4"
"21276","646",2023-04-10 14:45:00,987,1006,19,0,TRUE,NA,"0.1.4"
"21277","646",2023-04-10 15:00:00,987,1006,19,0,TRUE,NA,"0.1.4"
"21278","646",2023-04-10 15:15:00,987,1006,19,0,FALSE,NA,"0.1.4"
"21279","646",2023-04-10 15:30:00,987,1006,19,0,FALSE,NA,"0.1.4"
"21280","646",2023-04-10 15:45:00,987,1006,19,0,FALSE,NA,"0.1.4"
"21281","646",2023-04-10 16:00:00,987,1006,19,0,FALSE,NA,"0.1.4"
"21282","646",2023-04-10 16:15:00,987,1006,19,0,FALSE,NA,"0.1.4"
"21283","646",2023-04-10 16:30:00,987,1006,19,0,FALSE,NA,"0.1.4"
"21284","646",2023-04-10 16:45:00,987,1006,19,0,FALSE,NA,"0.1.4"
"21285","646",2023-04-10 17:00:00,987,1006,19,0,FALSE,NA,"0.1.4"
"21286","646",2023-04-10 17:15:00,987,1006,19,0,FALSE,NA,"0.1.4"
"21287","646",2023-04-10 17:30:00,987,1006,19,0,FALSE,NA,"0.1.4"
"21288","646",2023-04-10 17:45:00,987,1006,19,0,FALSE,NA,"0.1.4"
"21289","646",2023-04-10 18:00:00,987,1006,19,0,FALSE,NA,"0.1.4"
"21290","646",2023-04-10 18:15:00,987,1006,19,0,FALSE,NA,"0.1.4"
"21291","646",2023-04-10 18:30:00,987,1006,19,0,FALSE,NA,"0.1.4"
"21292","646",2023-04-10 18:45:00,987,1006,19,0,FALSE,NA,"0.1.4"
"21293","646",2023-04-10 19:00:00,987,1006,19,0,FALSE,NA,"0.1.4"
"21294","646",2023-04-10 19:15:00,987,1006,19,0,FALSE,NA,"0.1.4"
"21295","646",2023-04-10 19:30:00,987,1006,19,0,FALSE,NA,"0.1.4"
"21296","646",2023-04-10 19:45:00,987,1006,19,0,FALSE,NA,"0.1.4"
"21297","646",2023-04-10 20:00:00,987,1006,19,0,FALSE,NA,"0.1.4"
"21298","646",2023-04-10 20:15:00,987,1006,19,0,FALSE,NA,"0.1.4"
"21299","646",2023-04-10 20:30:00,987,1006,19,0,FALSE,NA,"0.1.4"
"21300","646",2023-04-10 20:45:00,987,1006,19,0,FALSE,NA,"0.1.4"
"21301","646",2023-04-10 21:00:00,987,1006,19,0,FALSE,NA,"0.1.4"
"21302","646",2023-04-10 21:15:00,987,1006,19,0,FALSE,NA,"0.1.4"
"21303","646",2023-04-10 21:30:00,987,1006,19,0,FALSE,NA,"0.1.4"
"21304","646",2023-04-10 21:45:00,987,1006,19,0,FALSE,NA,"0.1.4"
"21305","646",2023-04-10 22:00:00,987,1006,19,0,FALSE,NA,"0.1.4"
"21306","646",2023-04-10 22:15:00,987,1006,19,0,FALSE,NA,"0.1.4"
"21307","646",2023-04-10 22:30:00,987,1006,19,0,FALSE,NA,"0.1.4"
"21308","646",2023-04-10 22:45:00,987,1006,19,0,FALSE,NA,"0.1.4"
"21309","646",2023-04-10 23:00:00,987,1006,19,0,FALSE,NA,"0.1.4"
"21310","646",2023-04-10 23:15:00,987,1006,19,0,FALSE,NA,"0.1.4"
"21311","646",2023-04-10 23:30:00,987,1006,19,0,FALSE,NA,"0.1.4"
"21312","646",2023-04-10 23:45:00,987,1006,19,0,FALSE,NA,"0.1.4"
"21313","646",2023-04-11,987,1006,19,0,FALSE,NA,"0.1.4"
"21314","646",2023-04-11 00:15:00,987,1006,19,0,FALSE,NA,"0.1.4"
"21315","646",2023-04-11 00:30:00,987,1006,19,0,FALSE,NA,"0.1.4"
"21316","646",2023-04-11 00:45:00,987,1006,19,0,FALSE,NA,"0.1.4"
"21317","646",2023-04-11 01:00:00,987,1006,19,0,FALSE,NA,"0.1.4"
"21318","646",2023-04-11 01:15:00,987,1006,19,0,FALSE,NA,"0.1.4"
"21319","646",2023-04-11 01:30:00,987,1006,19,0,FALSE,NA,"0.1.4"
"21320","646",2023-04-11 01:45:00,987,1006,19,0,FALSE,NA,"0.1.4"
"21321","646",2023-04-11 02:00:00,987,1006,19,0,FALSE,NA,"0.1.4"
"21322","646",2023-04-11 02:15:00,987,1006,19,0,FALSE,NA,"0.1.4"
"21323","646",2023-04-11 02:30:00,987,1006,19,0,FALSE,NA,"0.1.4"
"21324","646",2023-04-11 02:45:00,987,1006,19,0,FALSE,NA,"0.1.4"
"21325","646",2023-04-11 03:00:00,987,1006,19,0,FALSE,NA,"0.1.4"
"21326","646",2023-04-11 03:15:00,987,1006,19,0,FALSE,NA,"0.1.4"
"21327","646",2023-04-11 03:30:00,987,1006,19,0,FALSE,NA,"0.1.4"
"21328","646",2023-04-11 03:45:00,987,1006,19,0,FALSE,NA,"0.1.4"
"21329","646",2023-04-11 04:00:00,987,1006,19,0,FALSE,NA,"0.1.4"
"21330","646",2023-04-11 04:15:00,987,1006,19,0,FALSE,NA,"0.1.4"
"21331","646",2023-04-11 04:30:00,987,1006,19,0,FALSE,NA,"0.1.4"
"21332","646",2023-04-11 04:45:00,987,1006,19,0,FALSE,NA,"0.1.4"
"21333","646",2023-04-11 05:00:00,987,1006,19,0,FALSE,NA,"0.1.4"
"21334","646",2023-04-11 05:15:00,987,1006,19,0,FALSE,NA,"0.1.4"
"21335","646",2023-04-11 05:30:00,987,1006,19,0,FALSE,NA,"0.1.4"
"21336","646",2023-04-11 05:45:00,987,1006,19,0,FALSE,NA,"0.1.4"
"21337","646",2023-04-11 06:00:00,987,1006,19,0,TRUE,NA,"0.1.4"
"21338","646",2023-04-11 06:15:00,987,1006,19,0,TRUE,NA,"0.1.4"
"21339","646",2023-04-11 06:30:00,987,1006,19,0,TRUE,NA,"0.1.4"
"21340","646",2023-04-11 06:45:00,987,1006,19,0,TRUE,NA,"0.1.4"
"21341","646",2023-04-11 07:00:00,987,1006,19,0,TRUE,NA,"0.1.4"
"21342","646",2023-04-11 07:15:00,987,1006,19,0,TRUE,NA,"0.1.4"
"21343","646",2023-04-11 07:30:00,987,1006,19,0,TRUE,NA,"0.1.4"
"21344","646",2023-04-11 07:45:00,987,1006,19,0,TRUE,NA,"0.1.4"
"21345","646",2023-04-11 08:00:00,987,1006,19,0,TRUE,NA,"0.1.4"
"21346","646",2023-04-11 08:15:00,987,1006,19,0,TRUE,NA,"0.1.4"
"21347","646",2023-04-11 08:30:00,987,1006,19,0,TRUE,NA,"0.1.4"
"21348","646",2023-04-11 08:45:00,987,1006,19,0,TRUE,NA,"0.1.4"
"21349","646",2023-04-11 09:00:00,987,1006,19,0,TRUE,NA,"0.1.4"
"21350","646",2023-04-11 09:15:00,987,1006,19,0,TRUE,NA,"0.1.4"
"21351","646",2023-04-11 09:30:00,987,1006,19,0,TRUE,NA,"0.1.4"
"21352","646",2023-04-11 09:45:00,987,1006,19,0,TRUE,NA,"0.1.4"
"21353","646",2023-04-11 10:00:00,987,1006,19,0,TRUE,NA,"0.1.4"
"21354","646",2023-04-11 10:15:00,987,1006,19,0,TRUE,NA,"0.1.4"
"21355","646",2023-04-11 10:30:00,987,1006,19,0,TRUE,NA,"0.1.4"
"21356","646",2023-04-11 10:45:00,987,1006,19,0,TRUE,NA,"0.1.4"
"21357","646",2023-04-11 11:00:00,987,1006,19,0,TRUE,NA,"0.1.4"
"21358","646",2023-04-11 11:15:00,987,1006,19,0,TRUE,NA,"0.1.4"
"21359","646",2023-04-11 11:30:00,987,1006,19,0,TRUE,NA,"0.1.4"
"21360","646",2023-04-11 11:45:00,987,1006,19,0,TRUE,NA,"0.1.4"
"21361","646",2023-04-11 12:00:00,987,1006,19,0,TRUE,NA,"0.1.4"
"21362","646",2023-04-11 12:15:00,987,1006,19,0,TRUE,NA,"0.1.4"
"21363","646",2023-04-11 12:30:00,987,1006,19,0,TRUE,NA,"0.1.4"
"21364","646",2023-04-11 12:45:00,987,1006,19,0,TRUE,NA,"0.1.4"
"21365","646",2023-04-11 13:00:00,987,1006,19,0,TRUE,NA,"0.1.4"
"21366","646",2023-04-11 13:15:00,987,1006,19,0,TRUE,NA,"0.1.4"
"21367","646",2023-04-11 13:30:00,987,1006,19,0,TRUE,NA,"0.1.4"
"21368","646",2023-04-11 13:45:00,987,1006,19,0,TRUE,NA,"0.1.4"
"21369","646",2023-04-11 14:00:00,987,1006,19,0,TRUE,NA,"0.1.4"
"21370","646",2023-04-11 14:15:00,987,1006,19,0,TRUE,NA,"0.1.4"
"21371","646",2023-04-11 14:30:00,987,1006,19,0,TRUE,NA,"0.1.4"
"21372","646",2023-04-11 14:45:00,987,1006,19,0,TRUE,NA,"0.1.4"
"21373","646",2023-04-11 15:00:00,987,1006,19,0,TRUE,NA,"0.1.4"
"21374","646",2023-04-11 15:15:00,987,1006,19,0,TRUE,NA,"0.1.4"
"21375","646",2023-04-11 15:30:00,987,1006,19,0,TRUE,NA,"0.1.4"
"21376","646",2023-04-11 15:45:00,987,1006,19,0,TRUE,NA,"0.1.4"
"21377","646",2023-04-11 16:00:00,987,1006,19,0,TRUE,NA,"0.1.4"
"21378","646",2023-04-11 16:15:00,987,1006,19,0,TRUE,NA,"0.1.4"
"21379","646",2023-04-11 16:30:00,987,1006,19,0,TRUE,NA,"0.1.4"
"21380","646",2023-04-11 16:45:00,987,1006,19,0,TRUE,NA,"0.1.4"
"21381","646",2023-04-11 17:00:00,987,1006,19,0,TRUE,NA,"0.1.4"
"21382","646",2023-04-11 17:15:00,987,1006,19,0,TRUE,NA,"0.1.4"
"21383","646",2023-04-11 17:30:00,987,1006,19,0,TRUE,NA,"0.1.4"
"21384","646",2023-04-11 17:45:00,987,1006,19,0,TRUE,NA,"0.1.4"
"21385","646",2023-04-11 18:00:00,987,1006,19,0,TRUE,NA,"0.1.4"
"21386","646",2023-04-11 18:15:00,987,1006,19,0,TRUE,NA,"0.1.4"
"21387","646",2023-04-11 18:30:00,987,1006,19,0,TRUE,NA,"0.1.4"
"21388","646",2023-04-11 18:45:00,987,1006,19,0,TRUE,NA,"0.1.4"
"21389","646",2023-04-11 19:00:00,986,1006,20,0,TRUE,NA,"0.1.4"
"21390","646",2023-04-11 19:15:00,986,1006,20,0,TRUE,NA,"0.1.4"
"21391","646",2023-04-11 19:30:00,986,1006,20,0,TRUE,NA,"0.1.4"
"21392","646",2023-04-11 19:45:00,987,1006,19,0,TRUE,NA,"0.1.4"
"21393","646",2023-04-11 20:00:00,987,1006,19,0,TRUE,NA,"0.1.4"
"21394","646",2023-04-11 20:15:00,987,1006,19,0,TRUE,NA,"0.1.4"
"21395","646",2023-04-11 20:30:00,987,1006,19,0,TRUE,NA,"0.1.4"
"21396","646",2023-04-11 20:45:00,987,1006,19,0,FALSE,NA,"0.1.4"
"21397","646",2023-04-11 21:00:00,987,1006,19,0,TRUE,NA,"0.1.4"
"21398","646",2023-04-11 21:15:00,987,1006,19,0,FALSE,NA,"0.1.4"
"21399","646",2023-04-11 21:30:00,987,1006,19,0,FALSE,NA,"0.1.4"
"21400","646",2023-04-11 21:45:00,987,1006,19,0,TRUE,NA,"0.1.4"
"21401","646",2023-04-11 22:00:00,987,1006,19,0,FALSE,NA,"0.1.4"
"21402","646",2023-04-11 22:15:00,987,1006,19,0,FALSE,NA,"0.1.4"
"21403","646",2023-04-11 22:30:00,987,1006,19,0,TRUE,NA,"0.1.4"
"21404","646",2023-04-11 22:45:00,987,1006,19,0,TRUE,NA,"0.1.4"
"21405","646",2023-04-11 23:00:00,987,1006,19,0,TRUE,NA,"0.1.4"
"21406","646",2023-04-11 23:15:00,987,1006,19,0,TRUE,NA,"0.1.4"
"21407","646",2023-04-11 23:30:00,987,1006,19,0,TRUE,NA,"0.1.4"
"21408","646",2023-04-11 23:45:00,986,1006,20,0,TRUE,NA,"0.1.4"
"21409","646",2023-04-12,987,1006,19,0,TRUE,NA,"0.1.4"
"21410","646",2023-04-12 00:15:00,987,1006,19,0,TRUE,NA,"0.1.4"
"21411","646",2023-04-12 00:30:00,987,1006,19,0,TRUE,NA,"0.1.4"
"21412","646",2023-04-12 00:45:00,987,1006,19,0,TRUE,NA,"0.1.4"
"21413","646",2023-04-12 01:00:00,986,1006,20,0,TRUE,NA,"0.1.4"
"21414","646",2023-04-12 01:15:00,986,1006,20,0,TRUE,NA,"0.1.4"
"21415","646",2023-04-12 01:30:00,987,1006,19,0,TRUE,NA,"0.1.4"
"21416","646",2023-04-12 01:45:00,987,1006,19,0,TRUE,NA,"0.1.4"
"21417","646",2023-04-12 02:00:00,987,1006,19,0,TRUE,NA,"0.1.4"
"21418","646",2023-04-12 02:15:00,987,1006,19,0,TRUE,NA,"0.1.4"
"21419","646",2023-04-12 02:30:00,986,1006,20,0,TRUE,NA,"0.1.4"
"21420","646",2023-04-12 02:45:00,987,1006,19,0,TRUE,NA,"0.1.4"
"21421","646",2023-04-12 03:00:00,987,1006,19,0,TRUE,NA,"0.1.4"
"21422","646",2023-04-12 03:15:00,986,1006,20,0,TRUE,NA,"0.1.4"
"21423","646",2023-04-12 03:30:00,987,1006,19,0,TRUE,NA,"0.1.4"
"21424","646",2023-04-12 03:45:00,987,1006,19,0,TRUE,NA,"0.1.4"
"21425","646",2023-04-12 04:00:00,987,1006,19,0,TRUE,NA,"0.1.4"
"21426","646",2023-04-12 04:15:00,987,1006,19,0,TRUE,NA,"0.1.4"
"21427","646",2023-04-12 04:30:00,987,1006,19,0,TRUE,NA,"0.1.4"
"21428","646",2023-04-12 04:45:00,987,1006,19,0,TRUE,NA,"0.1.4"
"21429","646",2023-04-12 05:00:00,987,1006,19,0,TRUE,NA,"0.1.4"
"21430","646",2023-04-12 05:15:00,987,1006,19,0,TRUE,NA,"0.1.4"
"21431","646",2023-04-12 05:30:00,987,1006,19,0,TRUE,NA,"0.1.4"
"21432","646",2023-04-12 05:45:00,987,1006,19,0,TRUE,NA,"0.1.4"
"21433","646",2023-04-12 06:00:00,987,1006,19,0,TRUE,NA,"0.1.4"
"21434","646",2023-04-12 06:15:00,987,1006,19,0,TRUE,NA,"0.1.4"
"21435","646",2023-04-12 06:30:00,987,1006,19,0,TRUE,NA,"0.1.4"
"21436","646",2023-04-12 06:45:00,987,1006,19,0,TRUE,NA,"0.1.4"
"21437","646",2023-04-12 07:00:00,987,1006,19,0,TRUE,NA,"0.1.4"
"21438","646",2023-04-12 07:15:00,987,1006,19,0,TRUE,NA,"0.1.4"
"21439","646",2023-04-12 07:30:00,987,1006,19,0,TRUE,NA,"0.1.4"
"21440","646",2023-04-12 07:45:00,987,1006,19,0,TRUE,NA,"0.1.4"
"21441","646",2023-04-12 08:00:00,987,1006,19,0,TRUE,NA,"0.1.4"
"21442","646",2023-04-12 08:15:00,987,1006,19,0,TRUE,NA,"0.1.4"
"21443","646",2023-04-12 08:30:00,987,1006,19,0,TRUE,NA,"0.1.4"
"21444","646",2023-04-12 08:45:00,987,1006,19,0,TRUE,NA,"0.1.4"
"21445","646",2023-04-12 09:00:00,987,1006,19,0,TRUE,NA,"0.1.4"
"21446","646",2023-04-12 09:15:00,987,1006,19,0,TRUE,NA,"0.1.4"
"21447","646",2023-04-12 09:30:00,987,1006,19,0,TRUE,NA,"0.1.4"
"21448","646",2023-04-12 09:45:00,987,1006,19,0,TRUE,NA,"0.1.4"
"21449","646",2023-04-12 10:00:00,987,1006,19,0,TRUE,NA,"0.1.4"
"21450","646",2023-04-12 10:15:00,987,1006,19,0,TRUE,NA,"0.1.4"
"21451","646",2023-04-12 10:30:00,987,1006,19,0,TRUE,NA,"0.1.4"
"21452","646",2023-04-12 10:45:00,987,1006,19,0,TRUE,NA,"0.1.4"
"21453","646",2023-04-12 11:00:00,987,1006,19,0,TRUE,NA,"0.1.4"
"21454","646",2023-04-12 11:15:00,987,1006,19,0,TRUE,NA,"0.1.4"
"21455","646",2023-04-12 11:30:00,987,1006,19,0,TRUE,NA,"0.1.4"
"21456","646",2023-04-12 11:45:00,987,1006,19,0,TRUE,NA,"0.1.4"
"21457","646",2023-04-12 12:00:00,987,1006,19,0,TRUE,NA,"0.1.4"
"21458","646",2023-04-12 12:15:00,987,1006,19,0,TRUE,NA,"0.1.4"
"21459","646",2023-04-12 12:30:00,987,1006,19,0,TRUE,NA,"0.1.4"
"21460","646",2023-04-12 12:45:00,987,1006,19,0,TRUE,NA,"0.1.4"
"21461","646",2023-04-12 13:00:00,987,1006,19,0,TRUE,NA,"0.1.4"
"21462","646",2023-04-12 13:15:00,987,1006,19,0,TRUE,NA,"0.1.4"
"21463","646",2023-04-12 13:30:00,987,1006,19,0,TRUE,NA,"0.1.4"
"21464","646",2023-04-12 13:45:00,987,1006,19,0,TRUE,NA,"0.1.4"
"21465","646",2023-04-12 14:00:00,987,1006,19,0,TRUE,NA,"0.1.4"
"21466","646",2023-04-12 14:15:00,987,1006,19,0,TRUE,NA,"0.1.4"
"21467","646",2023-04-12 14:30:00,987,1006,19,0,TRUE,NA,"0.1.4"
"21468","646",2023-04-12 14:45:00,987,1006,19,0,TRUE,NA,"0.1.4"
"21469","646",2023-04-12 15:00:00,987,1006,19,0,TRUE,NA,"0.1.4"
"21470","646",2023-04-12 15:15:00,987,1006,19,0,TRUE,NA,"0.1.4"
"21471","646",2023-04-12 15:30:00,987,1006,19,0,TRUE,NA,"0.1.4"
"21472","646",2023-04-12 15:45:00,987,1006,19,0,TRUE,NA,"0.1.4"
"21473","646",2023-04-12 16:00:00,987,1006,19,0,TRUE,NA,"0.1.4"
"21474","646",2023-04-12 16:15:00,987,1006,19,0,TRUE,NA,"0.1.4"
"21475","646",2023-04-12 16:30:00,987,1006,19,0,TRUE,NA,"0.1.4"
"21476","646",2023-04-12 16:45:00,987,1006,19,0,TRUE,NA,"0.1.4"
"21477","646",2023-04-12 17:00:00,987,1006,19,0,TRUE,NA,"0.1.4"
"21478","646",2023-04-12 17:15:00,987,1006,19,0,TRUE,NA,"0.1.4"
"21479","646",2023-04-12 17:30:00,987,1006,19,0,TRUE,NA,"0.1.4"
"21480","646",2023-04-12 17:45:00,987,1006,19,0,TRUE,NA,"0.1.4"
"21481","646",2023-04-12 18:00:00,987,1006,19,0,TRUE,NA,"0.1.4"
"21482","646",2023-04-12 18:15:00,987,1006,19,0,TRUE,NA,"0.1.4"
"21483","646",2023-04-12 18:30:00,987,1006,19,0,TRUE,NA,"0.1.4"
"21484","646",2023-04-12 18:45:00,987,1006,19,0,TRUE,NA,"0.1.4"
"21485","646",2023-04-12 19:00:00,987,1006,19,0,TRUE,NA,"0.1.4"
"21486","646",2023-04-12 19:15:00,987,1006,19,0,TRUE,NA,"0.1.4"
"21487","646",2023-04-12 19:30:00,987,1006,19,0,TRUE,NA,"0.1.4"
"21488","646",2023-04-12 19:45:00,987,1006,19,0,TRUE,NA,"0.1.4"
"21489","646",2023-04-12 20:00:00,987,1006,19,0,TRUE,NA,"0.1.4"
"21490","646",2023-04-12 20:15:00,987,1006,19,0,TRUE,NA,"0.1.4"
"21491","646",2023-04-12 20:30:00,987,1006,19,0,TRUE,NA,"0.1.4"
"21492","646",2023-04-12 20:45:00,986,1006,20,0,TRUE,NA,"0.1.4"
"21493","646",2023-04-12 21:00:00,986,1006,20,0,TRUE,NA,"0.1.4"
"21494","646",2023-04-12 21:15:00,986,1006,20,0,TRUE,NA,"0.1.4"
"21495","646",2023-04-12 21:30:00,987,1006,19,0,TRUE,NA,"0.1.4"
"21496","646",2023-04-12 21:45:00,987,1006,19,0,TRUE,NA,"0.1.4"
"21497","646",2023-04-12 22:00:00,987,1006,19,0,TRUE,NA,"0.1.4"
"21498","646",2023-04-12 22:15:00,987,1006,19,0,TRUE,NA,"0.1.4"
"21499","646",2023-04-12 22:30:00,987,1006,19,0,TRUE,NA,"0.1.4"
"21500","646",2023-04-12 22:45:00,987,1006,19,0,TRUE,NA,"0.1.4"
"21501","646",2023-04-12 23:00:00,987,1006,19,0,TRUE,NA,"0.1.4"
"21502","646",2023-04-12 23:15:00,987,1006,19,0,TRUE,NA,"0.1.4"
"21503","646",2023-04-12 23:30:00,987,1006,19,0,TRUE,NA,"0.1.4"
"21504","646",2023-04-12 23:45:00,987,1006,19,0,TRUE,NA,"0.1.4"
"21505","646",2023-04-13,986,1006,20,0,TRUE,NA,"0.1.4"
"21506","646",2023-04-13 00:15:00,986,1006,20,0,TRUE,NA,"0.1.4"
"21507","646",2023-04-13 00:30:00,986,1006,20,0,TRUE,NA,"0.1.4"
"21508","646",2023-04-13 00:45:00,986,1006,20,0,TRUE,NA,"0.1.4"
"21509","646",2023-04-13 01:00:00,986,1006,20,0,TRUE,NA,"0.1.4"
"21510","646",2023-04-13 01:15:00,987,1006,19,0,TRUE,NA,"0.1.4"
"21511","646",2023-04-13 01:30:00,987,1006,19,0,TRUE,NA,"0.1.4"
"21512","646",2023-04-13 01:45:00,987,1006,19,0,TRUE,NA,"0.1.4"
"21513","646",2023-04-13 02:00:00,987,1006,19,0,TRUE,NA,"0.1.4"
"21514","646",2023-04-13 02:15:00,987,1006,19,0,TRUE,NA,"0.1.4"
"21515","646",2023-04-13 02:30:00,987,1006,19,0,TRUE,NA,"0.1.4"
"21516","646",2023-04-13 02:45:00,987,1006,19,0,TRUE,NA,"0.1.4"
"21517","646",2023-04-13 03:00:00,987,1006,19,0,TRUE,NA,"0.1.4"
"21518","646",2023-04-13 03:15:00,987,1006,19,0,TRUE,NA,"0.1.4"
"21519","646",2023-04-13 03:30:00,987,1006,19,0,TRUE,NA,"0.1.4"
"21520","646",2023-04-13 03:45:00,987,1006,19,0,TRUE,NA,"0.1.4"
"21521","646",2023-04-13 04:00:00,987,1006,19,0,TRUE,NA,"0.1.4"
"21522","646",2023-04-13 04:15:00,987,1006,19,0,TRUE,NA,"0.1.4"
"21523","646",2023-04-13 04:30:00,987,1006,19,0,TRUE,NA,"0.1.4"
"21524","646",2023-04-13 04:45:00,987,1006,19,0,TRUE,NA,"0.1.4"
"21525","646",2023-04-13 05:00:00,987,1006,19,0,TRUE,NA,"0.1.4"
"21526","646",2023-04-13 05:15:00,987,1006,19,0,TRUE,NA,"0.1.4"
"21527","646",2023-04-13 05:30:00,986,1006,20,0,TRUE,NA,"0.1.4"
"21528","646",2023-04-13 05:45:00,986,1006,20,0,TRUE,NA,"0.1.4"
"21529","646",2023-04-13 06:00:00,986,1006,20,0,TRUE,NA,"0.1.4"
"21530","646",2023-04-13 06:15:00,986,1006,20,0,TRUE,NA,"0.1.4"
"21531","646",2023-04-13 06:30:00,987,1006,19,0,TRUE,NA,"0.1.4"
"21532","646",2023-04-13 06:45:00,987,1006,19,0,TRUE,NA,"0.1.4"
"21533","646",2023-04-13 07:00:00,986,1006,20,0,TRUE,NA,"0.1.4"
"21534","646",2023-04-13 07:15:00,987,1006,19,0,TRUE,NA,"0.1.4"
"21535","646",2023-04-13 07:30:00,987,1006,19,0,TRUE,NA,"0.1.4"
"21536","646",2023-04-13 07:45:00,987,1006,19,0,TRUE,NA,"0.1.4"
"21537","646",2023-04-13 08:00:00,987,1006,19,0,TRUE,NA,"0.1.4"
"21538","646",2023-04-13 08:15:00,987,1006,19,0,TRUE,NA,"0.1.4"
"21539","646",2023-04-13 08:30:00,986,1006,20,0,TRUE,NA,"0.1.4"
"21540","646",2023-04-13 08:45:00,987,1006,19,0,TRUE,NA,"0.1.4"
"21541","646",2023-04-13 09:00:00,986,1006,20,0,TRUE,NA,"0.1.4"
"21542","646",2023-04-13 09:15:00,986,1006,20,0,TRUE,NA,"0.1.4"
"21543","646",2023-04-13 09:30:00,986,1006,20,0,TRUE,NA,"0.1.4"
"21544","646",2023-04-13 09:45:00,986,1006,20,0,TRUE,NA,"0.1.4"
"21545","646",2023-04-13 10:00:00,986,1006,20,0,TRUE,NA,"0.1.4"
"21546","646",2023-04-13 10:15:00,986,1006,20,0,TRUE,NA,"0.1.4"
"21547","646",2023-04-13 10:30:00,986,1006,20,0,TRUE,NA,"0.1.4"
"21548","646",2023-04-13 10:45:00,986,1006,20,0,TRUE,NA,"0.1.4"
"21549","646",2023-04-13 11:00:00,986,1006,20,0,TRUE,NA,"0.1.4"
"21550","646",2023-04-13 11:15:00,986,1006,20,0,TRUE,NA,"0.1.4"
"21551","646",2023-04-13 11:30:00,986,1006,20,0,TRUE,NA,"0.1.4"
"21552","646",2023-04-13 11:45:00,986,1006,20,0,TRUE,NA,"0.1.4"
"21553","646",2023-04-13 12:00:00,986,1006,20,0,TRUE,NA,"0.1.4"
"21554","646",2023-04-13 12:15:00,986,1006,20,0,TRUE,NA,"0.1.4"
"21555","646",2023-04-13 12:30:00,986,1006,20,0,TRUE,NA,"0.1.4"
"21556","646",2023-04-13 12:45:00,986,1006,20,0,TRUE,NA,"0.1.4"
"21557","646",2023-04-13 13:00:00,986,1006,20,0,TRUE,NA,"0.1.4"
"21558","646",2023-04-13 13:15:00,986,1006,20,0,TRUE,NA,"0.1.4"
"21559","646",2023-04-13 13:30:00,986,1006,20,0,TRUE,NA,"0.1.4"
"21560","646",2023-04-13 13:45:00,986,1006,20,0,TRUE,NA,"0.1.4"
"21561","646",2023-04-13 14:00:00,986,1006,20,0,TRUE,NA,"0.1.4"
"21562","646",2023-04-13 14:15:00,986,1006,20,0,TRUE,NA,"0.1.4"
"21563","646",2023-04-13 14:30:00,986,1006,20,0,TRUE,NA,"0.1.4"
"21564","646",2023-04-13 14:45:00,986,1006,20,0,TRUE,NA,"0.1.4"
"21565","646",2023-04-13 15:00:00,986,1006,20,0,TRUE,NA,"0.1.4"
"21566","646",2023-04-13 15:15:00,986,1006,20,0,TRUE,NA,"0.1.4"
"21567","646",2023-04-13 15:30:00,986,1006,20,0,TRUE,NA,"0.1.4"
"21568","646",2023-04-13 15:45:00,986,1006,20,0,TRUE,NA,"0.1.4"
"21569","646",2023-04-13 16:00:00,986,1006,20,0,TRUE,NA,"0.1.4"
"21570","646",2023-04-13 16:15:00,986,1006,20,0,TRUE,NA,"0.1.4"
"21571","646",2023-04-13 16:30:00,986,1006,20,0,TRUE,NA,"0.1.4"
"21572","646",2023-04-13 16:45:00,986,1006,20,0,TRUE,NA,"0.1.4"
"21573","646",2023-04-13 17:00:00,986,1006,20,0,TRUE,NA,"0.1.4"
"21574","646",2023-04-13 17:15:00,986,1006,20,0,TRUE,NA,"0.1.4"
"21575","646",2023-04-13 17:30:00,986,1006,20,0,TRUE,NA,"0.1.4"
"21576","646",2023-04-13 17:45:00,986,1006,20,0,TRUE,NA,"0.1.4"
"21577","646",2023-04-13 18:00:00,986,1006,20,0,TRUE,NA,"0.1.4"
"21578","646",2023-04-13 18:15:00,986,1006,20,0,TRUE,NA,"0.1.4"
"21579","646",2023-04-13 18:30:00,986,1006,20,0,TRUE,NA,"0.1.4"
"21580","646",2023-04-13 18:45:00,987,1006,19,0,TRUE,NA,"0.1.4"
"21581","646",2023-04-13 19:00:00,987,1006,19,0,TRUE,NA,"0.1.4"
"21582","646",2023-04-13 19:15:00,986,1006,20,0,FALSE,NA,"0.1.4"
"21583","646",2023-04-13 19:30:00,986,1006,20,0,FALSE,NA,"0.1.4"
"21584","646",2023-04-13 19:45:00,986,1006,20,0,FALSE,NA,"0.1.4"
"21585","646",2023-04-13 20:00:00,986,1006,20,0,FALSE,NA,"0.1.4"
"21586","646",2023-04-13 20:15:00,987,1006,19,0,FALSE,NA,"0.1.4"
"21587","646",2023-04-13 20:30:00,987,1006,19,0,FALSE,NA,"0.1.4"
"21588","646",2023-04-13 20:45:00,987,1006,19,0,FALSE,NA,"0.1.4"
"21589","646",2023-04-13 21:00:00,987,1006,19,0,FALSE,NA,"0.1.4"
"21590","646",2023-04-13 21:15:00,987,1006,19,0,FALSE,NA,"0.1.4"
"21591","646",2023-04-13 21:30:00,986,1006,20,0,FALSE,NA,"0.1.4"
"21592","646",2023-04-13 21:45:00,986,1006,20,0,FALSE,NA,"0.1.4"
"21593","646",2023-04-13 22:00:00,986,1006,20,0,FALSE,NA,"0.1.4"
"21594","646",2023-04-13 22:15:00,987,1006,19,0,FALSE,NA,"0.1.4"
"21595","646",2023-04-13 22:30:00,986,1006,20,0,FALSE,NA,"0.1.4"
"21596","646",2023-04-13 22:45:00,986,1006,20,0,FALSE,NA,"0.1.4"
"21597","646",2023-04-13 23:00:00,986,1006,20,0,FALSE,NA,"0.1.4"
"21598","646",2023-04-13 23:15:00,986,1006,20,0,FALSE,NA,"0.1.4"
"21599","646",2023-04-13 23:30:00,986,1006,20,0,FALSE,NA,"0.1.4"
"21600","646",2023-04-13 23:45:00,986,1006,20,0,FALSE,NA,"0.1.4"
"21601","646",2023-04-14,986,1006,20,0,FALSE,NA,"0.1.4"
"21602","646",2023-04-14 00:15:00,986,1006,20,0,FALSE,NA,"0.1.4"
"21603","646",2023-04-14 00:30:00,986,1006,20,0,FALSE,NA,"0.1.4"
"21604","646",2023-04-14 00:45:00,986,1006,20,0,FALSE,NA,"0.1.4"
"21605","646",2023-04-14 01:00:00,986,1006,20,0,FALSE,NA,"0.1.4"
"21606","646",2023-04-14 01:15:00,986,1006,20,0,FALSE,NA,"0.1.4"
"21607","646",2023-04-14 01:30:00,986,1006,20,0,FALSE,NA,"0.1.4"
"21608","646",2023-04-14 01:45:00,986,1006,20,0,FALSE,NA,"0.1.4"
"21609","646",2023-04-14 02:00:00,986,1006,20,0,FALSE,NA,"0.1.4"
"21610","646",2023-04-14 02:15:00,986,1006,20,0,FALSE,NA,"0.1.4"
"21611","646",2023-04-14 02:30:00,986,1006,20,0,FALSE,NA,"0.1.4"
"21612","646",2023-04-14 02:45:00,986,1006,20,0,TRUE,NA,"0.1.4"
"21613","646",2023-04-14 03:00:00,986,1006,20,0,TRUE,NA,"0.1.4"
"21614","646",2023-04-14 03:15:00,986,1006,20,0,TRUE,NA,"0.1.4"
"21615","646",2023-04-14 03:30:00,986,1006,20,0,TRUE,NA,"0.1.4"
"21616","646",2023-04-14 03:45:00,986,1006,20,0,TRUE,NA,"0.1.4"
"21617","646",2023-04-14 04:00:00,986,1006,20,0,TRUE,NA,"0.1.4"
"21618","646",2023-04-14 04:15:00,986,1006,20,0,TRUE,NA,"0.1.4"
"21619","646",2023-04-14 04:30:00,986,1006,20,0,TRUE,NA,"0.1.4"
"21620","646",2023-04-14 04:45:00,986,1006,20,0,TRUE,NA,"0.1.4"
"21621","646",2023-04-14 05:00:00,986,1006,20,0,TRUE,NA,"0.1.4"
"21622","646",2023-04-14 05:15:00,986,1006,20,0,TRUE,NA,"0.1.4"
"21623","646",2023-04-14 05:30:00,986,1006,20,0,TRUE,NA,"0.1.4"
"21624","646",2023-04-14 05:45:00,986,1006,20,0,TRUE,NA,"0.1.4"
"21625","646",2023-04-14 06:00:00,986,1006,20,0,TRUE,NA,"0.1.4"
"21626","646",2023-04-14 06:15:00,986,1006,20,0,TRUE,NA,"0.1.4"
"21627","646",2023-04-14 06:30:00,986,1006,20,0,TRUE,NA,"0.1.4"
"21628","646",2023-04-14 06:45:00,986,1006,20,0,TRUE,NA,"0.1.4"
"21629","646",2023-04-14 07:00:00,986,1006,20,0,TRUE,NA,"0.1.4"
"21630","646",2023-04-14 07:15:00,986,1006,20,0,TRUE,NA,"0.1.4"
"21631","646",2023-04-14 07:30:00,986,1006,20,0,TRUE,NA,"0.1.4"
"21632","646",2023-04-14 07:45:00,986,1006,20,0,TRUE,NA,"0.1.4"
"21633","646",2023-04-14 08:00:00,986,1006,20,0,TRUE,NA,"0.1.4"
"21634","646",2023-04-14 08:15:00,986,1006,20,0,TRUE,NA,"0.1.4"
"21635","646",2023-04-14 08:30:00,986,1006,20,0,TRUE,NA,"0.1.4"
"21636","646",2023-04-14 08:45:00,986,1006,20,0,TRUE,NA,"0.1.4"
"21637","646",2023-04-14 09:00:00,986,1006,20,0,TRUE,NA,"0.1.4"
"21638","646",2023-04-14 09:15:00,986,1006,20,0,TRUE,NA,"0.1.4"
"21639","646",2023-04-14 09:30:00,986,1006,20,0,TRUE,NA,"0.1.4"
"21640","646",2023-04-14 09:45:00,986,1006,20,0,TRUE,NA,"0.1.4"
"21641","646",2023-04-14 10:00:00,986,1006,20,0,TRUE,NA,"0.1.4"
"21642","646",2023-04-14 10:15:00,986,1006,20,0,TRUE,NA,"0.1.4"
"21643","646",2023-04-14 10:30:00,986,1006,20,0,TRUE,NA,"0.1.4"
"21644","646",2023-04-14 10:45:00,986,1006,20,0,TRUE,NA,"0.1.4"
"21645","646",2023-04-14 11:00:00,986,1006,20,0,TRUE,NA,"0.1.4"
"21646","646",2023-04-14 11:15:00,986,1006,20,0,TRUE,NA,"0.1.4"
"21647","646",2023-04-14 11:30:00,986,1006,20,0,TRUE,NA,"0.1.4"
"21648","646",2023-04-14 11:45:00,986,1006,20,0,TRUE,NA,"0.1.4"
"21649","646",2023-04-14 12:00:00,986,1006,20,0,TRUE,NA,"0.1.4"
"21650","646",2023-04-14 12:15:00,986,1006,20,0,TRUE,NA,"0.1.4"
"21651","646",2023-04-14 12:30:00,986,1006,20,0,TRUE,NA,"0.1.4"
"21652","646",2023-04-14 12:45:00,986,1006,20,0,TRUE,NA,"0.1.4"
"21653","646",2023-04-14 13:00:00,986,1006,20,0,TRUE,NA,"0.1.4"
"21654","646",2023-04-14 13:15:00,986,1006,20,0,TRUE,NA,"0.1.4"
"21655","646",2023-04-14 13:30:00,986,1006,20,0,TRUE,NA,"0.1.4"
"21656","646",2023-04-14 13:45:00,986,1006,20,0,TRUE,NA,"0.1.4"
"21657","646",2023-04-14 14:00:00,986,1006,20,0,TRUE,NA,"0.1.4"
"21658","646",2023-04-14 14:15:00,986,1006,20,0,TRUE,NA,"0.1.4"
"21659","646",2023-04-14 14:30:00,986,1006,20,0,TRUE,NA,"0.1.4"
"21660","646",2023-04-14 14:45:00,986,1006,20,0,TRUE,NA,"0.1.4"
"21661","646",2023-04-14 15:00:00,986,1006,20,0,TRUE,NA,"0.1.4"
"21662","646",2023-04-14 15:15:00,986,1006,20,0,TRUE,NA,"0.1.4"
"21663","646",2023-04-14 15:30:00,986,1006,20,0,TRUE,NA,"0.1.4"
"21664","646",2023-04-14 15:45:00,986,1006,20,0,TRUE,NA,"0.1.4"
"21665","646",2023-04-14 16:00:00,986,1006,20,0,TRUE,NA,"0.1.4"
"21666","646",2023-04-14 16:15:00,986,1006,20,0,TRUE,NA,"0.1.4"
"21667","646",2023-04-14 16:30:00,986,1006,20,0,TRUE,NA,"0.1.4"
"21668","646",2023-04-14 16:45:00,986,1006,20,0,TRUE,NA,"0.1.4"
"21669","646",2023-04-14 17:00:00,986,1006,20,0,TRUE,NA,"0.1.4"
"21670","646",2023-04-14 17:15:00,986,1006,20,0,TRUE,NA,"0.1.4"
"21671","646",2023-04-14 17:30:00,986,1006,20,0,TRUE,NA,"0.1.4"
"21672","646",2023-04-14 17:45:00,986,1006,20,0,TRUE,NA,"0.1.4"
"21673","646",2023-04-14 18:00:00,986,1006,20,0,TRUE,NA,"0.1.4"
"21674","646",2023-04-14 18:15:00,986,1006,20,0,FALSE,NA,"0.1.4"
"21675","646",2023-04-14 18:30:00,986,1006,20,0,FALSE,NA,"0.1.4"
"21676","646",2023-04-14 18:45:00,986,1006,20,0,FALSE,NA,"0.1.4"
"21677","646",2023-04-14 19:00:00,986,1006,20,0,FALSE,NA,"0.1.4"
"21678","646",2023-04-14 19:15:00,986,1006,20,0,FALSE,NA,"0.1.4"
"21679","646",2023-04-14 19:30:00,986,1006,20,0,FALSE,NA,"0.1.4"
"21680","646",2023-04-14 19:45:00,986,1006,20,0,FALSE,NA,"0.1.4"
"21681","646",2023-04-14 20:00:00,986,1006,20,0,FALSE,NA,"0.1.4"
"21682","646",2023-04-14 20:15:00,986,1006,20,0,FALSE,NA,"0.1.4"
"21683","646",2023-04-14 20:30:00,986,1006,20,0,FALSE,NA,"0.1.4"
"21684","646",2023-04-14 20:45:00,986,1006,20,0,FALSE,NA,"0.1.4"
"21685","646",2023-04-14 21:00:00,986,1006,20,0,FALSE,NA,"0.1.4"
"21686","646",2023-04-14 21:15:00,986,1006,20,0,FALSE,NA,"0.1.4"
"21687","646",2023-04-14 21:30:00,986,1006,20,0,FALSE,NA,"0.1.4"
"21688","646",2023-04-14 21:45:00,986,1006,20,0,FALSE,NA,"0.1.4"
"21689","646",2023-04-14 22:00:00,986,1006,20,0,FALSE,NA,"0.1.4"
"21690","646",2023-04-14 22:15:00,986,1006,20,0,FALSE,NA,"0.1.4"
"21691","646",2023-04-14 22:30:00,986,1006,20,0,FALSE,NA,"0.1.4"
"21692","646",2023-04-14 22:45:00,985,1006,21,0,FALSE,NA,"0.1.4"
"21693","646",2023-04-14 23:00:00,985,1006,21,0,FALSE,NA,"0.1.4"
"21694","646",2023-04-14 23:15:00,985,1006,21,0,FALSE,NA,"0.1.4"
"21695","646",2023-04-14 23:30:00,985,1006,21,0,FALSE,NA,"0.1.4"
"21696","646",2023-04-14 23:45:00,986,1006,20,0,FALSE,NA,"0.1.4"
"21697","646",2023-04-15,986,1006,20,0,FALSE,NA,"0.1.4"
"21698","646",2023-04-15 00:15:00,986,1006,20,0,FALSE,NA,"0.1.4"
"21699","646",2023-04-15 00:30:00,986,1006,20,0,FALSE,NA,"0.1.4"
"21700","646",2023-04-15 00:45:00,986,1006,20,0,FALSE,NA,"0.1.4"
"21701","646",2023-04-15 01:00:00,986,1006,20,0,FALSE,NA,"0.1.4"
"21702","646",2023-04-15 01:15:00,985,1006,21,0,FALSE,NA,"0.1.4"
"21703","646",2023-04-15 01:30:00,986,1006,20,0,FALSE,NA,"0.1.4"
"21704","646",2023-04-15 01:45:00,985,1006,21,0,FALSE,NA,"0.1.4"
"21705","646",2023-04-15 02:00:00,985,1006,21,0,FALSE,NA,"0.1.4"
"21706","646",2023-04-15 02:15:00,985,1006,21,0,FALSE,NA,"0.1.4"
"21707","646",2023-04-15 02:30:00,986,1006,20,0,FALSE,NA,"0.1.4"
"21708","646",2023-04-15 02:45:00,985,1006,21,0,FALSE,NA,"0.1.4"
"21709","646",2023-04-15 03:00:00,985,1006,21,0,FALSE,NA,"0.1.4"
"21710","646",2023-04-15 03:15:00,986,1006,20,0,FALSE,NA,"0.1.4"
"21711","646",2023-04-15 03:30:00,986,1006,20,0,FALSE,NA,"0.1.4"
"21712","646",2023-04-15 03:45:00,985,1006,21,0,FALSE,NA,"0.1.4"
"21713","646",2023-04-15 04:00:00,986,1006,20,0,FALSE,NA,"0.1.4"
"21714","646",2023-04-15 04:15:00,985,1006,21,0,TRUE,NA,"0.1.4"
"21715","646",2023-04-15 04:30:00,986,1006,20,0,TRUE,NA,"0.1.4"
"21716","646",2023-04-15 04:45:00,986,1006,20,0,TRUE,NA,"0.1.4"
"21717","646",2023-04-15 05:00:00,986,1006,20,0,TRUE,NA,"0.1.4"
"21718","646",2023-04-15 05:15:00,985,1006,21,0,TRUE,NA,"0.1.4"
"21719","646",2023-04-15 05:30:00,985,1006,21,0,TRUE,NA,"0.1.4"
"21720","646",2023-04-15 05:45:00,985,1006,21,0,TRUE,NA,"0.1.4"
"21721","646",2023-04-15 06:00:00,986,1006,20,0,TRUE,NA,"0.1.4"
"21722","646",2023-04-15 06:15:00,986,1006,20,0,TRUE,NA,"0.1.4"
"21723","646",2023-04-15 06:30:00,986,1006,20,0,TRUE,NA,"0.1.4"
"21724","646",2023-04-15 06:45:00,986,1006,20,0,TRUE,NA,"0.1.4"
"21725","646",2023-04-15 07:00:00,986,1006,20,0,TRUE,NA,"0.1.4"
"21726","646",2023-04-15 07:15:00,986,1006,20,0,TRUE,NA,"0.1.4"
"21727","646",2023-04-15 07:30:00,986,1006,20,0,TRUE,NA,"0.1.4"
"21728","646",2023-04-15 07:45:00,986,1006,20,0,TRUE,NA,"0.1.4"
"21729","646",2023-04-15 08:00:00,986,1006,20,0,TRUE,NA,"0.1.4"
"21730","646",2023-04-15 08:15:00,986,1006,20,0,TRUE,NA,"0.1.4"
"21731","646",2023-04-15 08:30:00,986,1006,20,0,TRUE,NA,"0.1.4"
"21732","646",2023-04-15 08:45:00,986,1006,20,0,TRUE,NA,"0.1.4"
"21733","646",2023-04-15 09:00:00,986,1006,20,0,TRUE,NA,"0.1.4"
"21734","646",2023-04-15 09:15:00,986,1006,20,0,TRUE,NA,"0.1.4"
"21735","646",2023-04-15 09:30:00,986,1006,20,0,TRUE,NA,"0.1.4"
"21736","646",2023-04-15 09:45:00,986,1006,20,0,TRUE,NA,"0.1.4"
"21737","646",2023-04-15 10:00:00,986,1006,20,0,TRUE,NA,"0.1.4"
"21738","646",2023-04-15 10:15:00,986,1006,20,0,TRUE,NA,"0.1.4"
"21739","646",2023-04-15 10:30:00,986,1006,20,0,TRUE,NA,"0.1.4"
"21740","646",2023-04-15 10:45:00,986,1006,20,0,TRUE,NA,"0.1.4"
"21741","646",2023-04-15 11:00:00,986,1006,20,0,TRUE,NA,"0.1.4"
"21742","646",2023-04-15 11:15:00,986,1006,20,0,TRUE,NA,"0.1.4"
"21743","646",2023-04-15 11:30:00,986,1006,20,0,TRUE,NA,"0.1.4"
"21744","646",2023-04-15 11:45:00,986,1006,20,0,TRUE,NA,"0.1.4"
"21745","646",2023-04-15 12:00:00,986,1006,20,0,TRUE,NA,"0.1.4"
"21746","646",2023-04-15 12:15:00,986,1006,20,0,TRUE,NA,"0.1.4"
"21747","646",2023-04-15 12:30:00,986,1006,20,0,TRUE,NA,"0.1.4"
"21748","646",2023-04-15 12:45:00,986,1006,20,0,TRUE,NA,"0.1.4"
"21749","646",2023-04-15 13:00:00,986,1006,20,0,TRUE,NA,"0.1.4"
"21750","646",2023-04-15 13:15:00,986,1006,20,0,TRUE,NA,"0.1.4"
"21751","646",2023-04-15 13:30:00,986,1006,20,0,TRUE,NA,"0.1.4"
"21752","646",2023-04-15 13:45:00,986,1006,20,0,TRUE,NA,"0.1.4"
"21753","646",2023-04-15 14:00:00,986,1006,20,0,TRUE,NA,"0.1.4"
"21754","646",2023-04-15 14:15:00,986,1006,20,0,TRUE,NA,"0.1.4"
"21755","646",2023-04-15 14:30:00,986,1006,20,0,TRUE,NA,"0.1.4"
"21756","646",2023-04-15 14:45:00,986,1006,20,0,TRUE,NA,"0.1.4"
"21757","646",2023-04-15 15:00:00,986,1006,20,0,TRUE,NA,"0.1.4"
"21758","646",2023-04-15 15:15:00,986,1006,20,0,TRUE,NA,"0.1.4"
"21759","646",2023-04-15 15:30:00,986,1006,20,0,TRUE,NA,"0.1.4"
"21760","646",2023-04-15 15:45:00,986,1006,20,0,TRUE,NA,"0.1.4"
"21761","646",2023-04-15 16:00:00,986,1006,20,0,TRUE,NA,"0.1.4"
"21762","646",2023-04-15 16:15:00,986,1006,20,0,TRUE,NA,"0.1.4"
"21763","646",2023-04-15 16:30:00,986,1006,20,0,TRUE,NA,"0.1.4"
"21764","646",2023-04-15 16:45:00,986,1006,20,0,TRUE,NA,"0.1.4"
"21765","646",2023-04-15 17:00:00,986,1006,20,0,TRUE,NA,"0.1.4"
"21766","646",2023-04-15 17:15:00,986,1006,20,0,TRUE,NA,"0.1.4"
"21767","646",2023-04-15 17:30:00,986,1006,20,0,TRUE,NA,"0.1.4"
"21768","646",2023-04-15 17:45:00,986,1006,20,0,FALSE,NA,"0.1.4"
"21769","646",2023-04-15 18:00:00,986,1006,20,0,FALSE,NA,"0.1.4"
"21770","646",2023-04-15 18:15:00,986,1006,20,0,FALSE,NA,"0.1.4"
"21771","646",2023-04-15 18:30:00,986,1006,20,0,FALSE,NA,"0.1.4"
"21772","646",2023-04-15 18:45:00,986,1006,20,0,FALSE,NA,"0.1.4"
"21773","646",2023-04-15 19:00:00,986,1006,20,0,FALSE,NA,"0.1.4"
"21774","646",2023-04-15 19:15:00,986,1006,20,0,FALSE,NA,"0.1.4"
"21775","646",2023-04-15 19:30:00,986,1006,20,0,FALSE,NA,"0.1.4"
"21776","646",2023-04-15 19:45:00,986,1006,20,0,FALSE,NA,"0.1.4"
"21777","646",2023-04-15 20:00:00,986,1006,20,0,FALSE,NA,"0.1.4"
"21778","646",2023-04-15 20:15:00,986,1006,20,0,FALSE,NA,"0.1.4"
"21779","646",2023-04-15 20:30:00,986,1006,20,0,FALSE,NA,"0.1.4"
"21780","646",2023-04-15 20:45:00,986,1006,20,0,FALSE,NA,"0.1.4"
"21781","646",2023-04-15 21:00:00,986,1006,20,0,FALSE,NA,"0.1.4"
"21782","646",2023-04-15 21:15:00,986,1006,20,0,FALSE,NA,"0.1.4"
"21783","646",2023-04-15 21:30:00,985,1006,21,0,FALSE,NA,"0.1.4"
"21784","646",2023-04-15 21:45:00,986,1006,20,0,FALSE,NA,"0.1.4"
"21785","646",2023-04-15 22:00:00,985,1006,21,0,FALSE,NA,"0.1.4"
"21786","646",2023-04-15 22:15:00,985,1006,21,0,FALSE,NA,"0.1.4"
"21787","646",2023-04-15 22:30:00,985,1006,21,0,FALSE,NA,"0.1.4"
"21788","646",2023-04-15 22:45:00,986,1006,20,0,FALSE,NA,"0.1.4"
"21789","646",2023-04-15 23:00:00,985,1006,21,0,FALSE,NA,"0.1.4"
"21790","646",2023-04-15 23:15:00,986,1006,20,0,FALSE,NA,"0.1.4"
"21791","646",2023-04-15 23:30:00,986,1006,20,0,FALSE,NA,"0.1.4"
"21792","646",2023-04-15 23:45:00,985,1006,21,0,FALSE,NA,"0.1.4"
"21793","646",2023-04-16,985,1006,21,0,FALSE,NA,"0.1.4"
"21794","646",2023-04-16 00:15:00,986,1006,20,0,FALSE,NA,"0.1.4"
"21795","646",2023-04-16 00:30:00,986,1006,20,0,FALSE,NA,"0.1.4"
"21796","646",2023-04-16 00:45:00,986,1006,20,0,FALSE,NA,"0.1.4"
"21797","646",2023-04-16 01:00:00,985,1006,21,0,FALSE,NA,"0.1.4"
"21798","646",2023-04-16 01:15:00,985,1006,21,0,FALSE,NA,"0.1.4"
"21799","646",2023-04-16 01:30:00,985,1006,21,0,FALSE,NA,"0.1.4"
"21800","646",2023-04-16 01:45:00,985,1006,21,0,FALSE,NA,"0.1.4"
"21801","646",2023-04-16 02:00:00,985,1006,21,0,FALSE,NA,"0.1.4"
"21802","646",2023-04-16 02:15:00,985,1006,21,0,FALSE,NA,"0.1.4"
"21803","646",2023-04-16 02:30:00,985,1006,21,0,FALSE,NA,"0.1.4"
"21804","646",2023-04-16 02:45:00,985,1006,21,0,FALSE,NA,"0.1.4"
"21805","646",2023-04-16 03:00:00,985,1006,21,0,FALSE,NA,"0.1.4"
"21806","646",2023-04-16 03:15:00,985,1006,21,0,FALSE,NA,"0.1.4"
"21807","646",2023-04-16 03:30:00,985,1006,21,0,FALSE,NA,"0.1.4"
"21808","646",2023-04-16 03:45:00,985,1006,21,0,FALSE,NA,"0.1.4"
"21809","646",2023-04-16 04:00:00,985,1006,21,0,FALSE,NA,"0.1.4"
"21810","646",2023-04-16 04:15:00,985,1006,21,0,FALSE,NA,"0.1.4"
"21811","646",2023-04-16 04:30:00,985,1006,21,0,FALSE,NA,"0.1.4"
"21812","646",2023-04-16 04:45:00,985,1006,21,0,FALSE,NA,"0.1.4"
"21813","646",2023-04-16 05:00:00,985,1006,21,0,FALSE,NA,"0.1.4"
"21814","646",2023-04-16 05:15:00,985,1006,21,0,FALSE,NA,"0.1.4"
"21815","646",2023-04-16 05:30:00,985,1006,21,0,FALSE,NA,"0.1.4"
"21816","646",2023-04-16 05:45:00,985,1006,21,0,FALSE,NA,"0.1.4"
"21817","646",2023-04-16 06:00:00,985,1006,21,0,FALSE,NA,"0.1.4"
"21818","646",2023-04-16 06:15:00,985,1006,21,0,FALSE,NA,"0.1.4"
"21819","646",2023-04-16 06:30:00,985,1006,21,0,TRUE,NA,"0.1.4"
"21820","646",2023-04-16 06:45:00,985,1006,21,0,TRUE,NA,"0.1.4"
"21821","646",2023-04-16 07:00:00,985,1006,21,0,TRUE,NA,"0.1.4"
"21822","646",2023-04-16 07:15:00,985,1006,21,0,TRUE,NA,"0.1.4"
"21823","646",2023-04-16 07:30:00,985,1006,21,0,TRUE,NA,"0.1.4"
"21824","646",2023-04-16 07:45:00,985,1006,21,0,TRUE,NA,"0.1.4"
"21825","646",2023-04-16 08:00:00,985,1006,21,0,TRUE,NA,"0.1.4"
"21826","646",2023-04-16 08:15:00,985,1006,21,0,TRUE,NA,"0.1.4"
"21827","646",2023-04-16 08:30:00,985,1006,21,0,TRUE,NA,"0.1.4"
"21828","646",2023-04-16 08:45:00,985,1006,21,0,TRUE,NA,"0.1.4"
"21829","646",2023-04-16 09:00:00,985,1006,21,0,TRUE,NA,"0.1.4"
"21830","646",2023-04-16 09:15:00,985,1006,21,0,TRUE,NA,"0.1.4"
"21831","646",2023-04-16 09:30:00,985,1006,21,0,TRUE,NA,"0.1.4"
"21832","646",2023-04-16 09:45:00,985,1006,21,0,TRUE,NA,"0.1.4"
"21833","646",2023-04-16 10:00:00,985,1006,21,0,TRUE,NA,"0.1.4"
"21834","646",2023-04-16 10:15:00,985,1006,21,0,TRUE,NA,"0.1.4"
"21835","646",2023-04-16 10:30:00,985,1006,21,0,TRUE,NA,"0.1.4"
"21836","646",2023-04-16 10:45:00,985,1006,21,0,TRUE,NA,"0.1.4"
"21837","646",2023-04-16 11:00:00,985,1006,21,0,TRUE,NA,"0.1.4"
"21838","646",2023-04-16 11:15:00,985,1006,21,0,TRUE,NA,"0.1.4"
"21839","646",2023-04-16 11:30:00,985,1006,21,0,TRUE,NA,"0.1.4"
"21840","646",2023-04-16 11:45:00,985,1006,21,0,TRUE,NA,"0.1.4"
"21841","646",2023-04-16 12:00:00,985,1006,21,0,TRUE,NA,"0.1.4"
"21842","646",2023-04-16 12:15:00,985,1006,21,0,TRUE,NA,"0.1.4"
"21843","646",2023-04-16 12:30:00,985,1006,21,0,TRUE,NA,"0.1.4"
"21844","646",2023-04-16 12:45:00,985,1006,21,0,TRUE,NA,"0.1.4"
"21845","646",2023-04-16 13:00:00,985,1006,21,0,TRUE,NA,"0.1.4"
"21846","646",2023-04-16 13:15:00,985,1006,21,0,TRUE,NA,"0.1.4"
"21847","646",2023-04-16 13:30:00,985,1006,21,0,TRUE,NA,"0.1.4"
"21848","646",2023-04-16 13:45:00,985,1006,21,0,TRUE,NA,"0.1.4"
"21849","646",2023-04-16 14:00:00,985,1006,21,0,TRUE,NA,"0.1.4"
"21850","646",2023-04-16 14:15:00,985,1006,21,0,TRUE,NA,"0.1.4"
"21851","646",2023-04-16 14:30:00,985,1006,21,0,TRUE,NA,"0.1.4"
"21852","646",2023-04-16 14:45:00,985,1006,21,0,TRUE,NA,"0.1.4"
"21853","646",2023-04-16 15:00:00,985,1006,21,0,TRUE,NA,"0.1.4"
"21854","646",2023-04-16 15:15:00,985,1006,21,0,TRUE,NA,"0.1.4"
"21855","646",2023-04-16 15:30:00,985,1006,21,0,TRUE,NA,"0.1.4"
"21856","646",2023-04-16 15:45:00,985,1006,21,0,TRUE,NA,"0.1.4"
"21857","646",2023-04-16 16:00:00,985,1006,21,0,TRUE,NA,"0.1.4"
"21858","646",2023-04-16 16:15:00,985,1006,21,0,TRUE,NA,"0.1.4"
"21859","646",2023-04-16 16:30:00,985,1006,21,0,TRUE,NA,"0.1.4"
"21860","646",2023-04-16 16:45:00,985,1006,21,0,FALSE,NA,"0.1.4"
"21861","646",2023-04-16 17:00:00,985,1006,21,0,FALSE,NA,"0.1.4"
"21862","646",2023-04-16 17:15:00,985,1006,21,0,FALSE,NA,"0.1.4"
"21863","646",2023-04-16 17:30:00,985,1006,21,0,FALSE,NA,"0.1.4"
"21864","646",2023-04-16 17:45:00,985,1006,21,0,FALSE,NA,"0.1.4"
"21865","646",2023-04-16 18:00:00,985,1006,21,0,FALSE,NA,"0.1.4"
"21866","646",2023-04-16 18:15:00,985,1006,21,0,FALSE,NA,"0.1.4"
"21867","646",2023-04-16 18:30:00,985,1006,21,0,FALSE,NA,"0.1.4"
"21868","646",2023-04-16 18:45:00,985,1006,21,0,FALSE,NA,"0.1.4"
"21869","646",2023-04-16 19:00:00,985,1006,21,0,FALSE,NA,"0.1.4"
"21870","646",2023-04-16 19:15:00,985,1006,21,0,FALSE,NA,"0.1.4"
"21871","646",2023-04-16 19:30:00,985,1006,21,0,FALSE,NA,"0.1.4"
"21872","646",2023-04-16 19:45:00,985,1006,21,0,FALSE,NA,"0.1.4"
"21873","646",2023-04-16 20:00:00,985,1006,21,0,FALSE,NA,"0.1.4"
"21874","646",2023-04-16 20:15:00,985,1006,21,0,FALSE,NA,"0.1.4"
"21875","646",2023-04-16 20:30:00,985,1006,21,0,FALSE,NA,"0.1.4"
"21876","646",2023-04-16 20:45:00,985,1006,21,0,FALSE,NA,"0.1.4"
"21877","646",2023-04-16 21:00:00,985,1006,21,0,FALSE,NA,"0.1.4"
"21878","646",2023-04-16 21:15:00,985,1006,21,0,FALSE,NA,"0.1.4"
"21879","646",2023-04-16 21:30:00,985,1006,21,0,FALSE,NA,"0.1.4"
"21880","646",2023-04-16 21:45:00,985,1006,21,0,FALSE,NA,"0.1.4"
"21881","646",2023-04-16 22:00:00,985,1006,21,0,FALSE,NA,"0.1.4"
"21882","646",2023-04-16 22:15:00,985,1006,21,0,FALSE,NA,"0.1.4"
"21883","646",2023-04-16 22:30:00,985,1006,21,0,FALSE,NA,"0.1.4"
"21884","646",2023-04-16 22:45:00,985,1006,21,0,FALSE,NA,"0.1.4"
"21885","646",2023-04-16 23:00:00,985,1006,21,0,FALSE,NA,"0.1.4"
"21886","646",2023-04-16 23:15:00,985,1006,21,0,FALSE,NA,"0.1.4"
"21887","646",2023-04-16 23:30:00,986,1006,20,0,FALSE,NA,"0.1.4"
"21888","646",2023-04-16 23:45:00,985,1006,21,0,FALSE,NA,"0.1.4"
"21889","646",2023-04-17,986,1006,20,0,FALSE,NA,"0.1.4"
"21890","646",2023-04-17 00:15:00,986,1006,20,0,FALSE,NA,"0.1.4"
"21891","646",2023-04-17 00:30:00,985,1006,21,0,FALSE,NA,"0.1.4"
"21892","646",2023-04-17 00:45:00,986,1006,20,0,FALSE,NA,"0.1.4"
"21893","646",2023-04-17 01:00:00,986,1006,20,0,FALSE,NA,"0.1.4"
"21894","646",2023-04-17 01:15:00,986,1006,20,0,FALSE,NA,"0.1.4"
"21895","646",2023-04-17 01:30:00,985,1006,21,0,FALSE,NA,"0.1.4"
"21896","646",2023-04-17 01:45:00,986,1006,20,0,FALSE,NA,"0.1.4"
"21897","646",2023-04-17 02:00:00,986,1006,20,0,FALSE,NA,"0.1.4"
"21898","646",2023-04-17 02:15:00,986,1006,20,0,TRUE,NA,"0.1.4"
"21899","646",2023-04-17 02:30:00,986,1006,20,0,TRUE,NA,"0.1.4"
"21900","646",2023-04-17 02:45:00,986,1006,20,0,TRUE,NA,"0.1.4"
"21901","646",2023-04-17 03:00:00,986,1006,20,0,TRUE,NA,"0.1.4"
"21902","646",2023-04-17 03:15:00,986,1006,20,0,TRUE,NA,"0.1.4"
"21903","646",2023-04-17 03:30:00,986,1006,20,0,TRUE,NA,"0.1.4"
"21904","646",2023-04-17 03:45:00,986,1006,20,0,TRUE,NA,"0.1.4"
"21905","646",2023-04-17 04:00:00,986,1006,20,0,TRUE,NA,"0.1.4"
"21906","646",2023-04-17 04:15:00,986,1006,20,0,TRUE,NA,"0.1.4"
"21907","646",2023-04-17 04:30:00,986,1006,20,0,TRUE,NA,"0.1.4"
"21908","646",2023-04-17 04:45:00,986,1006,20,0,TRUE,NA,"0.1.4"
"21909","646",2023-04-17 05:00:00,986,1006,20,0,TRUE,NA,"0.1.4"
"21910","646",2023-04-17 05:15:00,986,1006,20,0,TRUE,NA,"0.1.4"
"21911","646",2023-04-17 05:30:00,986,1006,20,0,TRUE,NA,"0.1.4"
"21912","646",2023-04-17 05:45:00,986,1006,20,0,TRUE,NA,"0.1.4"
"21913","646",2023-04-17 06:00:00,986,1006,20,0,TRUE,NA,"0.1.4"
"21914","646",2023-04-17 06:15:00,986,1006,20,0,TRUE,NA,"0.1.4"
"21915","646",2023-04-17 06:30:00,986,1006,20,0,TRUE,NA,"0.1.4"
"21916","646",2023-04-17 06:45:00,986,1006,20,0,TRUE,NA,"0.1.4"
"21917","646",2023-04-17 07:00:00,986,1006,20,0,TRUE,NA,"0.1.4"
"21918","646",2023-04-17 07:15:00,986,1006,20,0,TRUE,NA,"0.1.4"
"21919","646",2023-04-17 07:30:00,986,1006,20,0,TRUE,NA,"0.1.4"
"21920","646",2023-04-17 07:45:00,986,1006,20,0,TRUE,NA,"0.1.4"
"21921","646",2023-04-17 08:00:00,986,1006,20,0,TRUE,NA,"0.1.4"
"21922","646",2023-04-17 08:15:00,986,1006,20,0,TRUE,NA,"0.1.4"
"21923","646",2023-04-17 08:30:00,986,1006,20,0,TRUE,NA,"0.1.4"
"21924","646",2023-04-17 08:45:00,986,1006,20,0,TRUE,NA,"0.1.4"
"21925","646",2023-04-17 09:00:00,986,1006,20,0,TRUE,NA,"0.1.4"
"21926","646",2023-04-17 09:15:00,986,1006,20,0,TRUE,NA,"0.1.4"
"21927","646",2023-04-17 09:30:00,986,1006,20,0,TRUE,NA,"0.1.4"
"21928","646",2023-04-17 09:45:00,986,1006,20,0,TRUE,NA,"0.1.4"
"21929","646",2023-04-17 10:00:00,986,1006,20,0,TRUE,NA,"0.1.4"
"21930","646",2023-04-17 10:15:00,986,1006,20,0,TRUE,NA,"0.1.4"
"21931","646",2023-04-17 10:30:00,986,1006,20,0,TRUE,NA,"0.1.4"
"21932","646",2023-04-17 10:45:00,986,1006,20,0,TRUE,NA,"0.1.4"
"21933","646",2023-04-17 11:00:00,986,1006,20,0,TRUE,NA,"0.1.4"
"21934","646",2023-04-17 11:15:00,986,1006,20,0,TRUE,NA,"0.1.4"
"21935","646",2023-04-17 11:30:00,986,1006,20,0,TRUE,NA,"0.1.4"
"21936","646",2023-04-17 11:45:00,986,1006,20,0,TRUE,NA,"0.1.4"
"21937","646",2023-04-17 12:00:00,986,1006,20,0,TRUE,NA,"0.1.4"
"21938","646",2023-04-17 12:15:00,986,1006,20,0,TRUE,NA,"0.1.4"
"21939","646",2023-04-17 12:30:00,986,1006,20,0,TRUE,NA,"0.1.4"
"21940","646",2023-04-17 12:45:00,986,1006,20,0,TRUE,NA,"0.1.4"
"21941","646",2023-04-17 13:00:00,986,1006,20,0,TRUE,NA,"0.1.4"
"21942","646",2023-04-17 13:15:00,986,1006,20,0,TRUE,NA,"0.1.4"
"21943","646",2023-04-17 13:30:00,986,1006,20,0,TRUE,NA,"0.1.4"
"21944","646",2023-04-17 13:45:00,986,1006,20,0,TRUE,NA,"0.1.4"
"21945","646",2023-04-17 14:00:00,986,1006,20,0,TRUE,NA,"0.1.4"
"21946","646",2023-04-17 14:15:00,986,1006,20,0,TRUE,NA,"0.1.4"
"21947","646",2023-04-17 14:30:00,986,1006,20,0,TRUE,NA,"0.1.4"
"21948","646",2023-04-17 14:45:00,986,1006,20,0,TRUE,NA,"0.1.4"
"21949","646",2023-04-17 15:00:00,986,1006,20,0,TRUE,NA,"0.1.4"
"21950","646",2023-04-17 15:15:00,986,1006,20,0,TRUE,NA,"0.1.4"
"21951","646",2023-04-17 15:30:00,986,1006,20,0,TRUE,NA,"0.1.4"
"21952","646",2023-04-17 15:45:00,986,1006,20,0,TRUE,NA,"0.1.4"
"21953","646",2023-04-17 16:00:00,986,1006,20,0,TRUE,NA,"0.1.4"
"21954","646",2023-04-17 16:15:00,986,1006,20,0,TRUE,NA,"0.1.4"
"21955","646",2023-04-17 16:30:00,986,1006,20,0,TRUE,NA,"0.1.4"
"21956","646",2023-04-17 16:45:00,986,1006,20,0,TRUE,NA,"0.1.4"
"21957","646",2023-04-17 17:00:00,986,1006,20,0,TRUE,NA,"0.1.4"
"21958","646",2023-04-17 17:15:00,986,1006,20,0,TRUE,NA,"0.1.4"
"21959","646",2023-04-17 17:30:00,986,1006,20,0,TRUE,NA,"0.1.4"
"21960","646",2023-04-17 17:45:00,986,1006,20,0,TRUE,NA,"0.1.4"
"21961","646",2023-04-17 18:00:00,986,1006,20,0,TRUE,NA,"0.1.4"
"21962","646",2023-04-17 18:15:00,986,1006,20,0,TRUE,NA,"0.1.4"
"21963","646",2023-04-17 18:30:00,986,1006,20,0,TRUE,NA,"0.1.4"
"21964","646",2023-04-17 18:45:00,986,1006,20,0,TRUE,NA,"0.1.4"
"21965","646",2023-04-17 19:00:00,986,1006,20,0,TRUE,NA,"0.1.4"
"21966","646",2023-04-17 19:15:00,986,1006,20,0,TRUE,NA,"0.1.4"
"21967","646",2023-04-17 19:30:00,986,1006,20,0,TRUE,NA,"0.1.4"
"21968","646",2023-04-17 19:45:00,986,1006,20,0,TRUE,NA,"0.1.4"
"21969","646",2023-04-17 20:00:00,986,1006,20,0,TRUE,NA,"0.1.4"
"21970","646",2023-04-17 20:15:00,986,1006,20,0,TRUE,NA,"0.1.4"
"21971","646",2023-04-17 20:30:00,986,1006,20,0,TRUE,NA,"0.1.4"
"21972","646",2023-04-17 20:45:00,986,1006,20,0,TRUE,NA,"0.1.4"
"21973","646",2023-04-17 21:00:00,986,1006,20,0,TRUE,NA,"0.1.4"
"21974","646",2023-04-17 21:15:00,986,1006,20,0,TRUE,NA,"0.1.4"
"21975","646",2023-04-17 21:30:00,986,1006,20,0,TRUE,NA,"0.1.4"
"21976","646",2023-04-17 21:45:00,986,1006,20,0,TRUE,NA,"0.1.4"
"21977","646",2023-04-17 22:00:00,986,1006,20,0,TRUE,NA,"0.1.4"
"21978","646",2023-04-17 22:15:00,986,1006,20,0,TRUE,NA,"0.1.4"
"21979","646",2023-04-17 22:30:00,986,1006,20,0,TRUE,NA,"0.1.4"
"21980","646",2023-04-17 22:45:00,986,1006,20,0,TRUE,NA,"0.1.4"
"21981","646",2023-04-17 23:00:00,986,1006,20,0,TRUE,NA,"0.1.4"
"21982","646",2023-04-17 23:15:00,986,1006,20,0,TRUE,NA,"0.1.4"
"21983","646",2023-04-17 23:30:00,986,1006,20,0,TRUE,NA,"0.1.4"
"21984","646",2023-04-17 23:45:00,986,1006,20,0,TRUE,NA,"0.1.4"
"21985","646",2023-04-18,986,1006,20,0,TRUE,NA,"0.1.4"
"21986","646",2023-04-18 00:15:00,986,1006,20,0,TRUE,NA,"0.1.4"
"21987","646",2023-04-18 00:30:00,986,1006,20,0,TRUE,NA,"0.1.4"
"21988","646",2023-04-18 00:45:00,986,1006,20,0,TRUE,NA,"0.1.4"
"21989","646",2023-04-18 01:00:00,986,1006,20,0,TRUE,NA,"0.1.4"
"21990","646",2023-04-18 01:15:00,986,1006,20,0,TRUE,NA,"0.1.4"
"21991","646",2023-04-18 01:30:00,986,1006,20,0,TRUE,NA,"0.1.4"
"21992","646",2023-04-18 01:45:00,986,1006,20,0,TRUE,NA,"0.1.4"
"21993","646",2023-04-18 02:00:00,986,1006,20,0,TRUE,NA,"0.1.4"
"21994","646",2023-04-18 02:15:00,986,1006,20,0,TRUE,NA,"0.1.4"
"21995","646",2023-04-18 02:30:00,986,1006,20,0,TRUE,NA,"0.1.4"
"21996","646",2023-04-18 02:45:00,986,1006,20,0,TRUE,NA,"0.1.4"
"21997","646",2023-04-18 03:00:00,986,1006,20,0,TRUE,NA,"0.1.4"
"21998","646",2023-04-18 03:15:00,986,1006,20,0,TRUE,NA,"0.1.4"
"21999","646",2023-04-18 03:30:00,986,1006,20,0,TRUE,NA,"0.1.4"
"22000","646",2023-04-18 03:45:00,986,1006,20,0,TRUE,NA,"0.1.4"
"22001","646",2023-04-18 04:00:00,986,1006,20,0,TRUE,NA,"0.1.4"
"22002","646",2023-04-18 04:15:00,986,1006,20,0,TRUE,NA,"0.1.4"
"22003","646",2023-04-18 04:30:00,986,1006,20,0,TRUE,NA,"0.1.4"
"22004","646",2023-04-18 04:45:00,986,1006,20,0,TRUE,NA,"0.1.4"
"22005","646",2023-04-18 05:00:00,986,1006,20,0,TRUE,NA,"0.1.4"
"22006","646",2023-04-18 05:15:00,986,1006,20,0,TRUE,NA,"0.1.4"
"22007","646",2023-04-18 05:30:00,986,1006,20,0,TRUE,NA,"0.1.4"
"22008","646",2023-04-18 05:45:00,986,1006,20,0,TRUE,NA,"0.1.4"
"22009","646",2023-04-18 06:00:00,986,1006,20,0,TRUE,NA,"0.1.4"
"22010","646",2023-04-18 06:15:00,986,1006,20,0,TRUE,NA,"0.1.4"
"22011","646",2023-04-18 06:30:00,986,1006,20,0,TRUE,NA,"0.1.4"
"22012","646",2023-04-18 06:45:00,986,1006,20,0,TRUE,NA,"0.1.4"
"22013","646",2023-04-18 07:00:00,986,1006,20,0,TRUE,NA,"0.1.4"
"22014","646",2023-04-18 07:15:00,986,1006,20,0,TRUE,NA,"0.1.4"
"22015","646",2023-04-18 07:30:00,986,1006,20,0,TRUE,NA,"0.1.4"
"22016","646",2023-04-18 07:45:00,986,1006,20,0,TRUE,NA,"0.1.4"
"22017","646",2023-04-18 08:00:00,986,1006,20,0,TRUE,NA,"0.1.4"
"22018","646",2023-04-18 08:15:00,986,1006,20,0,TRUE,NA,"0.1.4"
"22019","646",2023-04-18 08:30:00,986,1006,20,0,TRUE,NA,"0.1.4"
"22020","646",2023-04-18 08:45:00,986,1006,20,0,TRUE,NA,"0.1.4"
"22021","646",2023-04-18 09:00:00,986,1006,20,0,TRUE,NA,"0.1.4"
"22022","646",2023-04-18 09:15:00,986,1006,20,0,TRUE,NA,"0.1.4"
"22023","646",2023-04-18 09:30:00,986,1006,20,0,TRUE,NA,"0.1.4"
"22024","646",2023-04-18 09:45:00,986,1006,20,0,TRUE,NA,"0.1.4"
"22025","646",2023-04-18 10:00:00,986,1006,20,0,TRUE,NA,"0.1.4"
"22026","646",2023-04-18 10:15:00,986,1006,20,0,TRUE,NA,"0.1.4"
"22027","646",2023-04-18 10:30:00,986,1006,20,0,TRUE,NA,"0.1.4"
"22028","646",2023-04-18 10:45:00,986,1006,20,0,TRUE,NA,"0.1.4"
"22029","646",2023-04-18 11:00:00,986,1006,20,0,TRUE,NA,"0.1.4"
"22030","646",2023-04-18 11:15:00,986,1006,20,0,TRUE,NA,"0.1.4"
"22031","646",2023-04-18 11:30:00,986,1006,20,0,TRUE,NA,"0.1.4"
"22032","646",2023-04-18 11:45:00,986,1006,20,0,TRUE,NA,"0.1.4"
"22033","646",2023-04-18 12:00:00,986,1006,20,0,TRUE,NA,"0.1.4"
"22034","646",2023-04-18 12:15:00,986,1006,20,0,TRUE,NA,"0.1.4"
"22035","646",2023-04-18 12:30:00,986,1006,20,0,TRUE,NA,"0.1.4"
"22036","646",2023-04-18 12:45:00,986,1006,20,0,TRUE,NA,"0.1.4"
"22037","646",2023-04-18 13:00:00,986,1006,20,0,TRUE,NA,"0.1.4"
"22038","646",2023-04-18 13:15:00,986,1006,20,0,TRUE,NA,"0.1.4"
"22039","646",2023-04-18 13:30:00,986,1006,20,0,TRUE,NA,"0.1.4"
"22040","646",2023-04-18 13:45:00,986,1006,20,0,TRUE,NA,"0.1.4"
"22041","646",2023-04-18 14:00:00,986,1006,20,0,TRUE,NA,"0.1.4"
"22042","646",2023-04-18 14:15:00,986,1006,20,0,TRUE,NA,"0.1.4"
"22043","646",2023-04-18 14:30:00,986,1006,20,0,TRUE,NA,"0.1.4"
"22044","646",2023-04-18 14:45:00,986,1006,20,0,TRUE,NA,"0.1.4"
"22045","646",2023-04-18 15:00:00,986,1006,20,0,TRUE,NA,"0.1.4"
"22046","646",2023-04-18 15:15:00,986,1006,20,0,TRUE,NA,"0.1.4"
"22047","646",2023-04-18 15:30:00,986,1006,20,0,TRUE,NA,"0.1.4"
"22048","646",2023-04-18 15:45:00,986,1006,20,0,TRUE,NA,"0.1.4"
"22049","646",2023-04-18 16:00:00,986,1006,20,0,TRUE,NA,"0.1.4"
"22050","646",2023-04-18 16:15:00,986,1006,20,0,TRUE,NA,"0.1.4"
"22051","646",2023-04-18 16:30:00,986,1006,20,0,TRUE,NA,"0.1.4"
"22052","646",2023-04-18 16:45:00,986,1006,20,0,TRUE,NA,"0.1.4"
"22053","646",2023-04-18 17:00:00,986,1006,20,0,TRUE,NA,"0.1.4"
"22054","646",2023-04-18 17:15:00,986,1006,20,0,TRUE,NA,"0.1.4"
"22055","646",2023-04-18 17:30:00,986,1006,20,0,TRUE,NA,"0.1.4"
"22056","646",2023-04-18 17:45:00,986,1006,20,0,TRUE,NA,"0.1.4"
"22057","646",2023-04-18 18:00:00,986,1006,20,0,TRUE,NA,"0.1.4"
"22058","646",2023-04-18 18:15:00,986,1006,20,0,TRUE,NA,"0.1.4"
"22059","646",2023-04-18 18:30:00,986,1006,20,0,TRUE,NA,"0.1.4"
"22060","646",2023-04-18 18:45:00,986,1006,20,0,TRUE,NA,"0.1.4"
"22061","646",2023-04-18 19:00:00,986,1006,20,0,TRUE,NA,"0.1.4"
"22062","646",2023-04-18 19:15:00,986,1006,20,0,TRUE,NA,"0.1.4"
"22063","646",2023-04-18 19:30:00,986,1006,20,0,TRUE,NA,"0.1.4"
"22064","646",2023-04-18 19:45:00,986,1006,20,0,TRUE,NA,"0.1.4"
"22065","646",2023-04-18 20:00:00,986,1006,20,0,TRUE,NA,"0.1.4"
"22066","646",2023-04-18 20:15:00,986,1006,20,0,TRUE,NA,"0.1.4"
"22067","646",2023-04-18 20:30:00,986,1006,20,0,TRUE,NA,"0.1.4"
"22068","646",2023-04-18 20:45:00,986,1006,20,0,TRUE,NA,"0.1.4"
"22069","646",2023-04-18 21:00:00,986,1006,20,0,TRUE,NA,"0.1.4"
"22070","646",2023-04-18 21:15:00,986,1006,20,0,TRUE,NA,"0.1.4"
"22071","646",2023-04-18 21:30:00,986,1006,20,0,TRUE,NA,"0.1.4"
"22072","646",2023-04-18 21:45:00,986,1006,20,0,TRUE,NA,"0.1.4"
"22073","646",2023-04-18 22:00:00,986,1006,20,0,TRUE,NA,"0.1.4"
"22074","646",2023-04-18 22:15:00,986,1006,20,0,TRUE,NA,"0.1.4"
"22075","646",2023-04-18 22:30:00,986,1006,20,0,TRUE,NA,"0.1.4"
"22076","646",2023-04-18 22:45:00,986,1006,20,0,TRUE,NA,"0.1.4"
"22077","646",2023-04-18 23:00:00,986,1006,20,0,TRUE,NA,"0.1.4"
"22078","646",2023-04-18 23:15:00,986,1006,20,0,TRUE,NA,"0.1.4"
"22079","646",2023-04-18 23:30:00,986,1006,20,0,TRUE,NA,"0.1.4"
"22080","646",2023-04-18 23:45:00,986,1006,20,0,TRUE,NA,"0.1.4"
"22081","646",2023-04-19,986,1006,20,0,TRUE,NA,"0.1.4"
"22082","646",2023-04-19 00:15:00,986,1006,20,0,TRUE,NA,"0.1.4"
"22083","646",2023-04-19 00:30:00,986,1006,20,0,TRUE,NA,"0.1.4"
"22084","646",2023-04-19 00:45:00,986,1006,20,0,TRUE,NA,"0.1.4"
"22085","646",2023-04-19 01:00:00,986,1006,20,0,TRUE,NA,"0.1.4"
"22086","646",2023-04-19 01:15:00,986,1006,20,0,TRUE,NA,"0.1.4"
"22087","646",2023-04-19 01:30:00,986,1006,20,0,TRUE,NA,"0.1.4"
"22088","646",2023-04-19 01:45:00,986,1006,20,0,TRUE,NA,"0.1.4"
"22089","646",2023-04-19 02:00:00,986,1006,20,0,TRUE,NA,"0.1.4"
"22090","646",2023-04-19 02:15:00,986,1006,20,0,TRUE,NA,"0.1.4"
"22091","646",2023-04-19 02:30:00,986,1006,20,0,TRUE,NA,"0.1.4"
"22092","646",2023-04-19 02:45:00,986,1006,20,0,TRUE,NA,"0.1.4"
"22093","646",2023-04-19 03:00:00,986,1006,20,0,TRUE,NA,"0.1.4"
"22094","646",2023-04-19 03:15:00,986,1006,20,0,TRUE,NA,"0.1.4"
"22095","646",2023-04-19 03:30:00,986,1006,20,0,TRUE,NA,"0.1.4"
"22096","646",2023-04-19 03:45:00,986,1006,20,0,TRUE,NA,"0.1.4"
"22097","646",2023-04-19 04:00:00,986,1006,20,0,TRUE,NA,"0.1.4"
"22098","646",2023-04-19 04:15:00,986,1006,20,0,TRUE,NA,"0.1.4"
"22099","646",2023-04-19 04:30:00,986,1006,20,0,TRUE,NA,"0.1.4"
"22100","646",2023-04-19 04:45:00,986,1006,20,0,TRUE,NA,"0.1.4"
"22101","646",2023-04-19 05:00:00,986,1006,20,0,TRUE,NA,"0.1.4"
"22102","646",2023-04-19 05:15:00,986,1006,20,0,TRUE,NA,"0.1.4"
"22103","646",2023-04-19 05:30:00,986,1006,20,0,TRUE,NA,"0.1.4"
"22104","646",2023-04-19 05:45:00,986,1006,20,0,TRUE,NA,"0.1.4"
"22105","646",2023-04-19 06:00:00,986,1006,20,0,TRUE,NA,"0.1.4"
"22106","646",2023-04-19 06:15:00,986,1006,20,0,TRUE,NA,"0.1.4"
"22107","646",2023-04-19 06:30:00,986,1006,20,0,TRUE,NA,"0.1.4"
"22108","646",2023-04-19 06:45:00,986,1006,20,0,TRUE,NA,"0.1.4"
"22109","646",2023-04-19 07:00:00,986,1006,20,0,TRUE,NA,"0.1.4"
"22110","646",2023-04-19 07:15:00,986,1006,20,0,TRUE,NA,"0.1.4"
"22111","646",2023-04-19 07:30:00,986,1006,20,0,TRUE,NA,"0.1.4"
"22112","646",2023-04-19 07:45:00,986,1006,20,0,TRUE,NA,"0.1.4"
"22113","646",2023-04-19 08:00:00,986,1006,20,0,TRUE,NA,"0.1.4"
"22114","646",2023-04-19 08:15:00,986,1006,20,0,TRUE,NA,"0.1.4"
"22115","646",2023-04-19 08:30:00,986,1006,20,0,TRUE,NA,"0.1.4"
"22116","646",2023-04-19 08:45:00,986,1006,20,0,TRUE,NA,"0.1.4"
"22117","646",2023-04-19 09:00:00,986,1006,20,0,TRUE,NA,"0.1.4"
"22118","646",2023-04-19 09:15:00,986,1006,20,0,TRUE,NA,"0.1.4"
"22119","646",2023-04-19 09:30:00,986,1006,20,0,TRUE,NA,"0.1.4"
"22120","646",2023-04-19 09:45:00,986,1006,20,0,TRUE,NA,"0.1.4"
"22121","646",2023-04-19 10:00:00,986,1006,20,0,TRUE,NA,"0.1.4"
"22122","646",2023-04-19 10:15:00,986,1006,20,0,TRUE,NA,"0.1.4"
"22123","646",2023-04-19 10:30:00,986,1006,20,0,TRUE,NA,"0.1.4"
"22124","646",2023-04-19 10:45:00,986,1006,20,0,TRUE,NA,"0.1.4"
"22125","646",2023-04-19 11:00:00,986,1006,20,0,TRUE,NA,"0.1.4"
"22126","646",2023-04-19 11:15:00,986,1006,20,0,TRUE,NA,"0.1.4"
"22127","646",2023-04-19 11:30:00,986,1006,20,0,TRUE,NA,"0.1.4"
"22128","646",2023-04-19 11:45:00,986,1006,20,0,TRUE,NA,"0.1.4"
"22129","646",2023-04-19 12:00:00,986,1006,20,0,TRUE,NA,"0.1.4"
"22130","646",2023-04-19 12:15:00,986,1006,20,0,TRUE,NA,"0.1.4"
"22131","646",2023-04-19 12:30:00,986,1006,20,0,TRUE,NA,"0.1.4"
"22132","646",2023-04-19 12:45:00,986,1006,20,0,TRUE,NA,"0.1.4"
"22133","646",2023-04-19 13:00:00,986,1006,20,0,TRUE,NA,"0.1.4"
"22134","646",2023-04-19 13:15:00,986,1006,20,0,TRUE,NA,"0.1.4"
"22135","646",2023-04-19 13:30:00,986,1006,20,0,TRUE,NA,"0.1.4"
"22136","646",2023-04-19 13:45:00,986,1006,20,0,TRUE,NA,"0.1.4"
"22137","646",2023-04-19 14:00:00,986,1006,20,0,TRUE,NA,"0.1.4"
"22138","646",2023-04-19 14:15:00,986,1006,20,0,TRUE,NA,"0.1.4"
"22139","646",2023-04-19 14:30:00,986,1006,20,0,TRUE,NA,"0.1.4"
"22140","646",2023-04-19 14:45:00,986,1006,20,0,TRUE,NA,"0.1.4"
"22141","646",2023-04-19 15:00:00,986,1006,20,0,TRUE,NA,"0.1.4"
"22142","646",2023-04-19 15:15:00,986,1006,20,0,TRUE,NA,"0.1.4"
"22143","646",2023-04-19 15:30:00,986,1006,20,0,TRUE,NA,"0.1.4"
"22144","646",2023-04-19 15:45:00,986,1006,20,0,TRUE,NA,"0.1.4"
"22145","646",2023-04-19 16:00:00,986,1006,20,0,TRUE,NA,"0.1.4"
"22146","646",2023-04-19 16:15:00,986,1006,20,0,TRUE,NA,"0.1.4"
"22147","646",2023-04-19 16:30:00,986,1006,20,0,TRUE,NA,"0.1.4"
"22148","646",2023-04-19 16:45:00,986,1006,20,0,TRUE,NA,"0.1.4"
"22149","646",2023-04-19 17:00:00,986,1006,20,0,TRUE,NA,"0.1.4"
"22150","646",2023-04-19 17:15:00,986,1006,20,0,TRUE,NA,"0.1.4"
"22151","646",2023-04-19 17:30:00,986,1006,20,0,TRUE,NA,"0.1.4"
"22152","646",2023-04-19 17:45:00,986,1006,20,0,TRUE,NA,"0.1.4"
"22153","646",2023-04-19 18:00:00,986,1006,20,0,TRUE,NA,"0.1.4"
"22154","646",2023-04-19 18:15:00,986,1006,20,0,TRUE,NA,"0.1.4"
"22155","646",2023-04-19 18:30:00,986,1006,20,0,TRUE,NA,"0.1.4"
"22156","646",2023-04-19 18:45:00,986,1006,20,0,TRUE,NA,"0.1.4"
"22157","646",2023-04-19 19:00:00,986,1006,20,0,TRUE,NA,"0.1.4"
"22158","646",2023-04-19 19:15:00,986,1006,20,0,TRUE,NA,"0.1.4"
"22159","646",2023-04-19 19:30:00,986,1006,20,0,TRUE,NA,"0.1.4"
"22160","646",2023-04-19 19:45:00,986,1006,20,0,TRUE,NA,"0.1.4"
"22161","646",2023-04-19 20:00:00,986,1006,20,0,TRUE,NA,"0.1.4"
"22162","646",2023-04-19 20:15:00,986,1006,20,0,TRUE,NA,"0.1.4"
"22163","646",2023-04-19 20:30:00,986,1006,20,0,TRUE,NA,"0.1.4"
"22164","646",2023-04-19 20:45:00,986,1006,20,0,TRUE,NA,"0.1.4"
"22165","646",2023-04-19 21:00:00,986,1006,20,0,TRUE,NA,"0.1.4"
"22166","646",2023-04-19 21:15:00,986,1006,20,0,TRUE,NA,"0.1.4"
"22167","646",2023-04-19 21:30:00,986,1006,20,0,TRUE,NA,"0.1.4"
"22168","646",2023-04-19 21:45:00,986,1006,20,0,TRUE,NA,"0.1.4"
"22169","646",2023-04-19 22:00:00,986,1006,20,0,TRUE,NA,"0.1.4"
"22170","646",2023-04-19 22:15:00,986,1006,20,0,TRUE,NA,"0.1.4"
"22171","646",2023-04-19 22:30:00,986,1006,20,0,TRUE,NA,"0.1.4"
"22172","646",2023-04-19 22:45:00,986,1006,20,0,TRUE,NA,"0.1.4"
"22173","646",2023-04-19 23:00:00,986,1006,20,0,TRUE,NA,"0.1.4"
"22174","646",2023-04-19 23:15:00,986,1006,20,0,TRUE,NA,"0.1.4"
"22175","646",2023-04-19 23:30:00,986,1006,20,0,TRUE,NA,"0.1.4"
"22176","646",2023-04-19 23:45:00,986,1006,20,0,TRUE,NA,"0.1.4"
"22177","646",2023-04-20,986,1006,20,0,TRUE,NA,"0.1.4"
"22178","646",2023-04-20 00:15:00,986,1006,20,0,TRUE,NA,"0.1.4"
"22179","646",2023-04-20 00:30:00,986,1006,20,0,TRUE,NA,"0.1.4"
"22180","646",2023-04-20 00:45:00,986,1006,20,0,TRUE,NA,"0.1.4"
"22181","646",2023-04-20 01:00:00,986,1006,20,0,TRUE,NA,"0.1.4"
"22182","646",2023-04-20 01:15:00,986,1006,20,0,TRUE,NA,"0.1.4"
"22183","646",2023-04-20 01:30:00,986,1006,20,0,TRUE,NA,"0.1.4"
"22184","646",2023-04-20 01:45:00,986,1006,20,0,TRUE,NA,"0.1.4"
"22185","646",2023-04-20 02:00:00,986,1006,20,0,TRUE,NA,"0.1.4"
"22186","646",2023-04-20 02:15:00,986,1006,20,0,TRUE,NA,"0.1.4"
"22187","646",2023-04-20 02:30:00,986,1006,20,0,TRUE,NA,"0.1.4"
"22188","646",2023-04-20 02:45:00,986,1006,20,0,TRUE,NA,"0.1.4"
"22189","646",2023-04-20 03:00:00,986,1006,20,0,TRUE,NA,"0.1.4"
"22190","646",2023-04-20 03:15:00,986,1006,20,0,TRUE,NA,"0.1.4"
"22191","646",2023-04-20 03:30:00,986,1006,20,0,TRUE,NA,"0.1.4"
"22192","646",2023-04-20 03:45:00,986,1006,20,0,TRUE,NA,"0.1.4"
"22193","646",2023-04-20 04:00:00,986,1006,20,0,TRUE,NA,"0.1.4"
"22194","646",2023-04-20 04:15:00,986,1006,20,0,TRUE,NA,"0.1.4"
"22195","646",2023-04-20 04:30:00,986,1006,20,0,TRUE,NA,"0.1.4"
"22196","646",2023-04-20 04:45:00,986,1006,20,0,TRUE,NA,"0.1.4"
"22197","646",2023-04-20 05:00:00,986,1006,20,0,TRUE,NA,"0.1.4"
"22198","646",2023-04-20 05:15:00,986,1006,20,0,TRUE,NA,"0.1.4"
"22199","646",2023-04-20 05:30:00,986,1006,20,0,TRUE,NA,"0.1.4"
"22200","646",2023-04-20 05:45:00,986,1006,20,0,TRUE,NA,"0.1.4"
"22201","646",2023-04-20 06:00:00,986,1006,20,0,TRUE,NA,"0.1.4"
"22202","646",2023-04-20 06:15:00,986,1006,20,0,TRUE,NA,"0.1.4"
"22203","646",2023-04-20 06:30:00,986,1006,20,0,TRUE,NA,"0.1.4"
"22204","646",2023-04-20 06:45:00,986,1006,20,0,TRUE,NA,"0.1.4"
"22205","646",2023-04-20 07:00:00,986,1006,20,0,TRUE,NA,"0.1.4"
"22206","646",2023-04-20 07:15:00,986,1006,20,0,TRUE,NA,"0.1.4"
"22207","646",2023-04-20 07:30:00,986,1006,20,0,TRUE,NA,"0.1.4"
"22208","646",2023-04-20 07:45:00,986,1006,20,0,TRUE,NA,"0.1.4"
"22209","646",2023-04-20 08:00:00,986,1006,20,0,TRUE,NA,"0.1.4"
"22210","646",2023-04-20 08:15:00,986,1006,20,0,TRUE,NA,"0.1.4"
"22211","646",2023-04-20 08:30:00,986,1006,20,0,TRUE,NA,"0.1.4"
"22212","646",2023-04-20 08:45:00,986,1006,20,0,TRUE,NA,"0.1.4"
"22213","646",2023-04-20 09:00:00,986,1006,20,0,TRUE,NA,"0.1.4"
"22214","646",2023-04-20 09:15:00,986,1006,20,0,TRUE,NA,"0.1.4"
"22215","646",2023-04-20 09:30:00,986,1006,20,0,TRUE,NA,"0.1.4"
"22216","646",2023-04-20 09:45:00,986,1006,20,0,TRUE,NA,"0.1.4"
"22217","646",2023-04-20 10:00:00,986,1006,20,0,TRUE,NA,"0.1.4"
"22218","646",2023-04-20 10:15:00,986,1006,20,0,TRUE,NA,"0.1.4"
"22219","646",2023-04-20 10:30:00,986,1006,20,0,TRUE,NA,"0.1.4"
"22220","646",2023-04-20 10:45:00,986,1006,20,0,TRUE,NA,"0.1.4"
"22221","646",2023-04-20 11:00:00,986,1006,20,0,TRUE,NA,"0.1.4"
"22222","646",2023-04-20 11:15:00,986,1006,20,0,TRUE,NA,"0.1.4"
"22223","646",2023-04-20 11:30:00,986,1006,20,0,TRUE,NA,"0.1.4"
"22224","646",2023-04-20 11:45:00,986,1006,20,0,TRUE,NA,"0.1.4"
"22225","646",2023-04-20 12:00:00,986,1006,20,0,TRUE,NA,"0.1.4"
"22226","646",2023-04-20 12:15:00,986,1006,20,0,TRUE,NA,"0.1.4"
"22227","646",2023-04-20 12:30:00,986,1006,20,0,TRUE,NA,"0.1.4"
"22228","646",2023-04-20 12:45:00,986,1006,20,0,TRUE,NA,"0.1.4"
"22229","646",2023-04-20 13:00:00,986,1006,20,0,TRUE,NA,"0.1.4"
"22230","646",2023-04-20 13:15:00,986,1006,20,0,TRUE,NA,"0.1.4"
"22231","646",2023-04-20 13:30:00,986,1006,20,0,TRUE,NA,"0.1.4"
"22232","646",2023-04-20 13:45:00,986,1006,20,0,TRUE,NA,"0.1.4"
"22233","646",2023-04-20 14:00:00,986,1006,20,0,TRUE,NA,"0.1.4"
"22234","646",2023-04-20 14:15:00,986,1006,20,0,TRUE,NA,"0.1.4"
"22235","646",2023-04-20 14:30:00,986,1006,20,0,TRUE,NA,"0.1.4"
"22236","646",2023-04-20 14:45:00,986,1006,20,0,TRUE,NA,"0.1.4"
"22237","646",2023-04-20 15:00:00,986,1006,20,0,TRUE,NA,"0.1.4"
"22238","646",2023-04-20 15:15:00,986,1006,20,0,TRUE,NA,"0.1.4"
"22239","646",2023-04-20 15:30:00,986,1006,20,0,TRUE,NA,"0.1.4"
"22240","646",2023-04-20 15:45:00,986,1006,20,0,TRUE,NA,"0.1.4"
"22241","646",2023-04-20 16:00:00,986,1006,20,0,TRUE,NA,"0.1.4"
"22242","646",2023-04-20 16:15:00,986,1006,20,0,TRUE,NA,"0.1.4"
"22243","646",2023-04-20 16:30:00,986,1006,20,0,TRUE,NA,"0.1.4"
"22244","646",2023-04-20 16:45:00,986,1006,20,0,TRUE,NA,"0.1.4"
"22245","646",2023-04-20 17:00:00,986,1006,20,0,TRUE,NA,"0.1.4"
"22246","646",2023-04-20 17:15:00,986,1006,20,0,TRUE,NA,"0.1.4"
"22247","646",2023-04-20 17:30:00,986,1006,20,0,TRUE,NA,"0.1.4"
"22248","646",2023-04-20 17:45:00,986,1006,20,0,TRUE,NA,"0.1.4"
"22249","646",2023-04-20 18:00:00,986,1006,20,0,TRUE,NA,"0.1.4"
"22250","646",2023-04-20 18:15:00,986,1006,20,0,TRUE,NA,"0.1.4"
"22251","646",2023-04-20 18:30:00,986,1006,20,0,TRUE,NA,"0.1.4"
"22252","646",2023-04-20 18:45:00,986,1006,20,0,TRUE,NA,"0.1.4"
"22253","646",2023-04-20 19:00:00,986,1006,20,0,TRUE,NA,"0.1.4"
"22254","646",2023-04-20 19:15:00,986,1006,20,0,TRUE,NA,"0.1.4"
"22255","646",2023-04-20 19:30:00,986,1006,20,0,TRUE,NA,"0.1.4"
"22256","646",2023-04-20 19:45:00,986,1006,20,0,TRUE,NA,"0.1.4"
"22257","646",2023-04-20 20:00:00,986,1006,20,0,TRUE,NA,"0.1.4"
"22258","646",2023-04-20 20:15:00,986,1006,20,0,TRUE,NA,"0.1.4"
"22259","646",2023-04-20 20:30:00,986,1006,20,0,TRUE,NA,"0.1.4"
"22260","646",2023-04-20 20:45:00,986,1006,20,0,TRUE,NA,"0.1.4"
"22261","646",2023-04-20 21:00:00,986,1006,20,0,TRUE,NA,"0.1.4"
"22262","646",2023-04-20 21:15:00,986,1006,20,0,TRUE,NA,"0.1.4"
"22263","646",2023-04-20 21:30:00,986,1006,20,0,TRUE,NA,"0.1.4"
"22264","646",2023-04-20 21:45:00,986,1006,20,0,TRUE,NA,"0.1.4"
"22265","646",2023-04-20 22:00:00,986,1006,20,0,TRUE,NA,"0.1.4"
"22266","646",2023-04-20 22:15:00,986,1006,20,0,TRUE,NA,"0.1.4"
"22267","646",2023-04-20 22:30:00,986,1006,20,0,TRUE,NA,"0.1.4"
"22268","646",2023-04-20 22:45:00,986,1006,20,0,TRUE,NA,"0.1.4"
"22269","646",2023-04-20 23:00:00,986,1006,20,0,TRUE,NA,"0.1.4"
"22270","646",2023-04-20 23:15:00,986,1006,20,0,TRUE,NA,"0.1.4"
"22271","646",2023-04-20 23:30:00,986,1006,20,0,TRUE,NA,"0.1.4"
"22272","646",2023-04-20 23:45:00,986,1006,20,0,TRUE,NA,"0.1.4"
"22273","646",2023-04-21,986,1006,20,0,TRUE,NA,"0.1.4"
"22274","646",2023-04-21 00:15:00,986,1006,20,0,TRUE,NA,"0.1.4"
"22275","646",2023-04-21 00:30:00,986,1006,20,0,TRUE,NA,"0.1.4"
"22276","646",2023-04-21 00:45:00,986,1006,20,0,TRUE,NA,"0.1.4"
"22277","646",2023-04-21 01:00:00,986,1006,20,0,TRUE,NA,"0.1.4"
"22278","646",2023-04-21 01:15:00,986,1006,20,0,TRUE,NA,"0.1.4"
"22279","646",2023-04-21 01:30:00,986,1006,20,0,TRUE,NA,"0.1.4"
"22280","646",2023-04-21 01:45:00,986,1006,20,0,TRUE,NA,"0.1.4"
"22281","646",2023-04-21 02:00:00,986,1006,20,0,TRUE,NA,"0.1.4"
"22282","646",2023-04-21 02:15:00,986,1006,20,0,TRUE,NA,"0.1.4"
"22283","646",2023-04-21 02:30:00,986,1006,20,0,TRUE,NA,"0.1.4"
"22284","646",2023-04-21 02:45:00,986,1006,20,0,TRUE,NA,"0.1.4"
"22285","646",2023-04-21 03:00:00,986,1006,20,0,TRUE,NA,"0.1.4"
"22286","646",2023-04-21 03:15:00,986,1006,20,0,TRUE,NA,"0.1.4"
"22287","646",2023-04-21 03:30:00,986,1006,20,0,TRUE,NA,"0.1.4"
"22288","646",2023-04-21 03:45:00,986,1006,20,0,TRUE,NA,"0.1.4"
"22289","646",2023-04-21 04:00:00,986,1006,20,0,TRUE,NA,"0.1.4"
"22290","646",2023-04-21 04:15:00,986,1006,20,0,TRUE,NA,"0.1.4"
"22291","646",2023-04-21 04:30:00,986,1006,20,0,TRUE,NA,"0.1.4"
"22292","646",2023-04-21 04:45:00,986,1006,20,0,TRUE,NA,"0.1.4"
"22293","646",2023-04-21 05:00:00,986,1006,20,0,TRUE,NA,"0.1.4"
"22294","646",2023-04-21 05:15:00,986,1006,20,0,TRUE,NA,"0.1.4"
"22295","646",2023-04-21 05:30:00,986,1006,20,0,TRUE,NA,"0.1.4"
"22296","646",2023-04-21 05:45:00,986,1006,20,0,TRUE,NA,"0.1.4"
"22297","646",2023-04-21 06:00:00,986,1006,20,0,TRUE,NA,"0.1.4"
"22298","646",2023-04-21 06:15:00,986,1006,20,0,TRUE,NA,"0.1.4"
"22299","646",2023-04-21 06:30:00,986,1006,20,0,TRUE,NA,"0.1.4"
"22300","646",2023-04-21 06:45:00,986,1006,20,0,TRUE,NA,"0.1.4"
"22301","646",2023-04-21 07:00:00,986,1006,20,0,TRUE,NA,"0.1.4"
"22302","646",2023-04-21 07:15:00,986,1006,20,0,TRUE,NA,"0.1.4"
"22303","646",2023-04-21 07:30:00,986,1006,20,0,TRUE,NA,"0.1.4"
"22304","646",2023-04-21 07:45:00,986,1006,20,0,TRUE,NA,"0.1.4"
"22305","646",2023-04-21 08:00:00,986,1006,20,0,TRUE,NA,"0.1.4"
"22306","646",2023-04-21 08:15:00,986,1006,20,0,TRUE,NA,"0.1.4"
"22307","646",2023-04-21 08:30:00,986,1006,20,0,TRUE,NA,"0.1.4"
"22308","646",2023-04-21 08:45:00,986,1006,20,0,TRUE,NA,"0.1.4"
"22309","646",2023-04-21 09:00:00,986,1006,20,0,TRUE,NA,"0.1.4"
"22310","646",2023-04-21 09:15:00,986,1006,20,0,TRUE,NA,"0.1.4"
"22311","646",2023-04-21 09:30:00,986,1006,20,0,TRUE,NA,"0.1.4"
"22312","646",2023-04-21 09:45:00,986,1006,20,0,TRUE,NA,"0.1.4"
"22313","646",2023-04-21 10:00:00,986,1006,20,0,TRUE,NA,"0.1.4"
"22314","646",2023-04-21 10:15:00,986,1006,20,0,TRUE,NA,"0.1.4"
"22315","646",2023-04-21 10:30:00,987,1006,19,0,TRUE,NA,"0.1.4"
"22316","646",2023-04-21 10:45:00,987,1006,19,0,TRUE,NA,"0.1.4"
"22317","646",2023-04-21 11:00:00,987,1006,19,0,TRUE,NA,"0.1.4"
"22318","646",2023-04-21 11:15:00,987,1006,19,0,TRUE,NA,"0.1.4"
"22319","646",2023-04-21 11:30:00,986,1006,20,0,TRUE,NA,"0.1.4"
"22320","646",2023-04-21 11:45:00,986,1006,20,0,TRUE,NA,"0.1.4"
"22321","646",2023-04-21 12:00:00,986,1006,20,0,TRUE,NA,"0.1.4"
"22322","646",2023-04-21 12:15:00,986,1006,20,0,TRUE,NA,"0.1.4"
"22323","646",2023-04-21 12:30:00,987,1006,19,0,TRUE,NA,"0.1.4"
"22324","646",2023-04-21 12:45:00,987,1006,19,0,TRUE,NA,"0.1.4"
"22325","646",2023-04-21 13:00:00,987,1006,19,0,TRUE,NA,"0.1.4"
"22326","646",2023-04-21 13:15:00,986,1006,20,0,TRUE,NA,"0.1.4"
"22327","646",2023-04-21 13:30:00,987,1006,19,0,TRUE,NA,"0.1.4"
"22328","646",2023-04-21 13:45:00,987,1006,19,0,TRUE,NA,"0.1.4"
"22329","646",2023-04-21 14:00:00,987,1006,19,0,TRUE,NA,"0.1.4"
"22330","646",2023-04-21 14:15:00,987,1006,19,0,TRUE,NA,"0.1.4"
"22331","646",2023-04-21 14:30:00,987,1006,19,0,TRUE,NA,"0.1.4"
"22332","646",2023-04-21 14:45:00,986,1006,20,0,TRUE,NA,"0.1.4"
"22333","646",2023-04-21 15:00:00,986,1006,20,0,TRUE,NA,"0.1.4"
"22334","646",2023-04-21 15:15:00,987,1006,19,0,TRUE,NA,"0.1.4"
"22335","646",2023-04-21 15:30:00,986,1006,20,0,TRUE,NA,"0.1.4"
"22336","646",2023-04-21 15:45:00,986,1006,20,0,TRUE,NA,"0.1.4"
"22337","646",2023-04-21 16:00:00,987,1006,19,0,TRUE,NA,"0.1.4"
"22338","646",2023-04-21 16:15:00,986,1006,20,0,TRUE,NA,"0.1.4"
"22339","646",2023-04-21 16:30:00,987,1006,19,0,TRUE,NA,"0.1.4"
"22340","646",2023-04-21 16:45:00,987,1006,19,0,TRUE,NA,"0.1.4"
"22341","646",2023-04-21 17:00:00,987,1006,19,0,TRUE,NA,"0.1.4"
"22342","646",2023-04-21 17:15:00,987,1006,19,0,FALSE,NA,"0.1.4"
"22343","646",2023-04-21 17:30:00,987,1006,19,0,FALSE,NA,"0.1.4"
"22344","646",2023-04-21 17:45:00,987,1006,19,0,FALSE,NA,"0.1.4"
"22345","646",2023-04-21 18:00:00,987,1006,19,0,FALSE,NA,"0.1.4"
"22346","646",2023-04-21 18:15:00,986,1006,20,0,FALSE,NA,"0.1.4"
"22347","646",2023-04-21 18:30:00,986,1006,20,0,FALSE,NA,"0.1.4"
"22348","646",2023-04-21 18:45:00,986,1006,20,0,FALSE,NA,"0.1.4"
"22349","646",2023-04-21 19:00:00,986,1006,20,0,FALSE,NA,"0.1.4"
"22350","646",2023-04-21 19:15:00,987,1006,19,0,FALSE,NA,"0.1.4"
"22351","646",2023-04-21 19:30:00,986,1006,20,0,FALSE,NA,"0.1.4"
"22352","646",2023-04-21 19:45:00,986,1006,20,0,FALSE,NA,"0.1.4"
"22353","646",2023-04-21 20:00:00,986,1006,20,0,FALSE,NA,"0.1.4"
"22354","646",2023-04-21 20:15:00,986,1006,20,0,FALSE,NA,"0.1.4"
"22355","646",2023-04-21 20:30:00,986,1006,20,0,FALSE,NA,"0.1.4"
"22356","646",2023-04-21 20:45:00,986,1006,20,0,FALSE,NA,"0.1.4"
"22357","646",2023-04-21 21:00:00,987,1006,19,0,FALSE,NA,"0.1.4"
"22358","646",2023-04-21 21:15:00,987,1006,19,0,FALSE,NA,"0.1.4"
"22359","646",2023-04-21 21:30:00,987,1006,19,0,FALSE,NA,"0.1.4"
"22360","646",2023-04-21 21:45:00,987,1006,19,0,FALSE,NA,"0.1.4"
"22361","646",2023-04-21 22:00:00,987,1006,19,0,FALSE,NA,"0.1.4"
"22362","646",2023-04-21 22:15:00,987,1006,19,0,FALSE,NA,"0.1.4"
"22363","646",2023-04-21 22:30:00,987,1006,19,0,FALSE,NA,"0.1.4"
"22364","646",2023-04-21 22:45:00,987,1006,19,0,FALSE,NA,"0.1.4"
"22365","646",2023-04-21 23:00:00,987,1006,19,0,FALSE,NA,"0.1.4"
"22366","646",2023-04-21 23:15:00,987,1006,19,0,FALSE,NA,"0.1.4"
"22367","646",2023-04-21 23:30:00,987,1006,19,0,FALSE,NA,"0.1.4"
"22368","646",2023-04-21 23:45:00,987,1006,19,0,FALSE,NA,"0.1.4"
"22369","646",2023-04-22,987,1006,19,0,FALSE,NA,"0.1.4"
"22370","646",2023-04-22 00:15:00,987,1006,19,0,FALSE,NA,"0.1.4"
"22371","646",2023-04-22 00:30:00,987,1006,19,0,FALSE,NA,"0.1.4"
"22372","646",2023-04-22 00:45:00,987,1006,19,0,FALSE,NA,"0.1.4"
"22373","646",2023-04-22 01:00:00,987,1006,19,0,FALSE,NA,"0.1.4"
"22374","646",2023-04-22 01:15:00,987,1006,19,0,FALSE,NA,"0.1.4"
"22375","646",2023-04-22 01:30:00,987,1006,19,0,FALSE,NA,"0.1.4"
"22376","646",2023-04-22 01:45:00,987,1006,19,0,FALSE,NA,"0.1.4"
"22377","646",2023-04-22 02:00:00,987,1006,19,0,FALSE,NA,"0.1.4"
"22378","646",2023-04-22 02:15:00,987,1006,19,0,FALSE,NA,"0.1.4"
"22379","646",2023-04-22 02:30:00,987,1006,19,0,FALSE,NA,"0.1.4"
"22380","646",2023-04-22 02:45:00,987,1006,19,0,FALSE,NA,"0.1.4"
"22381","646",2023-04-22 03:00:00,987,1006,19,0,FALSE,NA,"0.1.4"
"22382","646",2023-04-22 03:15:00,987,1006,19,0,FALSE,NA,"0.1.4"
"22383","646",2023-04-22 03:30:00,987,1006,19,0,FALSE,NA,"0.1.4"
"22384","646",2023-04-22 03:45:00,987,1006,19,0,FALSE,NA,"0.1.4"
"22385","646",2023-04-22 04:00:00,987,1006,19,0,FALSE,NA,"0.1.4"
"22386","646",2023-04-22 04:15:00,987,1006,19,0,FALSE,NA,"0.1.4"
"22387","646",2023-04-22 04:30:00,987,1006,19,0,FALSE,NA,"0.1.4"
"22388","646",2023-04-22 04:45:00,987,1006,19,0,FALSE,NA,"0.1.4"
"22389","646",2023-04-22 05:00:00,987,1006,19,0,FALSE,NA,"0.1.4"
"22390","646",2023-04-22 05:15:00,987,1006,19,0,FALSE,NA,"0.1.4"
"22391","646",2023-04-22 05:30:00,987,1006,19,0,FALSE,NA,"0.1.4"
"22392","646",2023-04-22 05:45:00,987,1006,19,0,FALSE,NA,"0.1.4"
"22393","646",2023-04-22 06:00:00,987,1006,19,0,FALSE,NA,"0.1.4"
"22394","646",2023-04-22 06:15:00,987,1006,19,0,FALSE,NA,"0.1.4"
"22395","646",2023-04-22 06:30:00,987,1006,19,0,FALSE,NA,"0.1.4"
"22396","646",2023-04-22 06:45:00,987,1006,19,0,FALSE,NA,"0.1.4"
"22397","646",2023-04-22 07:00:00,987,1006,19,0,FALSE,NA,"0.1.4"
"22398","646",2023-04-22 07:15:00,987,1006,19,0,FALSE,NA,"0.1.4"
"22399","646",2023-04-22 07:30:00,987,1006,19,0,FALSE,NA,"0.1.4"
"22400","646",2023-04-22 07:45:00,987,1006,19,0,FALSE,NA,"0.1.4"
"22401","646",2023-04-22 08:00:00,987,1006,19,0,FALSE,NA,"0.1.4"
"22402","646",2023-04-22 08:15:00,987,1006,19,0,FALSE,NA,"0.1.4"
"22403","646",2023-04-22 08:30:00,987,1006,19,0,FALSE,NA,"0.1.4"
"22404","646",2023-04-22 08:45:00,987,1006,19,0,FALSE,NA,"0.1.4"
"22405","646",2023-04-22 09:00:00,987,1006,19,0,FALSE,NA,"0.1.4"
"22406","646",2023-04-22 09:15:00,987,1006,19,0,FALSE,NA,"0.1.4"
"22407","646",2023-04-22 09:30:00,987,1006,19,0,FALSE,NA,"0.1.4"
"22408","646",2023-04-22 09:45:00,987,1006,19,0,FALSE,NA,"0.1.4"
"22409","646",2023-04-22 10:00:00,987,1006,19,0,FALSE,NA,"0.1.4"
"22410","646",2023-04-22 10:15:00,987,1006,19,0,FALSE,NA,"0.1.4"
"22411","646",2023-04-22 10:30:00,987,1006,19,0,FALSE,NA,"0.1.4"
"22412","646",2023-04-22 10:45:00,987,1006,19,0,FALSE,NA,"0.1.4"
"22413","646",2023-04-22 11:00:00,987,1006,19,0,FALSE,NA,"0.1.4"
"22414","646",2023-04-22 11:15:00,987,1006,19,0,FALSE,NA,"0.1.4"
"22415","646",2023-04-22 11:30:00,987,1006,19,0,FALSE,NA,"0.1.4"
"22416","646",2023-04-22 11:45:00,987,1006,19,0,FALSE,NA,"0.1.4"
"22417","646",2023-04-22 12:00:00,987,1006,19,0,FALSE,NA,"0.1.4"
"22418","646",2023-04-22 12:15:00,987,1006,19,0,FALSE,NA,"0.1.4"
"22419","646",2023-04-22 12:30:00,987,1006,19,0,FALSE,NA,"0.1.4"
"22420","646",2023-04-22 12:45:00,987,1006,19,0,FALSE,NA,"0.1.4"
"22421","646",2023-04-22 13:00:00,987,1006,19,0,FALSE,NA,"0.1.4"
"22422","646",2023-04-22 13:15:00,987,1006,19,0,FALSE,NA,"0.1.4"
"22423","646",2023-04-22 13:30:00,987,1006,19,0,FALSE,NA,"0.1.4"
"22424","646",2023-04-22 13:45:00,987,1006,19,0,FALSE,NA,"0.1.4"
"22425","646",2023-04-22 14:00:00,987,1006,19,0,FALSE,NA,"0.1.4"
"22426","646",2023-04-22 14:15:00,987,1006,19,0,FALSE,NA,"0.1.4"
"22427","646",2023-04-22 14:30:00,987,1006,19,0,FALSE,NA,"0.1.4"
"22428","646",2023-04-22 14:45:00,987,1006,19,0,FALSE,NA,"0.1.4"
"22429","646",2023-04-22 15:00:00,987,1006,19,0,FALSE,NA,"0.1.4"
"22430","646",2023-04-22 15:15:00,987,1006,19,0,FALSE,NA,"0.1.4"
"22431","646",2023-04-22 15:30:00,987,1006,19,0,FALSE,NA,"0.1.4"
"22432","646",2023-04-22 15:45:00,987,1006,19,0,FALSE,NA,"0.1.4"
"22433","646",2023-04-22 16:00:00,987,1006,19,0,FALSE,NA,"0.1.4"
"22434","646",2023-04-22 16:15:00,987,1006,19,0,FALSE,NA,"0.1.4"
"22435","646",2023-04-22 16:30:00,987,1006,19,0,FALSE,NA,"0.1.4"
"22436","646",2023-04-22 16:45:00,987,1006,19,0,FALSE,NA,"0.1.4"
"22437","646",2023-04-22 17:00:00,987,1006,19,0,FALSE,NA,"0.1.4"
"22438","646",2023-04-22 17:15:00,987,1006,19,0,FALSE,NA,"0.1.4"
"22439","646",2023-04-22 17:30:00,987,1006,19,0,FALSE,NA,"0.1.4"
"22440","646",2023-04-22 17:45:00,987,1006,19,0,FALSE,NA,"0.1.4"
"22441","646",2023-04-22 18:00:00,987,1006,19,0,FALSE,NA,"0.1.4"
"22442","646",2023-04-22 18:15:00,987,1006,19,0,FALSE,NA,"0.1.4"
"22443","646",2023-04-22 18:30:00,987,1006,19,0,FALSE,NA,"0.1.4"
"22444","646",2023-04-22 18:45:00,987,1006,19,0,FALSE,NA,"0.1.4"
"22445","646",2023-04-22 19:00:00,987,1006,19,0,FALSE,NA,"0.1.4"
"22446","646",2023-04-22 19:15:00,987,1006,19,0,FALSE,NA,"0.1.4"
"22447","646",2023-04-22 19:30:00,987,1006,19,0,FALSE,NA,"0.1.4"
"22448","646",2023-04-22 19:45:00,987,1006,19,0,FALSE,NA,"0.1.4"
"22449","646",2023-04-22 20:00:00,987,1006,19,0,FALSE,NA,"0.1.4"
"22450","646",2023-04-22 20:15:00,987,1006,19,0,FALSE,NA,"0.1.4"
"22451","646",2023-04-22 20:30:00,987,1006,19,0,FALSE,NA,"0.1.4"
"22452","646",2023-04-22 20:45:00,987,1006,19,0,FALSE,NA,"0.1.4"
"22453","646",2023-04-22 21:00:00,987,1006,19,0,FALSE,NA,"0.1.4"
"22454","646",2023-04-22 21:15:00,987,1006,19,0,FALSE,NA,"0.1.4"
"22455","646",2023-04-22 21:30:00,987,1006,19,0,FALSE,NA,"0.1.4"
"22456","646",2023-04-22 21:45:00,987,1006,19,0,FALSE,NA,"0.1.4"
"22457","646",2023-04-22 22:00:00,987,1006,19,0,FALSE,NA,"0.1.4"
"22458","646",2023-04-22 22:15:00,987,1006,19,0,FALSE,NA,"0.1.4"
"22459","646",2023-04-22 22:30:00,987,1006,19,0,FALSE,NA,"0.1.4"
"22460","646",2023-04-22 22:45:00,987,1006,19,0,FALSE,NA,"0.1.4"
"22461","646",2023-04-22 23:00:00,987,1006,19,0,FALSE,NA,"0.1.4"
"22462","646",2023-04-22 23:15:00,987,1006,19,0,FALSE,NA,"0.1.4"
"22463","646",2023-04-22 23:30:00,987,1006,19,0,FALSE,NA,"0.1.4"
"22464","646",2023-04-22 23:45:00,987,1006,19,0,FALSE,NA,"0.1.4"
"22465","646",2023-04-23,987,1006,19,0,FALSE,NA,"0.1.4"
"22466","646",2023-04-23 00:15:00,986,1006,20,0,FALSE,NA,"0.1.4"
"22467","646",2023-04-23 00:30:00,986,1006,20,0,FALSE,NA,"0.1.4"
"22468","646",2023-04-23 00:45:00,987,1006,19,0,FALSE,NA,"0.1.4"
"22469","646",2023-04-23 01:00:00,987,1006,19,0,FALSE,NA,"0.1.4"
"22470","646",2023-04-23 01:15:00,987,1006,19,0,FALSE,NA,"0.1.4"
"22471","646",2023-04-23 01:30:00,986,1006,20,0,FALSE,NA,"0.1.4"
"22472","646",2023-04-23 01:45:00,987,1006,19,0,FALSE,NA,"0.1.4"
"22473","646",2023-04-23 02:00:00,986,1006,20,0,FALSE,NA,"0.1.4"
"22474","646",2023-04-23 02:15:00,986,1006,20,0,FALSE,NA,"0.1.4"
"22475","646",2023-04-23 02:30:00,987,1006,19,0,FALSE,NA,"0.1.4"
"22476","646",2023-04-23 02:45:00,987,1006,19,0,FALSE,NA,"0.1.4"
"22477","646",2023-04-23 03:00:00,986,1006,20,0,FALSE,NA,"0.1.4"
"22478","646",2023-04-23 03:15:00,987,1006,19,0,FALSE,NA,"0.1.4"
"22479","646",2023-04-23 03:30:00,986,1006,20,0,FALSE,NA,"0.1.4"
"22480","646",2023-04-23 03:45:00,987,1006,19,0,FALSE,NA,"0.1.4"
"22481","646",2023-04-23 04:00:00,986,1006,20,0,FALSE,NA,"0.1.4"
"22482","646",2023-04-23 04:15:00,986,1006,20,0,FALSE,NA,"0.1.4"
"22483","646",2023-04-23 04:30:00,986,1006,20,0,FALSE,NA,"0.1.4"
"22484","646",2023-04-23 04:45:00,986,1006,20,0,FALSE,NA,"0.1.4"
"22485","646",2023-04-23 05:00:00,986,1006,20,0,FALSE,NA,"0.1.4"
"22486","646",2023-04-23 05:15:00,987,1006,19,0,FALSE,NA,"0.1.4"
"22487","646",2023-04-23 05:30:00,986,1006,20,0,FALSE,NA,"0.1.4"
"22488","646",2023-04-23 05:45:00,986,1006,20,0,FALSE,NA,"0.1.4"
"22489","646",2023-04-23 06:00:00,986,1006,20,0,FALSE,NA,"0.1.4"
"22490","646",2023-04-23 06:15:00,986,1006,20,0,FALSE,NA,"0.1.4"
"22491","646",2023-04-23 06:30:00,987,1006,19,0,FALSE,NA,"0.1.4"
"22492","646",2023-04-23 06:45:00,986,1006,20,0,FALSE,NA,"0.1.4"
"22493","646",2023-04-23 07:00:00,987,1006,19,0,FALSE,NA,"0.1.4"
"22494","646",2023-04-23 07:15:00,987,1006,19,0,FALSE,NA,"0.1.4"
"22495","646",2023-04-23 07:30:00,986,1006,20,0,FALSE,NA,"0.1.4"
"22496","646",2023-04-23 07:45:00,986,1006,20,0,FALSE,NA,"0.1.4"
"22497","646",2023-04-23 08:00:00,986,1006,20,0,FALSE,NA,"0.1.4"
"22498","646",2023-04-23 08:15:00,987,1006,19,0,FALSE,NA,"0.1.4"
"22499","646",2023-04-23 08:30:00,987,1006,19,0,FALSE,NA,"0.1.4"
"22500","646",2023-04-23 08:45:00,987,1006,19,0,FALSE,NA,"0.1.4"
"22501","646",2023-04-23 09:00:00,987,1006,19,0,FALSE,NA,"0.1.4"
"22502","646",2023-04-23 09:15:00,987,1006,19,0,FALSE,NA,"0.1.4"
"22503","646",2023-04-23 09:30:00,987,1006,19,0,FALSE,NA,"0.1.4"
"22504","646",2023-04-23 09:45:00,987,1006,19,0,FALSE,NA,"0.1.4"
"22505","646",2023-04-23 10:00:00,987,1006,19,0,FALSE,NA,"0.1.4"
"22506","646",2023-04-23 10:15:00,987,1006,19,0,FALSE,NA,"0.1.4"
"22507","646",2023-04-23 10:30:00,987,1006,19,0,FALSE,NA,"0.1.4"
"22508","646",2023-04-23 10:45:00,987,1006,19,0,FALSE,NA,"0.1.4"
"22509","646",2023-04-23 11:00:00,987,1006,19,0,FALSE,NA,"0.1.4"
"22510","646",2023-04-23 11:15:00,987,1006,19,0,FALSE,NA,"0.1.4"
"22511","646",2023-04-23 11:30:00,987,1006,19,0,FALSE,NA,"0.1.4"
"22512","646",2023-04-23 11:45:00,987,1006,19,0,FALSE,NA,"0.1.4"
"22513","646",2023-04-23 12:00:00,987,1006,19,0,FALSE,NA,"0.1.4"
"22514","646",2023-04-23 12:15:00,987,1006,19,0,FALSE,NA,"0.1.4"
"22515","646",2023-04-23 12:30:00,987,1006,19,0,FALSE,NA,"0.1.4"
"22516","646",2023-04-23 12:45:00,987,1006,19,0,FALSE,NA,"0.1.4"
"22517","646",2023-04-23 13:00:00,987,1006,19,0,FALSE,NA,"0.1.4"
"22518","646",2023-04-23 13:15:00,987,1006,19,0,FALSE,NA,"0.1.4"
"22519","646",2023-04-23 13:30:00,987,1006,19,0,FALSE,NA,"0.1.4"
"22520","646",2023-04-23 13:45:00,987,1006,19,0,FALSE,NA,"0.1.4"
"22521","646",2023-04-23 14:00:00,987,1006,19,0,FALSE,NA,"0.1.4"
"22522","646",2023-04-23 14:15:00,987,1006,19,0,FALSE,NA,"0.1.4"
"22523","646",2023-04-23 14:30:00,987,1006,19,0,FALSE,NA,"0.1.4"
"22524","646",2023-04-23 14:45:00,987,1006,19,0,FALSE,NA,"0.1.4"
"22525","646",2023-04-23 15:00:00,987,1006,19,0,FALSE,NA,"0.1.4"
"22526","646",2023-04-23 15:15:00,987,1006,19,0,FALSE,NA,"0.1.4"
"22527","646",2023-04-23 15:30:00,987,1006,19,0,FALSE,NA,"0.1.4"
"22528","646",2023-04-23 15:45:00,987,1006,19,0,FALSE,NA,"0.1.4"
"22529","646",2023-04-23 16:00:00,987,1006,19,0,FALSE,NA,"0.1.4"
"22530","646",2023-04-23 16:15:00,987,1006,19,0,FALSE,NA,"0.1.4"
"22531","646",2023-04-23 16:30:00,987,1006,19,0,FALSE,NA,"0.1.4"
"22532","646",2023-04-23 16:45:00,987,1006,19,0,FALSE,NA,"0.1.4"
"22533","646",2023-04-23 17:00:00,987,1006,19,0,FALSE,NA,"0.1.4"
"22534","646",2023-04-23 17:15:00,987,1006,19,0,FALSE,NA,"0.1.4"
"22535","646",2023-04-23 17:30:00,987,1006,19,0,FALSE,NA,"0.1.4"
"22536","646",2023-04-23 17:45:00,987,1006,19,0,FALSE,NA,"0.1.4"
"22537","646",2023-04-23 18:00:00,987,1006,19,0,FALSE,NA,"0.1.4"
"22538","646",2023-04-23 18:15:00,987,1006,19,0,FALSE,NA,"0.1.4"
"22539","646",2023-04-23 18:30:00,987,1006,19,0,FALSE,NA,"0.1.4"
"22540","646",2023-04-23 18:45:00,987,1006,19,0,FALSE,NA,"0.1.4"
"22541","646",2023-04-23 19:00:00,987,1006,19,0,FALSE,NA,"0.1.4"
"22542","646",2023-04-23 19:15:00,987,1006,19,0,FALSE,NA,"0.1.4"
"22543","646",2023-04-23 19:30:00,986,1006,20,0,FALSE,NA,"0.1.4"
"22544","646",2023-04-23 19:45:00,987,1006,19,0,FALSE,NA,"0.1.4"
"22545","646",2023-04-23 20:00:00,986,1006,20,0,FALSE,NA,"0.1.4"
"22546","646",2023-04-23 20:15:00,987,1006,19,0,FALSE,NA,"0.1.4"
"22547","646",2023-04-23 20:30:00,986,1006,20,0,FALSE,NA,"0.1.4"
"22548","646",2023-04-23 20:45:00,986,1006,20,0,FALSE,NA,"0.1.4"
"22549","646",2023-04-23 21:00:00,986,1006,20,0,FALSE,NA,"0.1.4"
"22550","646",2023-04-23 21:15:00,986,1006,20,0,FALSE,NA,"0.1.4"
"22551","646",2023-04-23 21:30:00,986,1006,20,0,FALSE,NA,"0.1.4"
"22552","646",2023-04-23 21:45:00,986,1006,20,0,FALSE,NA,"0.1.4"
"22553","646",2023-04-23 22:00:00,986,1006,20,0,FALSE,NA,"0.1.4"
"22554","646",2023-04-23 22:15:00,986,1006,20,0,FALSE,NA,"0.1.4"
"22555","646",2023-04-23 22:30:00,986,1006,20,0,FALSE,NA,"0.1.4"
"22556","646",2023-04-23 22:45:00,986,1006,20,0,FALSE,NA,"0.1.4"
"22557","646",2023-04-23 23:00:00,986,1006,20,0,FALSE,NA,"0.1.4"
"22558","646",2023-04-23 23:15:00,986,1006,20,0,FALSE,NA,"0.1.4"
"22559","646",2023-04-23 23:30:00,986,1006,20,0,FALSE,NA,"0.1.4"
"22560","646",2023-04-23 23:45:00,986,1006,20,0,FALSE,NA,"0.1.4"
"22561","646",2023-04-24,987,1006,19,0,FALSE,NA,"0.1.4"
"22562","646",2023-04-24 00:15:00,987,1006,19,0,FALSE,NA,"0.1.4"
"22563","646",2023-04-24 00:30:00,987,1006,19,0,FALSE,NA,"0.1.4"
"22564","646",2023-04-24 00:45:00,987,1006,19,0,FALSE,NA,"0.1.4"
"22565","646",2023-04-24 01:00:00,987,1006,19,0,FALSE,NA,"0.1.4"
"22566","646",2023-04-24 01:15:00,987,1006,19,0,FALSE,NA,"0.1.4"
"22567","646",2023-04-24 01:30:00,987,1006,19,0,FALSE,NA,"0.1.4"
"22568","646",2023-04-24 01:45:00,987,1006,19,0,FALSE,NA,"0.1.4"
"22569","646",2023-04-24 02:00:00,987,1006,19,0,FALSE,NA,"0.1.4"
"22570","646",2023-04-24 02:15:00,987,1006,19,0,FALSE,NA,"0.1.4"
"22571","646",2023-04-24 02:30:00,987,1006,19,0,FALSE,NA,"0.1.4"
"22572","646",2023-04-24 02:45:00,986,1006,20,0,FALSE,NA,"0.1.4"
"22573","646",2023-04-24 03:00:00,987,1006,19,0,FALSE,NA,"0.1.4"
"22574","646",2023-04-24 03:15:00,986,1006,20,0,FALSE,NA,"0.1.4"
"22575","646",2023-04-24 03:30:00,987,1006,19,0,FALSE,NA,"0.1.4"
"22576","646",2023-04-24 03:45:00,986,1006,20,0,FALSE,NA,"0.1.4"
"22577","646",2023-04-24 04:00:00,986,1006,20,0,FALSE,NA,"0.1.4"
"22578","646",2023-04-24 04:15:00,986,1006,20,0,FALSE,NA,"0.1.4"
"22579","646",2023-04-24 04:30:00,986,1006,20,0,FALSE,NA,"0.1.4"
"22580","646",2023-04-24 04:45:00,986,1006,20,0,FALSE,NA,"0.1.4"
"22581","646",2023-04-24 05:00:00,986,1006,20,0,FALSE,NA,"0.1.4"
"22582","646",2023-04-24 05:15:00,986,1006,20,0,FALSE,NA,"0.1.4"
"22583","646",2023-04-24 05:30:00,986,1006,20,0,FALSE,NA,"0.1.4"
"22584","646",2023-04-24 05:45:00,986,1006,20,0,FALSE,NA,"0.1.4"
"22585","646",2023-04-24 06:00:00,986,1006,20,0,FALSE,NA,"0.1.4"
"22586","646",2023-04-24 06:15:00,986,1006,20,0,FALSE,NA,"0.1.4"
"22587","646",2023-04-24 06:30:00,986,1006,20,0,FALSE,NA,"0.1.4"
"22588","646",2023-04-24 06:45:00,986,1006,20,0,FALSE,NA,"0.1.4"
"22589","646",2023-04-24 07:00:00,986,1006,20,0,FALSE,NA,"0.1.4"
"22590","646",2023-04-24 07:15:00,986,1006,20,0,FALSE,NA,"0.1.4"
"22591","646",2023-04-24 07:30:00,986,1006,20,0,FALSE,NA,"0.1.4"
"22592","646",2023-04-24 07:45:00,986,1006,20,0,FALSE,NA,"0.1.4"
"22593","646",2023-04-24 08:00:00,986,1006,20,0,FALSE,NA,"0.1.4"
"22594","646",2023-04-24 08:15:00,986,1006,20,0,FALSE,NA,"0.1.4"
"22595","646",2023-04-24 08:30:00,986,1006,20,0,FALSE,NA,"0.1.4"
"22596","646",2023-04-24 08:45:00,986,1006,20,0,FALSE,NA,"0.1.4"
"22597","646",2023-04-24 09:00:00,986,1006,20,0,FALSE,NA,"0.1.4"
"22598","646",2023-04-24 09:15:00,986,1006,20,0,FALSE,NA,"0.1.4"
"22599","646",2023-04-24 09:30:00,986,1006,20,0,FALSE,NA,"0.1.4"
"22600","646",2023-04-24 09:45:00,987,1006,19,0,FALSE,NA,"0.1.4"
"22601","646",2023-04-24 10:00:00,986,1006,20,0,FALSE,NA,"0.1.4"
"22602","646",2023-04-24 10:15:00,987,1006,19,0,FALSE,NA,"0.1.4"
"22603","646",2023-04-24 10:30:00,987,1006,19,0,FALSE,NA,"0.1.4"
"22604","646",2023-04-24 10:45:00,987,1006,19,0,FALSE,NA,"0.1.4"
"22605","646",2023-04-24 11:00:00,987,1006,19,0,FALSE,NA,"0.1.4"
"22606","646",2023-04-24 11:15:00,987,1006,19,0,FALSE,NA,"0.1.4"
"22607","646",2023-04-24 11:30:00,987,1006,19,0,FALSE,NA,"0.1.4"
"22608","646",2023-04-24 11:45:00,987,1006,19,0,FALSE,NA,"0.1.4"
"22609","646",2023-04-24 12:00:00,987,1006,19,0,FALSE,NA,"0.1.4"
"22610","646",2023-04-24 12:15:00,987,1006,19,0,FALSE,NA,"0.1.4"
"22611","646",2023-04-24 12:30:00,986,1006,20,0,FALSE,NA,"0.1.4"
"22612","646",2023-04-24 12:45:00,986,1006,20,0,FALSE,NA,"0.1.4"
"22613","646",2023-04-24 13:00:00,987,1006,19,0,FALSE,NA,"0.1.4"
"22614","646",2023-04-24 13:15:00,987,1006,19,0,FALSE,NA,"0.1.4"
"22615","646",2023-04-24 13:30:00,987,1006,19,0,FALSE,NA,"0.1.4"
"22616","646",2023-04-24 13:45:00,987,1006,19,0,FALSE,NA,"0.1.4"
"22617","646",2023-04-24 14:00:00,987,1006,19,0,FALSE,NA,"0.1.4"
"22618","646",2023-04-24 14:15:00,987,1006,19,0,FALSE,NA,"0.1.4"
"22619","646",2023-04-24 14:30:00,987,1006,19,0,FALSE,NA,"0.1.4"
"22620","646",2023-04-24 14:45:00,987,1006,19,0,FALSE,NA,"0.1.4"
"22621","646",2023-04-24 15:00:00,987,1006,19,0,FALSE,NA,"0.1.4"
"22622","646",2023-04-24 15:15:00,987,1006,19,0,FALSE,NA,"0.1.4"
"22623","646",2023-04-24 15:30:00,987,1006,19,0,FALSE,NA,"0.1.4"
"22624","646",2023-04-24 15:45:00,987,1006,19,0,FALSE,NA,"0.1.4"
"22625","646",2023-04-24 16:00:00,987,1006,19,0,FALSE,NA,"0.1.4"
"22626","646",2023-04-24 16:15:00,987,1006,19,0,FALSE,NA,"0.1.4"
"22627","646",2023-04-24 16:30:00,987,1006,19,0,FALSE,NA,"0.1.4"
"22628","646",2023-04-24 16:45:00,987,1006,19,0,FALSE,NA,"0.1.4"
"22629","646",2023-04-24 17:00:00,987,1006,19,0,FALSE,NA,"0.1.4"
"22630","646",2023-04-24 17:15:00,987,1006,19,0,FALSE,NA,"0.1.4"
"22631","646",2023-04-24 17:30:00,987,1006,19,0,FALSE,NA,"0.1.4"
"22632","646",2023-04-24 17:45:00,987,1006,19,0,FALSE,NA,"0.1.4"
"22633","646",2023-04-24 18:00:00,987,1006,19,0,FALSE,NA,"0.1.4"
"22634","646",2023-04-24 18:15:00,987,1006,19,0,FALSE,NA,"0.1.4"
"22635","646",2023-04-24 18:30:00,986,1006,20,0,FALSE,NA,"0.1.4"
"22636","646",2023-04-24 18:45:00,986,1006,20,0,FALSE,NA,"0.1.4"
"22637","646",2023-04-24 19:00:00,986,1006,20,0,FALSE,NA,"0.1.4"
"22638","646",2023-04-24 19:15:00,986,1006,20,0,FALSE,NA,"0.1.4"
"22639","646",2023-04-24 19:30:00,986,1006,20,0,FALSE,NA,"0.1.4"
"22640","646",2023-04-24 19:45:00,986,1006,20,0,FALSE,NA,"0.1.4"
"22641","646",2023-04-24 20:00:00,986,1006,20,0,FALSE,NA,"0.1.4"
"22642","646",2023-04-24 20:15:00,986,1006,20,0,FALSE,NA,"0.1.4"
"22643","646",2023-04-24 20:30:00,986,1006,20,0,FALSE,NA,"0.1.4"
"22644","646",2023-04-24 20:45:00,986,1006,20,0,FALSE,NA,"0.1.4"
"22645","646",2023-04-24 21:00:00,986,1006,20,0,FALSE,NA,"0.1.4"
"22646","646",2023-04-24 21:15:00,986,1006,20,0,FALSE,NA,"0.1.4"
"22647","646",2023-04-24 21:30:00,986,1006,20,0,FALSE,NA,"0.1.4"
"22648","646",2023-04-24 21:45:00,986,1006,20,0,FALSE,NA,"0.1.4"
"22649","646",2023-04-24 22:00:00,986,1006,20,0,FALSE,NA,"0.1.4"
"22650","646",2023-04-24 22:15:00,986,1006,20,0,FALSE,NA,"0.1.4"
"22651","646",2023-04-24 22:30:00,986,1006,20,0,FALSE,NA,"0.1.4"
"22652","646",2023-04-24 22:45:00,986,1006,20,0,FALSE,NA,"0.1.4"
"22653","646",2023-04-24 23:00:00,986,1006,20,0,FALSE,NA,"0.1.4"
"22654","646",2023-04-24 23:15:00,986,1006,20,0,FALSE,NA,"0.1.4"
"22655","646",2023-04-24 23:30:00,986,1006,20,0,FALSE,NA,"0.1.4"
"22656","646",2023-04-24 23:45:00,986,1006,20,0,FALSE,NA,"0.1.4"
"22657","646",2023-04-25,986,1006,20,0,FALSE,NA,"0.1.4"
"22658","646",2023-04-25 00:15:00,986,1006,20,0,FALSE,NA,"0.1.4"
"22659","646",2023-04-25 00:30:00,986,1006,20,0,FALSE,NA,"0.1.4"
"22660","646",2023-04-25 00:45:00,986,1006,20,0,FALSE,NA,"0.1.4"
"22661","646",2023-04-25 01:00:00,986,1006,20,0,FALSE,NA,"0.1.4"
"22662","646",2023-04-25 01:15:00,986,1006,20,0,FALSE,NA,"0.1.4"
"22663","646",2023-04-25 01:30:00,986,1006,20,0,FALSE,NA,"0.1.4"
"22664","646",2023-04-25 01:45:00,986,1006,20,0,FALSE,NA,"0.1.4"
"22665","646",2023-04-25 02:00:00,986,1006,20,0,FALSE,NA,"0.1.4"
"22666","646",2023-04-25 02:15:00,986,1006,20,0,FALSE,NA,"0.1.4"
"22667","646",2023-04-25 02:30:00,986,1006,20,0,FALSE,NA,"0.1.4"
"22668","646",2023-04-25 02:45:00,986,1006,20,0,FALSE,NA,"0.1.4"
"22669","646",2023-04-25 03:00:00,986,1006,20,0,FALSE,NA,"0.1.4"
"22670","646",2023-04-25 03:15:00,986,1006,20,0,FALSE,NA,"0.1.4"
"22671","646",2023-04-25 03:30:00,986,1006,20,0,FALSE,NA,"0.1.4"
"22672","646",2023-04-25 03:45:00,986,1006,20,0,FALSE,NA,"0.1.4"
"22673","646",2023-04-25 04:00:00,987,1006,19,0,FALSE,NA,"0.1.4"
"22674","646",2023-04-25 04:15:00,987,1006,19,0,FALSE,NA,"0.1.4"
"22675","646",2023-04-25 04:30:00,986,1006,20,0,FALSE,NA,"0.1.4"
"22676","646",2023-04-25 04:45:00,987,1006,19,0,FALSE,NA,"0.1.4"
"22677","646",2023-04-25 05:00:00,987,1006,19,0,FALSE,NA,"0.1.4"
"22678","646",2023-04-25 05:15:00,987,1006,19,0,FALSE,NA,"0.1.4"
"22679","646",2023-04-25 05:30:00,987,1006,19,0,TRUE,NA,"0.1.4"
"22680","646",2023-04-25 05:45:00,987,1006,19,0,TRUE,NA,"0.1.4"
"22681","646",2023-04-25 06:00:00,987,1006,19,0,TRUE,NA,"0.1.4"
"22682","646",2023-04-25 06:15:00,987,1006,19,0,TRUE,NA,"0.1.4"
"22683","646",2023-04-25 06:30:00,987,1006,19,0,TRUE,NA,"0.1.4"
"22684","646",2023-04-25 06:45:00,987,1006,19,0,TRUE,NA,"0.1.4"
"22685","646",2023-04-25 07:00:00,987,1006,19,0,TRUE,NA,"0.1.4"
"22686","646",2023-04-25 07:15:00,987,1006,19,0,TRUE,NA,"0.1.4"
"22687","646",2023-04-25 07:30:00,987,1006,19,0,TRUE,NA,"0.1.4"
"22688","646",2023-04-25 07:45:00,987,1006,19,0,TRUE,NA,"0.1.4"
"22689","646",2023-04-25 08:00:00,987,1006,19,0,TRUE,NA,"0.1.4"
"22690","646",2023-04-25 08:15:00,987,1006,19,0,TRUE,NA,"0.1.4"
"22691","646",2023-04-25 08:30:00,987,1006,19,0,TRUE,NA,"0.1.4"
"22692","646",2023-04-25 08:45:00,987,1006,19,0,TRUE,NA,"0.1.4"
"22693","646",2023-04-25 09:00:00,987,1006,19,0,TRUE,NA,"0.1.4"
"22694","646",2023-04-25 09:15:00,987,1006,19,0,TRUE,NA,"0.1.4"
"22695","646",2023-04-25 09:30:00,987,1006,19,0,TRUE,NA,"0.1.4"
"22696","646",2023-04-25 09:45:00,987,1006,19,0,TRUE,NA,"0.1.4"
"22697","646",2023-04-25 10:00:00,987,1006,19,0,TRUE,NA,"0.1.4"
"22698","646",2023-04-25 10:15:00,987,1006,19,0,TRUE,NA,"0.1.4"
"22699","646",2023-04-25 10:30:00,987,1006,19,0,TRUE,NA,"0.1.4"
"22700","646",2023-04-25 10:45:00,987,1006,19,0,TRUE,NA,"0.1.4"
"22701","646",2023-04-25 11:00:00,987,1006,19,0,TRUE,NA,"0.1.4"
"22702","646",2023-04-25 11:15:00,987,1006,19,0,TRUE,NA,"0.1.4"
"22703","646",2023-04-25 11:30:00,987,1006,19,0,TRUE,NA,"0.1.4"
"22704","646",2023-04-25 11:45:00,987,1006,19,0,TRUE,NA,"0.1.4"
"22705","646",2023-04-25 12:00:00,987,1006,19,0,TRUE,NA,"0.1.4"
"22706","646",2023-04-25 12:15:00,987,1006,19,0,TRUE,NA,"0.1.4"
"22707","646",2023-04-25 12:30:00,987,1006,19,0,TRUE,NA,"0.1.4"
"22708","646",2023-04-25 12:45:00,987,1006,19,0,TRUE,NA,"0.1.4"
"22709","646",2023-04-25 13:00:00,987,1006,19,0,TRUE,NA,"0.1.4"
"22710","646",2023-04-25 13:15:00,987,1006,19,0,TRUE,NA,"0.1.4"
"22711","646",2023-04-25 13:30:00,987,1006,19,0,TRUE,NA,"0.1.4"
"22712","646",2023-04-25 13:45:00,987,1006,19,0,TRUE,NA,"0.1.4"
"22713","646",2023-04-25 14:00:00,987,1006,19,0,TRUE,NA,"0.1.4"
"22714","646",2023-04-25 14:15:00,987,1006,19,0,TRUE,NA,"0.1.4"
"22715","646",2023-04-25 14:30:00,987,1006,19,0,TRUE,NA,"0.1.4"
"22716","646",2023-04-25 14:45:00,987,1006,19,0,TRUE,NA,"0.1.4"
"22717","646",2023-04-25 15:00:00,987,1006,19,0,TRUE,NA,"0.1.4"
"22718","646",2023-04-25 15:15:00,987,1006,19,0,TRUE,NA,"0.1.4"
"22719","646",2023-04-25 15:30:00,987,1006,19,0,TRUE,NA,"0.1.4"
"22720","646",2023-04-25 15:45:00,987,1006,19,0,TRUE,NA,"0.1.4"
"22721","646",2023-04-25 16:00:00,987,1006,19,0,TRUE,NA,"0.1.4"
"22722","646",2023-04-25 16:15:00,987,1006,19,0,TRUE,NA,"0.1.4"
"22723","646",2023-04-25 16:30:00,987,1006,19,0,TRUE,NA,"0.1.4"
"22724","646",2023-04-25 16:45:00,987,1006,19,0,TRUE,NA,"0.1.4"
"22725","646",2023-04-25 17:00:00,987,1006,19,0,TRUE,NA,"0.1.4"
"22726","646",2023-04-25 17:15:00,987,1006,19,0,FALSE,NA,"0.1.4"
"22727","646",2023-04-25 17:30:00,987,1006,19,0,FALSE,NA,"0.1.4"
"22728","646",2023-04-25 17:45:00,987,1006,19,0,FALSE,NA,"0.1.4"
"22729","646",2023-04-25 18:00:00,987,1006,19,0,FALSE,NA,"0.1.4"
"22730","646",2023-04-25 18:15:00,987,1006,19,0,FALSE,NA,"0.1.4"
"22731","646",2023-04-25 18:30:00,987,1006,19,0,FALSE,NA,"0.1.4"
"22732","646",2023-04-25 18:45:00,987,1006,19,0,FALSE,NA,"0.1.4"
"22733","646",2023-04-25 19:00:00,987,1006,19,0,FALSE,NA,"0.1.4"
"22734","646",2023-04-25 19:15:00,987,1006,19,0,FALSE,NA,"0.1.4"
"22735","646",2023-04-25 19:30:00,987,1006,19,0,FALSE,NA,"0.1.4"
"22736","646",2023-04-25 19:45:00,987,1006,19,0,FALSE,NA,"0.1.4"
"22737","646",2023-04-25 20:00:00,987,1006,19,0,FALSE,NA,"0.1.4"
"22738","646",2023-04-25 20:15:00,987,1006,19,0,FALSE,NA,"0.1.4"
"22739","646",2023-04-25 20:30:00,987,1006,19,0,FALSE,NA,"0.1.4"
"22740","646",2023-04-25 20:45:00,987,1006,19,0,FALSE,NA,"0.1.4"
"22741","646",2023-04-25 21:00:00,986,1006,20,0,FALSE,NA,"0.1.4"
"22742","646",2023-04-25 21:15:00,987,1006,19,0,FALSE,NA,"0.1.4"
"22743","646",2023-04-25 21:30:00,987,1006,19,0,FALSE,NA,"0.1.4"
"22744","646",2023-04-25 21:45:00,987,1006,19,0,FALSE,NA,"0.1.4"
"22745","646",2023-04-25 22:00:00,987,1006,19,0,FALSE,NA,"0.1.4"
"22746","646",2023-04-25 22:15:00,986,1006,20,0,FALSE,NA,"0.1.4"
"22747","646",2023-04-25 22:30:00,986,1006,20,0,FALSE,NA,"0.1.4"
"22748","646",2023-04-25 22:45:00,986,1006,20,0,FALSE,NA,"0.1.4"
"22749","646",2023-04-25 23:00:00,986,1006,20,0,FALSE,NA,"0.1.4"
"22750","646",2023-04-25 23:15:00,985,1006,21,0,FALSE,NA,"0.1.4"
"22751","646",2023-04-25 23:30:00,986,1006,20,0,FALSE,NA,"0.1.4"
"22752","646",2023-04-25 23:45:00,986,1006,20,0,FALSE,NA,"0.1.4"
"22753","646",2023-04-26,986,1006,20,0,FALSE,NA,"0.1.4"
"22754","646",2023-04-26 00:15:00,985,1006,21,0,FALSE,NA,"0.1.4"
"22755","646",2023-04-26 00:30:00,985,1006,21,0,FALSE,NA,"0.1.4"
"22756","646",2023-04-26 00:45:00,985,1006,21,0,FALSE,NA,"0.1.4"
"22757","646",2023-04-26 01:00:00,985,1006,21,0,FALSE,NA,"0.1.4"
"22758","646",2023-04-26 01:15:00,985,1006,21,0,FALSE,NA,"0.1.4"
"22759","646",2023-04-26 01:30:00,985,1006,21,0,FALSE,NA,"0.1.4"
"22760","646",2023-04-26 01:45:00,986,1006,20,0,FALSE,NA,"0.1.4"
"22761","646",2023-04-26 02:00:00,985,1006,21,0,FALSE,NA,"0.1.4"
"22762","646",2023-04-26 02:15:00,985,1006,21,0,FALSE,NA,"0.1.4"
"22763","646",2023-04-26 02:30:00,985,1006,21,0,FALSE,NA,"0.1.4"
"22764","646",2023-04-26 02:45:00,985,1006,21,0,FALSE,NA,"0.1.4"
"22765","646",2023-04-26 03:00:00,985,1006,21,0,FALSE,NA,"0.1.4"
"22766","646",2023-04-26 03:15:00,985,1006,21,0,FALSE,NA,"0.1.4"
"22767","646",2023-04-26 03:30:00,985,1006,21,0,FALSE,NA,"0.1.4"
"22768","646",2023-04-26 03:45:00,985,1006,21,0,FALSE,NA,"0.1.4"
"22769","646",2023-04-26 04:00:00,985,1006,21,0,FALSE,NA,"0.1.4"
"22770","646",2023-04-26 04:15:00,985,1006,21,0,FALSE,NA,"0.1.4"
"22771","646",2023-04-26 04:30:00,985,1006,21,0,FALSE,NA,"0.1.4"
"22772","646",2023-04-26 04:45:00,985,1006,21,0,FALSE,NA,"0.1.4"
"22773","646",2023-04-26 05:00:00,985,1006,21,0,FALSE,NA,"0.1.4"
"22774","646",2023-04-26 05:15:00,985,1006,21,0,FALSE,NA,"0.1.4"
"22775","646",2023-04-26 05:30:00,985,1006,21,0,FALSE,NA,"0.1.4"
"22776","646",2023-04-26 05:45:00,985,1006,21,0,FALSE,NA,"0.1.4"
"22777","646",2023-04-26 06:00:00,985,1006,21,0,FALSE,NA,"0.1.4"
"22778","646",2023-04-26 06:15:00,985,1006,21,0,FALSE,NA,"0.1.4"
"22779","646",2023-04-26 06:30:00,985,1006,21,0,FALSE,NA,"0.1.4"
"22780","646",2023-04-26 06:45:00,985,1006,21,0,FALSE,NA,"0.1.4"
"22781","646",2023-04-26 07:00:00,985,1006,21,0,FALSE,NA,"0.1.4"
"22782","646",2023-04-26 07:15:00,985,1006,21,0,FALSE,NA,"0.1.4"
"22783","646",2023-04-26 07:30:00,985,1006,21,0,FALSE,NA,"0.1.4"
"22784","646",2023-04-26 07:45:00,985,1006,21,0,FALSE,NA,"0.1.4"
"22785","646",2023-04-26 08:00:00,985,1006,21,0,FALSE,NA,"0.1.4"
"22786","646",2023-04-26 08:15:00,985,1006,21,0,FALSE,NA,"0.1.4"
"22787","646",2023-04-26 08:30:00,985,1006,21,0,FALSE,NA,"0.1.4"
"22788","646",2023-04-26 08:45:00,985,1006,21,0,TRUE,NA,"0.1.4"
"22789","646",2023-04-26 09:00:00,985,1006,21,0,TRUE,NA,"0.1.4"
"22790","646",2023-04-26 09:15:00,985,1006,21,0,TRUE,NA,"0.1.4"
"22791","646",2023-04-26 09:30:00,985,1006,21,0,TRUE,NA,"0.1.4"
"22792","646",2023-04-26 09:45:00,985,1006,21,0,TRUE,NA,"0.1.4"
"22793","646",2023-04-26 10:00:00,985,1006,21,0,TRUE,NA,"0.1.4"
"22794","646",2023-04-26 10:15:00,985,1006,21,0,TRUE,NA,"0.1.4"
"22795","646",2023-04-26 10:30:00,985,1006,21,0,TRUE,NA,"0.1.4"
"22796","646",2023-04-26 10:45:00,985,1006,21,0,TRUE,NA,"0.1.4"
"22797","646",2023-04-26 11:00:00,985,1006,21,0,TRUE,NA,"0.1.4"
"22798","646",2023-04-26 11:15:00,985,1006,21,0,TRUE,NA,"0.1.4"
"22799","646",2023-04-26 11:30:00,985,1006,21,0,TRUE,NA,"0.1.4"
"22800","646",2023-04-26 11:45:00,985,1006,21,0,TRUE,NA,"0.1.4"
"22801","646",2023-04-26 12:00:00,985,1006,21,0,TRUE,NA,"0.1.4"
"22802","646",2023-04-26 12:15:00,985,1006,21,0,TRUE,NA,"0.1.4"
"22803","646",2023-04-26 12:30:00,985,1006,21,0,TRUE,NA,"0.1.4"
"22804","646",2023-04-26 12:45:00,985,1006,21,0,TRUE,NA,"0.1.4"
"22805","646",2023-04-26 13:00:00,985,1006,21,0,TRUE,NA,"0.1.4"
"22806","646",2023-04-26 13:15:00,985,1006,21,0,TRUE,NA,"0.1.4"
"22807","646",2023-04-26 13:30:00,985,1006,21,0,TRUE,NA,"0.1.4"
"22808","646",2023-04-26 13:45:00,985,1006,21,0,TRUE,NA,"0.1.4"
"22809","646",2023-04-26 14:00:00,985,1006,21,0,TRUE,NA,"0.1.4"
"22810","646",2023-04-26 14:15:00,985,1006,21,0,TRUE,NA,"0.1.4"
"22811","646",2023-04-26 14:30:00,985,1006,21,0,TRUE,NA,"0.1.4"
"22812","646",2023-04-26 14:45:00,985,1006,21,0,TRUE,NA,"0.1.4"
"22813","646",2023-04-26 15:00:00,985,1006,21,0,TRUE,NA,"0.1.4"
"22814","646",2023-04-26 15:15:00,985,1006,21,0,TRUE,NA,"0.1.4"
"22815","646",2023-04-26 15:30:00,985,1006,21,0,TRUE,NA,"0.1.4"
"22816","646",2023-04-26 15:45:00,985,1006,21,0,TRUE,NA,"0.1.4"
"22817","646",2023-04-26 16:00:00,985,1006,21,0,TRUE,NA,"0.1.4"
"22818","646",2023-04-26 16:15:00,985,1006,21,0,FALSE,NA,"0.1.4"
"22819","646",2023-04-26 16:30:00,985,1006,21,0,FALSE,NA,"0.1.4"
"22820","646",2023-04-26 16:45:00,985,1006,21,0,FALSE,NA,"0.1.4"
"22821","646",2023-04-26 17:00:00,985,1006,21,0,FALSE,NA,"0.1.4"
"22822","646",2023-04-26 17:15:00,985,1006,21,0,FALSE,NA,"0.1.4"
"22823","646",2023-04-26 17:30:00,985,1006,21,0,FALSE,NA,"0.1.4"
"22824","646",2023-04-26 17:45:00,985,1006,21,0,FALSE,NA,"0.1.4"
"22825","646",2023-04-26 18:00:00,985,1006,21,0,FALSE,NA,"0.1.4"
"22826","646",2023-04-26 18:15:00,985,1006,21,0,FALSE,NA,"0.1.4"
"22827","646",2023-04-26 18:30:00,985,1006,21,0,FALSE,NA,"0.1.4"
"22828","646",2023-04-26 18:45:00,985,1006,21,0,FALSE,NA,"0.1.4"
"22829","646",2023-04-26 19:00:00,985,1006,21,0,FALSE,NA,"0.1.4"
"22830","646",2023-04-26 19:15:00,985,1006,21,0,FALSE,NA,"0.1.4"
"22831","646",2023-04-26 19:30:00,985,1006,21,0,FALSE,NA,"0.1.4"
"22832","646",2023-04-26 19:45:00,986,1006,20,0,FALSE,NA,"0.1.4"
"22833","646",2023-04-26 20:00:00,986,1006,20,0,FALSE,NA,"0.1.4"
"22834","646",2023-04-26 20:15:00,986,1006,20,0,FALSE,NA,"0.1.4"
"22835","646",2023-04-26 20:30:00,986,1006,20,0,FALSE,NA,"0.1.4"
"22836","646",2023-04-26 20:45:00,985,1006,21,0,FALSE,NA,"0.1.4"
"22837","646",2023-04-26 21:00:00,985,1006,21,0,FALSE,NA,"0.1.4"
"22838","646",2023-04-26 21:15:00,985,1006,21,0,FALSE,NA,"0.1.4"
"22839","646",2023-04-26 21:30:00,985,1006,21,0,FALSE,NA,"0.1.4"
"22840","646",2023-04-26 21:45:00,985,1006,21,0,FALSE,NA,"0.1.4"
"22841","646",2023-04-26 22:00:00,984,1006,22,0,FALSE,NA,"0.1.4"
"22842","646",2023-04-26 22:15:00,984,1006,22,0,FALSE,NA,"0.1.4"
"22843","646",2023-04-26 22:30:00,984,1006,22,0,FALSE,NA,"0.1.4"
"22844","646",2023-04-26 22:45:00,984,1006,22,0,FALSE,NA,"0.1.4"
"22845","646",2023-04-26 23:00:00,984,1006,22,0,FALSE,NA,"0.1.4"
"22846","646",2023-04-26 23:15:00,983,1006,23,0,FALSE,NA,"0.1.4"
"22847","646",2023-04-26 23:30:00,982,1006,24,0,FALSE,NA,"0.1.4"
"22848","646",2023-04-26 23:45:00,982,1006,24,0,FALSE,NA,"0.1.4"
"22849","646",2023-04-27,982,1006,24,0,FALSE,NA,"0.1.4"
"22850","646",2023-04-27 00:15:00,981,1006,25,0,FALSE,NA,"0.1.4"
"22851","646",2023-04-27 00:30:00,981,1006,25,0,FALSE,NA,"0.1.4"
"22852","646",2023-04-27 00:45:00,981,1006,25,0,FALSE,NA,"0.1.4"
"22853","646",2023-04-27 01:00:00,981,1006,25,0,FALSE,NA,"0.1.4"
"22854","646",2023-04-27 01:15:00,981,1006,25,0,FALSE,NA,"0.1.4"
"22855","646",2023-04-27 01:30:00,981,1006,25,0,FALSE,NA,"0.1.4"
"22856","646",2023-04-27 01:45:00,981,1006,25,0,FALSE,NA,"0.1.4"
"22857","646",2023-04-27 02:00:00,980,1006,26,0,FALSE,NA,"0.1.4"
"22858","646",2023-04-27 02:15:00,981,1006,25,0,FALSE,NA,"0.1.4"
"22859","646",2023-04-27 02:30:00,981,1006,25,0,FALSE,NA,"0.1.4"
"22860","646",2023-04-27 02:45:00,980,1006,26,0,FALSE,NA,"0.1.4"
"22861","646",2023-04-27 03:00:00,981,1006,25,0,FALSE,NA,"0.1.4"
"22862","646",2023-04-27 03:15:00,981,1006,25,0,FALSE,NA,"0.1.4"
"22863","646",2023-04-27 03:30:00,980,1006,26,0,FALSE,NA,"0.1.4"
"22864","646",2023-04-27 03:45:00,981,1006,25,0,FALSE,NA,"0.1.4"
"22865","646",2023-04-27 04:00:00,981,1006,25,0,FALSE,NA,"0.1.4"
"22866","646",2023-04-27 04:15:00,981,1006,25,0,FALSE,NA,"0.1.4"
"22867","646",2023-04-27 04:30:00,981,1006,25,0,FALSE,NA,"0.1.4"
"22868","646",2023-04-27 04:45:00,981,1006,25,0,FALSE,NA,"0.1.4"
"22869","646",2023-04-27 05:00:00,981,1006,25,0,FALSE,NA,"0.1.4"
"22870","646",2023-04-27 05:15:00,981,1006,25,0,FALSE,NA,"0.1.4"
"22871","646",2023-04-27 05:30:00,981,1006,25,0,FALSE,NA,"0.1.4"
"22872","646",2023-04-27 05:45:00,981,1006,25,0,FALSE,NA,"0.1.4"
"22873","646",2023-04-27 06:00:00,981,1006,25,0,FALSE,NA,"0.1.4"
"22874","646",2023-04-27 06:15:00,981,1006,25,0,FALSE,NA,"0.1.4"
"22875","646",2023-04-27 06:30:00,981,1006,25,0,FALSE,NA,"0.1.4"
"22876","646",2023-04-27 06:45:00,981,1006,25,0,FALSE,NA,"0.1.4"
"22877","646",2023-04-27 07:00:00,981,1006,25,0,FALSE,NA,"0.1.4"
"22878","646",2023-04-27 07:15:00,981,1006,25,0,FALSE,NA,"0.1.4"
"22879","646",2023-04-27 07:30:00,981,1006,25,0,FALSE,NA,"0.1.4"
"22880","646",2023-04-27 07:45:00,981,1006,25,0,FALSE,NA,"0.1.4"
"22881","646",2023-04-27 08:00:00,981,1006,25,0,FALSE,NA,"0.1.4"
"22882","646",2023-04-27 08:15:00,981,1006,25,0,FALSE,NA,"0.1.4"
"22883","646",2023-04-27 08:30:00,981,1006,25,0,FALSE,NA,"0.1.4"
"22884","646",2023-04-27 08:45:00,981,1006,25,0,FALSE,NA,"0.1.4"
"22885","646",2023-04-27 09:00:00,981,1006,25,0,FALSE,NA,"0.1.4"
"22886","646",2023-04-27 09:15:00,981,1006,25,0,FALSE,NA,"0.1.4"
"22887","646",2023-04-27 09:30:00,981,1006,25,0,FALSE,NA,"0.1.4"
"22888","646",2023-04-27 09:45:00,981,1006,25,0,FALSE,NA,"0.1.4"
"22889","646",2023-04-27 10:00:00,981,1006,25,0,FALSE,NA,"0.1.4"
"22890","646",2023-04-27 10:15:00,981,1006,25,0,FALSE,NA,"0.1.4"
"22891","646",2023-04-27 10:30:00,981,1006,25,0,FALSE,NA,"0.1.4"
"22892","646",2023-04-27 10:45:00,981,1006,25,0,FALSE,NA,"0.1.4"
"22893","646",2023-04-27 11:00:00,981,1006,25,0,FALSE,NA,"0.1.4"
"22894","646",2023-04-27 11:15:00,981,1006,25,0,FALSE,NA,"0.1.4"
"22895","646",2023-04-27 11:30:00,981,1006,25,0,FALSE,NA,"0.1.4"
"22896","646",2023-04-27 11:45:00,981,1006,25,0,FALSE,NA,"0.1.4"
"22897","646",2023-04-27 12:00:00,981,1006,25,0,FALSE,NA,"0.1.4"
"22898","646",2023-04-27 12:15:00,981,1006,25,0,TRUE,NA,"0.1.4"
"22899","646",2023-04-27 12:30:00,981,1006,25,0,TRUE,NA,"0.1.4"
"22900","646",2023-04-27 12:45:00,981,1006,25,0,TRUE,NA,"0.1.4"
"22901","646",2023-04-27 13:00:00,981,1006,25,0,TRUE,NA,"0.1.4"
"22902","646",2023-04-27 13:15:00,981,1006,25,0,TRUE,NA,"0.1.4"
"22903","646",2023-04-27 13:30:00,981,1006,25,0,TRUE,NA,"0.1.4"
"22904","646",2023-04-27 13:45:00,981,1006,25,0,TRUE,NA,"0.1.4"
"22905","646",2023-04-27 14:00:00,981,1006,25,0,TRUE,NA,"0.1.4"
"22906","646",2023-04-27 14:15:00,981,1006,25,0,TRUE,NA,"0.1.4"
"22907","646",2023-04-27 14:30:00,981,1006,25,0,TRUE,NA,"0.1.4"
"22908","646",2023-04-27 14:45:00,981,1006,25,0,TRUE,NA,"0.1.4"
"22909","646",2023-04-27 15:00:00,981,1006,25,0,TRUE,NA,"0.1.4"
"22910","646",2023-04-27 15:15:00,981,1006,25,0,FALSE,NA,"0.1.4"
"22911","646",2023-04-27 15:30:00,981,1006,25,0,FALSE,NA,"0.1.4"
"22912","646",2023-04-27 15:45:00,981,1006,25,0,FALSE,NA,"0.1.4"
"22913","646",2023-04-27 16:00:00,981,1006,25,0,FALSE,NA,"0.1.4"
"22914","646",2023-04-27 16:15:00,981,1006,25,0,FALSE,NA,"0.1.4"
"22915","646",2023-04-27 16:30:00,981,1006,25,0,FALSE,NA,"0.1.4"
"22916","646",2023-04-27 16:45:00,981,1006,25,0,FALSE,NA,"0.1.4"
"22917","646",2023-04-27 17:00:00,981,1006,25,0,FALSE,NA,"0.1.4"
"22918","646",2023-04-27 17:15:00,981,1006,25,0,FALSE,NA,"0.1.4"
"22919","646",2023-04-27 17:30:00,981,1006,25,0,FALSE,NA,"0.1.4"
"22920","646",2023-04-27 17:45:00,981,1006,25,0,FALSE,NA,"0.1.4"
"22921","646",2023-04-27 18:00:00,981,1006,25,0,FALSE,NA,"0.1.4"
"22922","646",2023-04-27 18:15:00,981,1006,25,0,FALSE,NA,"0.1.4"
"22923","646",2023-04-27 18:30:00,981,1006,25,0,FALSE,NA,"0.1.4"
"22924","646",2023-04-27 18:45:00,981,1006,25,0,FALSE,NA,"0.1.4"
"22925","646",2023-04-27 19:00:00,981,1006,25,0,FALSE,NA,"0.1.4"
"22926","646",2023-04-27 19:15:00,981,1006,25,0,FALSE,NA,"0.1.4"
"22927","646",2023-04-27 19:30:00,981,1006,25,0,FALSE,NA,"0.1.4"
"22928","646",2023-04-27 19:45:00,981,1006,25,0,FALSE,NA,"0.1.4"
"22929","646",2023-04-27 20:00:00,981,1006,25,0,FALSE,NA,"0.1.4"
"22930","646",2023-04-27 20:15:00,981,1006,25,0,FALSE,NA,"0.1.4"
"22931","646",2023-04-27 20:30:00,981,1006,25,0,FALSE,NA,"0.1.4"
"22932","646",2023-04-27 20:45:00,981,1006,25,0,FALSE,NA,"0.1.4"
"22933","646",2023-04-27 21:00:00,981,1006,25,0,FALSE,NA,"0.1.4"
"22934","646",2023-04-27 21:15:00,981,1006,25,0,FALSE,NA,"0.1.4"
"22935","646",2023-04-27 21:30:00,981,1006,25,0,FALSE,NA,"0.1.4"
"22936","646",2023-04-27 21:45:00,980,1006,26,0,FALSE,NA,"0.1.4"
"22937","646",2023-04-27 22:00:00,979,1006,27,0,FALSE,NA,"0.1.4"
"22938","646",2023-04-27 22:15:00,979,1006,27,0,FALSE,NA,"0.1.4"
"22939","646",2023-04-27 22:30:00,978,1006,28,0,FALSE,NA,"0.1.4"
"22940","646",2023-04-27 22:45:00,979,1006,27,0,FALSE,NA,"0.1.4"
"22941","646",2023-04-27 23:00:00,977,1006,29,0,FALSE,NA,"0.1.4"
"22942","646",2023-04-27 23:15:00,978,1006,28,0,FALSE,NA,"0.1.4"
"22943","646",2023-04-27 23:30:00,976,1006,30,0,FALSE,NA,"0.1.4"
"22944","646",2023-04-27 23:45:00,976,1006,30,0,FALSE,NA,"0.1.4"
"22945","646",2023-04-28,976,1006,30,0,FALSE,NA,"0.1.4"
"22946","646",2023-04-28 00:15:00,975,1006,31,0,FALSE,NA,"0.1.4"
"22947","646",2023-04-28 00:30:00,976,1006,30,0,FALSE,NA,"0.1.4"
"22948","646",2023-04-28 00:45:00,975,1006,31,0,FALSE,NA,"0.1.4"
"22949","646",2023-04-28 01:00:00,975,1006,31,0,FALSE,NA,"0.1.4"
"22950","646",2023-04-28 01:15:00,976,1006,30,0,FALSE,NA,"0.1.4"
"22951","646",2023-04-28 01:30:00,974,1006,32,0,FALSE,NA,"0.1.4"
"22952","646",2023-04-28 01:45:00,974,1006,32,0,FALSE,NA,"0.1.4"
"22953","646",2023-04-28 02:00:00,975,1006,31,0,FALSE,NA,"0.1.4"
"22954","646",2023-04-28 02:15:00,975,1006,31,0,FALSE,NA,"0.1.4"
"22955","646",2023-04-28 02:30:00,975,1006,31,0,FALSE,NA,"0.1.4"
"22956","646",2023-04-28 02:45:00,975,1006,31,0,FALSE,NA,"0.1.4"
"22957","646",2023-04-28 03:00:00,975,1006,31,0,FALSE,NA,"0.1.4"
"22958","646",2023-04-28 03:15:00,975,1006,31,0,FALSE,NA,"0.1.4"
"22959","646",2023-04-28 03:30:00,975,1006,31,0,FALSE,NA,"0.1.4"
"22960","646",2023-04-28 03:45:00,975,1006,31,0,FALSE,NA,"0.1.4"
"22961","646",2023-04-28 04:00:00,975,1006,31,0,FALSE,NA,"0.1.4"
"22962","646",2023-04-28 04:15:00,975,1006,31,0,FALSE,NA,"0.1.4"
"22963","646",2023-04-28 04:30:00,975,1006,31,0,FALSE,NA,"0.1.4"
"22964","646",2023-04-28 04:45:00,975,1006,31,0,FALSE,NA,"0.1.4"
"22965","646",2023-04-28 05:00:00,975,1006,31,0,FALSE,NA,"0.1.4"
"22966","646",2023-04-28 05:15:00,975,1006,31,0,FALSE,NA,"0.1.4"
"22967","646",2023-04-28 05:30:00,975,1006,31,0,FALSE,NA,"0.1.4"
"22968","646",2023-04-28 05:45:00,975,1006,31,0,FALSE,NA,"0.1.4"
"22969","646",2023-04-28 06:00:00,975,1006,31,0,FALSE,NA,"0.1.4"
"22970","646",2023-04-28 06:15:00,975,1006,31,0,FALSE,NA,"0.1.4"
"22971","646",2023-04-28 06:30:00,975,1006,31,0,FALSE,NA,"0.1.4"
"22972","646",2023-04-28 06:45:00,975,1006,31,0,FALSE,NA,"0.1.4"
"22973","646",2023-04-28 07:00:00,975,1006,31,0,FALSE,NA,"0.1.4"
"22974","646",2023-04-28 07:15:00,975,1006,31,0,FALSE,NA,"0.1.4"
"22975","646",2023-04-28 07:30:00,975,1006,31,0,FALSE,NA,"0.1.4"
"22976","646",2023-04-28 07:45:00,975,1006,31,0,FALSE,NA,"0.1.4"
"22977","646",2023-04-28 08:00:00,975,1006,31,0,FALSE,NA,"0.1.4"
"22978","646",2023-04-28 08:15:00,975,1006,31,0,FALSE,NA,"0.1.4"
"22979","646",2023-04-28 08:30:00,975,1006,31,0,FALSE,NA,"0.1.4"
"22980","646",2023-04-28 08:45:00,975,1006,31,0,FALSE,NA,"0.1.4"
"22981","646",2023-04-28 09:00:00,975,1006,31,0,FALSE,NA,"0.1.4"
"22982","646",2023-04-28 09:15:00,975,1006,31,0,FALSE,NA,"0.1.4"
"22983","646",2023-04-28 09:30:00,975,1006,31,0,FALSE,NA,"0.1.4"
"22984","646",2023-04-28 09:45:00,975,1006,31,0,FALSE,NA,"0.1.4"
"22985","646",2023-04-28 10:00:00,975,1006,31,0,FALSE,NA,"0.1.4"
"22986","646",2023-04-28 10:15:00,975,1006,31,0,FALSE,NA,"0.1.4"
"22987","646",2023-04-28 10:30:00,975,1006,31,0,FALSE,NA,"0.1.4"
"22988","646",2023-04-28 10:45:00,975,1006,31,0,FALSE,NA,"0.1.4"
"22989","646",2023-04-28 11:00:00,975,1006,31,0,FALSE,NA,"0.1.4"
"22990","646",2023-04-28 11:15:00,975,1006,31,0,FALSE,NA,"0.1.4"
"22991","646",2023-04-28 11:30:00,975,1006,31,0,FALSE,NA,"0.1.4"
"22992","646",2023-04-28 11:45:00,975,1006,31,0,FALSE,NA,"0.1.4"
"22993","646",2023-04-28 12:00:00,975,1006,31,0,FALSE,NA,"0.1.4"
"22994","646",2023-04-28 12:15:00,975,1006,31,0,FALSE,NA,"0.1.4"
"22995","646",2023-04-28 12:30:00,975,1006,31,0,FALSE,NA,"0.1.4"
"22996","646",2023-04-28 12:45:00,975,1006,31,0,FALSE,NA,"0.1.4"
"22997","646",2023-04-28 13:00:00,975,1006,31,0,FALSE,NA,"0.1.4"
"22998","646",2023-04-28 13:15:00,975,1006,31,0,FALSE,NA,"0.1.4"
"22999","646",2023-04-28 13:30:00,975,1006,31,0,FALSE,NA,"0.1.4"
"23000","646",2023-04-28 13:45:00,975,1006,31,0,FALSE,NA,"0.1.4"
"23001","646",2023-04-28 14:00:00,975,1006,31,0,FALSE,NA,"0.1.4"
"23002","646",2023-04-28 14:15:00,975,1006,31,0,FALSE,NA,"0.1.4"
"23003","646",2023-04-28 14:30:00,975,1006,31,0,FALSE,NA,"0.1.4"
"23004","646",2023-04-28 14:45:00,975,1006,31,0,FALSE,NA,"0.1.4"
"23005","646",2023-04-28 15:00:00,975,1006,31,0,FALSE,NA,"0.1.4"
"23006","646",2023-04-28 15:15:00,975,1006,31,0,FALSE,NA,"0.1.4"
"23007","646",2023-04-28 15:30:00,975,1006,31,0,FALSE,NA,"0.1.4"
"23008","646",2023-04-28 15:45:00,975,1006,31,0,FALSE,NA,"0.1.4"
"23009","646",2023-04-28 16:00:00,975,1006,31,0,FALSE,NA,"0.1.4"
"23010","646",2023-04-28 16:15:00,975,1006,31,0,FALSE,NA,"0.1.4"
"23011","646",2023-04-28 16:30:00,975,1006,31,0,FALSE,NA,"0.1.4"
"23012","646",2023-04-28 16:45:00,975,1006,31,0,FALSE,NA,"0.1.4"
"23013","646",2023-04-28 17:00:00,975,1006,31,0,FALSE,NA,"0.1.4"
"23014","646",2023-04-28 17:15:00,975,1006,31,0,FALSE,NA,"0.1.4"
"23015","646",2023-04-28 17:30:00,975,1006,31,0,FALSE,NA,"0.1.4"
"23016","646",2023-04-28 17:45:00,975,1006,31,0,FALSE,NA,"0.1.4"
"23017","646",2023-04-28 18:00:00,975,1006,31,0,FALSE,NA,"0.1.4"
"23018","646",2023-04-28 18:15:00,975,1006,31,0,FALSE,NA,"0.1.4"
"23019","646",2023-04-28 18:30:00,975,1006,31,0,FALSE,NA,"0.1.4"
"23020","646",2023-04-28 18:45:00,975,1006,31,0,FALSE,NA,"0.1.4"
"23021","646",2023-04-28 19:00:00,975,1006,31,0,FALSE,NA,"0.1.4"
"23022","646",2023-04-28 19:15:00,975,1006,31,0,FALSE,NA,"0.1.4"
"23023","646",2023-04-28 19:30:00,975,1006,31,0,FALSE,NA,"0.1.4"
"23024","646",2023-04-28 19:45:00,975,1006,31,0,FALSE,NA,"0.1.4"
"23025","646",2023-04-28 20:00:00,974,1006,32,0,FALSE,NA,"0.1.4"
"23026","646",2023-04-28 20:15:00,974,1006,32,0,FALSE,NA,"0.1.4"
"23027","646",2023-04-28 20:30:00,974,1006,32,0,FALSE,NA,"0.1.4"
"23028","646",2023-04-28 20:45:00,974,1006,32,0,FALSE,NA,"0.1.4"
"23029","646",2023-04-28 21:00:00,974,1006,32,0,FALSE,NA,"0.1.4"
"23030","646",2023-04-28 21:15:00,971,1006,35,0,FALSE,NA,"0.1.4"
"23031","646",2023-04-28 21:30:00,971,1006,35,0,FALSE,NA,"0.1.4"
"23032","646",2023-04-28 21:45:00,970,1006,36,0,FALSE,NA,"0.1.4"
"23033","646",2023-04-28 22:00:00,971,1006,35,0,FALSE,NA,"0.1.4"
"23034","646",2023-04-28 22:15:00,970,1006,36,0,FALSE,NA,"0.1.4"
"23035","646",2023-04-28 22:30:00,968,1006,38,0,FALSE,NA,"0.1.4"
"23036","646",2023-04-28 22:45:00,969,1006,37,0,FALSE,NA,"0.1.4"
"23037","646",2023-04-28 23:00:00,966,1006,40,0,FALSE,NA,"0.1.4"
"23038","646",2023-04-28 23:15:00,966,1006,40,0,FALSE,NA,"0.1.4"
"23039","646",2023-04-28 23:30:00,965,1006,41,0,FALSE,NA,"0.1.4"
"23040","646",2023-04-28 23:45:00,965,1006,41,0,FALSE,NA,"0.1.4"
"23041","646",2023-04-29,964,1006,42,0,FALSE,NA,"0.1.4"
"23042","646",2023-04-29 00:15:00,964,1006,42,0,FALSE,NA,"0.1.4"
"23043","646",2023-04-29 00:30:00,963,1006,43,0,FALSE,NA,"0.1.4"
"23044","646",2023-04-29 00:45:00,965,1006,41,0,FALSE,NA,"0.1.4"
"23045","646",2023-04-29 01:00:00,964,1006,42,0,FALSE,NA,"0.1.4"
"23046","646",2023-04-29 01:15:00,965,1006,41,0,FALSE,NA,"0.1.4"
"23047","646",2023-04-29 01:30:00,964,1006,42,0,FALSE,NA,"0.1.4"
"23048","646",2023-04-29 01:45:00,965,1006,41,0,FALSE,NA,"0.1.4"
"23049","646",2023-04-29 02:00:00,965,1006,41,0,FALSE,NA,"0.1.4"
"23050","646",2023-04-29 02:15:00,964,1006,42,0,FALSE,NA,"0.1.4"
"23051","646",2023-04-29 02:30:00,965,1006,41,0,FALSE,NA,"0.1.4"
"23052","646",2023-04-29 02:45:00,965,1006,41,0,FALSE,NA,"0.1.4"
"23053","646",2023-04-29 03:00:00,965,1006,41,0,FALSE,NA,"0.1.4"
"23054","646",2023-04-29 03:15:00,965,1006,41,0,FALSE,NA,"0.1.4"
"23055","646",2023-04-29 03:30:00,965,1006,41,0,FALSE,NA,"0.1.4"
"23056","646",2023-04-29 03:45:00,965,1006,41,0,FALSE,NA,"0.1.4"
"23057","646",2023-04-29 04:00:00,965,1006,41,0,FALSE,NA,"0.1.4"
"23058","646",2023-04-29 04:15:00,965,1006,41,0,FALSE,NA,"0.1.4"
"23059","646",2023-04-29 04:30:00,965,1006,41,0,FALSE,NA,"0.1.4"
"23060","646",2023-04-29 04:45:00,965,1006,41,0,FALSE,NA,"0.1.4"
"23061","646",2023-04-29 05:00:00,965,1006,41,0,FALSE,NA,"0.1.4"
"23062","646",2023-04-29 05:15:00,965,1006,41,0,FALSE,NA,"0.1.4"
"23063","646",2023-04-29 05:30:00,965,1006,41,0,FALSE,NA,"0.1.4"
"23064","646",2023-04-29 05:45:00,965,1006,41,0,FALSE,NA,"0.1.4"
"23065","646",2023-04-29 06:00:00,965,1006,41,0,FALSE,NA,"0.1.4"
"23066","646",2023-04-29 06:15:00,965,1006,41,0,FALSE,NA,"0.1.4"
"23067","646",2023-04-29 06:30:00,965,1006,41,0,FALSE,NA,"0.1.4"
"23068","646",2023-04-29 06:45:00,965,1006,41,0,FALSE,NA,"0.1.4"
"23069","646",2023-04-29 07:00:00,964,1006,42,0,FALSE,NA,"0.1.4"
"23070","646",2023-04-29 07:15:00,965,1006,41,0,FALSE,NA,"0.1.4"
"23071","646",2023-04-29 07:30:00,964,1006,42,0,FALSE,NA,"0.1.4"
"23072","646",2023-04-29 07:45:00,964,1006,42,0,FALSE,NA,"0.1.4"
"23073","646",2023-04-29 08:00:00,964,1006,42,0,FALSE,NA,"0.1.4"
"23074","646",2023-04-29 08:15:00,964,1006,42,0,FALSE,NA,"0.1.4"
"23075","646",2023-04-29 08:30:00,964,1006,42,0,FALSE,NA,"0.1.4"
"23076","646",2023-04-29 08:45:00,964,1006,42,0,FALSE,NA,"0.1.4"
"23077","646",2023-04-29 09:00:00,964,1006,42,0,FALSE,NA,"0.1.4"
"23078","646",2023-04-29 09:15:00,964,1006,42,0,FALSE,NA,"0.1.4"
"23079","646",2023-04-29 09:30:00,965,1006,41,0,FALSE,NA,"0.1.4"
"23080","646",2023-04-29 09:45:00,964,1006,42,0,FALSE,NA,"0.1.4"
"23081","646",2023-04-29 10:00:00,964,1006,42,0,FALSE,NA,"0.1.4"
"23082","646",2023-04-29 10:15:00,964,1006,42,0,FALSE,NA,"0.1.4"
"23083","646",2023-04-29 10:30:00,964,1006,42,0,FALSE,NA,"0.1.4"
"23084","646",2023-04-29 10:45:00,964,1006,42,0,FALSE,NA,"0.1.4"
"23085","646",2023-04-29 11:00:00,964,1006,42,0,FALSE,NA,"0.1.4"
"23086","646",2023-04-29 11:15:00,964,1006,42,0,FALSE,NA,"0.1.4"
"23087","646",2023-04-29 11:30:00,964,1006,42,0,FALSE,NA,"0.1.4"
"23088","646",2023-04-29 11:45:00,965,1006,41,0,FALSE,NA,"0.1.4"
"23089","646",2023-04-29 12:00:00,965,1006,41,0,FALSE,NA,"0.1.4"
"23090","646",2023-04-29 12:15:00,965,1006,41,0,FALSE,NA,"0.1.4"
"23091","646",2023-04-29 12:30:00,965,1006,41,0,FALSE,NA,"0.1.4"
"23092","646",2023-04-29 12:45:00,965,1006,41,0,FALSE,NA,"0.1.4"
"23093","646",2023-04-29 13:00:00,965,1006,41,0,FALSE,NA,"0.1.4"
"23094","646",2023-04-29 13:15:00,966,1006,40,0,FALSE,NA,"0.1.4"
"23095","646",2023-04-29 13:30:00,966,1006,40,0,FALSE,NA,"0.1.4"
"23096","646",2023-04-29 13:45:00,965,1006,41,0,FALSE,NA,"0.1.4"
"23097","646",2023-04-29 14:00:00,965,1006,41,0,FALSE,NA,"0.1.4"
"23098","646",2023-04-29 14:15:00,965,1006,41,0,FALSE,NA,"0.1.4"
"23099","646",2023-04-29 14:30:00,965,1006,41,0,FALSE,NA,"0.1.4"
"23100","646",2023-04-29 14:45:00,965,1006,41,0,FALSE,NA,"0.1.4"
"23101","646",2023-04-29 15:00:00,965,1006,41,0,FALSE,NA,"0.1.4"
"23102","646",2023-04-29 15:15:00,965,1006,41,0,FALSE,NA,"0.1.4"
"23103","646",2023-04-29 15:30:00,965,1006,41,0,FALSE,NA,"0.1.4"
"23104","646",2023-04-29 15:45:00,965,1006,41,0,FALSE,NA,"0.1.4"
"23105","646",2023-04-29 16:00:00,965,1006,41,0,FALSE,NA,"0.1.4"
"23106","646",2023-04-29 16:15:00,965,1006,41,0,FALSE,NA,"0.1.4"
"23107","646",2023-04-29 16:30:00,965,1006,41,0,FALSE,NA,"0.1.4"
"23108","646",2023-04-29 16:45:00,965,1006,41,0,FALSE,NA,"0.1.4"
"23109","646",2023-04-29 17:00:00,965,1006,41,0,FALSE,NA,"0.1.4"
"23110","646",2023-04-29 17:15:00,965,1006,41,0,FALSE,NA,"0.1.4"
"23111","646",2023-04-29 17:30:00,965,1006,41,0,FALSE,NA,"0.1.4"
"23112","646",2023-04-29 17:45:00,965,1006,41,0,FALSE,NA,"0.1.4"
"23113","646",2023-04-29 18:00:00,965,1006,41,0,FALSE,NA,"0.1.4"
"23114","646",2023-04-29 18:15:00,965,1006,41,0,FALSE,NA,"0.1.4"
"23115","646",2023-04-29 18:30:00,965,1006,41,0,FALSE,NA,"0.1.4"
"23116","646",2023-04-29 18:45:00,965,1006,41,0,FALSE,NA,"0.1.4"
"23117","646",2023-04-29 19:00:00,965,1006,41,0,FALSE,NA,"0.1.4"
"23118","646",2023-04-29 19:15:00,965,1006,41,0,FALSE,NA,"0.1.4"
"23119","646",2023-04-29 19:30:00,965,1006,41,0,FALSE,NA,"0.1.4"
"23120","646",2023-04-29 19:45:00,965,1006,41,0,FALSE,NA,"0.1.4"
"23121","646",2023-04-29 20:00:00,965,1006,41,0,FALSE,NA,"0.1.4"
"23122","646",2023-04-29 20:15:00,965,1006,41,0,FALSE,NA,"0.1.4"
"23123","646",2023-04-29 20:30:00,965,1006,41,0,FALSE,NA,"0.1.4"
"23124","646",2023-04-29 20:45:00,965,1006,41,0,FALSE,NA,"0.1.4"
"23125","646",2023-04-29 21:00:00,965,1006,41,0,FALSE,NA,"0.1.4"
"23126","646",2023-04-29 21:15:00,965,1006,41,0,FALSE,NA,"0.1.4"
"23127","646",2023-04-29 21:30:00,965,1006,41,0,FALSE,NA,"0.1.4"
"23128","646",2023-04-29 21:45:00,965,1006,41,0,FALSE,NA,"0.1.4"
"23129","646",2023-04-29 22:00:00,965,1006,41,0,FALSE,NA,"0.1.4"
"23130","646",2023-04-29 22:15:00,965,1006,41,0,FALSE,NA,"0.1.4"
"23131","646",2023-04-29 22:30:00,965,1006,41,0,FALSE,NA,"0.1.4"
"23132","646",2023-04-29 22:45:00,965,1006,41,0,FALSE,NA,"0.1.4"
"23133","646",2023-04-29 23:00:00,965,1006,41,0,FALSE,NA,"0.1.4"
"23134","646",2023-04-29 23:15:00,965,1006,41,0,FALSE,NA,"0.1.4"
"23135","646",2023-04-29 23:30:00,965,1006,41,0,FALSE,NA,"0.1.4"
"23136","646",2023-04-29 23:45:00,966,1006,40,0,FALSE,NA,"0.1.4"
"23137","646",2023-04-30,965,1006,41,0,FALSE,NA,"0.1.4"
"23138","646",2023-04-30 00:15:00,966,1006,40,0,FALSE,NA,"0.1.4"
"23139","646",2023-04-30 00:30:00,964,1006,42,0,FALSE,NA,"0.1.4"
"23140","646",2023-04-30 00:45:00,964,1006,42,0,FALSE,NA,"0.1.4"
"23141","646",2023-04-30 01:00:00,963,1006,43,0,FALSE,NA,"0.1.4"
"23142","646",2023-04-30 01:15:00,965,1006,41,0,FALSE,NA,"0.1.4"
"23143","646",2023-04-30 01:30:00,964,1006,42,0,FALSE,NA,"0.1.4"
"23144","646",2023-04-30 01:45:00,965,1006,41,0,FALSE,NA,"0.1.4"
"23145","646",2023-04-30 02:00:00,963,1006,43,0,FALSE,NA,"0.1.4"
"23146","646",2023-04-30 02:15:00,964,1006,42,0,FALSE,NA,"0.1.4"
"23147","646",2023-04-30 02:30:00,963,1006,43,0,FALSE,NA,"0.1.4"
"23148","646",2023-04-30 02:45:00,963,1006,43,0,FALSE,NA,"0.1.4"
"23149","646",2023-04-30 03:00:00,963,1006,43,0,FALSE,NA,"0.1.4"
"23150","646",2023-04-30 03:15:00,963,1006,43,0,FALSE,NA,"0.1.4"
"23151","646",2023-04-30 03:30:00,963,1006,43,0,FALSE,NA,"0.1.4"
"23152","646",2023-04-30 03:45:00,963,1006,43,0,FALSE,NA,"0.1.4"
"23153","646",2023-04-30 04:00:00,963,1006,43,0,FALSE,NA,"0.1.4"
"23154","646",2023-04-30 04:15:00,963,1006,43,0,FALSE,NA,"0.1.4"
"23155","646",2023-04-30 04:30:00,963,1006,43,0,FALSE,NA,"0.1.4"
"23156","646",2023-04-30 04:45:00,963,1006,43,0,FALSE,NA,"0.1.4"
"23157","646",2023-04-30 05:00:00,963,1006,43,0,FALSE,NA,"0.1.4"
"23158","646",2023-04-30 05:15:00,963,1006,43,0,FALSE,NA,"0.1.4"
"23159","646",2023-04-30 05:30:00,963,1006,43,0,FALSE,NA,"0.1.4"
"23160","646",2023-04-30 05:45:00,963,1006,43,0,FALSE,NA,"0.1.4"
"23161","646",2023-04-30 06:00:00,963,1006,43,0,FALSE,NA,"0.1.4"
"23162","646",2023-04-30 06:15:00,963,1006,43,0,FALSE,NA,"0.1.4"
"23163","646",2023-04-30 06:30:00,963,1006,43,0,FALSE,NA,"0.1.4"
"23164","646",2023-04-30 06:45:00,963,1006,43,0,FALSE,NA,"0.1.4"
"23165","646",2023-04-30 07:00:00,963,1006,43,0,FALSE,NA,"0.1.4"
"23166","646",2023-04-30 07:15:00,963,1006,43,0,FALSE,NA,"0.1.4"
"23167","646",2023-04-30 07:30:00,963,1006,43,0,FALSE,NA,"0.1.4"
"23168","646",2023-04-30 07:45:00,963,1006,43,0,FALSE,NA,"0.1.4"
"23169","646",2023-04-30 08:00:00,963,1006,43,0,FALSE,NA,"0.1.4"
"23170","646",2023-04-30 08:15:00,963,1006,43,0,FALSE,NA,"0.1.4"
"23171","646",2023-04-30 08:30:00,963,1006,43,0,FALSE,NA,"0.1.4"
"23172","646",2023-04-30 08:45:00,963,1006,43,0,FALSE,NA,"0.1.4"
"23173","646",2023-04-30 09:00:00,963,1006,43,0,FALSE,NA,"0.1.4"
"23174","646",2023-04-30 09:15:00,963,1006,43,0,FALSE,NA,"0.1.4"
"23175","646",2023-04-30 09:30:00,963,1006,43,0,FALSE,NA,"0.1.4"
"23176","646",2023-04-30 09:45:00,963,1006,43,0,FALSE,NA,"0.1.4"
"23177","646",2023-04-30 10:00:00,963,1006,43,0,FALSE,NA,"0.1.4"
"23178","646",2023-04-30 10:15:00,963,1006,43,0,FALSE,NA,"0.1.4"
"23179","646",2023-04-30 10:30:00,963,1006,43,0,FALSE,NA,"0.1.4"
"23180","646",2023-04-30 10:45:00,963,1006,43,0,FALSE,NA,"0.1.4"
"23181","646",2023-04-30 11:00:00,963,1006,43,0,FALSE,NA,"0.1.4"
"23182","646",2023-04-30 11:15:00,963,1006,43,0,FALSE,NA,"0.1.4"
"23183","646",2023-04-30 11:30:00,963,1006,43,0,FALSE,NA,"0.1.4"
"23184","646",2023-04-30 11:45:00,963,1006,43,0,FALSE,NA,"0.1.4"
"23185","646",2023-04-30 12:00:00,963,1006,43,0,FALSE,NA,"0.1.4"
"23186","646",2023-04-30 12:15:00,963,1006,43,0,FALSE,NA,"0.1.4"
"23187","646",2023-04-30 12:30:00,963,1006,43,0,FALSE,NA,"0.1.4"
"23188","646",2023-04-30 12:45:00,963,1006,43,0,FALSE,NA,"0.1.4"
"23189","646",2023-04-30 13:00:00,963,1006,43,0,FALSE,NA,"0.1.4"
"23190","646",2023-04-30 13:15:00,963,1006,43,0,FALSE,NA,"0.1.4"
"23191","646",2023-04-30 13:30:00,963,1006,43,0,FALSE,NA,"0.1.4"
"23192","646",2023-04-30 13:45:00,964,1006,42,0,FALSE,NA,"0.1.4"
"23193","646",2023-04-30 14:00:00,963,1006,43,0,FALSE,NA,"0.1.4"
"23194","646",2023-04-30 14:15:00,963,1006,43,0,FALSE,NA,"0.1.4"
"23195","646",2023-04-30 14:30:00,963,1006,43,0,FALSE,NA,"0.1.4"
"23196","646",2023-04-30 14:45:00,963,1006,43,0,FALSE,NA,"0.1.4"
"23197","646",2023-04-30 15:00:00,963,1006,43,0,FALSE,NA,"0.1.4"
"23198","646",2023-04-30 15:15:00,963,1006,43,0,FALSE,NA,"0.1.4"
"23199","646",2023-04-30 15:30:00,964,1006,42,0,FALSE,NA,"0.1.4"
"23200","646",2023-04-30 15:45:00,964,1006,42,0,FALSE,NA,"0.1.4"
"23201","646",2023-04-30 16:00:00,964,1006,42,0,FALSE,NA,"0.1.4"
"23202","646",2023-04-30 16:15:00,964,1006,42,0,FALSE,NA,"0.1.4"
"23203","646",2023-04-30 16:30:00,964,1006,42,0,FALSE,NA,"0.1.4"
"23204","646",2023-04-30 16:45:00,964,1006,42,0,FALSE,NA,"0.1.4"
"23205","646",2023-04-30 17:00:00,964,1006,42,0,FALSE,NA,"0.1.4"
"23206","646",2023-04-30 17:15:00,964,1006,42,0,FALSE,NA,"0.1.4"
"23207","646",2023-04-30 17:30:00,963,1006,43,0,FALSE,NA,"0.1.4"
"23208","646",2023-04-30 17:45:00,963,1006,43,0,FALSE,NA,"0.1.4"
"23209","646",2023-04-30 18:00:00,964,1006,42,0,FALSE,NA,"0.1.4"
"23210","646",2023-04-30 18:15:00,963,1006,43,0,FALSE,NA,"0.1.4"
"23211","646",2023-04-30 18:30:00,963,1006,43,0,FALSE,NA,"0.1.4"
"23212","646",2023-04-30 18:45:00,963,1006,43,0,FALSE,NA,"0.1.4"
"23213","646",2023-04-30 19:00:00,963,1006,43,0,FALSE,NA,"0.1.4"
"23214","646",2023-04-30 19:15:00,963,1006,43,0,FALSE,NA,"0.1.4"
"23215","646",2023-04-30 19:30:00,963,1006,43,0,FALSE,NA,"0.1.4"
"23216","646",2023-04-30 19:45:00,963,1006,43,0,FALSE,NA,"0.1.4"
"23217","646",2023-04-30 20:00:00,963,1006,43,0,FALSE,NA,"0.1.4"
"23218","646",2023-04-30 20:15:00,963,1006,43,0,FALSE,NA,"0.1.4"
"23219","646",2023-04-30 20:30:00,963,1006,43,0,FALSE,NA,"0.1.4"
"23220","646",2023-04-30 20:45:00,963,1006,43,0,FALSE,NA,"0.1.4"
"23221","646",2023-04-30 21:00:00,963,1006,43,0,FALSE,NA,"0.1.4"
"23222","646",2023-04-30 21:15:00,963,1006,43,0,FALSE,NA,"0.1.4"
"23223","646",2023-04-30 21:30:00,963,1006,43,0,FALSE,NA,"0.1.4"
"23224","646",2023-04-30 21:45:00,962,1006,44,0,FALSE,NA,"0.1.4"
"23225","646",2023-04-30 22:00:00,962,1006,44,0,FALSE,NA,"0.1.4"
"23226","646",2023-04-30 22:15:00,962,1006,44,0,FALSE,NA,"0.1.4"
"23227","646",2023-04-30 22:30:00,962,1006,44,0,FALSE,NA,"0.1.4"
"23228","646",2023-04-30 22:45:00,962,1006,44,0,FALSE,NA,"0.1.4"
"23229","646",2023-04-30 23:00:00,962,1006,44,0,FALSE,NA,"0.1.4"
"23230","646",2023-04-30 23:15:00,963,1006,43,0,FALSE,NA,"0.1.4"
"23231","646",2023-04-30 23:30:00,962,1006,44,0,FALSE,NA,"0.1.4"
"23232","646",2023-04-30 23:45:00,962,1006,44,0,FALSE,NA,"0.1.4"
"23233","646",2023-05-01,963,1006,43,0,FALSE,NA,"0.1.4"
"23234","646",2023-05-01 00:15:00,963,1006,43,0,FALSE,NA,"0.1.4"
"23235","646",2023-05-01 00:30:00,963,1006,43,0,FALSE,NA,"0.1.4"
"23236","646",2023-05-01 00:45:00,962,1006,44,0,FALSE,NA,"0.1.4"
"23237","646",2023-05-01 01:00:00,962,1006,44,0,FALSE,NA,"0.1.4"
"23238","646",2023-05-01 01:15:00,962,1006,44,0,FALSE,NA,"0.1.4"
"23239","646",2023-05-01 01:30:00,962,1006,44,0,FALSE,NA,"0.1.4"
"23240","646",2023-05-01 01:45:00,962,1006,44,0,FALSE,NA,"0.1.4"
"23241","646",2023-05-01 02:00:00,962,1006,44,0,FALSE,NA,"0.1.4"
"23242","646",2023-05-01 02:15:00,962,1006,44,0,FALSE,NA,"0.1.4"
"23243","646",2023-05-01 02:30:00,962,1006,44,0,FALSE,NA,"0.1.4"
"23244","646",2023-05-01 02:45:00,962,1006,44,0,FALSE,NA,"0.1.4"
"23245","646",2023-05-01 03:00:00,962,1006,44,0,FALSE,NA,"0.1.4"
"23246","646",2023-05-01 03:15:00,962,1006,44,0,FALSE,NA,"0.1.4"
"23247","646",2023-05-01 03:30:00,962,1006,44,0,FALSE,NA,"0.1.4"
"23248","646",2023-05-01 03:45:00,962,1006,44,0,FALSE,NA,"0.1.4"
"23249","646",2023-05-01 04:00:00,962,1006,44,0,FALSE,NA,"0.1.4"
"23250","646",2023-05-01 04:15:00,962,1006,44,0,FALSE,NA,"0.1.4"
"23251","646",2023-05-01 04:30:00,962,1006,44,0,FALSE,NA,"0.1.4"
"23252","646",2023-05-01 04:45:00,962,1006,44,0,FALSE,NA,"0.1.4"
"23253","646",2023-05-01 05:00:00,963,1006,43,0,FALSE,NA,"0.1.4"
"23254","646",2023-05-01 05:15:00,962,1006,44,0,FALSE,NA,"0.1.4"
"23255","646",2023-05-01 05:30:00,962,1006,44,0,FALSE,NA,"0.1.4"
"23256","646",2023-05-01 05:45:00,962,1006,44,0,FALSE,NA,"0.1.4"
"23257","646",2023-05-01 06:00:00,962,1006,44,0,FALSE,NA,"0.1.4"
"23258","646",2023-05-01 06:15:00,963,1006,43,0,FALSE,NA,"0.1.4"
"23259","646",2023-05-01 06:30:00,963,1006,43,0,FALSE,NA,"0.1.4"
"23260","646",2023-05-01 06:45:00,963,1006,43,0,FALSE,NA,"0.1.4"
"23261","646",2023-05-01 07:00:00,963,1006,43,0,FALSE,NA,"0.1.4"
"23262","646",2023-05-01 07:15:00,963,1006,43,0,FALSE,NA,"0.1.4"
"23263","646",2023-05-01 07:30:00,963,1006,43,0,FALSE,NA,"0.1.4"
"23264","646",2023-05-01 07:45:00,963,1006,43,0,FALSE,NA,"0.1.4"
"23265","646",2023-05-01 08:00:00,963,1006,43,0,FALSE,NA,"0.1.4"
"23266","646",2023-05-01 08:15:00,963,1006,43,0,FALSE,NA,"0.1.4"
"23267","646",2023-05-01 08:30:00,963,1006,43,0,FALSE,NA,"0.1.4"
"23268","646",2023-05-01 08:45:00,963,1006,43,0,FALSE,NA,"0.1.4"
"23269","646",2023-05-01 09:00:00,963,1006,43,0,FALSE,NA,"0.1.4"
"23270","646",2023-05-01 09:15:00,963,1006,43,0,FALSE,NA,"0.1.4"
"23271","646",2023-05-01 09:30:00,963,1006,43,0,FALSE,NA,"0.1.4"
"23272","646",2023-05-01 09:45:00,963,1006,43,0,FALSE,NA,"0.1.4"
"23273","646",2023-05-01 10:00:00,963,1006,43,0,FALSE,NA,"0.1.4"
"23274","646",2023-05-01 10:15:00,963,1006,43,0,FALSE,NA,"0.1.4"
"23275","646",2023-05-01 10:30:00,963,1006,43,0,FALSE,NA,"0.1.4"
"23276","646",2023-05-01 10:45:00,963,1006,43,0,FALSE,NA,"0.1.4"
"23277","646",2023-05-01 11:00:00,963,1006,43,0,FALSE,NA,"0.1.4"
"23278","646",2023-05-01 11:15:00,963,1006,43,0,FALSE,NA,"0.1.4"
"23279","646",2023-05-01 11:30:00,963,1006,43,0,FALSE,NA,"0.1.4"
"23280","646",2023-05-01 11:45:00,963,1006,43,0,FALSE,NA,"0.1.4"
"23281","646",2023-05-01 12:00:00,963,1006,43,0,FALSE,NA,"0.1.4"
"23282","646",2023-05-01 12:15:00,963,1006,43,0,FALSE,NA,"0.1.4"
"23283","646",2023-05-01 12:30:00,963,1006,43,0,FALSE,NA,"0.1.4"
"23284","646",2023-05-01 12:45:00,963,1006,43,0,FALSE,NA,"0.1.4"
"23285","646",2023-05-01 13:00:00,963,1006,43,0,FALSE,NA,"0.1.4"
"23286","646",2023-05-01 13:15:00,963,1006,43,0,FALSE,NA,"0.1.4"
"23287","646",2023-05-01 13:30:00,963,1006,43,0,FALSE,NA,"0.1.4"
"23288","646",2023-05-01 13:45:00,963,1006,43,0,FALSE,NA,"0.1.4"
"23289","646",2023-05-01 14:00:00,963,1006,43,0,FALSE,NA,"0.1.4"
"23290","646",2023-05-01 14:15:00,963,1006,43,0,FALSE,NA,"0.1.4"
"23291","646",2023-05-01 14:30:00,963,1006,43,0,FALSE,NA,"0.1.4"
"23292","646",2023-05-01 14:45:00,963,1006,43,0,FALSE,NA,"0.1.4"
"23293","646",2023-05-01 15:00:00,963,1006,43,0,FALSE,NA,"0.1.4"
"23294","646",2023-05-01 15:15:00,963,1006,43,0,FALSE,NA,"0.1.4"
"23295","646",2023-05-01 15:30:00,963,1006,43,0,FALSE,NA,"0.1.4"
"23296","646",2023-05-01 15:45:00,963,1006,43,0,FALSE,NA,"0.1.4"
"23297","646",2023-05-01 16:00:00,963,1006,43,0,FALSE,NA,"0.1.4"
"23298","646",2023-05-01 16:15:00,963,1006,43,0,FALSE,NA,"0.1.4"
"23299","646",2023-05-01 16:30:00,963,1006,43,0,FALSE,NA,"0.1.4"
"23300","646",2023-05-01 16:45:00,963,1006,43,0,FALSE,NA,"0.1.4"
"23301","646",2023-05-01 17:00:00,963,1006,43,0,FALSE,NA,"0.1.4"
"23302","646",2023-05-01 17:15:00,963,1006,43,0,FALSE,NA,"0.1.4"
"23303","646",2023-05-01 17:30:00,963,1006,43,0,FALSE,NA,"0.1.4"
"23304","646",2023-05-01 17:45:00,963,1006,43,0,FALSE,NA,"0.1.4"
"23305","646",2023-05-01 18:00:00,963,1006,43,0,FALSE,NA,"0.1.4"
"23306","646",2023-05-01 18:15:00,963,1006,43,0,FALSE,NA,"0.1.4"
"23307","646",2023-05-01 18:30:00,963,1006,43,0,FALSE,NA,"0.1.4"
"23308","646",2023-05-01 18:45:00,963,1006,43,0,FALSE,NA,"0.1.4"
"23309","646",2023-05-01 19:00:00,963,1006,43,0,FALSE,NA,"0.1.4"
"23310","646",2023-05-01 19:15:00,963,1006,43,0,FALSE,NA,"0.1.4"
"23311","646",2023-05-01 19:30:00,963,1006,43,0,FALSE,NA,"0.1.4"
"23312","646",2023-05-01 19:45:00,963,1006,43,0,FALSE,NA,"0.1.4"
"23313","646",2023-05-01 20:00:00,963,1006,43,0,FALSE,NA,"0.1.4"
"23314","646",2023-05-01 20:15:00,963,1006,43,0,FALSE,NA,"0.1.4"
"23315","646",2023-05-01 20:30:00,963,1006,43,0,FALSE,NA,"0.1.4"
"23316","646",2023-05-01 20:45:00,963,1006,43,0,FALSE,NA,"0.1.4"
"23317","646",2023-05-01 21:00:00,962,1006,44,0,FALSE,NA,"0.1.4"
"23318","646",2023-05-01 21:15:00,962,1006,44,0,FALSE,NA,"0.1.4"
"23319","646",2023-05-01 21:30:00,962,1006,44,0,FALSE,NA,"0.1.4"
"23320","646",2023-05-01 21:45:00,963,1006,43,0,FALSE,NA,"0.1.4"
"23321","646",2023-05-01 22:00:00,962,1006,44,0,FALSE,NA,"0.1.4"
"23322","646",2023-05-01 22:15:00,962,1006,44,0,FALSE,NA,"0.1.4"
"23323","646",2023-05-01 22:30:00,962,1006,44,0,FALSE,NA,"0.1.4"
"23324","646",2023-05-01 22:45:00,962,1006,44,0,FALSE,NA,"0.1.4"
"23325","646",2023-05-01 23:00:00,963,1006,43,0,FALSE,NA,"0.1.4"
"23326","646",2023-05-01 23:15:00,964,1006,42,0,FALSE,NA,"0.1.4"
"23327","646",2023-05-01 23:30:00,963,1006,43,0,FALSE,NA,"0.1.4"
"23328","646",2023-05-01 23:45:00,963,1006,43,0,FALSE,NA,"0.1.4"
"23329","646",2023-05-02,963,1006,43,0,FALSE,NA,"0.1.4"
"23330","646",2023-05-02 00:15:00,963,1006,43,0,FALSE,NA,"0.1.4"
"23331","646",2023-05-02 00:30:00,964,1006,42,0,FALSE,NA,"0.1.4"
"23332","646",2023-05-02 00:45:00,964,1006,42,0,FALSE,NA,"0.1.4"
"23333","646",2023-05-02 01:00:00,964,1006,42,0,FALSE,NA,"0.1.4"
"23334","646",2023-05-02 01:15:00,964,1006,42,0,FALSE,NA,"0.1.4"
"23335","646",2023-05-02 01:30:00,964,1006,42,0,FALSE,NA,"0.1.4"
"23336","646",2023-05-02 01:45:00,964,1006,42,0,FALSE,NA,"0.1.4"
"23337","646",2023-05-02 02:00:00,965,1006,41,0,FALSE,NA,"0.1.4"
"23338","646",2023-05-02 02:15:00,964,1006,42,0,FALSE,NA,"0.1.4"
"23339","646",2023-05-02 02:30:00,965,1006,41,0,FALSE,NA,"0.1.4"
"23340","646",2023-05-02 02:45:00,965,1006,41,0,FALSE,NA,"0.1.4"
"23341","646",2023-05-02 03:00:00,965,1006,41,0,FALSE,NA,"0.1.4"
"23342","646",2023-05-02 03:15:00,965,1006,41,0,FALSE,NA,"0.1.4"
"23343","646",2023-05-02 03:30:00,964,1006,42,0,FALSE,NA,"0.1.4"
"23344","646",2023-05-02 03:45:00,964,1006,42,0,FALSE,NA,"0.1.4"
"23345","646",2023-05-02 04:00:00,964,1006,42,0,FALSE,NA,"0.1.4"
"23346","646",2023-05-02 04:15:00,964,1006,42,0,FALSE,NA,"0.1.4"
"23347","646",2023-05-02 04:30:00,964,1006,42,0,FALSE,NA,"0.1.4"
"23348","646",2023-05-02 04:45:00,965,1006,41,0,FALSE,NA,"0.1.4"
"23349","646",2023-05-02 05:00:00,965,1006,41,0,FALSE,NA,"0.1.4"
"23350","646",2023-05-02 05:15:00,965,1006,41,0,FALSE,NA,"0.1.4"
"23351","646",2023-05-02 05:30:00,965,1006,41,0,FALSE,NA,"0.1.4"
"23352","646",2023-05-02 05:45:00,965,1006,41,0,FALSE,NA,"0.1.4"
"23353","646",2023-05-02 06:00:00,965,1006,41,0,FALSE,NA,"0.1.4"
"23354","646",2023-05-02 06:15:00,965,1006,41,0,FALSE,NA,"0.1.4"
"23355","646",2023-05-02 06:30:00,965,1006,41,0,FALSE,NA,"0.1.4"
"23356","646",2023-05-02 06:45:00,966,1006,40,0,FALSE,NA,"0.1.4"
"23357","646",2023-05-02 07:00:00,966,1006,40,0,FALSE,NA,"0.1.4"
"23358","646",2023-05-02 07:15:00,965,1006,41,0,FALSE,NA,"0.1.4"
"23359","646",2023-05-02 07:30:00,966,1006,40,0,FALSE,NA,"0.1.4"
"23360","646",2023-05-02 07:45:00,965,1006,41,0,FALSE,NA,"0.1.4"
"23361","646",2023-05-02 08:00:00,965,1006,41,0,FALSE,NA,"0.1.4"
"23362","646",2023-05-02 08:15:00,965,1006,41,0,FALSE,NA,"0.1.4"
"23363","646",2023-05-02 08:30:00,965,1006,41,0,FALSE,NA,"0.1.4"
"23364","646",2023-05-02 08:45:00,964,1006,42,0,FALSE,NA,"0.1.4"
"23365","646",2023-05-02 09:00:00,965,1006,41,0,FALSE,NA,"0.1.4"
"23366","646",2023-05-02 09:15:00,965,1006,41,0,FALSE,NA,"0.1.4"
"23367","646",2023-05-02 09:30:00,965,1006,41,0,FALSE,NA,"0.1.4"
"23368","646",2023-05-02 09:45:00,965,1006,41,0,FALSE,NA,"0.1.4"
"23369","646",2023-05-02 10:00:00,965,1006,41,0,FALSE,NA,"0.1.4"
"23370","646",2023-05-02 10:15:00,965,1006,41,0,FALSE,NA,"0.1.4"
"23371","646",2023-05-02 10:30:00,965,1006,41,0,FALSE,NA,"0.1.4"
"23372","646",2023-05-02 10:45:00,965,1006,41,0,FALSE,NA,"0.1.4"
"23373","646",2023-05-02 11:00:00,965,1006,41,0,FALSE,NA,"0.1.4"
"23374","646",2023-05-02 11:15:00,964,1006,42,0,FALSE,NA,"0.1.4"
"23375","646",2023-05-02 11:30:00,965,1006,41,0,FALSE,NA,"0.1.4"
"23376","646",2023-05-02 11:45:00,965,1006,41,0,FALSE,NA,"0.1.4"
"23377","646",2023-05-02 12:00:00,965,1006,41,0,FALSE,NA,"0.1.4"
"23378","646",2023-05-02 12:15:00,965,1006,41,0,FALSE,NA,"0.1.4"
"23379","646",2023-05-02 12:30:00,965,1006,41,0,FALSE,NA,"0.1.4"
"23380","646",2023-05-02 12:45:00,965,1006,41,0,FALSE,NA,"0.1.4"
"23381","646",2023-05-02 13:00:00,965,1006,41,0,FALSE,NA,"0.1.4"
"23382","646",2023-05-02 13:15:00,965,1006,41,0,FALSE,NA,"0.1.4"
"23383","646",2023-05-02 13:30:00,965,1006,41,0,FALSE,NA,"0.1.4"
"23384","646",2023-05-02 13:45:00,965,1006,41,0,FALSE,NA,"0.1.4"
"23385","646",2023-05-02 14:00:00,965,1006,41,0,FALSE,NA,"0.1.4"
"23386","646",2023-05-02 14:15:00,965,1006,41,0,FALSE,NA,"0.1.4"
"23387","646",2023-05-02 14:30:00,965,1006,41,0,FALSE,NA,"0.1.4"
"23388","646",2023-05-02 14:45:00,965,1006,41,0,FALSE,NA,"0.1.4"
"23389","646",2023-05-02 15:00:00,965,1006,41,0,FALSE,NA,"0.1.4"
"23390","646",2023-05-02 15:15:00,965,1006,41,0,FALSE,NA,"0.1.4"
"23391","646",2023-05-02 15:30:00,965,1006,41,0,FALSE,NA,"0.1.4"
"23392","646",2023-05-02 15:45:00,965,1006,41,0,FALSE,NA,"0.1.4"
"23393","646",2023-05-02 16:00:00,965,1006,41,0,FALSE,NA,"0.1.4"
"23394","646",2023-05-02 16:15:00,965,1006,41,0,FALSE,NA,"0.1.4"
"23395","646",2023-05-02 16:30:00,965,1006,41,0,FALSE,NA,"0.1.4"
"23396","646",2023-05-02 16:45:00,965,1006,41,0,FALSE,NA,"0.1.4"
"23397","646",2023-05-02 17:00:00,965,1006,41,0,FALSE,NA,"0.1.4"
"23398","646",2023-05-02 17:15:00,964,1006,42,0,FALSE,NA,"0.1.4"
"23399","646",2023-05-02 17:30:00,965,1006,41,0,FALSE,NA,"0.1.4"
"23400","646",2023-05-02 17:45:00,965,1006,41,0,FALSE,NA,"0.1.4"
"23401","646",2023-05-02 18:00:00,965,1006,41,0,FALSE,NA,"0.1.4"
"23402","646",2023-05-02 18:15:00,965,1006,41,0,FALSE,NA,"0.1.4"
"23403","646",2023-05-02 18:30:00,965,1006,41,0,FALSE,NA,"0.1.4"
"23404","646",2023-05-02 18:45:00,965,1006,41,0,FALSE,NA,"0.1.4"
"23405","646",2023-05-02 19:00:00,965,1006,41,0,FALSE,NA,"0.1.4"
"23406","646",2023-05-02 19:15:00,965,1006,41,0,FALSE,NA,"0.1.4"
"23407","646",2023-05-02 19:30:00,966,1006,40,0,FALSE,NA,"0.1.4"
"23408","646",2023-05-02 19:45:00,966,1006,40,0,FALSE,NA,"0.1.4"
"23409","646",2023-05-02 20:00:00,966,1006,40,0,FALSE,NA,"0.1.4"
"23410","646",2023-05-02 20:15:00,966,1006,40,0,FALSE,NA,"0.1.4"
"23411","646",2023-05-02 20:30:00,966,1006,40,0,FALSE,NA,"0.1.4"
"23412","646",2023-05-02 20:45:00,966,1006,40,0,FALSE,NA,"0.1.4"
"23413","646",2023-05-02 21:00:00,966,1006,40,0,FALSE,NA,"0.1.4"
"23414","646",2023-05-02 21:15:00,966,1006,40,0,FALSE,NA,"0.1.4"
"23415","646",2023-05-02 21:30:00,966,1006,40,0,FALSE,NA,"0.1.4"
"23416","646",2023-05-02 21:45:00,966,1006,40,0,FALSE,NA,"0.1.4"
"23417","646",2023-05-02 22:00:00,966,1006,40,0,FALSE,NA,"0.1.4"
"23418","646",2023-05-02 22:15:00,966,1006,40,0,FALSE,NA,"0.1.4"
"23419","646",2023-05-02 22:30:00,966,1006,40,0,FALSE,NA,"0.1.4"
"23420","646",2023-05-02 22:45:00,966,1006,40,0,FALSE,NA,"0.1.4"
"23421","646",2023-05-02 23:00:00,966,1006,40,0,FALSE,NA,"0.1.4"
"23422","646",2023-05-02 23:15:00,966,1006,40,0,FALSE,NA,"0.1.4"
"23423","646",2023-05-02 23:30:00,966,1006,40,0,FALSE,NA,"0.1.4"
"23424","646",2023-05-02 23:45:00,966,1006,40,0,FALSE,NA,"0.1.4"
"23425","646",2023-05-03,966,1006,40,0,FALSE,NA,"0.1.4"
"23426","646",2023-05-03 00:15:00,966,1006,40,0,FALSE,NA,"0.1.4"
"23427","646",2023-05-03 00:30:00,966,1006,40,0,FALSE,NA,"0.1.4"
"23428","646",2023-05-03 00:45:00,965,1006,41,0,FALSE,NA,"0.1.4"
"23429","646",2023-05-03 01:00:00,965,1006,41,0,FALSE,NA,"0.1.4"
"23430","646",2023-05-03 01:15:00,965,1006,41,0,FALSE,NA,"0.1.4"
"23431","646",2023-05-03 01:30:00,966,1006,40,0,FALSE,NA,"0.1.4"
"23432","646",2023-05-03 01:45:00,965,1006,41,0,FALSE,NA,"0.1.4"
"23433","646",2023-05-03 02:00:00,965,1006,41,0,FALSE,NA,"0.1.4"
"23434","646",2023-05-03 02:15:00,965,1006,41,0,FALSE,NA,"0.1.4"
"23435","646",2023-05-03 02:30:00,966,1006,40,0,FALSE,NA,"0.1.4"
"23436","646",2023-05-03 02:45:00,966,1006,40,0,FALSE,NA,"0.1.4"
"23437","646",2023-05-03 03:00:00,966,1006,40,0,FALSE,NA,"0.1.4"
"23438","646",2023-05-03 03:15:00,966,1006,40,0,FALSE,NA,"0.1.4"
"23439","646",2023-05-03 03:30:00,966,1006,40,0,FALSE,NA,"0.1.4"
"23440","646",2023-05-03 03:45:00,966,1006,40,0,FALSE,NA,"0.1.4"
"23441","646",2023-05-03 04:00:00,966,1006,40,0,FALSE,NA,"0.1.4"
"23442","646",2023-05-03 04:15:00,965,1006,41,0,FALSE,NA,"0.1.4"
"23443","646",2023-05-03 04:30:00,966,1006,40,0,FALSE,NA,"0.1.4"
"23444","646",2023-05-03 04:45:00,966,1006,40,0,FALSE,NA,"0.1.4"
"23445","646",2023-05-03 05:00:00,966,1006,40,0,FALSE,NA,"0.1.4"
"23446","646",2023-05-03 05:15:00,966,1006,40,0,FALSE,NA,"0.1.4"
"23447","646",2023-05-03 05:30:00,966,1006,40,0,FALSE,NA,"0.1.4"
"23448","646",2023-05-03 05:45:00,966,1006,40,0,FALSE,NA,"0.1.4"
"23449","646",2023-05-03 06:00:00,966,1006,40,0,FALSE,NA,"0.1.4"
"23450","646",2023-05-03 06:15:00,966,1006,40,0,FALSE,NA,"0.1.4"
"23451","646",2023-05-03 06:30:00,966,1006,40,0,FALSE,NA,"0.1.4"
"23452","646",2023-05-03 06:45:00,966,1006,40,0,FALSE,NA,"0.1.4"
"23453","646",2023-05-03 07:00:00,966,1006,40,0,FALSE,NA,"0.1.4"
"23454","646",2023-05-03 07:15:00,965,1006,41,0,FALSE,NA,"0.1.4"
"23455","646",2023-05-03 07:30:00,965,1006,41,0,FALSE,NA,"0.1.4"
"23456","646",2023-05-03 07:45:00,965,1006,41,0,FALSE,NA,"0.1.4"
"23457","646",2023-05-03 08:00:00,963,1006,43,0,FALSE,NA,"0.1.4"
"23458","646",2023-05-03 08:15:00,963,1006,43,0,FALSE,NA,"0.1.4"
"23459","646",2023-05-03 08:30:00,963,1006,43,0,FALSE,NA,"0.1.4"
"23460","646",2023-05-03 08:45:00,963,1006,43,0,FALSE,NA,"0.1.4"
"23461","646",2023-05-03 09:00:00,963,1006,43,0,FALSE,NA,"0.1.4"
"23462","646",2023-05-03 09:15:00,963,1006,43,0,FALSE,NA,"0.1.4"
"23463","646",2023-05-03 09:30:00,963,1006,43,0,FALSE,NA,"0.1.4"
"23464","646",2023-05-03 09:45:00,963,1006,43,0,FALSE,NA,"0.1.4"
"23465","646",2023-05-03 10:00:00,963,1006,43,0,FALSE,NA,"0.1.4"
"23466","646",2023-05-03 10:15:00,963,1006,43,0,FALSE,NA,"0.1.4"
"23467","646",2023-05-03 10:30:00,963,1006,43,0,FALSE,NA,"0.1.4"
"23468","646",2023-05-03 10:45:00,963,1006,43,0,FALSE,NA,"0.1.4"
"23469","646",2023-05-03 11:00:00,962,1006,44,0,FALSE,NA,"0.1.4"
"23470","646",2023-05-03 11:15:00,963,1006,43,0,FALSE,NA,"0.1.4"
"23471","646",2023-05-03 11:30:00,963,1006,43,0,FALSE,NA,"0.1.4"
"23472","646",2023-05-03 11:45:00,963,1006,43,0,FALSE,NA,"0.1.4"
"23473","646",2023-05-03 12:00:00,962,1006,44,0,FALSE,NA,"0.1.4"
"23474","646",2023-05-03 12:15:00,962,1006,44,0,FALSE,NA,"0.1.4"
"23475","646",2023-05-03 12:30:00,962,1006,44,0,FALSE,NA,"0.1.4"
"23476","646",2023-05-03 12:45:00,962,1006,44,0,FALSE,NA,"0.1.4"
"23477","646",2023-05-03 13:00:00,962,1006,44,0,FALSE,NA,"0.1.4"
"23478","646",2023-05-03 13:15:00,962,1006,44,0,FALSE,NA,"0.1.4"
"23479","646",2023-05-03 13:30:00,962,1006,44,0,FALSE,NA,"0.1.4"
"23480","646",2023-05-03 13:45:00,962,1006,44,0,FALSE,NA,"0.1.4"
"23481","646",2023-05-03 14:00:00,962,1006,44,0,FALSE,NA,"0.1.4"
"23482","646",2023-05-03 14:15:00,962,1006,44,0,FALSE,NA,"0.1.4"
"23483","646",2023-05-03 14:30:00,962,1006,44,0,FALSE,NA,"0.1.4"
"23484","646",2023-05-03 14:45:00,962,1006,44,0,FALSE,NA,"0.1.4"
"23485","646",2023-05-03 15:00:00,962,1006,44,0,FALSE,NA,"0.1.4"
"23486","646",2023-05-03 15:15:00,962,1006,44,0,FALSE,NA,"0.1.4"
"23487","646",2023-05-03 15:30:00,962,1006,44,0,FALSE,NA,"0.1.4"
"23488","646",2023-05-03 15:45:00,962,1006,44,0,FALSE,NA,"0.1.4"
"23489","646",2023-05-03 16:00:00,962,1006,44,0,FALSE,NA,"0.1.4"
"23490","646",2023-05-03 16:15:00,963,1006,43,0,FALSE,NA,"0.1.4"
"23491","646",2023-05-03 16:30:00,963,1006,43,0,FALSE,NA,"0.1.4"
"23492","646",2023-05-03 16:45:00,963,1006,43,0,FALSE,NA,"0.1.4"
"23493","646",2023-05-03 17:00:00,963,1006,43,0,FALSE,NA,"0.1.4"
"23494","646",2023-05-03 17:15:00,963,1006,43,0,FALSE,NA,"0.1.4"
"23495","646",2023-05-03 17:30:00,963,1006,43,0,FALSE,NA,"0.1.4"
"23496","646",2023-05-03 17:45:00,963,1006,43,0,FALSE,NA,"0.1.4"
"23497","646",2023-05-03 18:00:00,963,1006,43,0,FALSE,NA,"0.1.4"
"23498","646",2023-05-03 18:15:00,963,1006,43,0,FALSE,NA,"0.1.4"
"23499","646",2023-05-03 18:30:00,963,1006,43,0,FALSE,NA,"0.1.4"
"23500","646",2023-05-03 18:45:00,963,1006,43,0,FALSE,NA,"0.1.4"
"23501","646",2023-05-03 19:00:00,963,1006,43,0,FALSE,NA,"0.1.4"
"23502","646",2023-05-03 19:15:00,963,1006,43,0,FALSE,NA,"0.1.4"
"23503","646",2023-05-03 19:30:00,963,1006,43,0,FALSE,NA,"0.1.4"
"23504","646",2023-05-03 19:45:00,963,1006,43,0,FALSE,NA,"0.1.4"
"23505","646",2023-05-03 20:00:00,963,1006,43,0,FALSE,NA,"0.1.4"
"23506","646",2023-05-03 20:15:00,963,1006,43,0,FALSE,NA,"0.1.4"
"23507","646",2023-05-03 20:30:00,963,1006,43,0,FALSE,NA,"0.1.4"
"23508","646",2023-05-03 20:45:00,963,1006,43,0,FALSE,NA,"0.1.4"
"23509","646",2023-05-03 21:00:00,963,1006,43,0,FALSE,NA,"0.1.4"
"23510","646",2023-05-03 21:15:00,963,1006,43,0,FALSE,NA,"0.1.4"
"23511","646",2023-05-03 21:30:00,961,1006,45,0,FALSE,NA,"0.1.4"
"23512","646",2023-05-03 21:45:00,961,1006,45,0,FALSE,NA,"0.1.4"
"23513","646",2023-05-03 22:00:00,961,1006,45,0,FALSE,NA,"0.1.4"
"23514","646",2023-05-03 22:15:00,961,1006,45,0,FALSE,NA,"0.1.4"
"23515","646",2023-05-03 22:30:00,961,1006,45,0,FALSE,NA,"0.1.4"
"23516","646",2023-05-03 22:45:00,961,1006,45,0,FALSE,NA,"0.1.4"
"23517","646",2023-05-03 23:00:00,961,1006,45,0,FALSE,NA,"0.1.4"
"23518","646",2023-05-03 23:15:00,961,1006,45,0,FALSE,NA,"0.1.4"
"23519","646",2023-05-03 23:30:00,961,1006,45,0,FALSE,NA,"0.1.4"
"23520","646",2023-05-03 23:45:00,961,1006,45,0,FALSE,NA,"0.1.4"
"23521","646",2023-05-04,961,1006,45,0,FALSE,NA,"0.1.4"
"23522","646",2023-05-04 00:15:00,962,1006,44,0,FALSE,NA,"0.1.4"
"23523","646",2023-05-04 00:30:00,962,1006,44,0,FALSE,NA,"0.1.4"
"23524","646",2023-05-04 00:45:00,962,1006,44,0,FALSE,NA,"0.1.4"
"23525","646",2023-05-04 01:00:00,961,1006,45,0,FALSE,NA,"0.1.4"
"23526","646",2023-05-04 01:15:00,961,1006,45,0,FALSE,NA,"0.1.4"
"23527","646",2023-05-04 01:30:00,961,1006,45,0,FALSE,NA,"0.1.4"
"23528","646",2023-05-04 01:45:00,962,1006,44,0,FALSE,NA,"0.1.4"
"23529","646",2023-05-04 02:00:00,962,1006,44,0,FALSE,NA,"0.1.4"
"23530","646",2023-05-04 02:15:00,962,1006,44,0,FALSE,NA,"0.1.4"
"23531","646",2023-05-04 02:30:00,962,1006,44,0,FALSE,NA,"0.1.4"
"23532","646",2023-05-04 02:45:00,961,1006,45,0,FALSE,NA,"0.1.4"
"23533","646",2023-05-04 03:00:00,961,1006,45,0,FALSE,NA,"0.1.4"
"23534","646",2023-05-04 03:15:00,961,1006,45,0,FALSE,NA,"0.1.4"
"23535","646",2023-05-04 03:30:00,961,1006,45,0,FALSE,NA,"0.1.4"
"23536","646",2023-05-04 03:45:00,961,1006,45,0,FALSE,NA,"0.1.4"
"23537","646",2023-05-04 04:00:00,961,1006,45,0,FALSE,NA,"0.1.4"
"23538","646",2023-05-04 04:15:00,961,1006,45,0,FALSE,NA,"0.1.4"
"23539","646",2023-05-04 04:30:00,961,1006,45,0,FALSE,NA,"0.1.4"
"23540","646",2023-05-04 04:45:00,961,1006,45,0,FALSE,NA,"0.1.4"
"23541","646",2023-05-04 05:00:00,961,1006,45,0,FALSE,NA,"0.1.4"
"23542","646",2023-05-04 05:15:00,961,1006,45,0,FALSE,NA,"0.1.4"
"23543","646",2023-05-04 05:30:00,961,1006,45,0,FALSE,NA,"0.1.4"
"23544","646",2023-05-04 05:45:00,961,1006,45,0,FALSE,NA,"0.1.4"
"23545","646",2023-05-04 06:00:00,961,1006,45,0,FALSE,NA,"0.1.4"
"23546","646",2023-05-04 06:15:00,961,1006,45,0,FALSE,NA,"0.1.4"
"23547","646",2023-05-04 06:30:00,961,1006,45,0,FALSE,NA,"0.1.4"
"23548","646",2023-05-04 06:45:00,961,1006,45,0,FALSE,NA,"0.1.4"
"23549","646",2023-05-04 07:00:00,961,1006,45,0,FALSE,NA,"0.1.4"
"23550","646",2023-05-04 07:15:00,961,1006,45,0,FALSE,NA,"0.1.4"
"23551","646",2023-05-04 07:30:00,961,1006,45,0,FALSE,NA,"0.1.4"
"23552","646",2023-05-04 07:45:00,960,1006,46,0,FALSE,NA,"0.1.4"
"23553","646",2023-05-04 08:00:00,960,1006,46,0,FALSE,NA,"0.1.4"
"23554","646",2023-05-04 08:15:00,960,1006,46,0,FALSE,NA,"0.1.4"
"23555","646",2023-05-04 08:30:00,960,1006,46,0,FALSE,NA,"0.1.4"
"23556","646",2023-05-04 08:45:00,960,1006,46,0,FALSE,NA,"0.1.4"
"23557","646",2023-05-04 09:00:00,960,1006,46,0,FALSE,NA,"0.1.4"
"23558","646",2023-05-04 09:15:00,960,1006,46,0,FALSE,NA,"0.1.4"
"23559","646",2023-05-04 09:30:00,961,1006,45,0,FALSE,NA,"0.1.4"
"23560","646",2023-05-04 09:45:00,961,1006,45,0,FALSE,NA,"0.1.4"
"23561","646",2023-05-04 10:00:00,961,1006,45,0,FALSE,NA,"0.1.4"
"23562","646",2023-05-04 10:15:00,961,1006,45,0,FALSE,NA,"0.1.4"
"23563","646",2023-05-04 10:30:00,961,1006,45,0,FALSE,NA,"0.1.4"
"23564","646",2023-05-04 10:45:00,961,1006,45,0,FALSE,NA,"0.1.4"
"23565","646",2023-05-04 11:00:00,960,1006,46,0,FALSE,NA,"0.1.4"
"23566","646",2023-05-04 11:15:00,961,1006,45,0,FALSE,NA,"0.1.4"
"23567","646",2023-05-04 11:30:00,960,1006,46,0,FALSE,NA,"0.1.4"
"23568","646",2023-05-04 11:45:00,961,1006,45,0,FALSE,NA,"0.1.4"
"23569","646",2023-05-04 12:00:00,961,1006,45,0,FALSE,NA,"0.1.4"
"23570","646",2023-05-04 12:15:00,961,1006,45,0,FALSE,NA,"0.1.4"
"23571","646",2023-05-04 12:30:00,961,1006,45,0,FALSE,NA,"0.1.4"
"23572","646",2023-05-04 12:45:00,961,1006,45,0,FALSE,NA,"0.1.4"
"23573","646",2023-05-04 13:00:00,961,1006,45,0,FALSE,NA,"0.1.4"
"23574","646",2023-05-04 13:15:00,961,1006,45,0,FALSE,NA,"0.1.4"
"23575","646",2023-05-04 13:30:00,961,1006,45,0,FALSE,NA,"0.1.4"
"23576","646",2023-05-04 13:45:00,961,1006,45,0,FALSE,NA,"0.1.4"
"23577","646",2023-05-04 14:00:00,961,1006,45,0,FALSE,NA,"0.1.4"
"23578","646",2023-05-04 14:15:00,961,1006,45,0,FALSE,NA,"0.1.4"
"23579","646",2023-05-04 14:30:00,961,1006,45,0,FALSE,NA,"0.1.4"
"23580","646",2023-05-04 14:45:00,960,1006,46,0,FALSE,NA,"0.1.4"
"23581","646",2023-05-04 15:00:00,960,1006,46,0,FALSE,NA,"0.1.4"
"23582","646",2023-05-04 15:15:00,961,1006,45,0,FALSE,NA,"0.1.4"
"23583","646",2023-05-04 15:30:00,961,1006,45,0,FALSE,NA,"0.1.4"
"23584","646",2023-05-04 15:45:00,960,1006,46,0,FALSE,NA,"0.1.4"
"23585","646",2023-05-04 16:00:00,960,1006,46,0,FALSE,NA,"0.1.4"
"23586","646",2023-05-04 16:15:00,960,1006,46,0,FALSE,NA,"0.1.4"
"23587","646",2023-05-04 16:30:00,961,1006,45,0,FALSE,NA,"0.1.4"
"23588","646",2023-05-04 16:45:00,960,1006,46,0,FALSE,NA,"0.1.4"
"23589","646",2023-05-04 17:00:00,960,1006,46,0,FALSE,NA,"0.1.4"
"23590","646",2023-05-04 17:15:00,963,1006,43,0,FALSE,NA,"0.1.4"
"23591","646",2023-05-04 17:30:00,963,1006,43,0,FALSE,NA,"0.1.4"
"23592","646",2023-05-04 17:45:00,960,1006,46,0,FALSE,NA,"0.1.4"
"23593","646",2023-05-04 18:00:00,965,1006,41,0,FALSE,NA,"0.1.4"
"23594","646",2023-05-04 18:15:00,964,1006,42,0,FALSE,NA,"0.1.4"
"23595","646",2023-05-04 18:30:00,966,1006,40,0,FALSE,NA,"0.1.4"
"23596","646",2023-05-04 18:45:00,967,1006,39,0,FALSE,NA,"0.1.4"
"23597","646",2023-05-04 19:00:00,967,1006,39,0,FALSE,NA,"0.1.4"
"23598","646",2023-05-04 19:15:00,966,1006,40,0,FALSE,NA,"0.1.4"
"23599","646",2023-05-04 19:30:00,965,1006,41,0,FALSE,NA,"0.1.4"
"23600","646",2023-05-04 19:45:00,968,1006,38,0,FALSE,NA,"0.1.4"
"23601","646",2023-05-04 20:00:00,969,1006,37,0,FALSE,NA,"0.1.4"
"23602","646",2023-05-04 20:15:00,968,1006,38,0,FALSE,NA,"0.1.4"
"23603","646",2023-05-04 20:30:00,966,1006,40,0,FALSE,NA,"0.1.4"
"23604","646",2023-05-04 20:45:00,966,1006,40,0,FALSE,NA,"0.1.4"
"23605","646",2023-05-04 21:00:00,966,1006,40,0,FALSE,NA,"0.1.4"
"23606","646",2023-05-04 21:15:00,965,1006,41,0,FALSE,NA,"0.1.4"
"23607","646",2023-05-04 21:30:00,965,1006,41,0,FALSE,NA,"0.1.4"
"23608","646",2023-05-04 21:45:00,966,1006,40,0,FALSE,NA,"0.1.4"
"23609","646",2023-05-04 22:00:00,965,1006,41,0,FALSE,NA,"0.1.4"
"23610","646",2023-05-04 22:15:00,966,1006,40,0,FALSE,NA,"0.1.4"
"23611","646",2023-05-04 22:30:00,967,1006,39,0,FALSE,NA,"0.1.4"
"23612","646",2023-05-04 22:45:00,966,1006,40,0,FALSE,NA,"0.1.4"
"23613","646",2023-05-04 23:00:00,967,1006,39,0,FALSE,NA,"0.1.4"
"23614","646",2023-05-04 23:15:00,967,1006,39,0,FALSE,NA,"0.1.4"
"23615","646",2023-05-04 23:30:00,967,1006,39,0,FALSE,NA,"0.1.4"
"23616","646",2023-05-04 23:45:00,966,1006,40,0,FALSE,NA,"0.1.4"
"23617","646",2023-05-05,967,1006,39,0,FALSE,NA,"0.1.4"
"23618","646",2023-05-05 00:15:00,967,1006,39,0,FALSE,NA,"0.1.4"
"23619","646",2023-05-05 00:30:00,967,1006,39,0,FALSE,NA,"0.1.4"
"23620","646",2023-05-05 00:45:00,967,1006,39,0,FALSE,NA,"0.1.4"
"23621","646",2023-05-05 01:00:00,967,1006,39,0,FALSE,NA,"0.1.4"
"23622","646",2023-05-05 01:15:00,967,1006,39,0,FALSE,NA,"0.1.4"
"23623","646",2023-05-05 01:30:00,967,1006,39,0,FALSE,NA,"0.1.4"
"23624","646",2023-05-05 01:45:00,967,1006,39,0,FALSE,NA,"0.1.4"
"23625","646",2023-05-05 02:00:00,967,1006,39,0,FALSE,NA,"0.1.4"
"23626","646",2023-05-05 02:15:00,966,1006,40,0,FALSE,NA,"0.1.4"
"23627","646",2023-05-05 02:30:00,966,1006,40,0,FALSE,NA,"0.1.4"
"23628","646",2023-05-05 02:45:00,966,1006,40,0,FALSE,NA,"0.1.4"
"23629","646",2023-05-05 03:00:00,966,1006,40,0,FALSE,NA,"0.1.4"
"23630","646",2023-05-05 03:15:00,965,1006,41,0,FALSE,NA,"0.1.4"
"23631","646",2023-05-05 03:30:00,965,1006,41,0,FALSE,NA,"0.1.4"
"23632","646",2023-05-05 03:45:00,965,1006,41,0,FALSE,NA,"0.1.4"
"23633","646",2023-05-05 04:00:00,964,1006,42,0,FALSE,NA,"0.1.4"
"23634","646",2023-05-05 04:15:00,966,1006,40,0,FALSE,NA,"0.1.4"
"23635","646",2023-05-05 04:30:00,963,1006,43,0,FALSE,NA,"0.1.4"
"23636","646",2023-05-05 04:45:00,966,1006,40,0,FALSE,NA,"0.1.4"
"23637","646",2023-05-05 05:00:00,966,1006,40,0,FALSE,NA,"0.1.4"
"23638","646",2023-05-05 05:15:00,966,1006,40,0,FALSE,NA,"0.1.4"
"23639","646",2023-05-05 05:30:00,966,1006,40,0,FALSE,NA,"0.1.4"
"23640","646",2023-05-05 05:45:00,967,1006,39,0,FALSE,NA,"0.1.4"
"23641","646",2023-05-05 06:00:00,968,1006,38,0,FALSE,NA,"0.1.4"
"23642","646",2023-05-05 06:15:00,968,1006,38,0,FALSE,NA,"0.1.4"
"23643","646",2023-05-05 06:30:00,968,1006,38,0,FALSE,NA,"0.1.4"
"23644","646",2023-05-05 06:45:00,969,1006,37,0,FALSE,NA,"0.1.4"
"23645","646",2023-05-05 07:00:00,969,1006,37,0,FALSE,NA,"0.1.4"
"23646","646",2023-05-05 07:15:00,970,1006,36,0,FALSE,NA,"0.1.4"
"23647","646",2023-05-05 07:30:00,971,1006,35,0,FALSE,NA,"0.1.4"
"23648","646",2023-05-05 07:45:00,971,1006,35,0,FALSE,NA,"0.1.4"
"23649","646",2023-05-05 08:00:00,969,1006,37,0,FALSE,NA,"0.1.4"
"23650","646",2023-05-05 08:15:00,967,1006,39,0,FALSE,NA,"0.1.4"
"23651","646",2023-05-05 08:30:00,967,1006,39,0,FALSE,NA,"0.1.4"
"23652","646",2023-05-05 08:45:00,970,1006,36,0,FALSE,NA,"0.1.4"
"23653","646",2023-05-05 09:00:00,970,1006,36,0,FALSE,NA,"0.1.4"
"23654","646",2023-05-05 09:15:00,967,1006,39,0,FALSE,NA,"0.1.4"
"23655","646",2023-05-05 09:30:00,969,1006,37,0,FALSE,NA,"0.1.4"
"23656","646",2023-05-05 09:45:00,969,1006,37,0,FALSE,NA,"0.1.4"
"23657","646",2023-05-05 10:00:00,969,1006,37,0,FALSE,NA,"0.1.4"
"23658","646",2023-05-05 10:15:00,970,1006,36,0,FALSE,NA,"0.1.4"
"23659","646",2023-05-05 10:30:00,969,1006,37,0,FALSE,NA,"0.1.4"
"23660","646",2023-05-05 10:45:00,971,1006,35,0,FALSE,NA,"0.1.4"
"23661","646",2023-05-05 11:00:00,971,1006,35,0,FALSE,NA,"0.1.4"
"23662","646",2023-05-05 11:15:00,970,1006,36,0,FALSE,NA,"0.1.4"
"23663","646",2023-05-05 11:30:00,970,1006,36,0,FALSE,NA,"0.1.4"
"23664","646",2023-05-05 11:45:00,971,1006,35,0,FALSE,NA,"0.1.4"
"23665","646",2023-05-05 12:00:00,970,1006,36,0,FALSE,NA,"0.1.4"
"23666","646",2023-05-05 12:15:00,968,1006,38,0,FALSE,NA,"0.1.4"
"23667","646",2023-05-05 12:30:00,968,1006,38,0,FALSE,NA,"0.1.4"
"23668","646",2023-05-05 12:45:00,968,1006,38,0,FALSE,NA,"0.1.4"
"23669","646",2023-05-05 13:00:00,969,1006,37,0,FALSE,NA,"0.1.4"
"23670","646",2023-05-05 13:15:00,969,1006,37,0,FALSE,NA,"0.1.4"
"23671","646",2023-05-05 13:30:00,970,1006,36,0,FALSE,NA,"0.1.4"
"23672","646",2023-05-05 13:45:00,970,1006,36,0,FALSE,NA,"0.1.4"
"23673","646",2023-05-05 14:00:00,970,1006,36,0,FALSE,NA,"0.1.4"
"23674","646",2023-05-05 14:15:00,969,1006,37,0,FALSE,NA,"0.1.4"
"23675","646",2023-05-05 14:30:00,969,1006,37,0,FALSE,NA,"0.1.4"
"23676","646",2023-05-05 14:45:00,968,1006,38,0,FALSE,NA,"0.1.4"
"23677","646",2023-05-05 15:00:00,969,1006,37,0,FALSE,NA,"0.1.4"
"23678","646",2023-05-05 15:15:00,967,1006,39,0,FALSE,NA,"0.1.4"
"23679","646",2023-05-05 15:30:00,967,1006,39,0,FALSE,NA,"0.1.4"
"23680","646",2023-05-05 15:45:00,968,1006,38,0,FALSE,NA,"0.1.4"
"23681","646",2023-05-05 16:00:00,968,1006,38,0,FALSE,NA,"0.1.4"
"23682","646",2023-05-05 16:15:00,969,1006,37,0,FALSE,NA,"0.1.4"
"23683","646",2023-05-05 16:30:00,969,1006,37,0,FALSE,NA,"0.1.4"
"23684","646",2023-05-05 16:45:00,969,1006,37,0,FALSE,NA,"0.1.4"
"23685","646",2023-05-05 17:00:00,968,1006,38,0,FALSE,NA,"0.1.4"
"23686","646",2023-05-05 17:15:00,968,1006,38,0,FALSE,NA,"0.1.4"
"23687","646",2023-05-05 17:30:00,969,1006,37,0,FALSE,NA,"0.1.4"
"23688","646",2023-05-05 17:45:00,969,1006,37,0,FALSE,NA,"0.1.4"
"23689","646",2023-05-05 18:00:00,969,1006,37,0,FALSE,NA,"0.1.4"
"23690","646",2023-05-05 18:15:00,969,1006,37,0,FALSE,NA,"0.1.4"
"23691","646",2023-05-05 18:30:00,969,1006,37,0,FALSE,NA,"0.1.4"
"23692","646",2023-05-05 18:45:00,969,1006,37,0,FALSE,NA,"0.1.4"
"23693","646",2023-05-05 19:00:00,969,1006,37,0,FALSE,NA,"0.1.4"
"23694","646",2023-05-05 19:15:00,969,1006,37,0,FALSE,NA,"0.1.4"
"23695","646",2023-05-05 19:30:00,969,1006,37,0,FALSE,NA,"0.1.4"
"23696","646",2023-05-05 19:45:00,969,1006,37,0,FALSE,NA,"0.1.4"
"23697","646",2023-05-05 20:00:00,969,1006,37,0,FALSE,NA,"0.1.4"
"23698","646",2023-05-05 20:15:00,969,1006,37,0,FALSE,NA,"0.1.4"
"23699","646",2023-05-05 20:30:00,969,1006,37,0,FALSE,NA,"0.1.4"
"23700","646",2023-05-05 20:45:00,969,1006,37,0,FALSE,NA,"0.1.4"
"23701","646",2023-05-05 21:00:00,969,1006,37,0,FALSE,NA,"0.1.4"
"23702","646",2023-05-05 21:15:00,969,1006,37,0,FALSE,NA,"0.1.4"
"23703","646",2023-05-05 21:30:00,969,1006,37,0,FALSE,NA,"0.1.4"
"23704","646",2023-05-05 21:45:00,969,1006,37,0,FALSE,NA,"0.1.4"
"23705","646",2023-05-05 22:00:00,969,1006,37,0,FALSE,NA,"0.1.4"
"23706","646",2023-05-05 22:15:00,969,1006,37,0,FALSE,NA,"0.1.4"
"23707","646",2023-05-05 22:30:00,969,1006,37,0,FALSE,NA,"0.1.4"
"23708","646",2023-05-05 22:45:00,969,1006,37,0,FALSE,NA,"0.1.4"
"23709","646",2023-05-05 23:00:00,969,1006,37,0,FALSE,NA,"0.1.4"
"23710","646",2023-05-05 23:15:00,969,1006,37,0,FALSE,NA,"0.1.4"
"23711","646",2023-05-05 23:30:00,969,1006,37,0,FALSE,NA,"0.1.4"
"23712","646",2023-05-05 23:45:00,969,1006,37,0,FALSE,NA,"0.1.4"
"23713","646",2023-05-06,969,1006,37,0,FALSE,NA,"0.1.4"
"23714","646",2023-05-06 00:15:00,969,1006,37,0,FALSE,NA,"0.1.4"
"23715","646",2023-05-06 00:30:00,969,1006,37,0,FALSE,NA,"0.1.4"
"23716","646",2023-05-06 00:45:00,968,1006,38,0,FALSE,NA,"0.1.4"
"23717","646",2023-05-06 01:00:00,969,1006,37,0,FALSE,NA,"0.1.4"
"23718","646",2023-05-06 01:15:00,969,1006,37,0,FALSE,NA,"0.1.4"
"23719","646",2023-05-06 01:30:00,969,1006,37,0,FALSE,NA,"0.1.4"
"23720","646",2023-05-06 01:45:00,969,1006,37,0,FALSE,NA,"0.1.4"
"23721","646",2023-05-06 02:00:00,968,1006,38,0,FALSE,NA,"0.1.4"
"23722","646",2023-05-06 02:15:00,968,1006,38,0,FALSE,NA,"0.1.4"
"23723","646",2023-05-06 02:30:00,968,1006,38,0,FALSE,NA,"0.1.4"
"23724","646",2023-05-06 02:45:00,969,1006,37,0,FALSE,NA,"0.1.4"
"23725","646",2023-05-06 03:00:00,969,1006,37,0,FALSE,NA,"0.1.4"
"23726","646",2023-05-06 03:15:00,969,1006,37,0,FALSE,NA,"0.1.4"
"23727","646",2023-05-06 03:30:00,969,1006,37,0,FALSE,NA,"0.1.4"
"23728","646",2023-05-06 03:45:00,968,1006,38,0,FALSE,NA,"0.1.4"
"23729","646",2023-05-06 04:00:00,969,1006,37,0,FALSE,NA,"0.1.4"
"23730","646",2023-05-06 04:15:00,969,1006,37,0,FALSE,NA,"0.1.4"
"23731","646",2023-05-06 04:30:00,968,1006,38,0,FALSE,NA,"0.1.4"
"23732","646",2023-05-06 04:45:00,969,1006,37,0,FALSE,NA,"0.1.4"
"23733","646",2023-05-06 05:00:00,969,1006,37,0,FALSE,NA,"0.1.4"
"23734","646",2023-05-06 05:15:00,968,1006,38,0,FALSE,NA,"0.1.4"
"23735","646",2023-05-06 05:30:00,968,1006,38,0,FALSE,NA,"0.1.4"
"23736","646",2023-05-06 05:45:00,968,1006,38,0,FALSE,NA,"0.1.4"
"23737","646",2023-05-06 06:00:00,968,1006,38,0,FALSE,NA,"0.1.4"
"23738","646",2023-05-06 06:15:00,968,1006,38,0,FALSE,NA,"0.1.4"
"23739","646",2023-05-06 06:30:00,968,1006,38,0,FALSE,NA,"0.1.4"
"23740","646",2023-05-06 06:45:00,968,1006,38,0,FALSE,NA,"0.1.4"
"23741","646",2023-05-06 07:00:00,968,1006,38,0,FALSE,NA,"0.1.4"
"23742","646",2023-05-06 07:15:00,968,1006,38,0,FALSE,NA,"0.1.4"
"23743","646",2023-05-06 07:30:00,968,1006,38,0,FALSE,NA,"0.1.4"
"23744","646",2023-05-06 07:45:00,968,1006,38,0,FALSE,NA,"0.1.4"
"23745","646",2023-05-06 08:00:00,968,1006,38,0,FALSE,NA,"0.1.4"
"23746","646",2023-05-06 08:15:00,968,1006,38,0,FALSE,NA,"0.1.4"
"23747","646",2023-05-06 08:30:00,968,1006,38,0,FALSE,NA,"0.1.4"
"23748","646",2023-05-06 08:45:00,968,1006,38,0,FALSE,NA,"0.1.4"
"23749","646",2023-05-06 09:00:00,968,1006,38,0,FALSE,NA,"0.1.4"
"23750","646",2023-05-06 09:15:00,968,1006,38,0,FALSE,NA,"0.1.4"
"23751","646",2023-05-06 09:30:00,968,1006,38,0,FALSE,NA,"0.1.4"
"23752","646",2023-05-06 09:45:00,968,1006,38,0,FALSE,NA,"0.1.4"
"23753","646",2023-05-06 10:00:00,968,1006,38,0,FALSE,NA,"0.1.4"
"23754","646",2023-05-06 10:15:00,967,1006,39,0,FALSE,NA,"0.1.4"
"23755","646",2023-05-06 10:30:00,967,1006,39,0,FALSE,NA,"0.1.4"
"23756","646",2023-05-06 10:45:00,968,1006,38,0,FALSE,NA,"0.1.4"
"23757","646",2023-05-06 11:00:00,968,1006,38,0,FALSE,NA,"0.1.4"
"23758","646",2023-05-06 11:15:00,968,1006,38,0,FALSE,NA,"0.1.4"
"23759","646",2023-05-06 11:30:00,968,1006,38,0,FALSE,NA,"0.1.4"
"23760","646",2023-05-06 11:45:00,968,1006,38,0,FALSE,NA,"0.1.4"
"23761","646",2023-05-06 12:00:00,968,1006,38,0,FALSE,NA,"0.1.4"
"23762","646",2023-05-06 12:15:00,967,1006,39,0,FALSE,NA,"0.1.4"
"23763","646",2023-05-06 12:30:00,968,1006,38,0,FALSE,NA,"0.1.4"
"23764","646",2023-05-06 12:45:00,968,1006,38,0,FALSE,NA,"0.1.4"
"23765","646",2023-05-06 13:00:00,967,1006,39,0,FALSE,NA,"0.1.4"
"23766","646",2023-05-06 13:15:00,967,1006,39,0,FALSE,NA,"0.1.4"
"23767","646",2023-05-06 13:30:00,968,1006,38,0,FALSE,NA,"0.1.4"
"23768","646",2023-05-06 13:45:00,967,1006,39,0,FALSE,NA,"0.1.4"
"23769","646",2023-05-06 14:00:00,968,1006,38,0,FALSE,NA,"0.1.4"
"23770","646",2023-05-06 14:15:00,968,1006,38,0,FALSE,NA,"0.1.4"
"23771","646",2023-05-06 14:30:00,969,1006,37,0,FALSE,NA,"0.1.4"
"23772","646",2023-05-06 14:45:00,968,1006,38,0,FALSE,NA,"0.1.4"
"23773","646",2023-05-06 15:00:00,969,1006,37,0,FALSE,NA,"0.1.4"
"23774","646",2023-05-06 15:15:00,969,1006,37,0,FALSE,NA,"0.1.4"
"23775","646",2023-05-06 15:30:00,969,1006,37,0,FALSE,NA,"0.1.4"
"23776","646",2023-05-06 15:45:00,969,1006,37,0,FALSE,NA,"0.1.4"
"23777","646",2023-05-06 16:00:00,969,1006,37,0,FALSE,NA,"0.1.4"
"23778","646",2023-05-06 16:15:00,969,1006,37,0,FALSE,NA,"0.1.4"
"23779","646",2023-05-06 16:30:00,969,1006,37,0,FALSE,NA,"0.1.4"
"23780","646",2023-05-06 16:45:00,969,1006,37,0,FALSE,NA,"0.1.4"
"23781","646",2023-05-06 17:00:00,969,1006,37,0,FALSE,NA,"0.1.4"
"23782","646",2023-05-06 17:15:00,969,1006,37,0,FALSE,NA,"0.1.4"
"23783","646",2023-05-06 17:30:00,968,1006,38,0,FALSE,NA,"0.1.4"
"23784","646",2023-05-06 17:45:00,969,1006,37,0,FALSE,NA,"0.1.4"
"23785","646",2023-05-06 18:00:00,969,1006,37,0,FALSE,NA,"0.1.4"
"23786","646",2023-05-06 18:15:00,969,1006,37,0,FALSE,NA,"0.1.4"
"23787","646",2023-05-06 18:30:00,968,1006,38,0,FALSE,NA,"0.1.4"
"23788","646",2023-05-06 18:45:00,969,1006,37,0,FALSE,NA,"0.1.4"
"23789","646",2023-05-06 19:00:00,969,1006,37,0,FALSE,NA,"0.1.4"
"23790","646",2023-05-06 19:15:00,970,1006,36,0,FALSE,NA,"0.1.4"
"23791","646",2023-05-06 19:30:00,970,1006,36,0,FALSE,NA,"0.1.4"
"23792","646",2023-05-06 19:45:00,971,1006,35,0,FALSE,NA,"0.1.4"
"23793","646",2023-05-06 20:00:00,971,1006,35,0,FALSE,NA,"0.1.4"
"23794","646",2023-05-06 20:15:00,971,1006,35,0,FALSE,NA,"0.1.4"
"23795","646",2023-05-06 20:30:00,972,1006,34,0,FALSE,NA,"0.1.4"
"23796","646",2023-05-06 20:45:00,971,1006,35,0,FALSE,NA,"0.1.4"
"23797","646",2023-05-06 21:00:00,971,1006,35,0,FALSE,NA,"0.1.4"
"23798","646",2023-05-06 21:15:00,971,1006,35,0,FALSE,NA,"0.1.4"
"23799","646",2023-05-06 21:30:00,971,1006,35,0,FALSE,NA,"0.1.4"
"23800","646",2023-05-06 21:45:00,971,1006,35,0,FALSE,NA,"0.1.4"
"23801","646",2023-05-06 22:00:00,971,1006,35,0,FALSE,NA,"0.1.4"
"23802","646",2023-05-06 22:15:00,971,1006,35,0,FALSE,NA,"0.1.4"
"23803","646",2023-05-06 22:30:00,971,1006,35,0,FALSE,NA,"0.1.4"
"23804","646",2023-05-06 22:45:00,971,1006,35,0,FALSE,NA,"0.1.4"
"23805","646",2023-05-06 23:00:00,971,1006,35,0,FALSE,NA,"0.1.4"
"23806","646",2023-05-06 23:15:00,971,1006,35,0,FALSE,NA,"0.1.4"
"23807","646",2023-05-06 23:30:00,971,1006,35,0,FALSE,NA,"0.1.4"
"23808","646",2023-05-06 23:45:00,971,1006,35,0,FALSE,NA,"0.1.4"
"23809","646",2023-05-07,970,1006,36,0,FALSE,NA,"0.1.4"
"23810","646",2023-05-07 00:15:00,970,1006,36,0,FALSE,NA,"0.1.4"
"23811","646",2023-05-07 00:30:00,970,1006,36,0,FALSE,NA,"0.1.4"
"23812","646",2023-05-07 00:45:00,970,1006,36,0,FALSE,NA,"0.1.4"
"23813","646",2023-05-07 01:00:00,970,1006,36,0,FALSE,NA,"0.1.4"
"23814","646",2023-05-07 01:15:00,970,1006,36,0,FALSE,NA,"0.1.4"
"23815","646",2023-05-07 01:30:00,970,1006,36,0,FALSE,NA,"0.1.4"
"23816","646",2023-05-07 01:45:00,970,1006,36,0,FALSE,NA,"0.1.4"
"23817","646",2023-05-07 02:00:00,970,1006,36,0,FALSE,NA,"0.1.4"
"23818","646",2023-05-07 02:15:00,970,1006,36,0,FALSE,NA,"0.1.4"
"23819","646",2023-05-07 02:30:00,970,1006,36,0,FALSE,NA,"0.1.4"
"23820","646",2023-05-07 02:45:00,970,1006,36,0,FALSE,NA,"0.1.4"
"23821","646",2023-05-07 03:00:00,970,1006,36,0,FALSE,NA,"0.1.4"
"23822","646",2023-05-07 03:15:00,970,1006,36,0,FALSE,NA,"0.1.4"
"23823","646",2023-05-07 03:30:00,970,1006,36,0,FALSE,NA,"0.1.4"
"23824","646",2023-05-07 03:45:00,970,1006,36,0,FALSE,NA,"0.1.4"
"23825","646",2023-05-07 04:00:00,969,1006,37,0,FALSE,NA,"0.1.4"
"23826","646",2023-05-07 04:15:00,969,1006,37,0,FALSE,NA,"0.1.4"
"23827","646",2023-05-07 04:30:00,969,1006,37,0,FALSE,NA,"0.1.4"
"23828","646",2023-05-07 04:45:00,969,1006,37,0,FALSE,NA,"0.1.4"
"23829","646",2023-05-07 05:00:00,968,1006,38,0,FALSE,NA,"0.1.4"
"23830","646",2023-05-07 05:15:00,968,1006,38,0,FALSE,NA,"0.1.4"
"23831","646",2023-05-07 05:30:00,968,1006,38,0,FALSE,NA,"0.1.4"
"23832","646",2023-05-07 05:45:00,968,1006,38,0,FALSE,NA,"0.1.4"
"23833","646",2023-05-07 06:00:00,969,1006,37,0,FALSE,NA,"0.1.4"
"23834","646",2023-05-07 06:15:00,970,1006,36,0,FALSE,NA,"0.1.4"
"23835","646",2023-05-07 06:30:00,969,1006,37,0,FALSE,NA,"0.1.4"
"23836","646",2023-05-07 06:45:00,969,1006,37,0,FALSE,NA,"0.1.4"
"23837","646",2023-05-07 07:00:00,970,1006,36,0,FALSE,NA,"0.1.4"
"23838","646",2023-05-07 07:15:00,970,1006,36,0,FALSE,NA,"0.1.4"
"23839","646",2023-05-07 07:30:00,971,1006,35,0,FALSE,NA,"0.1.4"
"23840","646",2023-05-07 07:45:00,969,1006,37,0,FALSE,NA,"0.1.4"
"23841","646",2023-05-07 08:00:00,970,1006,36,0,FALSE,NA,"0.1.4"
"23842","646",2023-05-07 08:15:00,970,1006,36,0,FALSE,NA,"0.1.4"
"23843","646",2023-05-07 08:30:00,970,1006,36,0,FALSE,NA,"0.1.4"
"23844","646",2023-05-07 08:45:00,971,1006,35,0,FALSE,NA,"0.1.4"
"23845","646",2023-05-07 09:00:00,971,1006,35,0,FALSE,NA,"0.1.4"
"23846","646",2023-05-07 09:15:00,971,1006,35,0,FALSE,NA,"0.1.4"
"23847","646",2023-05-07 09:30:00,971,1006,35,0,FALSE,NA,"0.1.4"
"23848","646",2023-05-07 09:45:00,972,1006,34,0,FALSE,NA,"0.1.4"
"23849","646",2023-05-07 10:00:00,972,1006,34,0,FALSE,NA,"0.1.4"
"23850","646",2023-05-07 10:15:00,972,1006,34,0,FALSE,NA,"0.1.4"
"23851","646",2023-05-07 10:30:00,973,1006,33,0,FALSE,NA,"0.1.4"
"23852","646",2023-05-07 10:45:00,974,1006,32,0,FALSE,NA,"0.1.4"
"23853","646",2023-05-07 11:00:00,973,1006,33,0,FALSE,NA,"0.1.4"
"23854","646",2023-05-07 11:15:00,972,1006,34,0,FALSE,NA,"0.1.4"
"23855","646",2023-05-07 11:30:00,973,1006,33,0,FALSE,NA,"0.1.4"
"23856","646",2023-05-07 11:45:00,972,1006,34,0,FALSE,NA,"0.1.4"
"23857","646",2023-05-07 12:00:00,972,1006,34,0,FALSE,NA,"0.1.4"
"23858","646",2023-05-07 12:15:00,972,1006,34,0,FALSE,NA,"0.1.4"
"23859","646",2023-05-07 12:30:00,973,1006,33,0,FALSE,NA,"0.1.4"
"23860","646",2023-05-07 12:45:00,975,1006,31,0,FALSE,NA,"0.1.4"
"23861","646",2023-05-07 13:00:00,972,1006,34,0,FALSE,NA,"0.1.4"
"23862","646",2023-05-07 13:15:00,973,1006,33,0,FALSE,NA,"0.1.4"
"23863","646",2023-05-07 13:30:00,970,1006,36,0,FALSE,NA,"0.1.4"
"23864","646",2023-05-07 13:45:00,972,1006,34,0,FALSE,NA,"0.1.4"
"23865","646",2023-05-07 14:00:00,969,1006,37,0,FALSE,NA,"0.1.4"
"23866","646",2023-05-07 14:15:00,971,1006,35,0,FALSE,NA,"0.1.4"
"23867","646",2023-05-07 14:30:00,972,1006,34,0,FALSE,NA,"0.1.4"
"23868","646",2023-05-07 14:45:00,973,1006,33,0,FALSE,NA,"0.1.4"
"23869","646",2023-05-07 15:00:00,975,1006,31,0,FALSE,NA,"0.1.4"
"23870","646",2023-05-07 15:15:00,976,1006,30,0,FALSE,NA,"0.1.4"
"23871","646",2023-05-07 15:30:00,976,1006,30,0,FALSE,NA,"0.1.4"
"23872","646",2023-05-07 15:45:00,977,1006,29,0,FALSE,NA,"0.1.4"
"23873","646",2023-05-07 16:00:00,976,1006,30,0,FALSE,NA,"0.1.4"
"23874","646",2023-05-07 16:15:00,977,1006,29,0,FALSE,NA,"0.1.4"
"23875","646",2023-05-07 16:30:00,976,1006,30,0,FALSE,NA,"0.1.4"
"23876","646",2023-05-07 16:45:00,976,1006,30,0,FALSE,NA,"0.1.4"
"23877","646",2023-05-07 17:00:00,976,1006,30,0,FALSE,NA,"0.1.4"
"23878","646",2023-05-07 17:15:00,975,1006,31,0,FALSE,NA,"0.1.4"
"23879","646",2023-05-07 17:30:00,975,1006,31,0,FALSE,NA,"0.1.4"
"23880","646",2023-05-07 17:45:00,975,1006,31,0,FALSE,NA,"0.1.4"
"23881","646",2023-05-07 18:00:00,974,1006,32,0,FALSE,NA,"0.1.4"
"23882","646",2023-05-07 18:15:00,975,1006,31,0,FALSE,NA,"0.1.4"
"23883","646",2023-05-07 18:30:00,975,1006,31,0,FALSE,NA,"0.1.4"
"23884","646",2023-05-07 18:45:00,975,1006,31,0,FALSE,NA,"0.1.4"
"23885","646",2023-05-07 19:00:00,975,1006,31,0,FALSE,NA,"0.1.4"
"23886","646",2023-05-07 19:15:00,974,1006,32,0,FALSE,NA,"0.1.4"
"23887","646",2023-05-07 19:30:00,973,1006,33,0,FALSE,NA,"0.1.4"
"23888","646",2023-05-07 19:45:00,973,1006,33,0,FALSE,NA,"0.1.4"
"23889","646",2023-05-07 20:00:00,973,1006,33,0,FALSE,NA,"0.1.4"
"23890","646",2023-05-07 20:15:00,973,1006,33,0,FALSE,NA,"0.1.4"
"23891","646",2023-05-07 20:30:00,973,1006,33,0,FALSE,NA,"0.1.4"
"23892","646",2023-05-07 20:45:00,973,1006,33,0,FALSE,NA,"0.1.4"
"23893","646",2023-05-07 21:00:00,973,1006,33,0,FALSE,NA,"0.1.4"
"23894","646",2023-05-07 21:15:00,976,1006,30,0,FALSE,NA,"0.1.4"
"23895","646",2023-05-07 21:30:00,976,1006,30,0,FALSE,NA,"0.1.4"
"23896","646",2023-05-07 21:45:00,974,1006,32,0,FALSE,NA,"0.1.4"
"23897","646",2023-05-07 22:00:00,974,1006,32,0,FALSE,NA,"0.1.4"
"23898","646",2023-05-07 22:15:00,975,1006,31,0,FALSE,NA,"0.1.4"
"23899","646",2023-05-07 22:30:00,974,1006,32,0,FALSE,NA,"0.1.4"
"23900","646",2023-05-07 22:45:00,975,1006,31,0,FALSE,NA,"0.1.4"
"23901","646",2023-05-07 23:00:00,975,1006,31,0,FALSE,NA,"0.1.4"
"23902","646",2023-05-07 23:15:00,975,1006,31,0,FALSE,NA,"0.1.4"
"23903","646",2023-05-07 23:30:00,975,1006,31,0,FALSE,NA,"0.1.4"
"23904","646",2023-05-07 23:45:00,975,1006,31,0,FALSE,NA,"0.1.4"
"23905","646",2023-05-08,975,1006,31,0,FALSE,NA,"0.1.4"
"23906","646",2023-05-08 00:15:00,975,1006,31,0,FALSE,NA,"0.1.4"
"23907","646",2023-05-08 00:30:00,975,1006,31,0,FALSE,NA,"0.1.4"
"23908","646",2023-05-08 00:45:00,975,1006,31,0,FALSE,NA,"0.1.4"
"23909","646",2023-05-08 01:00:00,975,1006,31,0,FALSE,NA,"0.1.4"
"23910","646",2023-05-08 01:15:00,975,1006,31,0,FALSE,NA,"0.1.4"
"23911","646",2023-05-08 01:30:00,975,1006,31,0,FALSE,NA,"0.1.4"
"23912","646",2023-05-08 01:45:00,975,1006,31,0,FALSE,NA,"0.1.4"
"23913","646",2023-05-08 02:00:00,975,1006,31,0,FALSE,NA,"0.1.4"
"23914","646",2023-05-08 02:15:00,975,1006,31,0,FALSE,NA,"0.1.4"
"23915","646",2023-05-08 02:30:00,974,1006,32,0,FALSE,NA,"0.1.4"
"23916","646",2023-05-08 02:45:00,975,1006,31,0,FALSE,NA,"0.1.4"
"23917","646",2023-05-08 03:00:00,975,1006,31,0,FALSE,NA,"0.1.4"
"23918","646",2023-05-08 03:15:00,975,1006,31,0,FALSE,NA,"0.1.4"
"23919","646",2023-05-08 03:30:00,975,1006,31,0,FALSE,NA,"0.1.4"
"23920","646",2023-05-08 03:45:00,974,1006,32,0,FALSE,NA,"0.1.4"
"23921","646",2023-05-08 04:00:00,974,1006,32,0,FALSE,NA,"0.1.4"
"23922","646",2023-05-08 04:15:00,974,1006,32,0,FALSE,NA,"0.1.4"
"23923","646",2023-05-08 04:30:00,974,1006,32,0,FALSE,NA,"0.1.4"
"23924","646",2023-05-08 04:45:00,974,1006,32,0,FALSE,NA,"0.1.4"
"23925","646",2023-05-08 05:00:00,974,1006,32,0,FALSE,NA,"0.1.4"
"23926","646",2023-05-08 05:15:00,974,1006,32,0,FALSE,NA,"0.1.4"
"23927","646",2023-05-08 05:30:00,974,1006,32,0,FALSE,NA,"0.1.4"
"23928","646",2023-05-08 05:45:00,974,1006,32,0,FALSE,NA,"0.1.4"
"23929","646",2023-05-08 06:00:00,974,1006,32,0,FALSE,NA,"0.1.4"
"23930","646",2023-05-08 06:15:00,974,1006,32,0,FALSE,NA,"0.1.4"
"23931","646",2023-05-08 06:30:00,974,1006,32,0,FALSE,NA,"0.1.4"
"23932","646",2023-05-08 06:45:00,974,1006,32,0,FALSE,NA,"0.1.4"
"23933","646",2023-05-08 07:00:00,974,1006,32,0,FALSE,NA,"0.1.4"
"23934","646",2023-05-08 07:15:00,974,1006,32,0,FALSE,NA,"0.1.4"
"23935","646",2023-05-08 07:30:00,974,1006,32,0,FALSE,NA,"0.1.4"
"23936","646",2023-05-08 07:45:00,974,1006,32,0,FALSE,NA,"0.1.4"
"23937","646",2023-05-08 08:00:00,974,1006,32,0,FALSE,NA,"0.1.4"
"23938","646",2023-05-08 08:15:00,974,1006,32,0,FALSE,NA,"0.1.4"
"23939","646",2023-05-08 08:30:00,974,1006,32,0,FALSE,NA,"0.1.4"
"23940","646",2023-05-08 08:45:00,974,1006,32,0,FALSE,NA,"0.1.4"
"23941","646",2023-05-08 09:00:00,973,1006,33,0,FALSE,NA,"0.1.4"
"23942","646",2023-05-08 09:15:00,973,1006,33,0,FALSE,NA,"0.1.4"
"23943","646",2023-05-08 09:30:00,973,1006,33,0,FALSE,NA,"0.1.4"
"23944","646",2023-05-08 09:45:00,973,1006,33,0,FALSE,NA,"0.1.4"
"23945","646",2023-05-08 10:00:00,973,1006,33,0,FALSE,NA,"0.1.4"
"23946","646",2023-05-08 10:15:00,973,1006,33,0,FALSE,NA,"0.1.4"
"23947","646",2023-05-08 10:30:00,974,1006,32,0,FALSE,NA,"0.1.4"
"23948","646",2023-05-08 10:45:00,974,1006,32,0,FALSE,NA,"0.1.4"
"23949","646",2023-05-08 11:00:00,974,1006,32,0,FALSE,NA,"0.1.4"
"23950","646",2023-05-08 11:15:00,973,1006,33,0,FALSE,NA,"0.1.4"
"23951","646",2023-05-08 11:30:00,973,1006,33,0,FALSE,NA,"0.1.4"
"23952","646",2023-05-08 11:45:00,973,1006,33,0,FALSE,NA,"0.1.4"
"23953","646",2023-05-08 12:00:00,973,1006,33,0,FALSE,NA,"0.1.4"
"23954","646",2023-05-08 12:15:00,972,1006,34,0,FALSE,NA,"0.1.4"
"23955","646",2023-05-08 12:30:00,973,1006,33,0,FALSE,NA,"0.1.4"
"23956","646",2023-05-08 12:45:00,973,1006,33,0,FALSE,NA,"0.1.4"
"23957","646",2023-05-08 13:00:00,973,1006,33,0,FALSE,NA,"0.1.4"
"23958","646",2023-05-08 13:15:00,973,1006,33,0,FALSE,NA,"0.1.4"
"23959","646",2023-05-08 13:30:00,972,1006,34,0,FALSE,NA,"0.1.4"
"23960","646",2023-05-08 13:45:00,972,1006,34,0,FALSE,NA,"0.1.4"
"23961","646",2023-05-08 14:00:00,972,1006,34,0,FALSE,NA,"0.1.4"
"23962","646",2023-05-08 14:15:00,972,1006,34,0,FALSE,NA,"0.1.4"
"23963","646",2023-05-08 14:30:00,972,1006,34,0,FALSE,NA,"0.1.4"
"23964","646",2023-05-08 14:45:00,971,1006,35,0,FALSE,NA,"0.1.4"
"23965","646",2023-05-08 15:00:00,972,1006,34,0,FALSE,NA,"0.1.4"
"23966","646",2023-05-08 15:15:00,971,1006,35,0,FALSE,NA,"0.1.4"
"23967","646",2023-05-08 15:30:00,972,1006,34,0,FALSE,NA,"0.1.4"
"23968","646",2023-05-08 15:45:00,972,1006,34,0,FALSE,NA,"0.1.4"
"23969","646",2023-05-08 16:00:00,971,1006,35,0,FALSE,NA,"0.1.4"
"23970","646",2023-05-08 16:15:00,972,1006,34,0,FALSE,NA,"0.1.4"
"23971","646",2023-05-08 16:30:00,972,1006,34,0,FALSE,NA,"0.1.4"
"23972","646",2023-05-08 16:45:00,972,1006,34,0,FALSE,NA,"0.1.4"
"23973","646",2023-05-08 17:00:00,972,1006,34,0,FALSE,NA,"0.1.4"
"23974","646",2023-05-08 17:15:00,971,1006,35,0,FALSE,NA,"0.1.4"
"23975","646",2023-05-08 17:30:00,971,1006,35,0,FALSE,NA,"0.1.4"
"23976","646",2023-05-08 17:45:00,971,1006,35,0,FALSE,NA,"0.1.4"
"23977","646",2023-05-08 18:00:00,970,1006,36,0,FALSE,NA,"0.1.4"
"23978","646",2023-05-08 18:15:00,971,1006,35,0,FALSE,NA,"0.1.4"
"23979","646",2023-05-08 18:30:00,971,1006,35,0,FALSE,NA,"0.1.4"
"23980","646",2023-05-08 18:45:00,971,1006,35,0,FALSE,NA,"0.1.4"
"23981","646",2023-05-08 19:00:00,971,1006,35,0,FALSE,NA,"0.1.4"
"23982","646",2023-05-08 19:15:00,971,1006,35,0,FALSE,NA,"0.1.4"
"23983","646",2023-05-08 19:30:00,971,1006,35,0,FALSE,NA,"0.1.4"
"23984","646",2023-05-08 19:45:00,971,1006,35,0,FALSE,NA,"0.1.4"
"23985","646",2023-05-08 20:00:00,971,1006,35,0,FALSE,NA,"0.1.4"
"23986","646",2023-05-08 20:15:00,971,1006,35,0,FALSE,NA,"0.1.4"
"23987","646",2023-05-08 20:30:00,972,1006,34,0,FALSE,NA,"0.1.4"
"23988","646",2023-05-08 20:45:00,971,1006,35,0,FALSE,NA,"0.1.4"
"23989","646",2023-05-08 21:00:00,971,1006,35,0,FALSE,NA,"0.1.4"
"23990","646",2023-05-08 21:15:00,972,1006,34,0,FALSE,NA,"0.1.4"
"23991","646",2023-05-08 21:30:00,971,1006,35,0,FALSE,NA,"0.1.4"
"23992","646",2023-05-08 21:45:00,971,1006,35,0,FALSE,NA,"0.1.4"
"23993","646",2023-05-08 22:00:00,971,1006,35,0,FALSE,NA,"0.1.4"
"23994","646",2023-05-08 22:15:00,971,1006,35,0,FALSE,NA,"0.1.4"
"23995","646",2023-05-08 22:30:00,971,1006,35,0,FALSE,NA,"0.1.4"
"23996","646",2023-05-08 22:45:00,971,1006,35,0,FALSE,NA,"0.1.4"
"23997","646",2023-05-08 23:00:00,971,1006,35,0,FALSE,NA,"0.1.4"
"23998","646",2023-05-08 23:15:00,971,1006,35,0,FALSE,NA,"0.1.4"
"23999","646",2023-05-08 23:30:00,971,1006,35,0,FALSE,NA,"0.1.4"
"24000","646",2023-05-08 23:45:00,970,1006,36,0,FALSE,NA,"0.1.4"
"24001","646",2023-05-09,971,1006,35,0,FALSE,NA,"0.1.4"
"24002","646",2023-05-09 00:15:00,971,1006,35,0,FALSE,NA,"0.1.4"
"24003","646",2023-05-09 00:30:00,971,1006,35,0,FALSE,NA,"0.1.4"
"24004","646",2023-05-09 00:45:00,972,1006,34,0,FALSE,NA,"0.1.4"
"24005","646",2023-05-09 01:00:00,972,1006,34,0,FALSE,NA,"0.1.4"
"24006","646",2023-05-09 01:15:00,972,1006,34,0,FALSE,NA,"0.1.4"
"24007","646",2023-05-09 01:30:00,972,1006,34,0,FALSE,NA,"0.1.4"
"24008","646",2023-05-09 01:45:00,972,1006,34,0,FALSE,NA,"0.1.4"
"24009","646",2023-05-09 02:00:00,972,1006,34,0,FALSE,NA,"0.1.4"
"24010","646",2023-05-09 02:15:00,971,1006,35,0,FALSE,NA,"0.1.4"
"24011","646",2023-05-09 02:30:00,971,1006,35,0,FALSE,NA,"0.1.4"
"24012","646",2023-05-09 02:45:00,971,1006,35,0,FALSE,NA,"0.1.4"
"24013","646",2023-05-09 03:00:00,971,1006,35,0,FALSE,NA,"0.1.4"
"24014","646",2023-05-09 03:15:00,971,1006,35,0,FALSE,NA,"0.1.4"
"24015","646",2023-05-09 03:30:00,970,1006,36,0,FALSE,NA,"0.1.4"
"24016","646",2023-05-09 03:45:00,971,1006,35,0,FALSE,NA,"0.1.4"
"24017","646",2023-05-09 04:00:00,971,1006,35,0,FALSE,NA,"0.1.4"
"24018","646",2023-05-09 04:15:00,971,1006,35,0,FALSE,NA,"0.1.4"
"24019","646",2023-05-09 04:30:00,970,1006,36,0,FALSE,NA,"0.1.4"
"24020","646",2023-05-09 04:45:00,970,1006,36,0,FALSE,NA,"0.1.4"
"24021","646",2023-05-09 05:00:00,970,1006,36,0,FALSE,NA,"0.1.4"
"24022","646",2023-05-09 05:15:00,970,1006,36,0,FALSE,NA,"0.1.4"
"24023","646",2023-05-09 05:30:00,971,1006,35,0,FALSE,NA,"0.1.4"
"24024","646",2023-05-09 05:45:00,971,1006,35,0,FALSE,NA,"0.1.4"
"24025","646",2023-05-09 06:00:00,971,1006,35,0,FALSE,NA,"0.1.4"
"24026","646",2023-05-09 06:15:00,971,1006,35,0,FALSE,NA,"0.1.4"
"24027","646",2023-05-09 06:30:00,971,1006,35,0,FALSE,NA,"0.1.4"
"24028","646",2023-05-09 06:45:00,971,1006,35,0,FALSE,NA,"0.1.4"
"24029","646",2023-05-09 07:00:00,970,1006,36,0,FALSE,NA,"0.1.4"
"24030","646",2023-05-09 07:15:00,971,1006,35,0,FALSE,NA,"0.1.4"
"24031","646",2023-05-09 07:30:00,971,1006,35,0,FALSE,NA,"0.1.4"
"24032","646",2023-05-09 07:45:00,970,1006,36,0,FALSE,NA,"0.1.4"
"24033","646",2023-05-09 08:00:00,970,1006,36,0,FALSE,NA,"0.1.4"
"24034","646",2023-05-09 08:15:00,971,1006,35,0,FALSE,NA,"0.1.4"
"24035","646",2023-05-09 08:30:00,971,1006,35,0,FALSE,NA,"0.1.4"
"24036","646",2023-05-09 08:45:00,971,1006,35,0,FALSE,NA,"0.1.4"
"24037","646",2023-05-09 09:00:00,973,1006,33,0,FALSE,NA,"0.1.4"
"24038","646",2023-05-09 09:15:00,972,1006,34,0,FALSE,NA,"0.1.4"
"24039","646",2023-05-09 09:30:00,972,1006,34,0,FALSE,NA,"0.1.4"
"24040","646",2023-05-09 09:45:00,972,1006,34,0,FALSE,NA,"0.1.4"
"24041","646",2023-05-09 10:00:00,971,1006,35,0,FALSE,NA,"0.1.4"
"24042","646",2023-05-09 10:15:00,971,1006,35,0,FALSE,NA,"0.1.4"
"24043","646",2023-05-09 10:30:00,971,1006,35,0,FALSE,NA,"0.1.4"
"24044","646",2023-05-09 10:45:00,970,1006,36,0,FALSE,NA,"0.1.4"
"24045","646",2023-05-09 11:00:00,970,1006,36,0,FALSE,NA,"0.1.4"
"24046","646",2023-05-09 11:15:00,970,1006,36,0,FALSE,NA,"0.1.4"
"24047","646",2023-05-09 11:30:00,970,1006,36,0,FALSE,NA,"0.1.4"
"24048","646",2023-05-09 11:45:00,970,1006,36,0,FALSE,NA,"0.1.4"
"24049","646",2023-05-09 12:00:00,970,1006,36,0,FALSE,NA,"0.1.4"
"24050","646",2023-05-09 12:15:00,970,1006,36,0,FALSE,NA,"0.1.4"
"24051","646",2023-05-09 12:30:00,969,1006,37,0,FALSE,NA,"0.1.4"
"24052","646",2023-05-09 12:45:00,969,1006,37,0,FALSE,NA,"0.1.4"
"24053","646",2023-05-09 13:00:00,970,1006,36,0,FALSE,NA,"0.1.4"
"24054","646",2023-05-09 13:15:00,969,1006,37,0,FALSE,NA,"0.1.4"
"24055","646",2023-05-09 13:30:00,969,1006,37,0,FALSE,NA,"0.1.4"
"24056","646",2023-05-09 13:45:00,969,1006,37,0,FALSE,NA,"0.1.4"
"24057","646",2023-05-09 14:00:00,969,1006,37,0,FALSE,NA,"0.1.4"
"24058","646",2023-05-09 14:15:00,969,1006,37,0,FALSE,NA,"0.1.4"
"24059","646",2023-05-09 14:30:00,969,1006,37,0,FALSE,NA,"0.1.4"
"24060","646",2023-05-09 14:45:00,969,1006,37,0,FALSE,NA,"0.1.4"
"24061","646",2023-05-09 15:00:00,969,1006,37,0,FALSE,NA,"0.1.4"
"24062","646",2023-05-09 15:15:00,968,1006,38,0,FALSE,NA,"0.1.4"
"24063","646",2023-05-09 15:30:00,969,1006,37,0,FALSE,NA,"0.1.4"
"24064","646",2023-05-09 15:45:00,969,1006,37,0,FALSE,NA,"0.1.4"
"24065","646",2023-05-09 16:00:00,969,1006,37,0,FALSE,NA,"0.1.4"
"24066","646",2023-05-09 16:15:00,969,1006,37,0,FALSE,NA,"0.1.4"
"24067","646",2023-05-09 16:30:00,969,1006,37,0,FALSE,NA,"0.1.4"
"24068","646",2023-05-09 16:45:00,969,1006,37,0,FALSE,NA,"0.1.4"
"24069","646",2023-05-09 17:00:00,969,1006,37,0,FALSE,NA,"0.1.4"
"24070","646",2023-05-09 17:15:00,969,1006,37,0,FALSE,NA,"0.1.4"
"24071","646",2023-05-09 17:30:00,969,1006,37,0,FALSE,NA,"0.1.4"
"24072","646",2023-05-09 17:45:00,969,1006,37,0,FALSE,NA,"0.1.4"
"24073","646",2023-05-09 18:00:00,969,1006,37,0,FALSE,NA,"0.1.4"
"24074","646",2023-05-09 18:15:00,969,1006,37,0,FALSE,NA,"0.1.4"
"24075","646",2023-05-09 18:30:00,969,1006,37,0,FALSE,NA,"0.1.4"
"24076","646",2023-05-09 18:45:00,969,1006,37,0,FALSE,NA,"0.1.4"
"24077","646",2023-05-09 19:00:00,966,1006,40,0,FALSE,NA,"0.1.4"
"24078","646",2023-05-09 19:15:00,967,1006,39,0,FALSE,NA,"0.1.4"
"24079","646",2023-05-09 19:30:00,968,1006,38,0,FALSE,NA,"0.1.4"
"24080","646",2023-05-09 19:45:00,968,1006,38,0,FALSE,NA,"0.1.4"
"24081","646",2023-05-09 20:00:00,967,1006,39,0,FALSE,NA,"0.1.4"
"24082","646",2023-05-09 20:15:00,967,1006,39,0,FALSE,NA,"0.1.4"
"24083","646",2023-05-09 20:30:00,967,1006,39,0,FALSE,NA,"0.1.4"
"24084","646",2023-05-09 20:45:00,967,1006,39,0,FALSE,NA,"0.1.4"
"24085","646",2023-05-09 21:00:00,967,1006,39,0,FALSE,NA,"0.1.4"
"24086","646",2023-05-09 21:15:00,966,1006,40,0,FALSE,NA,"0.1.4"
"24087","646",2023-05-09 21:30:00,966,1006,40,0,FALSE,NA,"0.1.4"
"24088","646",2023-05-09 21:45:00,966,1006,40,0,FALSE,NA,"0.1.4"
"24089","646",2023-05-09 22:00:00,966,1006,40,0,FALSE,NA,"0.1.4"
"24090","646",2023-05-09 22:15:00,966,1006,40,0,FALSE,NA,"0.1.4"
"24091","646",2023-05-09 22:30:00,966,1006,40,0,FALSE,NA,"0.1.4"
"24092","646",2023-05-09 22:45:00,966,1006,40,0,FALSE,NA,"0.1.4"
"24093","646",2023-05-09 23:00:00,965,1006,41,0,FALSE,NA,"0.1.4"
"24094","646",2023-05-09 23:15:00,965,1006,41,0,FALSE,NA,"0.1.4"
"24095","646",2023-05-09 23:30:00,965,1006,41,0,FALSE,NA,"0.1.4"
"24096","646",2023-05-09 23:45:00,965,1006,41,0,FALSE,NA,"0.1.4"
"24097","646",2023-05-10,965,1006,41,0,FALSE,NA,"0.1.4"
"24098","646",2023-05-10 00:15:00,965,1006,41,0,FALSE,NA,"0.1.4"
"24099","646",2023-05-10 00:30:00,964,1006,42,0,FALSE,NA,"0.1.4"
"24100","646",2023-05-10 00:45:00,964,1006,42,0,FALSE,NA,"0.1.4"
"24101","646",2023-05-10 01:00:00,965,1006,41,0,FALSE,NA,"0.1.4"
"24102","646",2023-05-10 01:15:00,965,1006,41,0,FALSE,NA,"0.1.4"
"24103","646",2023-05-10 01:30:00,965,1006,41,0,FALSE,NA,"0.1.4"
"24104","646",2023-05-10 01:45:00,965,1006,41,0,FALSE,NA,"0.1.4"
"24105","646",2023-05-10 02:00:00,965,1006,41,0,FALSE,NA,"0.1.4"
"24106","646",2023-05-10 02:15:00,965,1006,41,0,FALSE,NA,"0.1.4"
"24107","646",2023-05-10 02:30:00,965,1006,41,0,FALSE,NA,"0.1.4"
"24108","646",2023-05-10 02:45:00,964,1006,42,0,FALSE,NA,"0.1.4"
"24109","646",2023-05-10 03:00:00,964,1006,42,0,FALSE,NA,"0.1.4"
"24110","646",2023-05-10 03:15:00,965,1006,41,0,FALSE,NA,"0.1.4"
"24111","646",2023-05-10 03:30:00,964,1006,42,0,FALSE,NA,"0.1.4"
"24112","646",2023-05-10 03:45:00,965,1006,41,0,FALSE,NA,"0.1.4"
"24113","646",2023-05-10 04:00:00,964,1006,42,0,FALSE,NA,"0.1.4"
"24114","646",2023-05-10 04:15:00,965,1006,41,0,FALSE,NA,"0.1.4"
"24115","646",2023-05-10 04:30:00,965,1006,41,0,FALSE,NA,"0.1.4"
"24116","646",2023-05-10 04:45:00,965,1006,41,0,FALSE,NA,"0.1.4"
"24117","646",2023-05-10 05:00:00,965,1006,41,0,FALSE,NA,"0.1.4"
"24118","646",2023-05-10 05:15:00,965,1006,41,0,FALSE,NA,"0.1.4"
"24119","646",2023-05-10 05:30:00,965,1006,41,0,FALSE,NA,"0.1.4"
"24120","646",2023-05-10 05:45:00,965,1006,41,0,FALSE,NA,"0.1.4"
"24121","646",2023-05-10 06:00:00,964,1006,42,0,FALSE,NA,"0.1.4"
"24122","646",2023-05-10 06:15:00,965,1006,41,0,FALSE,NA,"0.1.4"
"24123","646",2023-05-10 06:30:00,965,1006,41,0,FALSE,NA,"0.1.4"
"24124","646",2023-05-10 06:45:00,965,1006,41,0,FALSE,NA,"0.1.4"
"24125","646",2023-05-10 07:00:00,965,1006,41,0,FALSE,NA,"0.1.4"
"24126","646",2023-05-10 07:15:00,965,1006,41,0,FALSE,NA,"0.1.4"
"24127","646",2023-05-10 07:30:00,965,1006,41,0,FALSE,NA,"0.1.4"
"24128","646",2023-05-10 07:45:00,965,1006,41,0,FALSE,NA,"0.1.4"
"24129","646",2023-05-10 08:00:00,964,1006,42,0,FALSE,NA,"0.1.4"
"24130","646",2023-05-10 08:15:00,965,1006,41,0,FALSE,NA,"0.1.4"
"24131","646",2023-05-10 08:30:00,966,1006,40,0,FALSE,NA,"0.1.4"
"24132","646",2023-05-10 08:45:00,966,1006,40,0,FALSE,NA,"0.1.4"
"24133","646",2023-05-10 09:00:00,965,1006,41,0,FALSE,NA,"0.1.4"
"24134","646",2023-05-10 09:15:00,966,1006,40,0,FALSE,NA,"0.1.4"
"24135","646",2023-05-10 09:30:00,966,1006,40,0,FALSE,NA,"0.1.4"
"24136","646",2023-05-10 09:45:00,966,1006,40,0,FALSE,NA,"0.1.4"
"24137","646",2023-05-10 10:00:00,966,1006,40,0,FALSE,NA,"0.1.4"
"24138","646",2023-05-10 10:15:00,966,1006,40,0,FALSE,NA,"0.1.4"
"24139","646",2023-05-10 10:30:00,967,1006,39,0,FALSE,NA,"0.1.4"
"24140","646",2023-05-10 10:45:00,966,1006,40,0,FALSE,NA,"0.1.4"
"24141","646",2023-05-10 11:00:00,966,1006,40,0,FALSE,NA,"0.1.4"
"24142","646",2023-05-10 11:15:00,965,1006,41,0,FALSE,NA,"0.1.4"
"24143","646",2023-05-10 11:30:00,965,1006,41,0,TRUE,NA,"0.1.4"
"24144","646",2023-05-10 11:45:00,965,1006,41,0,TRUE,NA,"0.1.4"
"24145","646",2023-05-10 12:00:00,965,1006,41,0,TRUE,NA,"0.1.4"
"24146","646",2023-05-10 12:15:00,967,1006,39,0,TRUE,NA,"0.1.4"
"24147","646",2023-05-10 12:30:00,967,1006,39,0,TRUE,NA,"0.1.4"
"24148","646",2023-05-10 12:45:00,967,1006,39,0,TRUE,NA,"0.1.4"
"24149","646",2023-05-10 13:00:00,967,1006,39,0,TRUE,NA,"0.1.4"
"24150","646",2023-05-10 13:15:00,966,1006,40,0,TRUE,NA,"0.1.4"
"24151","646",2023-05-10 13:30:00,966,1006,40,0,TRUE,NA,"0.1.4"
"24152","646",2023-05-10 13:45:00,966,1006,40,0,TRUE,NA,"0.1.4"
"24153","646",2023-05-10 14:00:00,966,1006,40,0,TRUE,NA,"0.1.4"
"24154","646",2023-05-10 14:15:00,966,1006,40,0,TRUE,NA,"0.1.4"
"24155","646",2023-05-10 14:30:00,966,1006,40,0,TRUE,NA,"0.1.4"
"24156","646",2023-05-10 14:45:00,966,1006,40,0,TRUE,NA,"0.1.4"
"24157","646",2023-05-10 15:00:00,965,1006,41,0,TRUE,NA,"0.1.4"
"24158","646",2023-05-10 15:15:00,966,1006,40,0,TRUE,NA,"0.1.4"
"24159","646",2023-05-10 15:30:00,966,1006,40,0,FALSE,NA,"0.1.4"
"24160","646",2023-05-10 15:45:00,966,1006,40,0,FALSE,NA,"0.1.4"
"24161","646",2023-05-10 16:00:00,967,1006,39,0,FALSE,NA,"0.1.4"
"24162","646",2023-05-10 16:15:00,969,1006,37,0,FALSE,NA,"0.1.4"
"24163","646",2023-05-10 16:30:00,967,1006,39,0,FALSE,NA,"0.1.4"
"24164","646",2023-05-10 16:45:00,967,1006,39,0,FALSE,NA,"0.1.4"
"24165","646",2023-05-10 17:00:00,967,1006,39,0,FALSE,NA,"0.1.4"
"24166","646",2023-05-10 17:15:00,967,1006,39,0,FALSE,NA,"0.1.4"
"24167","646",2023-05-10 17:30:00,967,1006,39,0,FALSE,NA,"0.1.4"
"24168","646",2023-05-10 17:45:00,967,1006,39,0,FALSE,NA,"0.1.4"
"24169","646",2023-05-10 18:00:00,968,1006,38,0,FALSE,NA,"0.1.4"
"24170","646",2023-05-10 18:15:00,967,1006,39,0,FALSE,NA,"0.1.4"
"24171","646",2023-05-10 18:30:00,966,1006,40,0,FALSE,NA,"0.1.4"
"24172","646",2023-05-10 18:45:00,967,1006,39,0,FALSE,NA,"0.1.4"
"24173","646",2023-05-10 19:00:00,966,1006,40,0,FALSE,NA,"0.1.4"
"24174","646",2023-05-10 19:15:00,966,1006,40,0,FALSE,NA,"0.1.4"
"24175","646",2023-05-10 19:30:00,966,1006,40,0,FALSE,NA,"0.1.4"
"24176","646",2023-05-10 19:45:00,966,1006,40,0,FALSE,NA,"0.1.4"
"24177","646",2023-05-10 20:00:00,966,1006,40,0,FALSE,NA,"0.1.4"
"24178","646",2023-05-10 20:15:00,966,1006,40,0,FALSE,NA,"0.1.4"
"24179","646",2023-05-10 20:30:00,965,1006,41,0,FALSE,NA,"0.1.4"
"24180","646",2023-05-10 20:45:00,965,1006,41,0,FALSE,NA,"0.1.4"
"24181","646",2023-05-10 21:00:00,964,1006,42,0,FALSE,NA,"0.1.4"
"24182","646",2023-05-10 21:15:00,964,1006,42,0,FALSE,NA,"0.1.4"
"24183","646",2023-05-10 21:30:00,964,1006,42,0,FALSE,NA,"0.1.4"
"24184","646",2023-05-10 21:45:00,964,1006,42,0,FALSE,NA,"0.1.4"
"24185","646",2023-05-10 22:00:00,964,1006,42,0,FALSE,NA,"0.1.4"
"24186","646",2023-05-10 22:15:00,963,1006,43,0,FALSE,NA,"0.1.4"
"24187","646",2023-05-10 22:30:00,963,1006,43,0,FALSE,NA,"0.1.4"
"24188","646",2023-05-10 22:45:00,963,1006,43,0,FALSE,NA,"0.1.4"
"24189","646",2023-05-10 23:00:00,964,1006,42,0,FALSE,NA,"0.1.4"
"24190","646",2023-05-10 23:15:00,964,1006,42,0,FALSE,NA,"0.1.4"
"24191","646",2023-05-10 23:30:00,963,1006,43,0,FALSE,NA,"0.1.4"
"24192","646",2023-05-10 23:45:00,964,1006,42,0,FALSE,NA,"0.1.4"
"24193","646",2023-05-11,964,1006,42,0,FALSE,NA,"0.1.4"
"24194","646",2023-05-11 00:15:00,963,1006,43,0,FALSE,NA,"0.1.4"
"24195","646",2023-05-11 00:30:00,963,1006,43,0,FALSE,NA,"0.1.4"
"24196","646",2023-05-11 00:45:00,962,1006,44,0,FALSE,NA,"0.1.4"
"24197","646",2023-05-11 01:00:00,962,1006,44,0,FALSE,NA,"0.1.4"
"24198","646",2023-05-11 01:15:00,963,1006,43,0,FALSE,NA,"0.1.4"
"24199","646",2023-05-11 01:30:00,963,1006,43,0,FALSE,NA,"0.1.4"
"24200","646",2023-05-11 01:45:00,963,1006,43,0,FALSE,NA,"0.1.4"
"24201","646",2023-05-11 02:00:00,963,1006,43,0,FALSE,NA,"0.1.4"
"24202","646",2023-05-11 02:15:00,962,1006,44,0,FALSE,NA,"0.1.4"
"24203","646",2023-05-11 02:30:00,963,1006,43,0,FALSE,NA,"0.1.4"
"24204","646",2023-05-11 02:45:00,962,1006,44,0,FALSE,NA,"0.1.4"
"24205","646",2023-05-11 03:00:00,962,1006,44,0,FALSE,NA,"0.1.4"
"24206","646",2023-05-11 03:15:00,963,1006,43,0,FALSE,NA,"0.1.4"
"24207","646",2023-05-11 03:30:00,964,1006,42,0,FALSE,NA,"0.1.4"
"24208","646",2023-05-11 03:45:00,963,1006,43,0,FALSE,NA,"0.1.4"
"24209","646",2023-05-11 04:00:00,965,1006,41,0,FALSE,NA,"0.1.4"
"24210","646",2023-05-11 04:15:00,965,1006,41,0,FALSE,NA,"0.1.4"
"24211","646",2023-05-11 04:30:00,966,1006,40,0,FALSE,NA,"0.1.4"
"24212","646",2023-05-11 04:45:00,967,1006,39,0,FALSE,NA,"0.1.4"
"24213","646",2023-05-11 05:00:00,966,1006,40,0,FALSE,NA,"0.1.4"
"24214","646",2023-05-11 05:15:00,967,1006,39,0,FALSE,NA,"0.1.4"
"24215","646",2023-05-11 05:30:00,966,1006,40,0,FALSE,NA,"0.1.4"
"24216","646",2023-05-11 05:45:00,967,1006,39,0,FALSE,NA,"0.1.4"
"24217","646",2023-05-11 06:00:00,968,1006,38,0,FALSE,NA,"0.1.4"
"24218","646",2023-05-11 06:15:00,966,1006,40,0,FALSE,NA,"0.1.4"
"24219","646",2023-05-11 06:30:00,965,1006,41,0,FALSE,NA,"0.1.4"
"24220","646",2023-05-11 06:45:00,966,1006,40,0,FALSE,NA,"0.1.4"
"24221","646",2023-05-11 07:00:00,970,1006,36,0,FALSE,NA,"0.1.4"
"24222","646",2023-05-11 07:15:00,969,1006,37,0,FALSE,NA,"0.1.4"
"24223","646",2023-05-11 07:30:00,969,1006,37,0,FALSE,NA,"0.1.4"
"24224","646",2023-05-11 07:45:00,970,1006,36,0,FALSE,NA,"0.1.4"
"24225","646",2023-05-11 08:00:00,970,1006,36,0,FALSE,NA,"0.1.4"
"24226","646",2023-05-11 08:15:00,972,1006,34,0,FALSE,NA,"0.1.4"
"24227","646",2023-05-11 08:30:00,971,1006,35,0,FALSE,NA,"0.1.4"
"24228","646",2023-05-11 08:45:00,969,1006,37,0,FALSE,NA,"0.1.4"
"24229","646",2023-05-11 09:00:00,969,1006,37,0,FALSE,NA,"0.1.4"
"24230","646",2023-05-11 09:15:00,970,1006,36,0,FALSE,NA,"0.1.4"
"24231","646",2023-05-11 09:30:00,969,1006,37,0,FALSE,NA,"0.1.4"
"24232","646",2023-05-11 09:45:00,968,1006,38,0,FALSE,NA,"0.1.4"
"24233","646",2023-05-11 10:00:00,969,1006,37,0,FALSE,NA,"0.1.4"
"24234","646",2023-05-11 10:15:00,971,1006,35,0,FALSE,NA,"0.1.4"
"24235","646",2023-05-11 10:30:00,969,1006,37,0,FALSE,NA,"0.1.4"
"24236","646",2023-05-11 10:45:00,970,1006,36,0,FALSE,NA,"0.1.4"
"24237","646",2023-05-11 11:00:00,973,1006,33,0,FALSE,NA,"0.1.4"
"24238","646",2023-05-11 11:15:00,973,1006,33,0,FALSE,NA,"0.1.4"
"24239","646",2023-05-11 11:30:00,972,1006,34,0,FALSE,NA,"0.1.4"
"24240","646",2023-05-11 11:45:00,973,1006,33,0,FALSE,NA,"0.1.4"
"24241","646",2023-05-11 12:00:00,972,1006,34,0,FALSE,NA,"0.1.4"
"24242","646",2023-05-11 12:15:00,971,1006,35,0,FALSE,NA,"0.1.4"
"24243","646",2023-05-11 12:30:00,973,1006,33,0,FALSE,NA,"0.1.4"
"24244","646",2023-05-11 12:45:00,974,1006,32,0,FALSE,NA,"0.1.4"
"24245","646",2023-05-11 13:00:00,973,1006,33,0,FALSE,NA,"0.1.4"
"24246","646",2023-05-11 13:15:00,973,1006,33,0,FALSE,NA,"0.1.4"
"24247","646",2023-05-11 13:30:00,973,1006,33,0,FALSE,NA,"0.1.4"
"24248","646",2023-05-11 13:45:00,973,1006,33,0,FALSE,NA,"0.1.4"
"24249","646",2023-05-11 14:00:00,974,1006,32,0,FALSE,NA,"0.1.4"
"24250","646",2023-05-11 14:15:00,973,1006,33,0,FALSE,NA,"0.1.4"
"24251","646",2023-05-11 14:30:00,974,1006,32,0,FALSE,NA,"0.1.4"
"24252","646",2023-05-11 14:45:00,973,1006,33,0,FALSE,NA,"0.1.4"
"24253","646",2023-05-11 15:00:00,973,1006,33,0,FALSE,NA,"0.1.4"
"24254","646",2023-05-11 15:15:00,974,1006,32,0,FALSE,NA,"0.1.4"
"24255","646",2023-05-11 15:30:00,973,1006,33,0,FALSE,NA,"0.1.4"
"24256","646",2023-05-11 15:45:00,973,1006,33,0,FALSE,NA,"0.1.4"
"24257","646",2023-05-11 16:00:00,974,1006,32,0,FALSE,NA,"0.1.4"
"24258","646",2023-05-11 16:15:00,974,1006,32,0,FALSE,NA,"0.1.4"
"24259","646",2023-05-11 16:30:00,974,1006,32,0,FALSE,NA,"0.1.4"
"24260","646",2023-05-11 16:45:00,974,1006,32,0,FALSE,NA,"0.1.4"
"24261","646",2023-05-11 17:00:00,973,1006,33,0,FALSE,NA,"0.1.4"
"24262","646",2023-05-11 17:15:00,973,1006,33,0,FALSE,NA,"0.1.4"
"24263","646",2023-05-11 17:30:00,975,1006,31,0,FALSE,NA,"0.1.4"
"24264","646",2023-05-11 17:45:00,974,1006,32,0,FALSE,NA,"0.1.4"
"24265","646",2023-05-11 18:00:00,973,1006,33,0,FALSE,NA,"0.1.4"
"24266","646",2023-05-11 18:15:00,973,1006,33,0,FALSE,NA,"0.1.4"
"24267","646",2023-05-11 18:30:00,974,1006,32,0,FALSE,NA,"0.1.4"
"24268","646",2023-05-11 18:45:00,974,1006,32,0,FALSE,NA,"0.1.4"
"24269","646",2023-05-11 19:00:00,973,1006,33,0,FALSE,NA,"0.1.4"
"24270","646",2023-05-11 19:15:00,973,1006,33,0,FALSE,NA,"0.1.4"
"24271","646",2023-05-11 19:30:00,974,1006,32,0,FALSE,NA,"0.1.4"
"24272","646",2023-05-11 19:45:00,975,1006,31,0,FALSE,NA,"0.1.4"
"24273","646",2023-05-11 20:00:00,975,1006,31,0,FALSE,NA,"0.1.4"
"24274","646",2023-05-11 20:15:00,976,1006,30,0,FALSE,NA,"0.1.4"
"24275","646",2023-05-11 20:30:00,975,1006,31,0,FALSE,NA,"0.1.4"
"24276","646",2023-05-11 20:45:00,975,1006,31,0,FALSE,NA,"0.1.4"
"24277","646",2023-05-11 21:00:00,975,1006,31,0,FALSE,NA,"0.1.4"
"24278","646",2023-05-11 21:15:00,975,1006,31,0,FALSE,NA,"0.1.4"
"24279","646",2023-05-11 21:30:00,975,1006,31,0,FALSE,NA,"0.1.4"
"24280","646",2023-05-11 21:45:00,975,1006,31,0,FALSE,NA,"0.1.4"
"24281","646",2023-05-11 22:00:00,975,1006,31,0,FALSE,NA,"0.1.4"
"24282","646",2023-05-11 22:15:00,975,1006,31,0,FALSE,NA,"0.1.4"
"24283","646",2023-05-11 22:30:00,974,1006,32,0,FALSE,NA,"0.1.4"
"24284","646",2023-05-11 22:45:00,973,1006,33,0,FALSE,NA,"0.1.4"
"24285","646",2023-05-11 23:00:00,971,1006,35,0,FALSE,NA,"0.1.4"
"24286","646",2023-05-11 23:15:00,974,1006,32,0,FALSE,NA,"0.1.4"
"24287","646",2023-05-11 23:30:00,974,1006,32,0,FALSE,NA,"0.1.4"
"24288","646",2023-05-11 23:45:00,973,1006,33,0,FALSE,NA,"0.1.4"
"24289","646",2023-05-12,972,1006,34,0,FALSE,NA,"0.1.4"
"24290","646",2023-05-12 00:15:00,971,1006,35,0,FALSE,NA,"0.1.4"
"24291","646",2023-05-12 00:30:00,972,1006,34,0,FALSE,NA,"0.1.4"
"24292","646",2023-05-12 00:45:00,973,1006,33,0,FALSE,NA,"0.1.4"
"24293","646",2023-05-12 01:00:00,972,1006,34,0,FALSE,NA,"0.1.4"
"24294","646",2023-05-12 01:15:00,971,1006,35,0,FALSE,NA,"0.1.4"
"24295","646",2023-05-12 01:30:00,971,1006,35,0,FALSE,NA,"0.1.4"
"24296","646",2023-05-12 01:45:00,970,1006,36,0,FALSE,NA,"0.1.4"
"24297","646",2023-05-12 02:00:00,973,1006,33,0,FALSE,NA,"0.1.4"
"24298","646",2023-05-12 02:15:00,973,1006,33,0,FALSE,NA,"0.1.4"
"24299","646",2023-05-12 02:30:00,972,1006,34,0,FALSE,NA,"0.1.4"
"24300","646",2023-05-12 02:45:00,973,1006,33,0,FALSE,NA,"0.1.4"
"24301","646",2023-05-12 03:00:00,972,1006,34,0,FALSE,NA,"0.1.4"
"24302","646",2023-05-12 03:15:00,972,1006,34,0,FALSE,NA,"0.1.4"
"24303","646",2023-05-12 03:30:00,971,1006,35,0,FALSE,NA,"0.1.4"
"24304","646",2023-05-12 03:45:00,971,1006,35,0,FALSE,NA,"0.1.4"
"24305","646",2023-05-12 04:00:00,971,1006,35,0,FALSE,NA,"0.1.4"
"24306","646",2023-05-12 04:15:00,972,1006,34,0,FALSE,NA,"0.1.4"
"24307","646",2023-05-12 04:30:00,972,1006,34,0,FALSE,NA,"0.1.4"
"24308","646",2023-05-12 04:45:00,972,1006,34,0,FALSE,NA,"0.1.4"
"24309","646",2023-05-12 05:00:00,972,1006,34,0,FALSE,NA,"0.1.4"
"24310","646",2023-05-12 05:15:00,972,1006,34,0,FALSE,NA,"0.1.4"
"24311","646",2023-05-12 05:30:00,973,1006,33,0,FALSE,NA,"0.1.4"
"24312","646",2023-05-12 05:45:00,973,1006,33,0,FALSE,NA,"0.1.4"
"24313","646",2023-05-12 06:00:00,972,1006,34,0,FALSE,NA,"0.1.4"
"24314","646",2023-05-12 06:15:00,972,1006,34,0,FALSE,NA,"0.1.4"
"24315","646",2023-05-12 06:30:00,972,1006,34,0,FALSE,NA,"0.1.4"
"24316","646",2023-05-12 06:45:00,972,1006,34,0,FALSE,NA,"0.1.4"
"24317","646",2023-05-12 07:00:00,972,1006,34,0,FALSE,NA,"0.1.4"
"24318","646",2023-05-12 07:15:00,971,1006,35,0,FALSE,NA,"0.1.4"
"24319","646",2023-05-12 07:30:00,970,1006,36,0,FALSE,NA,"0.1.4"
"24320","646",2023-05-12 07:45:00,971,1006,35,0,FALSE,NA,"0.1.4"
"24321","646",2023-05-12 08:00:00,971,1006,35,0,FALSE,NA,"0.1.4"
"24322","646",2023-05-12 08:15:00,971,1006,35,0,FALSE,NA,"0.1.4"
"24323","646",2023-05-12 08:30:00,971,1006,35,0,FALSE,NA,"0.1.4"
"24324","646",2023-05-12 08:45:00,969,1006,37,0,FALSE,NA,"0.1.4"
"24325","646",2023-05-12 09:00:00,969,1006,37,0,FALSE,NA,"0.1.4"
"24326","646",2023-05-12 09:15:00,970,1006,36,0,FALSE,NA,"0.1.4"
"24327","646",2023-05-12 09:30:00,971,1006,35,0,FALSE,NA,"0.1.4"
"24328","646",2023-05-12 09:45:00,970,1006,36,0,FALSE,NA,"0.1.4"
"24329","646",2023-05-12 10:00:00,970,1006,36,0,FALSE,NA,"0.1.4"
"24330","646",2023-05-12 10:15:00,970,1006,36,0,FALSE,NA,"0.1.4"
"24331","646",2023-05-12 10:30:00,968,1006,38,0,FALSE,NA,"0.1.4"
"24332","646",2023-05-12 10:45:00,969,1006,37,0,FALSE,NA,"0.1.4"
"24333","646",2023-05-12 11:00:00,969,1006,37,0,FALSE,NA,"0.1.4"
"24334","646",2023-05-12 11:15:00,969,1006,37,0,FALSE,NA,"0.1.4"
"24335","646",2023-05-12 11:30:00,969,1006,37,0,FALSE,NA,"0.1.4"
"24336","646",2023-05-12 11:45:00,971,1006,35,0,FALSE,NA,"0.1.4"
"24337","646",2023-05-12 12:00:00,971,1006,35,0,FALSE,NA,"0.1.4"
"24338","646",2023-05-12 12:15:00,973,1006,33,0,FALSE,NA,"0.1.4"
"24339","646",2023-05-12 12:30:00,974,1006,32,0,FALSE,NA,"0.1.4"
"24340","646",2023-05-12 12:45:00,973,1006,33,0,FALSE,NA,"0.1.4"
"24341","646",2023-05-12 13:00:00,972,1006,34,0,FALSE,NA,"0.1.4"
"24342","646",2023-05-12 13:15:00,972,1006,34,0,FALSE,NA,"0.1.4"
"24343","646",2023-05-12 13:30:00,972,1006,34,0,FALSE,NA,"0.1.4"
"24344","646",2023-05-12 13:45:00,972,1006,34,0,FALSE,NA,"0.1.4"
"24345","646",2023-05-12 14:00:00,972,1006,34,0,FALSE,NA,"0.1.4"
"24346","646",2023-05-12 14:15:00,973,1006,33,0,FALSE,NA,"0.1.4"
"24347","646",2023-05-12 14:30:00,973,1006,33,0,FALSE,NA,"0.1.4"
"24348","646",2023-05-12 14:45:00,973,1006,33,0,FALSE,NA,"0.1.4"
"24349","646",2023-05-12 15:00:00,974,1006,32,0,FALSE,NA,"0.1.4"
"24350","646",2023-05-12 15:15:00,973,1006,33,0,FALSE,NA,"0.1.4"
"24351","646",2023-05-12 15:30:00,974,1006,32,0,FALSE,NA,"0.1.4"
"24352","646",2023-05-12 15:45:00,973,1006,33,0,FALSE,NA,"0.1.4"
"24353","646",2023-05-12 16:00:00,974,1006,32,0,FALSE,NA,"0.1.4"
"24354","646",2023-05-12 16:15:00,973,1006,33,0,FALSE,NA,"0.1.4"
"24355","646",2023-05-12 16:30:00,971,1006,35,0,FALSE,NA,"0.1.4"
"24356","646",2023-05-12 16:45:00,972,1006,34,0,FALSE,NA,"0.1.4"
"24357","646",2023-05-12 17:00:00,973,1006,33,0,FALSE,NA,"0.1.4"
"24358","646",2023-05-12 17:15:00,972,1006,34,0,FALSE,NA,"0.1.4"
"24359","646",2023-05-12 17:30:00,971,1006,35,0,FALSE,NA,"0.1.4"
"24360","646",2023-05-12 17:45:00,971,1006,35,0,FALSE,NA,"0.1.4"
"24361","646",2023-05-12 18:00:00,971,1006,35,0,FALSE,NA,"0.1.4"
"24362","646",2023-05-12 18:15:00,972,1006,34,0,FALSE,NA,"0.1.4"
"24363","646",2023-05-12 18:30:00,971,1006,35,0,FALSE,NA,"0.1.4"
"24364","646",2023-05-12 18:45:00,971,1006,35,0,FALSE,NA,"0.1.4"
"24365","646",2023-05-12 19:00:00,971,1006,35,0,FALSE,NA,"0.1.4"
"24366","646",2023-05-12 19:15:00,971,1006,35,0,FALSE,NA,"0.1.4"
"24367","646",2023-05-12 19:30:00,972,1006,34,0,FALSE,NA,"0.1.4"
"24368","646",2023-05-12 19:45:00,972,1006,34,0,FALSE,NA,"0.1.4"
"24369","646",2023-05-12 20:00:00,971,1006,35,0,FALSE,NA,"0.1.4"
"24370","646",2023-05-12 20:15:00,971,1006,35,0,FALSE,NA,"0.1.4"
"24371","646",2023-05-12 20:30:00,971,1006,35,0,FALSE,NA,"0.1.4"
"24372","646",2023-05-12 20:45:00,971,1006,35,0,FALSE,NA,"0.1.4"
"24373","646",2023-05-12 21:00:00,971,1006,35,0,FALSE,NA,"0.1.4"
"24374","646",2023-05-12 21:15:00,971,1006,35,0,FALSE,NA,"0.1.4"
"24375","646",2023-05-12 21:30:00,970,1006,36,0,FALSE,NA,"0.1.4"
"24376","646",2023-05-12 21:45:00,969,1006,37,0,FALSE,NA,"0.1.4"
"24377","646",2023-05-12 22:00:00,969,1006,37,0,FALSE,NA,"0.1.4"
"24378","646",2023-05-12 22:15:00,968,1006,38,0,FALSE,NA,"0.1.4"
"24379","646",2023-05-12 22:30:00,970,1006,36,0,FALSE,NA,"0.1.4"
"24380","646",2023-05-12 22:45:00,968,1006,38,0,FALSE,NA,"0.1.4"
"24381","646",2023-05-12 23:00:00,967,1006,39,0,FALSE,NA,"0.1.4"
"24382","646",2023-05-12 23:15:00,968,1006,38,0,FALSE,NA,"0.1.4"
"24383","646",2023-05-12 23:30:00,962,1006,44,0,FALSE,NA,"0.1.4"
"24384","646",2023-05-12 23:45:00,966,1006,40,0,FALSE,NA,"0.1.4"
"24385","646",2023-05-13,964,1006,42,0,FALSE,NA,"0.1.4"
"24386","646",2023-05-13 00:15:00,966,1006,40,0,FALSE,NA,"0.1.4"
"24387","646",2023-05-13 00:30:00,964,1006,42,0,FALSE,NA,"0.1.4"
"24388","646",2023-05-13 00:45:00,967,1006,39,0,FALSE,NA,"0.1.4"
"24389","646",2023-05-13 01:00:00,967,1006,39,0,FALSE,NA,"0.1.4"
"24390","646",2023-05-13 01:15:00,968,1006,38,0,FALSE,NA,"0.1.4"
"24391","646",2023-05-13 01:30:00,967,1006,39,0,FALSE,NA,"0.1.4"
"24392","646",2023-05-13 01:45:00,968,1006,38,0,FALSE,NA,"0.1.4"
"24393","646",2023-05-13 02:00:00,966,1006,40,0,FALSE,NA,"0.1.4"
"24394","646",2023-05-13 02:15:00,968,1006,38,0,FALSE,NA,"0.1.4"
"24395","646",2023-05-13 02:30:00,967,1006,39,0,FALSE,NA,"0.1.4"
"24396","646",2023-05-13 02:45:00,968,1006,38,0,FALSE,NA,"0.1.4"
"24397","646",2023-05-13 03:00:00,968,1006,38,0,FALSE,NA,"0.1.4"
"24398","646",2023-05-13 03:15:00,967,1006,39,0,FALSE,NA,"0.1.4"
"24399","646",2023-05-13 03:30:00,966,1006,40,0,FALSE,NA,"0.1.4"
"24400","646",2023-05-13 03:45:00,966,1006,40,0,FALSE,NA,"0.1.4"
"24401","646",2023-05-13 04:00:00,967,1006,39,0,FALSE,NA,"0.1.4"
"24402","646",2023-05-13 04:15:00,966,1006,40,0,FALSE,NA,"0.1.4"
"24403","646",2023-05-13 04:30:00,966,1006,40,0,FALSE,NA,"0.1.4"
"24404","646",2023-05-13 04:45:00,967,1006,39,0,FALSE,NA,"0.1.4"
"24405","646",2023-05-13 05:00:00,967,1006,39,0,FALSE,NA,"0.1.4"
"24406","646",2023-05-13 05:15:00,967,1006,39,0,FALSE,NA,"0.1.4"
"24407","646",2023-05-13 05:30:00,966,1006,40,0,FALSE,NA,"0.1.4"
"24408","646",2023-05-13 05:45:00,966,1006,40,0,FALSE,NA,"0.1.4"
"24409","646",2023-05-13 06:00:00,966,1006,40,0,FALSE,NA,"0.1.4"
"24410","646",2023-05-13 06:15:00,967,1006,39,0,FALSE,NA,"0.1.4"
"24411","646",2023-05-13 06:30:00,965,1006,41,0,FALSE,NA,"0.1.4"
"24412","646",2023-05-13 06:45:00,966,1006,40,0,FALSE,NA,"0.1.4"
"24413","646",2023-05-13 07:00:00,966,1006,40,0,FALSE,NA,"0.1.4"
"24414","646",2023-05-13 07:15:00,967,1006,39,0,FALSE,NA,"0.1.4"
"24415","646",2023-05-13 07:30:00,967,1006,39,0,FALSE,NA,"0.1.4"
"24416","646",2023-05-13 07:45:00,966,1006,40,0,FALSE,NA,"0.1.4"
"24417","646",2023-05-13 08:00:00,966,1006,40,0,FALSE,NA,"0.1.4"
"24418","646",2023-05-13 08:15:00,966,1006,40,0,FALSE,NA,"0.1.4"
"24419","646",2023-05-13 08:30:00,966,1006,40,0,FALSE,NA,"0.1.4"
"24420","646",2023-05-13 08:45:00,964,1006,42,0,FALSE,NA,"0.1.4"
"24421","646",2023-05-13 09:00:00,965,1006,41,0,FALSE,NA,"0.1.4"
"24422","646",2023-05-13 09:15:00,966,1006,40,0,FALSE,NA,"0.1.4"
"24423","646",2023-05-13 09:30:00,966,1006,40,0,FALSE,NA,"0.1.4"
"24424","646",2023-05-13 09:45:00,966,1006,40,0,FALSE,NA,"0.1.4"
"24425","646",2023-05-13 10:00:00,966,1006,40,0,FALSE,NA,"0.1.4"
"24426","646",2023-05-13 10:15:00,966,1006,40,0,FALSE,NA,"0.1.4"
"24427","646",2023-05-13 10:30:00,967,1006,39,0,FALSE,NA,"0.1.4"
"24428","646",2023-05-13 10:45:00,965,1006,41,0,FALSE,NA,"0.1.4"
"24429","646",2023-05-13 11:00:00,965,1006,41,0,FALSE,NA,"0.1.4"
"24430","646",2023-05-13 11:15:00,964,1006,42,0,FALSE,NA,"0.1.4"
"24431","646",2023-05-13 11:30:00,965,1006,41,0,FALSE,NA,"0.1.4"
"24432","646",2023-05-13 11:45:00,964,1006,42,0,FALSE,NA,"0.1.4"
"24433","646",2023-05-13 12:00:00,965,1006,41,0,FALSE,NA,"0.1.4"
"24434","646",2023-05-13 12:15:00,965,1006,41,0,FALSE,NA,"0.1.4"
"24435","646",2023-05-13 12:30:00,966,1006,40,0,FALSE,NA,"0.1.4"
"24436","646",2023-05-13 12:45:00,967,1006,39,0,FALSE,NA,"0.1.4"
"24437","646",2023-05-13 13:00:00,967,1006,39,0,FALSE,NA,"0.1.4"
"24438","646",2023-05-13 13:15:00,966,1006,40,0,FALSE,NA,"0.1.4"
"24439","646",2023-05-13 13:30:00,966,1006,40,0,FALSE,NA,"0.1.4"
"24440","646",2023-05-13 13:45:00,966,1006,40,0,FALSE,NA,"0.1.4"
"24441","646",2023-05-13 14:00:00,966,1006,40,0,FALSE,NA,"0.1.4"
"24442","646",2023-05-13 14:15:00,966,1006,40,0,FALSE,NA,"0.1.4"
"24443","646",2023-05-13 14:30:00,967,1006,39,0,FALSE,NA,"0.1.4"
"24444","646",2023-05-13 14:45:00,967,1006,39,0,FALSE,NA,"0.1.4"
"24445","646",2023-05-13 15:00:00,967,1006,39,0,FALSE,NA,"0.1.4"
"24446","646",2023-05-13 15:15:00,967,1006,39,0,FALSE,NA,"0.1.4"
"24447","646",2023-05-13 15:30:00,968,1006,38,0,FALSE,NA,"0.1.4"
"24448","646",2023-05-13 15:45:00,967,1006,39,0,FALSE,NA,"0.1.4"
"24449","646",2023-05-13 16:00:00,968,1006,38,0,FALSE,NA,"0.1.4"
"24450","646",2023-05-13 16:15:00,968,1006,38,0,FALSE,NA,"0.1.4"
"24451","646",2023-05-13 16:30:00,967,1006,39,0,FALSE,NA,"0.1.4"
"24452","646",2023-05-13 16:45:00,967,1006,39,0,FALSE,NA,"0.1.4"
"24453","646",2023-05-13 17:00:00,966,1006,40,0,FALSE,NA,"0.1.4"
"24454","646",2023-05-13 17:15:00,969,1006,37,0,FALSE,NA,"0.1.4"
"24455","646",2023-05-13 17:30:00,967,1006,39,0,FALSE,NA,"0.1.4"
"24456","646",2023-05-13 17:45:00,967,1006,39,0,FALSE,NA,"0.1.4"
"24457","646",2023-05-13 18:00:00,967,1006,39,0,FALSE,NA,"0.1.4"
"24458","646",2023-05-13 18:15:00,968,1006,38,0,FALSE,NA,"0.1.4"
"24459","646",2023-05-13 18:30:00,967,1006,39,0,FALSE,NA,"0.1.4"
"24460","646",2023-05-13 18:45:00,969,1006,37,0,FALSE,NA,"0.1.4"
"24461","646",2023-05-13 19:00:00,967,1006,39,0,FALSE,NA,"0.1.4"
"24462","646",2023-05-13 19:15:00,966,1006,40,0,FALSE,NA,"0.1.4"
"24463","646",2023-05-13 19:30:00,964,1006,42,0,FALSE,NA,"0.1.4"
"24464","646",2023-05-13 19:45:00,961,1006,45,0,FALSE,NA,"0.1.4"
"24465","646",2023-05-13 20:00:00,963,1006,43,0,FALSE,NA,"0.1.4"
"24466","646",2023-05-13 20:15:00,963,1006,43,0,FALSE,NA,"0.1.4"
"24467","646",2023-05-13 20:30:00,965,1006,41,0,FALSE,NA,"0.1.4"
"24468","646",2023-05-13 20:45:00,965,1006,41,0,FALSE,NA,"0.1.4"
"24469","646",2023-05-13 21:00:00,966,1006,40,0,FALSE,NA,"0.1.4"
"24470","646",2023-05-13 21:15:00,966,1006,40,0,FALSE,NA,"0.1.4"
"24471","646",2023-05-13 21:30:00,967,1006,39,0,FALSE,NA,"0.1.4"
"24472","646",2023-05-13 21:45:00,968,1006,38,0,FALSE,NA,"0.1.4"
"24473","646",2023-05-13 22:00:00,966,1006,40,0,FALSE,NA,"0.1.4"
"24474","646",2023-05-13 22:15:00,966,1006,40,0,FALSE,NA,"0.1.4"
"24475","646",2023-05-13 22:30:00,969,1006,37,0,FALSE,NA,"0.1.4"
"24476","646",2023-05-13 22:45:00,968,1006,38,0,FALSE,NA,"0.1.4"
"24477","646",2023-05-13 23:00:00,967,1006,39,0,FALSE,NA,"0.1.4"
"24478","646",2023-05-13 23:15:00,968,1006,38,0,FALSE,NA,"0.1.4"
"24479","646",2023-05-13 23:30:00,968,1006,38,0,FALSE,NA,"0.1.4"
"24480","646",2023-05-13 23:45:00,967,1006,39,0,FALSE,NA,"0.1.4"
"24481","646",2023-05-14,967,1006,39,0,FALSE,NA,"0.1.4"
"24482","646",2023-05-14 00:15:00,965,1006,41,0,FALSE,NA,"0.1.4"
"24483","646",2023-05-14 00:30:00,963,1006,43,0,FALSE,NA,"0.1.4"
"24484","646",2023-05-14 00:45:00,966,1006,40,0,FALSE,NA,"0.1.4"
"24485","646",2023-05-14 01:00:00,965,1006,41,0,FALSE,NA,"0.1.4"
"24486","646",2023-05-14 01:15:00,965,1006,41,0,FALSE,NA,"0.1.4"
"24487","646",2023-05-14 01:30:00,965,1006,41,0,FALSE,NA,"0.1.4"
"24488","646",2023-05-14 01:45:00,965,1006,41,0,FALSE,NA,"0.1.4"
"24489","646",2023-05-14 02:00:00,965,1006,41,0,FALSE,NA,"0.1.4"
"24490","646",2023-05-14 02:15:00,965,1006,41,0,FALSE,NA,"0.1.4"
"24491","646",2023-05-14 02:30:00,965,1006,41,0,FALSE,NA,"0.1.4"
"24492","646",2023-05-14 02:45:00,965,1006,41,0,FALSE,NA,"0.1.4"
"24493","646",2023-05-14 03:00:00,965,1006,41,0,FALSE,NA,"0.1.4"
"24494","646",2023-05-14 03:15:00,965,1006,41,0,FALSE,NA,"0.1.4"
"24495","646",2023-05-14 03:30:00,965,1006,41,0,FALSE,NA,"0.1.4"
"24496","646",2023-05-14 03:45:00,965,1006,41,0,FALSE,NA,"0.1.4"
"24497","646",2023-05-14 04:00:00,965,1006,41,0,FALSE,NA,"0.1.4"
"24498","646",2023-05-14 04:15:00,965,1006,41,0,FALSE,NA,"0.1.4"
"24499","646",2023-05-14 04:30:00,965,1006,41,0,FALSE,NA,"0.1.4"
"24500","646",2023-05-14 04:45:00,965,1006,41,0,FALSE,NA,"0.1.4"
"24501","646",2023-05-14 05:00:00,964,1006,42,0,FALSE,NA,"0.1.4"
"24502","646",2023-05-14 05:15:00,965,1006,41,0,FALSE,NA,"0.1.4"
"24503","646",2023-05-14 05:30:00,965,1006,41,0,FALSE,NA,"0.1.4"
"24504","646",2023-05-14 05:45:00,965,1006,41,0,FALSE,NA,"0.1.4"
"24505","646",2023-05-14 06:00:00,965,1006,41,0,FALSE,NA,"0.1.4"
"24506","646",2023-05-14 06:15:00,966,1006,40,0,FALSE,NA,"0.1.4"
"24507","646",2023-05-14 06:30:00,967,1006,39,0,FALSE,NA,"0.1.4"
"24508","646",2023-05-14 06:45:00,967,1006,39,0,FALSE,NA,"0.1.4"
"24509","646",2023-05-14 07:00:00,966,1006,40,0,FALSE,NA,"0.1.4"
"24510","646",2023-05-14 07:15:00,966,1006,40,0,FALSE,NA,"0.1.4"
"24511","646",2023-05-14 07:30:00,965,1006,41,0,FALSE,NA,"0.1.4"
"24512","646",2023-05-14 07:45:00,966,1006,40,0,FALSE,NA,"0.1.4"
"24513","646",2023-05-14 08:00:00,965,1006,41,0,FALSE,NA,"0.1.4"
"24514","646",2023-05-14 08:15:00,967,1006,39,0,FALSE,NA,"0.1.4"
"24515","646",2023-05-14 08:30:00,966,1006,40,0,FALSE,NA,"0.1.4"
"24516","646",2023-05-14 08:45:00,966,1006,40,0,FALSE,NA,"0.1.4"
"24517","646",2023-05-14 09:00:00,966,1006,40,0,FALSE,NA,"0.1.4"
"24518","646",2023-05-14 09:15:00,966,1006,40,0,FALSE,NA,"0.1.4"
"24519","646",2023-05-14 09:30:00,965,1006,41,0,FALSE,NA,"0.1.4"
"24520","646",2023-05-14 09:45:00,966,1006,40,0,FALSE,NA,"0.1.4"
"24521","646",2023-05-14 10:00:00,966,1006,40,0,FALSE,NA,"0.1.4"
"24522","646",2023-05-14 10:15:00,966,1006,40,0,FALSE,NA,"0.1.4"
"24523","646",2023-05-14 10:30:00,966,1006,40,0,FALSE,NA,"0.1.4"
"24524","646",2023-05-14 10:45:00,966,1006,40,0,FALSE,NA,"0.1.4"
"24525","646",2023-05-14 11:00:00,965,1006,41,0,FALSE,NA,"0.1.4"
"24526","646",2023-05-14 11:15:00,966,1006,40,0,FALSE,NA,"0.1.4"
"24527","646",2023-05-14 11:30:00,968,1006,38,0,FALSE,NA,"0.1.4"
"24528","646",2023-05-14 11:45:00,967,1006,39,0,FALSE,NA,"0.1.4"
"24529","646",2023-05-14 12:00:00,966,1006,40,0,FALSE,NA,"0.1.4"
"24530","646",2023-05-14 12:15:00,966,1006,40,0,FALSE,NA,"0.1.4"
"24531","646",2023-05-14 12:30:00,965,1006,41,0,FALSE,NA,"0.1.4"
"24532","646",2023-05-14 12:45:00,965,1006,41,0,FALSE,NA,"0.1.4"
"24533","646",2023-05-14 13:00:00,966,1006,40,0,FALSE,NA,"0.1.4"
"24534","646",2023-05-14 13:15:00,967,1006,39,0,FALSE,NA,"0.1.4"
"24535","646",2023-05-14 13:30:00,966,1006,40,0,FALSE,NA,"0.1.4"
"24536","646",2023-05-14 13:45:00,965,1006,41,0,FALSE,NA,"0.1.4"
"24537","646",2023-05-14 14:00:00,965,1006,41,0,FALSE,NA,"0.1.4"
"24538","646",2023-05-14 14:15:00,966,1006,40,0,FALSE,NA,"0.1.4"
"24539","646",2023-05-14 14:30:00,966,1006,40,0,FALSE,NA,"0.1.4"
"24540","646",2023-05-14 14:45:00,966,1006,40,0,FALSE,NA,"0.1.4"
"24541","646",2023-05-14 15:00:00,966,1006,40,0,FALSE,NA,"0.1.4"
"24542","646",2023-05-14 15:15:00,966,1006,40,0,FALSE,NA,"0.1.4"
"24543","646",2023-05-14 15:30:00,966,1006,40,0,FALSE,NA,"0.1.4"
"24544","646",2023-05-14 15:45:00,966,1006,40,0,FALSE,NA,"0.1.4"
"24545","646",2023-05-14 16:00:00,966,1006,40,0,FALSE,NA,"0.1.4"
"24546","646",2023-05-14 16:15:00,966,1006,40,0,FALSE,NA,"0.1.4"
"24547","646",2023-05-14 16:30:00,966,1006,40,0,FALSE,NA,"0.1.4"
"24548","646",2023-05-14 16:45:00,967,1006,39,0,FALSE,NA,"0.1.4"
"24549","646",2023-05-14 17:00:00,965,1006,41,0,FALSE,NA,"0.1.4"
"24550","646",2023-05-14 17:15:00,966,1006,40,0,FALSE,NA,"0.1.4"
"24551","646",2023-05-14 17:30:00,967,1006,39,0,FALSE,NA,"0.1.4"
"24552","646",2023-05-14 17:45:00,968,1006,38,0,FALSE,NA,"0.1.4"
"24553","646",2023-05-14 18:00:00,967,1006,39,0,FALSE,NA,"0.1.4"
"24554","646",2023-05-14 18:15:00,962,1006,44,0,FALSE,NA,"0.1.4"
"24555","646",2023-05-14 18:30:00,963,1006,43,0,FALSE,NA,"0.1.4"
"24556","646",2023-05-14 18:45:00,960,1006,46,0,FALSE,NA,"0.1.4"
"24557","646",2023-05-14 19:00:00,962,1006,44,0,FALSE,NA,"0.1.4"
"24558","646",2023-05-14 19:15:00,963,1006,43,0,FALSE,NA,"0.1.4"
"24559","646",2023-05-14 19:30:00,963,1006,43,0,FALSE,NA,"0.1.4"
"24560","646",2023-05-14 19:45:00,963,1006,43,0,FALSE,NA,"0.1.4"
"24561","646",2023-05-14 20:00:00,964,1006,42,0,FALSE,NA,"0.1.4"
"24562","646",2023-05-14 20:15:00,963,1006,43,0,FALSE,NA,"0.1.4"
"24563","646",2023-05-14 20:30:00,964,1006,42,0,FALSE,NA,"0.1.4"
"24564","646",2023-05-14 20:45:00,964,1006,42,0,FALSE,NA,"0.1.4"
"24565","646",2023-05-14 21:00:00,963,1006,43,0,FALSE,NA,"0.1.4"
"24566","646",2023-05-14 21:15:00,965,1006,41,0,FALSE,NA,"0.1.4"
"24567","646",2023-05-14 21:30:00,964,1006,42,0,FALSE,NA,"0.1.4"
"24568","646",2023-05-14 21:45:00,964,1006,42,0,FALSE,NA,"0.1.4"
"24569","646",2023-05-14 22:00:00,965,1006,41,0,FALSE,NA,"0.1.4"
"24570","646",2023-05-14 22:15:00,964,1006,42,0,FALSE,NA,"0.1.4"
"24571","646",2023-05-14 22:30:00,963,1006,43,0,FALSE,NA,"0.1.4"
"24572","646",2023-05-14 22:45:00,963,1006,43,0,FALSE,NA,"0.1.4"
"24573","646",2023-05-14 23:00:00,963,1006,43,0,FALSE,NA,"0.1.4"
"24574","646",2023-05-14 23:15:00,964,1006,42,0,FALSE,NA,"0.1.4"
"24575","646",2023-05-14 23:30:00,973,1006,33,0,FALSE,NA,"0.1.4"
"24576","646",2023-05-14 23:45:00,970,1006,36,0,FALSE,NA,"0.1.4"
"24577","646",2023-05-15,966,1006,40,0,FALSE,NA,"0.1.4"
"24578","646",2023-05-15 00:15:00,964,1006,42,0,FALSE,NA,"0.1.4"
"24579","646",2023-05-15 00:30:00,965,1006,41,0,FALSE,NA,"0.1.4"
"24580","646",2023-05-15 00:45:00,966,1006,40,0,FALSE,NA,"0.1.4"
"24581","646",2023-05-15 01:00:00,966,1006,40,0,FALSE,NA,"0.1.4"
"24582","646",2023-05-15 01:15:00,965,1006,41,0,FALSE,NA,"0.1.4"
"24583","646",2023-05-15 01:30:00,967,1006,39,0,FALSE,NA,"0.1.4"
"24584","646",2023-05-15 01:45:00,969,1006,37,0,FALSE,NA,"0.1.4"
"24585","646",2023-05-15 02:00:00,970,1006,36,0,FALSE,NA,"0.1.4"
"24586","646",2023-05-15 02:15:00,976,1006,30,0,FALSE,NA,"0.1.4"
"24587","646",2023-05-15 02:30:00,974,1006,32,0,FALSE,NA,"0.1.4"
"24588","646",2023-05-15 02:45:00,972,1006,34,0,FALSE,NA,"0.1.4"
"24589","646",2023-05-15 03:00:00,972,1006,34,0,FALSE,NA,"0.1.4"
"24590","646",2023-05-15 03:15:00,972,1006,34,0,FALSE,NA,"0.1.4"
"24591","646",2023-05-15 03:30:00,971,1006,35,0,FALSE,NA,"0.1.4"
"24592","646",2023-05-15 03:45:00,971,1006,35,0,FALSE,NA,"0.1.4"
"24593","646",2023-05-15 04:00:00,971,1006,35,0,FALSE,NA,"0.1.4"
"24594","646",2023-05-15 04:15:00,970,1006,36,0,FALSE,NA,"0.1.4"
"24595","646",2023-05-15 04:30:00,970,1006,36,0,FALSE,NA,"0.1.4"
"24596","646",2023-05-15 04:45:00,969,1006,37,0,FALSE,NA,"0.1.4"
"24597","646",2023-05-15 05:00:00,970,1006,36,0,FALSE,NA,"0.1.4"
"24598","646",2023-05-15 05:15:00,972,1006,34,0,FALSE,NA,"0.1.4"
"24599","646",2023-05-15 05:30:00,972,1006,34,0,FALSE,NA,"0.1.4"
"24600","646",2023-05-15 05:45:00,972,1006,34,0,FALSE,NA,"0.1.4"
"24601","646",2023-05-15 06:00:00,969,1006,37,0,FALSE,NA,"0.1.4"
"24602","646",2023-05-15 06:15:00,969,1006,37,0,FALSE,NA,"0.1.4"
"24603","646",2023-05-15 06:30:00,970,1006,36,0,FALSE,NA,"0.1.4"
"24604","646",2023-05-15 06:45:00,970,1006,36,0,FALSE,NA,"0.1.4"
"24605","646",2023-05-15 07:00:00,967,1006,39,0,FALSE,NA,"0.1.4"
"24606","646",2023-05-15 07:15:00,966,1006,40,0,FALSE,NA,"0.1.4"
"24607","646",2023-05-15 07:30:00,967,1006,39,0,FALSE,NA,"0.1.4"
"24608","646",2023-05-15 07:45:00,966,1006,40,0,FALSE,NA,"0.1.4"
"24609","646",2023-05-15 08:00:00,967,1006,39,0,FALSE,NA,"0.1.4"
"24610","646",2023-05-15 08:15:00,967,1006,39,0,FALSE,NA,"0.1.4"
"24611","646",2023-05-15 08:30:00,968,1006,38,0,FALSE,NA,"0.1.4"
"24612","646",2023-05-15 08:45:00,967,1006,39,0,FALSE,NA,"0.1.4"
"24613","646",2023-05-15 09:00:00,971,1006,35,0,FALSE,NA,"0.1.4"
"24614","646",2023-05-15 09:15:00,968,1006,38,0,FALSE,NA,"0.1.4"
"24615","646",2023-05-15 09:30:00,973,1006,33,0,FALSE,NA,"0.1.4"
"24616","646",2023-05-15 09:45:00,970,1006,36,0,FALSE,NA,"0.1.4"
"24617","646",2023-05-15 10:00:00,971,1006,35,0,FALSE,NA,"0.1.4"
"24618","646",2023-05-15 10:15:00,973,1006,33,0,FALSE,NA,"0.1.4"
"24619","646",2023-05-15 10:30:00,970,1006,36,0,FALSE,NA,"0.1.4"
"24620","646",2023-05-15 10:45:00,972,1006,34,0,FALSE,NA,"0.1.4"
"24621","646",2023-05-15 11:00:00,967,1006,39,0,FALSE,NA,"0.1.4"
"24622","646",2023-05-15 11:15:00,970,1006,36,0,FALSE,NA,"0.1.4"
"24623","646",2023-05-15 11:30:00,970,1006,36,0,FALSE,NA,"0.1.4"
"24624","646",2023-05-15 11:45:00,972,1006,34,0,FALSE,NA,"0.1.4"
"24625","646",2023-05-15 12:00:00,973,1006,33,0,FALSE,NA,"0.1.4"
"24626","646",2023-05-15 12:15:00,972,1006,34,0,FALSE,NA,"0.1.4"
"24627","646",2023-05-15 12:30:00,975,1006,31,0,FALSE,NA,"0.1.4"
"24628","646",2023-05-15 12:45:00,976,1006,30,0,FALSE,NA,"0.1.4"
"24629","646",2023-05-15 13:00:00,972,1006,34,0,FALSE,NA,"0.1.4"
"24630","646",2023-05-15 13:15:00,977,1006,29,0,FALSE,NA,"0.1.4"
"24631","646",2023-05-15 13:30:00,975,1006,31,0,FALSE,NA,"0.1.4"
"24632","646",2023-05-15 13:45:00,975,1006,31,0,FALSE,NA,"0.1.4"
"24633","646",2023-05-15 14:00:00,972,1006,34,0,FALSE,NA,"0.1.4"
"24634","646",2023-05-15 14:15:00,975,1006,31,0,FALSE,NA,"0.1.4"
"24635","646",2023-05-15 14:30:00,971,1006,35,0,FALSE,NA,"0.1.4"
"24636","646",2023-05-15 14:45:00,971,1006,35,0,FALSE,NA,"0.1.4"
"24637","646",2023-05-15 15:00:00,972,1006,34,0,FALSE,NA,"0.1.4"
"24638","646",2023-05-15 15:15:00,971,1006,35,0,FALSE,NA,"0.1.4"
"24639","646",2023-05-15 15:30:00,970,1006,36,0,FALSE,NA,"0.1.4"
"24640","646",2023-05-15 15:45:00,973,1006,33,0,FALSE,NA,"0.1.4"
"24641","646",2023-05-15 16:00:00,973,1006,33,0,FALSE,NA,"0.1.4"
"24642","646",2023-05-15 16:15:00,974,1006,32,0,FALSE,NA,"0.1.4"
"24643","646",2023-05-15 16:30:00,973,1006,33,0,FALSE,NA,"0.1.4"
"24644","646",2023-05-15 16:45:00,974,1006,32,0,FALSE,NA,"0.1.4"
"24645","646",2023-05-15 17:00:00,975,1006,31,0,FALSE,NA,"0.1.4"
"24646","646",2023-05-15 17:15:00,975,1006,31,0,FALSE,NA,"0.1.4"
"24647","646",2023-05-15 17:30:00,976,1006,30,0,FALSE,NA,"0.1.4"
"24648","646",2023-05-15 17:45:00,979,1006,27,0,FALSE,NA,"0.1.4"
"24649","646",2023-05-15 18:00:00,980,1006,26,0,FALSE,NA,"0.1.4"
"24650","646",2023-05-15 18:15:00,982,1006,24,0,FALSE,NA,"0.1.4"
"24651","646",2023-05-15 18:30:00,979,1006,27,0,FALSE,NA,"0.1.4"
"24652","646",2023-05-15 18:45:00,978,1006,28,0,FALSE,NA,"0.1.4"
"24653","646",2023-05-15 19:00:00,978,1006,28,0,FALSE,NA,"0.1.4"
"24654","646",2023-05-15 19:15:00,978,1006,28,0,FALSE,NA,"0.1.4"
"24655","646",2023-05-15 19:30:00,979,1006,27,0,FALSE,NA,"0.1.4"
"24656","646",2023-05-15 19:45:00,973,1006,33,0,FALSE,NA,"0.1.4"
"24657","646",2023-05-15 20:00:00,971,1006,35,0,FALSE,NA,"0.1.4"
"24658","646",2023-05-15 20:15:00,972,1006,34,0,FALSE,NA,"0.1.4"
"24659","646",2023-05-15 20:30:00,975,1006,31,0,FALSE,NA,"0.1.4"
"24660","646",2023-05-15 20:45:00,976,1006,30,0,FALSE,NA,"0.1.4"
"24661","646",2023-05-15 21:00:00,976,1006,30,0,FALSE,NA,"0.1.4"
"24662","646",2023-05-15 21:15:00,974,1006,32,0,FALSE,NA,"0.1.4"
"24663","646",2023-05-15 21:30:00,971,1006,35,0,FALSE,NA,"0.1.4"
"24664","646",2023-05-15 21:45:00,973,1006,33,0,FALSE,NA,"0.1.4"
"24665","646",2023-05-15 22:00:00,973,1006,33,0,FALSE,NA,"0.1.4"
"24666","646",2023-05-15 22:15:00,974,1006,32,0,FALSE,NA,"0.1.4"
"24667","646",2023-05-15 22:30:00,973,1006,33,0,FALSE,NA,"0.1.4"
"24668","646",2023-05-15 22:45:00,974,1006,32,0,FALSE,NA,"0.1.4"
"24669","646",2023-05-15 23:00:00,973,1006,33,0,FALSE,NA,"0.1.4"
"24670","646",2023-05-15 23:15:00,972,1006,34,0,FALSE,NA,"0.1.4"
"24671","646",2023-05-15 23:30:00,974,1006,32,0,FALSE,NA,"0.1.4"
"24672","646",2023-05-15 23:45:00,974,1006,32,0,FALSE,NA,"0.1.4"
"24673","646",2023-05-16,975,1006,31,0,FALSE,NA,"0.1.4"
"24674","646",2023-05-16 00:15:00,975,1006,31,0,FALSE,NA,"0.1.4"
"24675","646",2023-05-16 00:30:00,975,1006,31,0,FALSE,NA,"0.1.4"
"24676","646",2023-05-16 00:45:00,975,1006,31,0,FALSE,NA,"0.1.4"
"24677","646",2023-05-16 01:00:00,975,1006,31,0,FALSE,NA,"0.1.4"
"24678","646",2023-05-16 01:15:00,970,1006,36,0,FALSE,NA,"0.1.4"
"24679","646",2023-05-16 01:30:00,970,1006,36,0,FALSE,NA,"0.1.4"
"24680","646",2023-05-16 01:45:00,971,1006,35,0,FALSE,NA,"0.1.4"
"24681","646",2023-05-16 02:00:00,972,1006,34,0,FALSE,NA,"0.1.4"
"24682","646",2023-05-16 02:15:00,973,1006,33,0,FALSE,NA,"0.1.4"
"24683","646",2023-05-16 02:30:00,970,1006,36,0,FALSE,NA,"0.1.4"
"24684","646",2023-05-16 02:45:00,973,1006,33,0,FALSE,NA,"0.1.4"
"24685","646",2023-05-16 03:00:00,979,1006,27,0,FALSE,NA,"0.1.4"
"24686","646",2023-05-16 03:15:00,976,1006,30,0,FALSE,NA,"0.1.4"
"24687","646",2023-05-16 03:30:00,975,1006,31,0,FALSE,NA,"0.1.4"
"24688","646",2023-05-16 03:45:00,976,1006,30,0,FALSE,NA,"0.1.4"
"24689","646",2023-05-16 04:00:00,971,1006,35,0,FALSE,NA,"0.1.4"
"24690","646",2023-05-16 04:15:00,979,1006,27,0,FALSE,NA,"0.1.4"
"24691","646",2023-05-16 04:30:00,971,1006,35,0,FALSE,NA,"0.1.4"
"24692","646",2023-05-16 04:45:00,979,1006,27,0,FALSE,NA,"0.1.4"
"24693","646",2023-05-16 05:00:00,980,1006,26,0,FALSE,NA,"0.1.4"
"24694","646",2023-05-16 05:15:00,975,1006,31,0,FALSE,NA,"0.1.4"
"24695","646",2023-05-16 05:30:00,980,1006,26,0,FALSE,NA,"0.1.4"
"24696","646",2023-05-16 05:45:00,980,1006,26,0,FALSE,NA,"0.1.4"
"24697","646",2023-05-16 06:00:00,975,1006,31,0,FALSE,NA,"0.1.4"
"24698","646",2023-05-16 06:15:00,978,1006,28,0,FALSE,NA,"0.1.4"
"24699","646",2023-05-16 06:30:00,989,1006,17,0,FALSE,NA,"0.1.4"
"24700","646",2023-05-16 06:45:00,988,1006,18,0,FALSE,NA,"0.1.4"
"24701","646",2023-05-16 07:00:00,984,1006,22,0,FALSE,NA,"0.1.4"
"24702","646",2023-05-16 07:15:00,985,1006,21,0,FALSE,NA,"0.1.4"
"24703","646",2023-05-16 07:30:00,981,1006,25,0,FALSE,NA,"0.1.4"
"24704","646",2023-05-16 07:45:00,984,1006,22,0,FALSE,NA,"0.1.4"
"24705","646",2023-05-16 08:00:00,989,1006,17,0,FALSE,NA,"0.1.4"
"24706","646",2023-05-16 08:15:00,989,1006,17,0,FALSE,NA,"0.1.4"
"24707","646",2023-05-16 08:30:00,990,1006,16,0,FALSE,NA,"0.1.4"
"24708","646",2023-05-16 08:45:00,980,1006,26,0,FALSE,NA,"0.1.4"
"24709","646",2023-05-16 09:00:00,993,1006,13,0,FALSE,NA,"0.1.4"
"24710","646",2023-05-16 09:15:00,985,1006,21,0,FALSE,NA,"0.1.4"
"24711","646",2023-05-16 09:30:00,976,1006,30,0,FALSE,NA,"0.1.4"
"24712","646",2023-05-16 09:45:00,979,1006,27,0,FALSE,NA,"0.1.4"
"24713","646",2023-05-16 10:00:00,983,1006,23,0,FALSE,NA,"0.1.4"
"24714","646",2023-05-16 10:15:00,995,1006,11,0,FALSE,NA,"0.1.4"
"24715","646",2023-05-16 10:30:00,992,1006,14,0,FALSE,NA,"0.1.4"
"24716","646",2023-05-16 10:45:00,990,1006,16,0,FALSE,NA,"0.1.4"
"24717","646",2023-05-16 11:00:00,992,1006,14,0,FALSE,NA,"0.1.4"
"24718","646",2023-05-16 11:15:00,986,1006,20,0,FALSE,NA,"0.1.4"
"24719","646",2023-05-16 11:30:00,984,1006,22,0,FALSE,NA,"0.1.4"
"24720","646",2023-05-16 11:45:00,984,1006,22,0,FALSE,NA,"0.1.4"
"24721","646",2023-05-16 12:00:00,981,1006,25,0,FALSE,NA,"0.1.4"
"24722","646",2023-05-16 12:15:00,982,1006,24,0,FALSE,NA,"0.1.4"
"24723","646",2023-05-16 12:30:00,987,1006,19,0,FALSE,NA,"0.1.4"
"24724","646",2023-05-16 12:45:00,989,1006,17,0,FALSE,NA,"0.1.4"
"24725","646",2023-05-16 13:00:00,985,1006,21,0,FALSE,NA,"0.1.4"
"24726","646",2023-05-16 13:15:00,988,1006,18,0,FALSE,NA,"0.1.4"
"24727","646",2023-05-16 13:30:00,984,1006,22,0,FALSE,NA,"0.1.4"
"24728","646",2023-05-16 13:45:00,988,1006,18,0,FALSE,NA,"0.1.4"
"24729","646",2023-05-16 14:00:00,992,1006,14,0,FALSE,NA,"0.1.4"
"24730","646",2023-05-16 14:15:00,993,1006,13,0,FALSE,NA,"0.1.4"
"24731","646",2023-05-16 14:30:00,994,1006,12,0,FALSE,NA,"0.1.4"
"24732","646",2023-05-16 14:45:00,991,1006,15,0,FALSE,NA,"0.1.4"
"24733","646",2023-05-16 15:00:00,994,1006,12,0,FALSE,NA,"0.1.4"
"24734","646",2023-05-16 15:15:00,993,1006,13,0,FALSE,NA,"0.1.4"
"24735","646",2023-05-16 15:30:00,994,1006,12,0,FALSE,NA,"0.1.4"
"24736","646",2023-05-16 15:45:00,992,1006,14,0,FALSE,NA,"0.1.4"
"24737","646",2023-05-16 16:00:00,992,1006,14,0,FALSE,NA,"0.1.4"
"24738","646",2023-05-16 16:15:00,994,1006,12,0,FALSE,NA,"0.1.4"
"24739","646",2023-05-16 16:30:00,995,1006,11,0,FALSE,NA,"0.1.4"
"24740","646",2023-05-16 16:45:00,993,1006,13,0,FALSE,NA,"0.1.4"
"24741","646",2023-05-16 17:00:00,993,1006,13,0,FALSE,NA,"0.1.4"
"24742","646",2023-05-16 17:15:00,995,1006,11,0,FALSE,NA,"0.1.4"
"24743","646",2023-05-16 17:30:00,992,1006,14,0,FALSE,NA,"0.1.4"
"24744","646",2023-05-16 17:45:00,985,1006,21,0,FALSE,NA,"0.1.4"
"24745","646",2023-05-16 18:00:00,983,1006,23,0,FALSE,NA,"0.1.4"
"24746","646",2023-05-16 18:15:00,985,1006,21,0,FALSE,NA,"0.1.4"
"24747","646",2023-05-16 18:30:00,983,1006,23,0,FALSE,NA,"0.1.4"
"24748","646",2023-05-16 18:45:00,980,1006,26,0,FALSE,NA,"0.1.4"
"24749","646",2023-05-16 19:00:00,985,1006,21,0,FALSE,NA,"0.1.4"
"24750","646",2023-05-16 19:15:00,984,1006,22,0,FALSE,NA,"0.1.4"
"24751","646",2023-05-16 19:30:00,986,1006,20,0,FALSE,NA,"0.1.4"
"24752","646",2023-05-16 19:45:00,986,1006,20,0,FALSE,NA,"0.1.4"
"24753","646",2023-05-16 20:00:00,987,1006,19,0,FALSE,NA,"0.1.4"
"24754","646",2023-05-16 20:15:00,984,1006,22,0,FALSE,NA,"0.1.4"
"24755","646",2023-05-16 20:30:00,980,1006,26,0,FALSE,NA,"0.1.4"
"24756","646",2023-05-16 20:45:00,981,1006,25,0,FALSE,NA,"0.1.4"
"24757","646",2023-05-16 21:00:00,980,1006,26,0,FALSE,NA,"0.1.4"
"24758","646",2023-05-16 21:15:00,981,1006,25,0,FALSE,NA,"0.1.4"
"24759","646",2023-05-16 21:30:00,980,1006,26,0,FALSE,NA,"0.1.4"
"24760","646",2023-05-16 21:45:00,981,1006,25,0,FALSE,NA,"0.1.4"
"24761","646",2023-05-16 22:00:00,983,1006,23,0,FALSE,NA,"0.1.4"
"24762","646",2023-05-16 22:15:00,973,1006,33,0,FALSE,NA,"0.1.4"
"24763","646",2023-05-16 22:30:00,987,1006,19,0,FALSE,NA,"0.1.4"
"24764","646",2023-05-16 22:45:00,986,1006,20,0,FALSE,NA,"0.1.4"
"24765","646",2023-05-16 23:00:00,988,1006,18,0,FALSE,NA,"0.1.4"
"24766","646",2023-05-16 23:15:00,988,1006,18,0,FALSE,NA,"0.1.4"
"24767","646",2023-05-16 23:30:00,983,1006,23,0,FALSE,NA,"0.1.4"
"24768","646",2023-05-16 23:45:00,988,1006,18,0,FALSE,NA,"0.1.4"
"24769","646",2023-05-17,987,1006,19,0,FALSE,NA,"0.1.4"
"24770","646",2023-05-17 00:15:00,988,1006,18,0,FALSE,NA,"0.1.4"
"24771","646",2023-05-17 00:30:00,993,1006,13,0,FALSE,NA,"0.1.4"
"24772","646",2023-05-17 00:45:00,1009,1009,0,3,FALSE,NA,"0.1.4"
"24773","646",2023-05-17 01:00:00,1016,1016,0,10,FALSE,NA,"0.1.4"
"24774","646",2023-05-17 01:15:00,1000,1016,16,10,FALSE,NA,"0.1.4"
"24775","646",2023-05-17 01:30:00,1012,1016,4,10,FALSE,NA,"0.1.4"
"24776","646",2023-05-17 01:45:00,1000,1016,16,10,FALSE,NA,"0.1.4"
"24777","646",2023-05-17 02:00:00,998,1016,18,10,FALSE,NA,"0.1.4"
"24778","646",2023-05-17 02:15:00,996,1016,20,10,FALSE,NA,"0.1.4"
"24779","646",2023-05-17 02:30:00,1010,1016,6,10,FALSE,NA,"0.1.4"
"24780","646",2023-05-17 02:45:00,1003,1016,13,10,FALSE,NA,"0.1.4"
"24781","646",2023-05-17 03:00:00,1004,1016,12,10,FALSE,NA,"0.1.4"
"24782","646",2023-05-17 03:15:00,1000,1016,16,10,FALSE,NA,"0.1.4"
"24783","646",2023-05-17 03:30:00,1000,1016,16,10,FALSE,NA,"0.1.4"
"24784","646",2023-05-17 03:45:00,991,1016,25,10,FALSE,NA,"0.1.4"
"24785","646",2023-05-17 04:00:00,1013,1016,3,10,FALSE,NA,"0.1.4"
"24786","646",2023-05-17 04:15:00,1010,1016,6,10,FALSE,NA,"0.1.4"
"24787","646",2023-05-17 04:30:00,1008,1016,8,10,FALSE,NA,"0.1.4"
"24788","646",2023-05-17 04:45:00,1021,1021,0,15,FALSE,NA,"0.1.4"
"24789","646",2023-05-17 05:00:00,1014,1021,7,15,FALSE,NA,"0.1.4"
"24790","646",2023-05-17 05:15:00,1001,1021,20,15,FALSE,NA,"0.1.4"
"24791","646",2023-05-17 05:30:00,1034,1034,0,28,FALSE,NA,"0.1.4"
"24792","646",2023-05-17 05:45:00,1034,1034,0,28,FALSE,NA,"0.1.4"
"24793","646",2023-05-17 06:00:00,1026,1034,8,28,FALSE,NA,"0.1.4"
"24794","646",2023-05-17 06:15:00,1012,1034,22,28,FALSE,NA,"0.1.4"
"24795","646",2023-05-17 06:30:00,1039,1039,0,33,FALSE,NA,"0.1.4"
"24796","646",2023-05-17 06:45:00,1027,1039,12,33,FALSE,NA,"0.1.4"
"24797","646",2023-05-17 07:00:00,1026,1039,13,33,FALSE,NA,"0.1.4"
"24798","646",2023-05-17 07:15:00,1027,1039,12,33,FALSE,NA,"0.1.4"
"24799","646",2023-05-17 07:30:00,1018,1039,21,33,FALSE,NA,"0.1.4"
"24800","646",2023-05-17 07:45:00,1013,1039,26,33,FALSE,NA,"0.1.4"
"24801","646",2023-05-17 08:00:00,1013,1039,26,33,FALSE,NA,"0.1.4"
"24802","646",2023-05-17 08:15:00,1031,1039,8,33,FALSE,NA,"0.1.4"
"24803","646",2023-05-17 08:30:00,1050,1050,0,44,FALSE,NA,"0.1.4"
"24804","646",2023-05-17 08:45:00,1049,1050,1,44,FALSE,NA,"0.1.4"
"24805","646",2023-05-17 09:00:00,1039,1050,11,44,FALSE,NA,"0.1.4"
"24806","646",2023-05-17 09:15:00,1028,1050,22,44,FALSE,NA,"0.1.4"
"24807","646",2023-05-17 09:30:00,1021,1050,29,44,FALSE,NA,"0.1.4"
"24808","646",2023-05-17 09:45:00,1031,1050,19,44,FALSE,NA,"0.1.4"
"24809","646",2023-05-17 10:00:00,1022,1050,28,44,FALSE,NA,"0.1.4"
"24810","646",2023-05-17 10:15:00,1035,1050,15,44,FALSE,NA,"0.1.4"
"24811","646",2023-05-17 10:30:00,1035,1050,15,44,FALSE,NA,"0.1.4"
"24812","646",2023-05-17 10:45:00,1040,1050,10,44,FALSE,NA,"0.1.4"
"24813","646",2023-05-17 11:00:00,1028,1050,22,44,FALSE,NA,"0.1.4"
"24814","646",2023-05-17 11:15:00,1042,1050,8,44,FALSE,NA,"0.1.4"
"24815","646",2023-05-17 11:30:00,1054,1054,0,48,FALSE,NA,"0.1.4"
"24816","646",2023-05-17 11:45:00,1044,1054,10,48,FALSE,NA,"0.1.4"
"24817","646",2023-05-17 12:00:00,1063,1063,0,57,FALSE,NA,"0.1.4"
"24818","646",2023-05-17 12:15:00,1066,1066,0,60,FALSE,NA,"0.1.4"
"24819","646",2023-05-17 12:30:00,1069,1069,0,63,FALSE,NA,"0.1.4"
"24820","646",2023-05-17 12:45:00,1043,1069,26,63,FALSE,NA,"0.1.4"
"24821","646",2023-05-17 13:00:00,1051,1069,18,63,FALSE,NA,"0.1.4"
"24822","646",2023-05-17 13:15:00,1045,1069,24,63,FALSE,NA,"0.1.4"
"24823","646",2023-05-17 13:30:00,1051,1069,18,63,FALSE,NA,"0.1.4"
"24824","646",2023-05-17 13:45:00,1043,1069,26,63,FALSE,NA,"0.1.4"
"24825","646",2023-05-17 14:00:00,1064,1069,5,63,FALSE,NA,"0.1.4"
"24826","646",2023-05-17 14:15:00,1066,1069,3,63,FALSE,NA,"0.1.4"
"24827","646",2023-05-17 14:30:00,1066,1069,3,63,FALSE,NA,"0.1.4"
"24828","646",2023-05-17 14:45:00,1062,1069,7,63,FALSE,NA,"0.1.4"
"24829","646",2023-05-17 15:00:00,1057,1069,12,63,FALSE,NA,"0.1.4"
"24830","646",2023-05-17 15:15:00,1057,1069,12,63,FALSE,NA,"0.1.4"
"24831","646",2023-05-17 15:30:00,1057,1069,12,63,FALSE,NA,"0.1.4"
"24832","646",2023-05-17 15:45:00,1054,1069,15,63,FALSE,NA,"0.1.4"
"24833","646",2023-05-17 16:00:00,1055,1069,14,63,FALSE,NA,"0.1.4"
"24834","646",2023-05-17 16:15:00,1047,1069,22,63,FALSE,NA,"0.1.4"
"24835","646",2023-05-17 16:30:00,1049,1069,20,63,FALSE,NA,"0.1.4"
"24836","646",2023-05-17 16:45:00,1045,1069,24,63,FALSE,NA,"0.1.4"
"24837","646",2023-05-17 17:00:00,1050,1069,19,63,FALSE,NA,"0.1.4"
"24838","646",2023-05-17 17:15:00,1048,1069,21,63,FALSE,NA,"0.1.4"
"24839","646",2023-05-17 17:30:00,1049,1069,20,63,FALSE,NA,"0.1.4"
"24840","646",2023-05-17 17:45:00,1057,1069,12,63,FALSE,NA,"0.1.4"
"24841","646",2023-05-17 18:00:00,1054,1069,15,63,FALSE,NA,"0.1.4"
"24842","646",2023-05-17 18:15:00,1054,1069,15,63,FALSE,NA,"0.1.4"
"24843","646",2023-05-17 18:30:00,1054,1069,15,63,FALSE,NA,"0.1.4"
"24844","646",2023-05-17 18:45:00,1050,1069,19,63,FALSE,NA,"0.1.4"
"24845","646",2023-05-17 19:00:00,1055,1069,14,63,FALSE,NA,"0.1.4"
"24846","646",2023-05-17 19:15:00,1050,1069,19,63,FALSE,NA,"0.1.4"
"24847","646",2023-05-17 19:30:00,1058,1069,11,63,FALSE,NA,"0.1.4"
"24848","646",2023-05-17 19:45:00,1057,1069,12,63,FALSE,NA,"0.1.4"
"24849","646",2023-05-17 20:00:00,1057,1069,12,63,FALSE,NA,"0.1.4"
"24850","646",2023-05-17 20:15:00,1056,1069,13,63,FALSE,NA,"0.1.4"
"24851","646",2023-05-17 20:30:00,1056,1069,13,63,FALSE,NA,"0.1.4"
"24852","646",2023-05-17 20:45:00,1050,1069,19,63,FALSE,NA,"0.1.4"
"24853","646",2023-05-17 21:00:00,1050,1069,19,63,FALSE,NA,"0.1.4"
"24854","646",2023-05-17 21:15:00,1051,1069,18,63,FALSE,NA,"0.1.4"
"24855","646",2023-05-17 21:30:00,1052,1069,17,63,FALSE,NA,"0.1.4"
"24856","646",2023-05-17 21:45:00,1048,1069,21,63,FALSE,NA,"0.1.4"
"24857","646",2023-05-17 22:00:00,1048,1069,21,63,FALSE,NA,"0.1.4"
"24858","646",2023-05-17 22:15:00,1049,1069,20,63,FALSE,NA,"0.1.4"
"24859","646",2023-05-17 22:30:00,1048,1069,21,63,FALSE,NA,"0.1.4"
"24860","646",2023-05-17 22:45:00,1049,1069,20,63,FALSE,NA,"0.1.4"
"24861","646",2023-05-17 23:00:00,1049,1069,20,63,FALSE,NA,"0.1.4"
"24862","646",2023-05-17 23:15:00,1048,1069,21,63,FALSE,NA,"0.1.4"
"24863","646",2023-05-17 23:30:00,1048,1069,21,63,FALSE,NA,"0.1.4"
"24864","646",2023-05-17 23:45:00,1048,1069,21,63,FALSE,NA,"0.1.4"
"24865","646",2023-05-18,1047,1069,22,63,FALSE,NA,"0.1.4"
"24866","646",2023-05-18 00:15:00,1048,1069,21,63,FALSE,NA,"0.1.4"
"24867","646",2023-05-18 00:30:00,1050,1069,19,63,FALSE,NA,"0.1.4"
"24868","646",2023-05-18 00:45:00,1049,1069,20,63,FALSE,NA,"0.1.4"
"24869","646",2023-05-18 01:00:00,1049,1069,20,63,FALSE,NA,"0.1.4"
"24870","646",2023-05-18 01:15:00,1051,1069,18,63,FALSE,NA,"0.1.4"
"24871","646",2023-05-18 01:30:00,1048,1069,21,63,FALSE,NA,"0.1.4"
"24872","646",2023-05-18 01:45:00,1058,1069,11,63,FALSE,NA,"0.1.4"
"24873","646",2023-05-18 02:00:00,1060,1069,9,63,FALSE,NA,"0.1.4"
"24874","646",2023-05-18 02:15:00,1059,1069,10,63,FALSE,NA,"0.1.4"
"24875","646",2023-05-18 02:30:00,1058,1069,11,63,FALSE,NA,"0.1.4"
"24876","646",2023-05-18 02:45:00,1052,1069,17,63,FALSE,NA,"0.1.4"
"24877","646",2023-05-18 03:00:00,1058,1069,11,63,FALSE,NA,"0.1.4"
"24878","646",2023-05-18 03:15:00,1044,1069,25,63,FALSE,NA,"0.1.4"
"24879","646",2023-05-18 03:30:00,1053,1069,16,63,FALSE,NA,"0.1.4"
"24880","646",2023-05-18 03:45:00,1061,1069,8,63,FALSE,NA,"0.1.4"
"24881","646",2023-05-18 04:00:00,1057,1069,12,63,FALSE,NA,"0.1.4"
"24882","646",2023-05-18 04:15:00,1057,1069,12,63,FALSE,NA,"0.1.4"
"24883","646",2023-05-18 04:30:00,1053,1069,16,63,FALSE,NA,"0.1.4"
"24884","646",2023-05-18 04:45:00,1059,1069,10,63,FALSE,NA,"0.1.4"
"24885","646",2023-05-18 05:00:00,1053,1069,16,63,FALSE,NA,"0.1.4"
"24886","646",2023-05-18 05:15:00,1057,1069,12,63,FALSE,NA,"0.1.4"
"24887","646",2023-05-18 05:30:00,1056,1069,13,63,FALSE,NA,"0.1.4"
"24888","646",2023-05-18 05:45:00,1060,1069,9,63,FALSE,NA,"0.1.4"
"24889","646",2023-05-18 06:00:00,1065,1069,4,63,FALSE,NA,"0.1.4"
"24890","646",2023-05-18 06:15:00,1056,1069,13,63,FALSE,NA,"0.1.4"
"24891","646",2023-05-18 06:30:00,1056,1069,13,63,FALSE,NA,"0.1.4"
"24892","646",2023-05-18 06:45:00,1052,1069,17,63,FALSE,NA,"0.1.4"
"24893","646",2023-05-18 07:00:00,1047,1069,22,63,FALSE,NA,"0.1.4"
"24894","646",2023-05-18 07:15:00,1048,1069,21,63,FALSE,NA,"0.1.4"
"24895","646",2023-05-18 07:30:00,1060,1069,9,63,FALSE,NA,"0.1.4"
"24896","646",2023-05-18 07:45:00,1050,1069,19,63,FALSE,NA,"0.1.4"
"24897","646",2023-05-18 08:00:00,1049,1069,20,63,FALSE,NA,"0.1.4"
"24898","646",2023-05-18 08:15:00,1072,1072,0,66,FALSE,NA,"0.1.4"
"24899","646",2023-05-18 08:30:00,1061,1072,11,66,FALSE,NA,"0.1.4"
"24900","646",2023-05-18 08:45:00,1058,1072,14,66,FALSE,NA,"0.1.4"
"24901","646",2023-05-18 09:00:00,1053,1072,19,66,FALSE,NA,"0.1.4"
"24902","646",2023-05-18 09:15:00,1056,1072,16,66,FALSE,NA,"0.1.4"
"24903","646",2023-05-18 09:30:00,1070,1072,2,66,FALSE,NA,"0.1.4"
"24904","646",2023-05-18 09:45:00,1066,1072,6,66,FALSE,NA,"0.1.4"
"24905","646",2023-05-18 10:00:00,1056,1072,16,66,FALSE,NA,"0.1.4"
"24906","646",2023-05-18 10:15:00,1083,1083,0,77,FALSE,NA,"0.1.4"
"24907","646",2023-05-18 10:30:00,1048,1083,35,77,FALSE,NA,"0.1.4"
"24908","646",2023-05-18 10:45:00,1084,1084,0,78,FALSE,NA,"0.1.4"
"24909","646",2023-05-18 11:00:00,1081,1084,3,78,FALSE,NA,"0.1.4"
"24910","646",2023-05-18 11:15:00,1080,1084,4,78,FALSE,NA,"0.1.4"
"24911","646",2023-05-18 11:30:00,1082,1084,2,78,FALSE,NA,"0.1.4"
"24912","646",2023-05-18 11:45:00,1081,1084,3,78,FALSE,NA,"0.1.4"
"24913","646",2023-05-18 12:00:00,1088,1088,0,82,FALSE,NA,"0.1.4"
"24914","646",2023-05-18 12:15:00,1082,1088,6,82,FALSE,NA,"0.1.4"
"24915","646",2023-05-18 12:30:00,1085,1088,3,82,FALSE,NA,"0.1.4"
"24916","646",2023-05-18 12:45:00,1089,1089,0,83,FALSE,NA,"0.1.4"
"24917","646",2023-05-18 13:00:00,1084,1089,5,83,FALSE,NA,"0.1.4"
"24918","646",2023-05-18 13:15:00,1073,1089,16,83,FALSE,NA,"0.1.4"
"24919","646",2023-05-18 13:30:00,1078,1089,11,83,FALSE,NA,"0.1.4"
"24920","646",2023-05-18 13:45:00,1089,1089,0,83,FALSE,NA,"0.1.4"
"24921","646",2023-05-18 14:00:00,1087,1089,2,83,FALSE,NA,"0.1.4"
"24922","646",2023-05-18 14:15:00,1095,1095,0,89,FALSE,NA,"0.1.4"
"24923","646",2023-05-18 14:30:00,1098,1098,0,92,FALSE,NA,"0.1.4"
"24924","646",2023-05-18 14:45:00,1094,1098,4,92,FALSE,NA,"0.1.4"
"24925","646",2023-05-18 15:00:00,1087,1098,11,92,FALSE,NA,"0.1.4"
"24926","646",2023-05-18 15:15:00,1085,1098,13,92,FALSE,NA,"0.1.4"
"24927","646",2023-05-18 15:30:00,1077,1098,21,92,FALSE,NA,"0.1.4"
"24928","646",2023-05-18 15:45:00,1072,1098,26,92,FALSE,NA,"0.1.4"
"24929","646",2023-05-18 16:00:00,1089,1098,9,92,FALSE,NA,"0.1.4"
"24930","646",2023-05-18 16:15:00,1084,1098,14,92,FALSE,NA,"0.1.4"
"24931","646",2023-05-18 16:30:00,1087,1098,11,92,FALSE,NA,"0.1.4"
"24932","646",2023-05-18 16:45:00,1083,1098,15,92,FALSE,NA,"0.1.4"
"24933","646",2023-05-18 17:00:00,1085,1098,13,92,FALSE,NA,"0.1.4"
"24934","646",2023-05-18 17:15:00,1074,1098,24,92,FALSE,NA,"0.1.4"
"24935","646",2023-05-18 17:30:00,1075,1098,23,92,FALSE,NA,"0.1.4"
"24936","646",2023-05-18 17:45:00,1075,1098,23,92,FALSE,NA,"0.1.4"
"24937","646",2023-05-18 18:00:00,1075,1098,23,92,FALSE,NA,"0.1.4"
"24938","646",2023-05-18 18:15:00,1072,1098,26,92,FALSE,NA,"0.1.4"
"24939","646",2023-05-18 18:30:00,1079,1098,19,92,FALSE,NA,"0.1.4"
"24940","646",2023-05-18 18:45:00,1079,1098,19,92,FALSE,NA,"0.1.4"
"24941","646",2023-05-18 19:00:00,1080,1098,18,92,FALSE,NA,"0.1.4"
"24942","646",2023-05-18 19:15:00,1081,1098,17,92,FALSE,NA,"0.1.4"
"24943","646",2023-05-18 19:30:00,1079,1098,19,92,FALSE,NA,"0.1.4"
"24944","646",2023-05-18 19:45:00,1078,1098,20,92,FALSE,NA,"0.1.4"
"24945","646",2023-05-18 20:00:00,1077,1098,21,92,FALSE,NA,"0.1.4"
"24946","646",2023-05-18 20:15:00,1078,1098,20,92,FALSE,NA,"0.1.4"
"24947","646",2023-05-18 20:30:00,1079,1098,19,92,FALSE,NA,"0.1.4"
"24948","646",2023-05-18 20:45:00,1078,1098,20,92,FALSE,NA,"0.1.4"
"24949","646",2023-05-18 21:00:00,1078,1098,20,92,FALSE,NA,"0.1.4"
"24950","646",2023-05-18 21:15:00,1077,1098,21,92,FALSE,NA,"0.1.4"
"24951","646",2023-05-18 21:30:00,1078,1098,20,92,FALSE,NA,"0.1.4"
"24952","646",2023-05-18 21:45:00,1079,1098,19,92,FALSE,NA,"0.1.4"
"24953","646",2023-05-18 22:00:00,1078,1098,20,92,FALSE,NA,"0.1.4"
"24954","646",2023-05-18 22:15:00,1077,1098,21,92,FALSE,NA,"0.1.4"
"24955","646",2023-05-18 22:30:00,1076,1098,22,92,FALSE,NA,"0.1.4"
"24956","646",2023-05-18 22:45:00,1077,1098,21,92,FALSE,NA,"0.1.4"
"24957","646",2023-05-18 23:00:00,1077,1098,21,92,FALSE,NA,"0.1.4"
"24958","646",2023-05-18 23:15:00,1077,1098,21,92,FALSE,NA,"0.1.4"
"24959","646",2023-05-18 23:30:00,1076,1098,22,92,FALSE,NA,"0.1.4"
"24960","646",2023-05-18 23:45:00,1076,1098,22,92,FALSE,NA,"0.1.4"
"24961","646",2023-05-19,1071,1098,27,92,FALSE,NA,"0.1.4"
"24962","646",2023-05-19 00:15:00,1076,1098,22,92,FALSE,NA,"0.1.4"
"24963","646",2023-05-19 00:30:00,1075,1098,23,92,FALSE,NA,"0.1.4"
"24964","646",2023-05-19 00:45:00,1073,1098,25,92,FALSE,NA,"0.1.4"
"24965","646",2023-05-19 01:00:00,1070,1098,28,92,FALSE,NA,"0.1.4"
"24966","646",2023-05-19 01:15:00,1070,1098,28,92,FALSE,NA,"0.1.4"
"24967","646",2023-05-19 01:30:00,1072,1098,26,92,FALSE,NA,"0.1.4"
"24968","646",2023-05-19 01:45:00,1075,1098,23,92,FALSE,NA,"0.1.4"
"24969","646",2023-05-19 02:00:00,1075,1098,23,92,FALSE,NA,"0.1.4"
"24970","646",2023-05-19 02:15:00,1075,1098,23,92,FALSE,NA,"0.1.4"
"24971","646",2023-05-19 02:30:00,1076,1098,22,92,FALSE,NA,"0.1.4"
"24972","646",2023-05-19 02:45:00,1073,1098,25,92,FALSE,NA,"0.1.4"
"24973","646",2023-05-19 03:00:00,1069,1098,29,92,FALSE,NA,"0.1.4"
"24974","646",2023-05-19 03:15:00,1072,1098,26,92,FALSE,NA,"0.1.4"
"24975","646",2023-05-19 03:30:00,1070,1098,28,92,FALSE,NA,"0.1.4"
"24976","646",2023-05-19 03:45:00,1079,1098,19,92,FALSE,NA,"0.1.4"
"24977","646",2023-05-19 04:00:00,1083,1098,15,92,FALSE,NA,"0.1.4"
"24978","646",2023-05-19 04:15:00,1075,1098,23,92,FALSE,NA,"0.1.4"
"24979","646",2023-05-19 04:30:00,1082,1098,16,92,FALSE,NA,"0.1.4"
"24980","646",2023-05-19 04:45:00,1075,1098,23,92,FALSE,NA,"0.1.4"
"24981","646",2023-05-19 05:00:00,1080,1098,18,92,FALSE,NA,"0.1.4"
"24982","646",2023-05-19 05:15:00,1087,1098,11,92,FALSE,NA,"0.1.4"
"24983","646",2023-05-19 05:30:00,1083,1098,15,92,FALSE,NA,"0.1.4"
"24984","646",2023-05-19 05:45:00,1093,1098,5,92,FALSE,NA,"0.1.4"
"24985","646",2023-05-19 06:00:00,1085,1098,13,92,FALSE,NA,"0.1.4"
"24986","646",2023-05-19 06:15:00,1069,1098,29,92,FALSE,NA,"0.1.4"
"24987","646",2023-05-19 06:30:00,1083,1098,15,92,FALSE,NA,"0.1.4"
"24988","646",2023-05-19 06:45:00,1071,1098,27,92,FALSE,NA,"0.1.4"
"24989","646",2023-05-19 07:00:00,1093,1098,5,92,FALSE,NA,"0.1.4"
"24990","646",2023-05-19 07:15:00,1097,1098,1,92,FALSE,NA,"0.1.4"
"24991","646",2023-05-19 07:30:00,1077,1098,21,92,FALSE,NA,"0.1.4"
"24992","646",2023-05-19 07:45:00,1084,1098,14,92,FALSE,NA,"0.1.4"
"24993","646",2023-05-19 08:00:00,1080,1098,18,92,FALSE,NA,"0.1.4"
"24994","646",2023-05-19 08:15:00,1089,1098,9,92,FALSE,NA,"0.1.4"
"24995","646",2023-05-19 08:30:00,1091,1098,7,92,FALSE,NA,"0.1.4"
"24996","646",2023-05-19 08:45:00,1088,1098,10,92,FALSE,NA,"0.1.4"
"24997","646",2023-05-19 09:00:00,1098,1098,0,92,FALSE,NA,"0.1.4"
"24998","646",2023-05-19 09:15:00,1105,1105,0,99,FALSE,NA,"0.1.4"
"24999","646",2023-05-19 09:30:00,1107,1107,0,101,FALSE,NA,"0.1.4"
"25000","646",2023-05-19 09:45:00,1101,1107,6,101,FALSE,NA,"0.1.4"
"25001","646",2023-05-19 10:00:00,1107,1107,0,101,FALSE,NA,"0.1.4"
"25002","646",2023-05-19 10:15:00,1100,1107,7,101,FALSE,NA,"0.1.4"
"25003","646",2023-05-19 10:30:00,1106,1107,1,101,FALSE,NA,"0.1.4"
"25004","646",2023-05-19 10:45:00,1107,1107,0,101,FALSE,NA,"0.1.4"
"25005","646",2023-05-19 11:00:00,1110,1110,0,104,FALSE,NA,"0.1.4"
"25006","646",2023-05-19 11:15:00,1108,1110,2,104,FALSE,NA,"0.1.4"
"25007","646",2023-05-19 11:30:00,1107,1110,3,104,FALSE,NA,"0.1.4"
"25008","646",2023-05-19 11:45:00,1103,1110,7,104,FALSE,NA,"0.1.4"
"25009","646",2023-05-19 12:00:00,1106,1110,4,104,FALSE,NA,"0.1.4"
"25010","646",2023-05-19 12:15:00,1108,1110,2,104,FALSE,NA,"0.1.4"
"25011","646",2023-05-19 12:30:00,1105,1110,5,104,FALSE,NA,"0.1.4"
"25012","646",2023-05-19 12:45:00,1109,1110,1,104,FALSE,NA,"0.1.4"
"25013","646",2023-05-19 13:00:00,1104,1110,6,104,FALSE,NA,"0.1.4"
"25014","646",2023-05-19 13:15:00,1094,1110,16,104,FALSE,NA,"0.1.4"
"25015","646",2023-05-19 13:30:00,1089,1110,21,104,FALSE,NA,"0.1.4"
"25016","646",2023-05-19 13:45:00,1073,1110,37,104,FALSE,NA,"0.1.4"
"25017","646",2023-05-19 14:00:00,1072,1110,38,104,FALSE,NA,"0.1.4"
"25018","646",2023-05-19 14:15:00,1068,1110,42,104,FALSE,NA,"0.1.4"
"25019","646",2023-05-19 14:30:00,1077,1110,33,104,FALSE,NA,"0.1.4"
"25020","646",2023-05-19 14:45:00,1089,1110,21,104,FALSE,NA,"0.1.4"
"25021","646",2023-05-19 15:00:00,1093,1110,17,104,FALSE,NA,"0.1.4"
"25022","646",2023-05-19 15:15:00,1094,1110,16,104,FALSE,NA,"0.1.4"
"25023","646",2023-05-19 15:30:00,1104,1110,6,104,FALSE,NA,"0.1.4"
"25024","646",2023-05-19 15:45:00,1101,1110,9,104,FALSE,NA,"0.1.4"
"25025","646",2023-05-19 16:00:00,1095,1110,15,104,FALSE,NA,"0.1.4"
"25026","646",2023-05-19 16:15:00,1114,1114,0,108,FALSE,NA,"0.1.4"
"25027","646",2023-05-19 16:30:00,1115,1115,0,109,FALSE,NA,"0.1.4"
"25028","646",2023-05-19 16:45:00,1118,1118,0,112,FALSE,NA,"0.1.4"
"25029","646",2023-05-19 17:00:00,1120,1120,0,114,FALSE,NA,"0.1.4"
"25030","646",2023-05-19 17:15:00,1123,1123,0,117,FALSE,NA,"0.1.4"
"25031","646",2023-05-19 17:30:00,1104,1123,19,117,FALSE,NA,"0.1.4"
"25032","646",2023-05-19 17:45:00,1104,1123,19,117,FALSE,NA,"0.1.4"
"25033","646",2023-05-19 18:00:00,1119,1123,4,117,FALSE,NA,"0.1.4"
"25034","646",2023-05-19 18:15:00,1114,1123,9,117,FALSE,NA,"0.1.4"
"25035","646",2023-05-19 18:30:00,1115,1123,8,117,FALSE,NA,"0.1.4"
"25036","646",2023-05-19 18:45:00,1115,1123,8,117,FALSE,NA,"0.1.4"
"25037","646",2023-05-19 19:00:00,1113,1123,10,117,FALSE,NA,"0.1.4"
"25038","646",2023-05-19 19:15:00,1116,1123,7,117,FALSE,NA,"0.1.4"
"25039","646",2023-05-19 19:30:00,1105,1123,18,117,FALSE,NA,"0.1.4"
"25040","646",2023-05-19 19:45:00,1105,1123,18,117,FALSE,NA,"0.1.4"
"25041","646",2023-05-19 20:00:00,1104,1123,19,117,FALSE,NA,"0.1.4"
"25042","646",2023-05-19 20:15:00,1105,1123,18,117,FALSE,NA,"0.1.4"
"25043","646",2023-05-19 20:30:00,1101,1123,22,117,FALSE,NA,"0.1.4"
"25044","646",2023-05-19 20:45:00,1110,1123,13,117,FALSE,NA,"0.1.4"
"25045","646",2023-05-19 21:00:00,1103,1123,20,117,FALSE,NA,"0.1.4"
"25046","646",2023-05-19 21:15:00,1104,1123,19,117,FALSE,NA,"0.1.4"
"25047","646",2023-05-19 21:30:00,1103,1123,20,117,FALSE,NA,"0.1.4"
"25048","646",2023-05-19 21:45:00,1104,1123,19,117,FALSE,NA,"0.1.4"
"25049","646",2023-05-19 22:00:00,1103,1123,20,117,FALSE,NA,"0.1.4"
"25050","646",2023-05-19 22:15:00,1100,1123,23,117,FALSE,NA,"0.1.4"
"25051","646",2023-05-19 22:30:00,1100,1123,23,117,FALSE,NA,"0.1.4"
"25052","646",2023-05-19 22:45:00,1098,1123,25,117,FALSE,NA,"0.1.4"
"25053","646",2023-05-19 23:00:00,1096,1123,27,117,FALSE,NA,"0.1.4"
"25054","646",2023-05-19 23:15:00,1094,1123,29,117,FALSE,NA,"0.1.4"
"25055","646",2023-05-19 23:30:00,1095,1123,28,117,FALSE,NA,"0.1.4"
"25056","646",2023-05-19 23:45:00,1097,1123,26,117,FALSE,NA,"0.1.4"
"25057","646",2023-05-20,1099,1123,24,117,FALSE,NA,"0.1.4"
"25058","646",2023-05-20 00:15:00,1096,1123,27,117,FALSE,NA,"0.1.4"
"25059","646",2023-05-20 00:30:00,1090,1123,33,117,FALSE,NA,"0.1.4"
"25060","646",2023-05-20 00:45:00,1090,1123,33,117,FALSE,NA,"0.1.4"
"25061","646",2023-05-20 01:00:00,1091,1123,32,117,FALSE,NA,"0.1.4"
"25062","646",2023-05-20 01:15:00,1107,1123,16,117,FALSE,NA,"0.1.4"
"25063","646",2023-05-20 01:30:00,1106,1123,17,117,FALSE,NA,"0.1.4"
"25064","646",2023-05-20 01:45:00,1111,1123,12,117,FALSE,NA,"0.1.4"
"25065","646",2023-05-20 02:00:00,1117,1123,6,117,FALSE,NA,"0.1.4"
"25066","646",2023-05-20 02:15:00,1125,1125,0,119,FALSE,NA,"0.1.4"
"25067","646",2023-05-20 02:30:00,1105,1125,20,119,FALSE,NA,"0.1.4"
"25068","646",2023-05-20 02:45:00,1118,1125,7,119,FALSE,NA,"0.1.4"
"25069","646",2023-05-20 03:00:00,1108,1125,17,119,FALSE,NA,"0.1.4"
"25070","646",2023-05-20 03:15:00,1116,1125,9,119,FALSE,NA,"0.1.4"
"25071","646",2023-05-20 03:30:00,1116,1125,9,119,FALSE,NA,"0.1.4"
"25072","646",2023-05-20 03:45:00,1116,1125,9,119,FALSE,NA,"0.1.4"
"25073","646",2023-05-20 04:00:00,1119,1125,6,119,FALSE,NA,"0.1.4"
"25074","646",2023-05-20 04:15:00,1121,1125,4,119,FALSE,NA,"0.1.4"
"25075","646",2023-05-20 04:30:00,1107,1125,18,119,FALSE,NA,"0.1.4"
"25076","646",2023-05-20 04:45:00,1102,1125,23,119,FALSE,NA,"0.1.4"
"25077","646",2023-05-20 05:00:00,1096,1125,29,119,FALSE,NA,"0.1.4"
"25078","646",2023-05-20 05:15:00,1120,1125,5,119,FALSE,NA,"0.1.4"
"25079","646",2023-05-20 05:30:00,1123,1125,2,119,FALSE,NA,"0.1.4"
"25080","646",2023-05-20 05:45:00,1120,1125,5,119,FALSE,NA,"0.1.4"
"25081","646",2023-05-20 06:00:00,1118,1125,7,119,FALSE,NA,"0.1.4"
"25082","646",2023-05-20 06:15:00,1115,1125,10,119,FALSE,NA,"0.1.4"
"25083","646",2023-05-20 06:30:00,1119,1125,6,119,FALSE,NA,"0.1.4"
"25084","646",2023-05-20 06:45:00,1130,1130,0,124,FALSE,NA,"0.1.4"
"25085","646",2023-05-20 07:00:00,1127,1130,3,124,FALSE,NA,"0.1.4"
"25086","646",2023-05-20 07:15:00,1114,1130,16,124,FALSE,NA,"0.1.4"
"25087","646",2023-05-20 07:30:00,1098,1130,32,124,FALSE,NA,"0.1.4"
"25088","646",2023-05-20 07:45:00,1110,1130,20,124,FALSE,NA,"0.1.4"
"25089","646",2023-05-20 08:00:00,1125,1130,5,124,FALSE,NA,"0.1.4"
"25090","646",2023-05-20 08:15:00,1110,1130,20,124,FALSE,NA,"0.1.4"
"25091","646",2023-05-20 08:30:00,1129,1130,1,124,FALSE,NA,"0.1.4"
"25092","646",2023-05-20 08:45:00,1117,1130,13,124,FALSE,NA,"0.1.4"
"25093","646",2023-05-20 09:00:00,1104,1130,26,124,FALSE,NA,"0.1.4"
"25094","646",2023-05-20 09:15:00,1123,1130,7,124,FALSE,NA,"0.1.4"
"25095","646",2023-05-20 09:30:00,1120,1130,10,124,FALSE,NA,"0.1.4"
"25096","646",2023-05-20 09:45:00,1110,1130,20,124,FALSE,NA,"0.1.4"
"25097","646",2023-05-20 10:00:00,1094,1130,36,124,FALSE,NA,"0.1.4"
"25098","646",2023-05-20 10:15:00,1121,1130,9,124,FALSE,NA,"0.1.4"
"25099","646",2023-05-20 10:30:00,1117,1130,13,124,FALSE,NA,"0.1.4"
"25100","646",2023-05-20 10:45:00,1107,1130,23,124,FALSE,NA,"0.1.4"
"25101","646",2023-05-20 11:00:00,1126,1130,4,124,FALSE,NA,"0.1.4"
"25102","646",2023-05-20 11:15:00,1126,1130,4,124,FALSE,NA,"0.1.4"
"25103","646",2023-05-20 11:30:00,1120,1130,10,124,FALSE,NA,"0.1.4"
"25104","646",2023-05-20 11:45:00,1111,1130,19,124,FALSE,NA,"0.1.4"
"25105","646",2023-05-20 12:00:00,1082,1130,48,124,FALSE,NA,"0.1.4"
"25106","646",2023-05-20 12:15:00,1117,1130,13,124,FALSE,NA,"0.1.4"
"25107","646",2023-05-20 12:30:00,1120,1130,10,124,FALSE,NA,"0.1.4"
"25108","646",2023-05-20 12:45:00,1105,1130,25,124,FALSE,NA,"0.1.4"
"25109","646",2023-05-20 13:00:00,1102,1130,28,124,FALSE,NA,"0.1.4"
"25110","646",2023-05-20 13:15:00,1102,1130,28,124,FALSE,NA,"0.1.4"
"25111","646",2023-05-20 13:30:00,1137,1137,0,131,FALSE,NA,"0.1.4"
"25112","646",2023-05-20 13:45:00,1094,1137,43,131,FALSE,NA,"0.1.4"
"25113","646",2023-05-20 14:00:00,1115,1137,22,131,FALSE,NA,"0.1.4"
"25114","646",2023-05-20 14:15:00,1118,1137,19,131,FALSE,NA,"0.1.4"
"25115","646",2023-05-20 14:30:00,1095,1137,42,131,FALSE,NA,"0.1.4"
"25116","646",2023-05-20 14:45:00,1107,1137,30,131,FALSE,NA,"0.1.4"
"25117","646",2023-05-20 15:00:00,1116,1137,21,131,FALSE,NA,"0.1.4"
"25118","646",2023-05-20 15:15:00,1116,1137,21,131,FALSE,NA,"0.1.4"
"25119","646",2023-05-20 15:30:00,1117,1137,20,131,FALSE,NA,"0.1.4"
"25120","646",2023-05-20 15:45:00,1119,1137,18,131,FALSE,NA,"0.1.4"
"25121","646",2023-05-20 16:00:00,1118,1137,19,131,FALSE,NA,"0.1.4"
"25122","646",2023-05-20 16:15:00,1119,1137,18,131,FALSE,NA,"0.1.4"
"25123","646",2023-05-20 16:30:00,1119,1137,18,131,FALSE,NA,"0.1.4"
"25124","646",2023-05-20 16:45:00,1119,1137,18,131,FALSE,NA,"0.1.4"
"25125","646",2023-05-20 17:00:00,1117,1137,20,131,FALSE,NA,"0.1.4"
"25126","646",2023-05-20 17:15:00,1118,1137,19,131,FALSE,NA,"0.1.4"
"25127","646",2023-05-20 17:30:00,1120,1137,17,131,FALSE,NA,"0.1.4"
"25128","646",2023-05-20 17:45:00,1113,1137,24,131,FALSE,NA,"0.1.4"
"25129","646",2023-05-20 18:00:00,1114,1137,23,131,FALSE,NA,"0.1.4"
"25130","646",2023-05-20 18:15:00,1118,1137,19,131,FALSE,NA,"0.1.4"
"25131","646",2023-05-20 18:30:00,1089,1137,48,131,FALSE,NA,"0.1.4"
"25132","646",2023-05-20 18:45:00,1085,1137,52,131,FALSE,NA,"0.1.4"
"25133","646",2023-05-20 19:00:00,1090,1137,47,131,FALSE,NA,"0.1.4"
"25134","646",2023-05-20 19:15:00,1115,1137,22,131,FALSE,NA,"0.1.4"
"25135","646",2023-05-20 19:30:00,1115,1137,22,131,FALSE,NA,"0.1.4"
"25136","646",2023-05-20 19:45:00,1092,1137,45,131,FALSE,NA,"0.1.4"
"25137","646",2023-05-20 20:00:00,1109,1137,28,131,FALSE,NA,"0.1.4"
"25138","646",2023-05-20 20:15:00,1113,1137,24,131,FALSE,NA,"0.1.4"
"25139","646",2023-05-20 20:30:00,1109,1137,28,131,FALSE,NA,"0.1.4"
"25140","646",2023-05-20 20:45:00,1119,1137,18,131,FALSE,NA,"0.1.4"
"25141","646",2023-05-20 21:00:00,1112,1137,25,131,FALSE,NA,"0.1.4"
"25142","646",2023-05-20 21:15:00,1116,1137,21,131,FALSE,NA,"0.1.4"
"25143","646",2023-05-20 21:30:00,1108,1137,29,131,FALSE,NA,"0.1.4"
"25144","646",2023-05-20 21:45:00,1106,1137,31,131,FALSE,NA,"0.1.4"
"25145","646",2023-05-20 22:00:00,1105,1137,32,131,FALSE,NA,"0.1.4"
"25146","646",2023-05-20 22:15:00,1106,1137,31,131,FALSE,NA,"0.1.4"
"25147","646",2023-05-20 22:30:00,1113,1137,24,131,FALSE,NA,"0.1.4"
"25148","646",2023-05-20 22:45:00,1122,1137,15,131,FALSE,NA,"0.1.4"
"25149","646",2023-05-20 23:00:00,1117,1137,20,131,FALSE,NA,"0.1.4"
"25150","646",2023-05-20 23:15:00,1113,1137,24,131,FALSE,NA,"0.1.4"
"25151","646",2023-05-20 23:30:00,1108,1137,29,131,FALSE,NA,"0.1.4"
"25152","646",2023-05-20 23:45:00,1107,1137,30,131,FALSE,NA,"0.1.4"
"25153","646",2023-05-21,1110,1137,27,131,FALSE,NA,"0.1.4"
"25154","646",2023-05-21 00:15:00,1115,1137,22,131,FALSE,NA,"0.1.4"
"25155","646",2023-05-21 00:30:00,1117,1137,20,131,FALSE,NA,"0.1.4"
"25156","646",2023-05-21 00:45:00,1118,1137,19,131,FALSE,NA,"0.1.4"
"25157","646",2023-05-21 01:00:00,1119,1137,18,131,FALSE,NA,"0.1.4"
"25158","646",2023-05-21 01:15:00,1117,1137,20,131,FALSE,NA,"0.1.4"
"25159","646",2023-05-21 01:30:00,1101,1137,36,131,FALSE,NA,"0.1.4"
"25160","646",2023-05-21 01:45:00,1088,1137,49,131,FALSE,NA,"0.1.4"
"25161","646",2023-05-21 02:00:00,1098,1137,39,131,FALSE,NA,"0.1.4"
"25162","646",2023-05-21 02:15:00,1101,1137,36,131,FALSE,NA,"0.1.4"
"25163","646",2023-05-21 02:30:00,1107,1137,30,131,FALSE,NA,"0.1.4"
"25164","646",2023-05-21 02:45:00,1094,1137,43,131,FALSE,NA,"0.1.4"
"25165","646",2023-05-21 03:00:00,1120,1137,17,131,FALSE,NA,"0.1.4"
"25166","646",2023-05-21 03:15:00,1114,1137,23,131,FALSE,NA,"0.1.4"
"25167","646",2023-05-21 03:30:00,1122,1137,15,131,FALSE,NA,"0.1.4"
"25168","646",2023-05-21 03:45:00,1133,1137,4,131,FALSE,NA,"0.1.4"
"25169","646",2023-05-21 04:00:00,1134,1137,3,131,FALSE,NA,"0.1.4"
"25170","646",2023-05-21 04:15:00,1136,1137,1,131,FALSE,NA,"0.1.4"
"25171","646",2023-05-21 04:30:00,1129,1137,8,131,FALSE,NA,"0.1.4"
"25172","646",2023-05-21 04:45:00,1131,1137,6,131,FALSE,NA,"0.1.4"
"25173","646",2023-05-21 05:00:00,1131,1137,6,131,FALSE,NA,"0.1.4"
"25174","646",2023-05-21 05:15:00,1127,1137,10,131,FALSE,NA,"0.1.4"
"25175","646",2023-05-21 05:30:00,1148,1148,0,142,FALSE,NA,"0.1.4"
"25176","646",2023-05-21 05:45:00,1134,1148,14,142,FALSE,NA,"0.1.4"
"25177","646",2023-05-21 06:00:00,1098,1148,50,142,FALSE,NA,"0.1.4"
"25178","646",2023-05-21 06:15:00,1103,1148,45,142,FALSE,NA,"0.1.4"
"25179","646",2023-05-21 06:30:00,1077,1148,71,142,FALSE,NA,"0.1.4"
"25180","646",2023-05-21 06:45:00,1106,1148,42,142,FALSE,NA,"0.1.4"
"25181","646",2023-05-21 07:00:00,1105,1148,43,142,FALSE,NA,"0.1.4"
"25182","646",2023-05-21 07:15:00,1066,1148,82,142,FALSE,NA,"0.1.4"
"25183","646",2023-05-21 07:30:00,1082,1148,66,142,FALSE,NA,"0.1.4"
"25184","646",2023-05-21 07:45:00,1101,1148,47,142,FALSE,NA,"0.1.4"
"25185","646",2023-05-21 08:00:00,1080,1148,68,142,FALSE,NA,"0.1.4"
"25186","646",2023-05-21 08:15:00,1097,1148,51,142,FALSE,NA,"0.1.4"
"25187","646",2023-05-21 08:30:00,1113,1148,35,142,FALSE,NA,"0.1.4"
"25188","646",2023-05-21 08:45:00,1120,1148,28,142,FALSE,NA,"0.1.4"
"25189","646",2023-05-21 09:00:00,1115,1148,33,142,FALSE,NA,"0.1.4"
"25190","646",2023-05-21 09:15:00,1126,1148,22,142,FALSE,NA,"0.1.4"
"25191","646",2023-05-21 09:30:00,1109,1148,39,142,FALSE,NA,"0.1.4"
"25192","646",2023-05-21 09:45:00,1134,1148,14,142,FALSE,NA,"0.1.4"
"25193","646",2023-05-21 10:00:00,1139,1148,9,142,FALSE,NA,"0.1.4"
"25194","646",2023-05-21 10:15:00,1127,1148,21,142,FALSE,NA,"0.1.4"
"25195","646",2023-05-21 10:30:00,1143,1148,5,142,FALSE,NA,"0.1.4"
"25196","646",2023-05-21 10:45:00,1110,1148,38,142,FALSE,NA,"0.1.4"
"25197","646",2023-05-21 11:00:00,1138,1148,10,142,FALSE,NA,"0.1.4"
"25198","646",2023-05-21 11:15:00,1124,1148,24,142,FALSE,NA,"0.1.4"
"25199","646",2023-05-21 11:30:00,1128,1148,20,142,FALSE,NA,"0.1.4"
"25200","646",2023-05-21 11:45:00,1136,1148,12,142,FALSE,NA,"0.1.4"
"25201","646",2023-05-21 12:00:00,1147,1148,1,142,FALSE,NA,"0.1.4"
"25202","646",2023-05-21 12:15:00,1109,1148,39,142,FALSE,NA,"0.1.4"
"25203","646",2023-05-21 12:30:00,1132,1148,16,142,FALSE,NA,"0.1.4"
"25204","646",2023-05-21 12:45:00,1153,1153,0,147,FALSE,NA,"0.1.4"
"25205","646",2023-05-21 13:00:00,1118,1153,35,147,FALSE,NA,"0.1.4"
"25206","646",2023-05-21 13:15:00,1123,1153,30,147,FALSE,NA,"0.1.4"
"25207","646",2023-05-21 13:30:00,1122,1153,31,147,FALSE,NA,"0.1.4"
"25208","646",2023-05-21 13:45:00,1160,1160,0,154,FALSE,NA,"0.1.4"
"25209","646",2023-05-21 14:00:00,1145,1160,15,154,FALSE,NA,"0.1.4"
"25210","646",2023-05-21 14:15:00,1147,1160,13,154,FALSE,NA,"0.1.4"
"25211","646",2023-05-21 14:30:00,1140,1160,20,154,FALSE,NA,"0.1.4"
"25212","646",2023-05-21 14:45:00,1134,1160,26,154,FALSE,NA,"0.1.4"
"25213","646",2023-05-21 15:00:00,1121,1160,39,154,FALSE,NA,"0.1.4"
"25214","646",2023-05-21 15:15:00,1126,1160,34,154,FALSE,NA,"0.1.4"
"25215","646",2023-05-21 15:30:00,1125,1160,35,154,FALSE,NA,"0.1.4"
"25216","646",2023-05-21 15:45:00,1125,1160,35,154,FALSE,NA,"0.1.4"
"25217","646",2023-05-21 16:00:00,1117,1160,43,154,FALSE,NA,"0.1.4"
"25218","646",2023-05-21 16:15:00,1107,1160,53,154,FALSE,NA,"0.1.4"
"25219","646",2023-05-21 16:30:00,1103,1160,57,154,FALSE,NA,"0.1.4"
"25220","646",2023-05-21 16:45:00,1113,1160,47,154,FALSE,NA,"0.1.4"
"25221","646",2023-05-21 17:00:00,1116,1160,44,154,FALSE,NA,"0.1.4"
"25222","646",2023-05-21 17:15:00,1113,1160,47,154,FALSE,NA,"0.1.4"
"25223","646",2023-05-21 17:30:00,1111,1160,49,154,FALSE,NA,"0.1.4"
"25224","646",2023-05-21 17:45:00,1111,1160,49,154,FALSE,NA,"0.1.4"
"25225","646",2023-05-21 18:00:00,1111,1160,49,154,FALSE,NA,"0.1.4"
"25226","646",2023-05-21 18:15:00,1112,1160,48,154,FALSE,NA,"0.1.4"
"25227","646",2023-05-21 18:30:00,1125,1160,35,154,FALSE,NA,"0.1.4"
"25228","646",2023-05-21 18:45:00,1134,1160,26,154,FALSE,NA,"0.1.4"
"25229","646",2023-05-21 19:00:00,1128,1160,32,154,FALSE,NA,"0.1.4"
"25230","646",2023-05-21 19:15:00,1129,1160,31,154,FALSE,NA,"0.1.4"
"25231","646",2023-05-21 19:30:00,1128,1160,32,154,FALSE,NA,"0.1.4"
"25232","646",2023-05-21 19:45:00,1128,1160,32,154,FALSE,NA,"0.1.4"
"25233","646",2023-05-21 20:00:00,1128,1160,32,154,FALSE,NA,"0.1.4"
"25234","646",2023-05-21 20:15:00,1128,1160,32,154,FALSE,NA,"0.1.4"
"25235","646",2023-05-21 20:30:00,1129,1160,31,154,FALSE,NA,"0.1.4"
"25236","646",2023-05-21 20:45:00,1129,1160,31,154,FALSE,NA,"0.1.4"
"25237","646",2023-05-21 21:00:00,1129,1160,31,154,FALSE,NA,"0.1.4"
"25238","646",2023-05-21 21:15:00,1129,1160,31,154,FALSE,NA,"0.1.4"
"25239","646",2023-05-21 21:30:00,1129,1160,31,154,FALSE,NA,"0.1.4"
"25240","646",2023-05-21 21:45:00,1130,1160,30,154,FALSE,NA,"0.1.4"
"25241","646",2023-05-21 22:00:00,1130,1160,30,154,FALSE,NA,"0.1.4"
"25242","646",2023-05-21 22:15:00,1129,1160,31,154,FALSE,NA,"0.1.4"
"25243","646",2023-05-21 22:30:00,1129,1160,31,154,FALSE,NA,"0.1.4"
"25244","646",2023-05-21 22:45:00,1128,1160,32,154,FALSE,NA,"0.1.4"
"25245","646",2023-05-21 23:00:00,1147,1160,13,154,FALSE,NA,"0.1.4"
"25246","646",2023-05-21 23:15:00,1141,1160,19,154,FALSE,NA,"0.1.4"
"25247","646",2023-05-21 23:30:00,1125,1160,35,154,FALSE,NA,"0.1.4"
"25248","646",2023-05-21 23:45:00,1157,1160,3,154,FALSE,NA,"0.1.4"
"25249","646",2023-05-22,1160,1160,0,154,FALSE,NA,"0.1.4"
"25250","646",2023-05-22 00:15:00,1158,1160,2,154,FALSE,NA,"0.1.4"
"25251","646",2023-05-22 00:30:00,1156,1160,4,154,FALSE,NA,"0.1.4"
"25252","646",2023-05-22 00:45:00,1142,1160,18,154,FALSE,NA,"0.1.4"
"25253","646",2023-05-22 01:00:00,1164,1164,0,158,FALSE,NA,"0.1.4"
"25254","646",2023-05-22 01:15:00,1160,1164,4,158,FALSE,NA,"0.1.4"
"25255","646",2023-05-22 01:30:00,1138,1164,26,158,FALSE,NA,"0.1.4"
"25256","646",2023-05-22 01:45:00,1130,1164,34,158,FALSE,NA,"0.1.4"
"25257","646",2023-05-22 02:00:00,1139,1164,25,158,FALSE,NA,"0.1.4"
"25258","646",2023-05-22 02:15:00,1117,1164,47,158,FALSE,NA,"0.1.4"
"25259","646",2023-05-22 02:30:00,1157,1164,7,158,FALSE,NA,"0.1.4"
"25260","646",2023-05-22 02:45:00,1159,1164,5,158,FALSE,NA,"0.1.4"
"25261","646",2023-05-22 03:00:00,1147,1164,17,158,FALSE,NA,"0.1.4"
"25262","646",2023-05-22 03:15:00,1158,1164,6,158,FALSE,NA,"0.1.4"
"25263","646",2023-05-22 03:30:00,1128,1164,36,158,FALSE,NA,"0.1.4"
"25264","646",2023-05-22 03:45:00,1107,1164,57,158,FALSE,NA,"0.1.4"
"25265","646",2023-05-22 04:00:00,1128,1164,36,158,FALSE,NA,"0.1.4"
"25266","646",2023-05-22 04:15:00,1158,1164,6,158,FALSE,NA,"0.1.4"
"25267","646",2023-05-22 04:30:00,1153,1164,11,158,FALSE,NA,"0.1.4"
"25268","646",2023-05-22 04:45:00,1174,1174,0,168,FALSE,NA,"0.1.4"
"25269","646",2023-05-22 05:00:00,1141,1174,33,168,FALSE,NA,"0.1.4"
"25270","646",2023-05-22 05:15:00,1173,1174,1,168,FALSE,NA,"0.1.4"
"25271","646",2023-05-22 05:30:00,1160,1174,14,168,FALSE,NA,"0.1.4"
"25272","646",2023-05-22 05:45:00,1147,1174,27,168,FALSE,NA,"0.1.4"
"25273","646",2023-05-22 06:00:00,1141,1174,33,168,FALSE,NA,"0.1.4"
"25274","646",2023-05-22 06:15:00,1118,1174,56,168,FALSE,NA,"0.1.4"
"25275","646",2023-05-22 06:30:00,1143,1174,31,168,FALSE,NA,"0.1.4"
"25276","646",2023-05-22 06:45:00,1169,1174,5,168,FALSE,NA,"0.1.4"
"25277","646",2023-05-22 07:00:00,1101,1174,73,168,FALSE,NA,"0.1.4"
"25278","646",2023-05-22 07:15:00,1109,1174,65,168,FALSE,NA,"0.1.4"
"25279","646",2023-05-22 07:30:00,1148,1174,26,168,FALSE,NA,"0.1.4"
"25280","646",2023-05-22 07:45:00,1134,1174,40,168,FALSE,NA,"0.1.4"
"25281","646",2023-05-22 08:00:00,1156,1174,18,168,FALSE,NA,"0.1.4"
"25282","646",2023-05-22 08:15:00,1152,1174,22,168,FALSE,NA,"0.1.4"
"25283","646",2023-05-22 08:30:00,1115,1174,59,168,FALSE,NA,"0.1.4"
"25284","646",2023-05-22 08:45:00,1155,1174,19,168,FALSE,NA,"0.1.4"
"25285","646",2023-05-22 09:00:00,1160,1174,14,168,FALSE,NA,"0.1.4"
"25286","646",2023-05-22 09:15:00,1162,1174,12,168,FALSE,NA,"0.1.4"
"25287","646",2023-05-22 09:30:00,1171,1174,3,168,FALSE,NA,"0.1.4"
"25288","646",2023-05-22 09:45:00,1162,1174,12,168,FALSE,NA,"0.1.4"
"25289","646",2023-05-22 10:00:00,1178,1178,0,172,FALSE,NA,"0.1.4"
"25290","646",2023-05-22 10:15:00,1168,1178,10,172,FALSE,NA,"0.1.4"
"25291","646",2023-05-22 10:30:00,1158,1178,20,172,FALSE,NA,"0.1.4"
"25292","646",2023-05-22 10:45:00,1128,1178,50,172,FALSE,NA,"0.1.4"
"25293","646",2023-05-22 11:00:00,1129,1178,49,172,FALSE,NA,"0.1.4"
"25294","646",2023-05-22 11:15:00,1154,1178,24,172,FALSE,NA,"0.1.4"
"25295","646",2023-05-22 11:30:00,1148,1178,30,172,FALSE,NA,"0.1.4"
"25296","646",2023-05-22 11:45:00,1126,1178,52,172,FALSE,NA,"0.1.4"
"25297","646",2023-05-22 12:00:00,1125,1178,53,172,FALSE,NA,"0.1.4"
"25298","646",2023-05-22 12:15:00,1146,1178,32,172,FALSE,NA,"0.1.4"
"25299","646",2023-05-22 12:30:00,1157,1178,21,172,FALSE,NA,"0.1.4"
"25300","646",2023-05-22 12:45:00,1171,1178,7,172,FALSE,NA,"0.1.4"
"25301","646",2023-05-22 13:00:00,1156,1178,22,172,FALSE,NA,"0.1.4"
"25302","646",2023-05-22 13:15:00,1189,1189,0,183,FALSE,NA,"0.1.4"
"25303","646",2023-05-22 13:30:00,1153,1189,36,183,FALSE,NA,"0.1.4"
"25304","646",2023-05-22 13:45:00,1144,1189,45,183,FALSE,NA,"0.1.4"
"25305","646",2023-05-22 14:00:00,1162,1189,27,183,FALSE,NA,"0.1.4"
"25306","646",2023-05-22 14:15:00,1122,1189,67,183,FALSE,NA,"0.1.4"
"25307","646",2023-05-22 14:30:00,1136,1189,53,183,FALSE,NA,"0.1.4"
"25308","646",2023-05-22 14:45:00,1148,1189,41,183,FALSE,NA,"0.1.4"
"25309","646",2023-05-22 15:00:00,1153,1189,36,183,FALSE,NA,"0.1.4"
"25310","646",2023-05-22 15:15:00,1142,1189,47,183,FALSE,NA,"0.1.4"
"25311","646",2023-05-22 15:30:00,1142,1189,47,183,FALSE,NA,"0.1.4"
"25312","646",2023-05-22 15:45:00,1135,1189,54,183,FALSE,NA,"0.1.4"
"25313","646",2023-05-22 16:00:00,1133,1189,56,183,FALSE,NA,"0.1.4"
"25314","646",2023-05-22 16:15:00,1133,1189,56,183,FALSE,NA,"0.1.4"
"25315","646",2023-05-22 16:30:00,1131,1189,58,183,FALSE,NA,"0.1.4"
"25316","646",2023-05-22 16:45:00,1127,1189,62,183,FALSE,NA,"0.1.4"
"25317","646",2023-05-22 17:00:00,1127,1189,62,183,FALSE,NA,"0.1.4"
"25318","646",2023-05-22 17:15:00,1138,1189,51,183,FALSE,NA,"0.1.4"
"25319","646",2023-05-22 17:30:00,1139,1189,50,183,FALSE,NA,"0.1.4"
"25320","646",2023-05-22 17:45:00,1151,1189,38,183,FALSE,NA,"0.1.4"
"25321","646",2023-05-22 18:00:00,1146,1189,43,183,FALSE,NA,"0.1.4"
"25322","646",2023-05-22 18:15:00,1152,1189,37,183,FALSE,NA,"0.1.4"
"25323","646",2023-05-22 18:30:00,1126,1189,63,183,FALSE,NA,"0.1.4"
"25324","646",2023-05-22 18:45:00,1126,1189,63,183,FALSE,NA,"0.1.4"
"25325","646",2023-05-22 19:00:00,1134,1189,55,183,FALSE,NA,"0.1.4"
"25326","646",2023-05-22 19:15:00,1133,1189,56,183,FALSE,NA,"0.1.4"
"25327","646",2023-05-22 19:30:00,1132,1189,57,183,FALSE,NA,"0.1.4"
"25328","646",2023-05-22 19:45:00,1139,1189,50,183,FALSE,NA,"0.1.4"
"25329","646",2023-05-22 20:00:00,1159,1189,30,183,FALSE,NA,"0.1.4"
"25330","646",2023-05-22 20:15:00,1130,1189,59,183,FALSE,NA,"0.1.4"
"25331","646",2023-05-22 20:30:00,1136,1189,53,183,FALSE,NA,"0.1.4"
"25332","646",2023-05-22 20:45:00,1133,1189,56,183,FALSE,NA,"0.1.4"
"25333","646",2023-05-22 21:00:00,1130,1189,59,183,FALSE,NA,"0.1.4"
"25334","646",2023-05-22 21:15:00,1139,1189,50,183,FALSE,NA,"0.1.4"
"25335","646",2023-05-22 21:30:00,1136,1189,53,183,FALSE,NA,"0.1.4"
"25336","646",2023-05-22 21:45:00,1135,1189,54,183,FALSE,NA,"0.1.4"
"25337","646",2023-05-22 22:00:00,1142,1189,47,183,FALSE,NA,"0.1.4"
"25338","646",2023-05-22 22:15:00,1140,1189,49,183,FALSE,NA,"0.1.4"
"25339","646",2023-05-22 22:30:00,1139,1189,50,183,FALSE,NA,"0.1.4"
"25340","646",2023-05-22 22:45:00,1140,1189,49,183,FALSE,NA,"0.1.4"
"25341","646",2023-05-22 23:00:00,1138,1189,51,183,FALSE,NA,"0.1.4"
"25342","646",2023-05-22 23:15:00,1142,1189,47,183,FALSE,NA,"0.1.4"
"25343","646",2023-05-22 23:30:00,1150,1189,39,183,FALSE,NA,"0.1.4"
"25344","646",2023-05-22 23:45:00,1139,1189,50,183,FALSE,NA,"0.1.4"
"25345","646",2023-05-23,1136,1189,53,183,FALSE,NA,"0.1.4"
"25346","646",2023-05-23 00:15:00,1136,1189,53,183,FALSE,NA,"0.1.4"
"25347","646",2023-05-23 00:30:00,1152,1189,37,183,FALSE,NA,"0.1.4"
"25348","646",2023-05-23 00:45:00,1143,1189,46,183,FALSE,NA,"0.1.4"
"25349","646",2023-05-23 01:00:00,1135,1189,54,183,FALSE,NA,"0.1.4"
"25350","646",2023-05-23 01:15:00,1129,1189,60,183,FALSE,NA,"0.1.4"
"25351","646",2023-05-23 01:30:00,1130,1189,59,183,FALSE,NA,"0.1.4"
"25352","646",2023-05-23 01:45:00,1130,1189,59,183,FALSE,NA,"0.1.4"
"25353","646",2023-05-23 02:00:00,1175,1189,14,183,FALSE,NA,"0.1.4"
"25354","646",2023-05-23 02:15:00,1158,1189,31,183,FALSE,NA,"0.1.4"
"25355","646",2023-05-23 02:30:00,1165,1189,24,183,FALSE,NA,"0.1.4"
"25356","646",2023-05-23 02:45:00,1162,1189,27,183,FALSE,NA,"0.1.4"
"25357","646",2023-05-23 03:00:00,1148,1189,41,183,FALSE,NA,"0.1.4"
"25358","646",2023-05-23 03:15:00,1141,1189,48,183,FALSE,NA,"0.1.4"
"25359","646",2023-05-23 03:30:00,1150,1189,39,183,FALSE,NA,"0.1.4"
"25360","646",2023-05-23 03:45:00,1161,1189,28,183,FALSE,NA,"0.1.4"
"25361","646",2023-05-23 04:00:00,1164,1189,25,183,FALSE,NA,"0.1.4"
"25362","646",2023-05-23 04:15:00,1155,1189,34,183,FALSE,NA,"0.1.4"
"25363","646",2023-05-23 04:30:00,1153,1189,36,183,FALSE,NA,"0.1.4"
"25364","646",2023-05-23 04:45:00,1172,1189,17,183,FALSE,NA,"0.1.4"
"25365","646",2023-05-23 05:00:00,1151,1189,38,183,FALSE,NA,"0.1.4"
"25366","646",2023-05-23 05:15:00,1154,1189,35,183,FALSE,NA,"0.1.4"
"25367","646",2023-05-23 05:30:00,1169,1189,20,183,FALSE,NA,"0.1.4"
"25368","646",2023-05-23 05:45:00,1155,1189,34,183,FALSE,NA,"0.1.4"
"25369","646",2023-05-23 06:00:00,1156,1189,33,183,FALSE,NA,"0.1.4"
"25370","646",2023-05-23 06:15:00,1151,1189,38,183,FALSE,NA,"0.1.4"
"25371","646",2023-05-23 06:30:00,1160,1189,29,183,FALSE,NA,"0.1.4"
"25372","646",2023-05-23 06:45:00,1155,1189,34,183,FALSE,NA,"0.1.4"
"25373","646",2023-05-23 07:00:00,1169,1189,20,183,FALSE,NA,"0.1.4"
"25374","646",2023-05-23 07:15:00,1154,1189,35,183,FALSE,NA,"0.1.4"
"25375","646",2023-05-23 07:30:00,1179,1189,10,183,FALSE,NA,"0.1.4"
"25376","646",2023-05-23 07:45:00,1174,1189,15,183,FALSE,NA,"0.1.4"
"25377","646",2023-05-23 08:00:00,1194,1194,0,188,FALSE,NA,"0.1.4"
"25378","646",2023-05-23 08:15:00,1177,1194,17,188,FALSE,NA,"0.1.4"
"25379","646",2023-05-23 08:30:00,1212,1212,0,206,FALSE,NA,"0.1.4"
"25380","646",2023-05-23 08:45:00,1197,1212,15,206,FALSE,NA,"0.1.4"
"25381","646",2023-05-23 09:00:00,1179,1212,33,206,FALSE,NA,"0.1.4"
"25382","646",2023-05-23 09:15:00,1173,1212,39,206,FALSE,NA,"0.1.4"
"25383","646",2023-05-23 09:30:00,1181,1212,31,206,FALSE,NA,"0.1.4"
"25384","646",2023-05-23 09:45:00,1177,1212,35,206,FALSE,NA,"0.1.4"
"25385","646",2023-05-23 10:00:00,1201,1212,11,206,FALSE,NA,"0.1.4"
"25386","646",2023-05-23 10:15:00,1170,1212,42,206,FALSE,NA,"0.1.4"
"25387","646",2023-05-23 10:30:00,1186,1212,26,206,FALSE,NA,"0.1.4"
"25388","646",2023-05-23 10:45:00,1173,1212,39,206,FALSE,NA,"0.1.4"
"25389","646",2023-05-23 11:00:00,1172,1212,40,206,FALSE,NA,"0.1.4"
"25390","646",2023-05-23 11:15:00,1189,1212,23,206,FALSE,NA,"0.1.4"
"25391","646",2023-05-23 11:30:00,1178,1212,34,206,TRUE,NA,"0.1.4"
"25392","646",2023-05-23 11:45:00,1180,1212,32,206,TRUE,NA,"0.1.4"
"25393","646",2023-05-23 12:00:00,1157,1212,55,206,TRUE,NA,"0.1.4"
"25394","646",2023-05-23 12:15:00,1194,1212,18,206,TRUE,NA,"0.1.4"
"25395","646",2023-05-23 12:30:00,1195,1212,17,206,TRUE,NA,"0.1.4"
"25396","646",2023-05-23 12:45:00,1185,1212,27,206,FALSE,NA,"0.1.4"
"25397","646",2023-05-23 13:00:00,1194,1212,18,206,FALSE,NA,"0.1.4"
"25398","646",2023-05-23 13:15:00,1193,1212,19,206,FALSE,NA,"0.1.4"
"25399","646",2023-05-23 13:30:00,1197,1212,15,206,FALSE,NA,"0.1.4"
"25400","646",2023-05-23 13:45:00,1195,1212,17,206,FALSE,NA,"0.1.4"
"25401","646",2023-05-23 14:00:00,1194,1212,18,206,FALSE,NA,"0.1.4"
"25402","646",2023-05-23 14:15:00,1196,1212,16,206,FALSE,NA,"0.1.4"
"25403","646",2023-05-23 14:30:00,1186,1212,26,206,FALSE,NA,"0.1.4"
"25404","646",2023-05-23 14:45:00,1192,1212,20,206,FALSE,NA,"0.1.4"
"25405","646",2023-05-23 15:00:00,1194,1212,18,206,FALSE,NA,"0.1.4"
"25406","646",2023-05-23 15:15:00,1201,1212,11,206,FALSE,NA,"0.1.4"
"25407","646",2023-05-23 15:30:00,1190,1212,22,206,FALSE,NA,"0.1.4"
"25408","646",2023-05-23 15:45:00,1201,1212,11,206,FALSE,NA,"0.1.4"
"25409","646",2023-05-23 16:00:00,1205,1212,7,206,FALSE,NA,"0.1.4"
"25410","646",2023-05-23 16:15:00,1206,1212,6,206,FALSE,NA,"0.1.4"
"25411","646",2023-05-23 16:30:00,1200,1212,12,206,FALSE,NA,"0.1.4"
"25412","646",2023-05-23 16:45:00,1199,1212,13,206,FALSE,NA,"0.1.4"
"25413","646",2023-05-23 17:00:00,1204,1212,8,206,FALSE,NA,"0.1.4"
"25414","646",2023-05-23 17:15:00,1200,1212,12,206,FALSE,NA,"0.1.4"
"25415","646",2023-05-23 17:30:00,1195,1212,17,206,FALSE,NA,"0.1.4"
"25416","646",2023-05-23 17:45:00,1198,1212,14,206,FALSE,NA,"0.1.4"
"25417","646",2023-05-23 18:00:00,1198,1212,14,206,FALSE,NA,"0.1.4"
"25418","646",2023-05-23 18:15:00,1195,1212,17,206,FALSE,NA,"0.1.4"
"25419","646",2023-05-23 18:30:00,1192,1212,20,206,FALSE,NA,"0.1.4"
"25420","646",2023-05-23 18:45:00,1198,1212,14,206,FALSE,NA,"0.1.4"
"25421","646",2023-05-23 19:00:00,1197,1212,15,206,FALSE,NA,"0.1.4"
"25422","646",2023-05-23 19:15:00,1198,1212,14,206,FALSE,NA,"0.1.4"
"25423","646",2023-05-23 19:30:00,1200,1212,12,206,FALSE,NA,"0.1.4"
"25424","646",2023-05-23 19:45:00,1199,1212,13,206,FALSE,NA,"0.1.4"
"25425","646",2023-05-23 20:00:00,1201,1212,11,206,FALSE,NA,"0.1.4"
"25426","646",2023-05-23 20:15:00,1188,1212,24,206,FALSE,NA,"0.1.4"
"25427","646",2023-05-23 20:30:00,1190,1212,22,206,FALSE,NA,"0.1.4"
"25428","646",2023-05-23 20:45:00,1188,1212,24,206,FALSE,NA,"0.1.4"
"25429","646",2023-05-23 21:00:00,1200,1212,12,206,FALSE,NA,"0.1.4"
"25430","646",2023-05-23 21:15:00,1201,1212,11,206,FALSE,NA,"0.1.4"
"25431","646",2023-05-23 21:30:00,1200,1212,12,206,FALSE,NA,"0.1.4"
"25432","646",2023-05-23 21:45:00,1196,1212,16,206,FALSE,NA,"0.1.4"
"25433","646",2023-05-23 22:00:00,1194,1212,18,206,FALSE,NA,"0.1.4"
"25434","646",2023-05-23 22:15:00,1189,1212,23,206,FALSE,NA,"0.1.4"
"25435","646",2023-05-23 22:30:00,1191,1212,21,206,FALSE,NA,"0.1.4"
"25436","646",2023-05-23 22:45:00,1178,1212,34,206,FALSE,NA,"0.1.4"
"25437","646",2023-05-23 23:00:00,1204,1212,8,206,FALSE,NA,"0.1.4"
"25438","646",2023-05-23 23:15:00,1152,1212,60,206,FALSE,NA,"0.1.4"
"25439","646",2023-05-23 23:30:00,1192,1212,20,206,FALSE,NA,"0.1.4"
"25440","646",2023-05-23 23:45:00,1181,1212,31,206,FALSE,NA,"0.1.4"
"25441","646",2023-05-24,1191,1212,21,206,FALSE,NA,"0.1.4"
"25442","646",2023-05-24 00:15:00,1203,1212,9,206,FALSE,NA,"0.1.4"
"25443","646",2023-05-24 00:30:00,1197,1212,15,206,FALSE,NA,"0.1.4"
"25444","646",2023-05-24 00:45:00,1196,1212,16,206,FALSE,NA,"0.1.4"
"25445","646",2023-05-24 01:00:00,1213,1213,0,207,FALSE,NA,"0.1.4"
"25446","646",2023-05-24 01:15:00,1194,1213,19,207,FALSE,NA,"0.1.4"
"25447","646",2023-05-24 01:30:00,1204,1213,9,207,FALSE,NA,"0.1.4"
"25448","646",2023-05-24 01:45:00,1166,1213,47,207,FALSE,NA,"0.1.4"
"25449","646",2023-05-24 02:00:00,1205,1213,8,207,FALSE,NA,"0.1.4"
"25450","646",2023-05-24 02:15:00,1202,1213,11,207,FALSE,NA,"0.1.4"
"25451","646",2023-05-24 02:30:00,1206,1213,7,207,FALSE,NA,"0.1.4"
"25452","646",2023-05-24 02:45:00,1201,1213,12,207,FALSE,NA,"0.1.4"
"25453","646",2023-05-24 03:00:00,1212,1213,1,207,FALSE,NA,"0.1.4"
"25454","646",2023-05-24 03:15:00,1211,1213,2,207,FALSE,NA,"0.1.4"
"25455","646",2023-05-24 03:30:00,1209,1213,4,207,FALSE,NA,"0.1.4"
"25456","646",2023-05-24 03:45:00,1209,1213,4,207,FALSE,NA,"0.1.4"
"25457","646",2023-05-24 04:00:00,1208,1213,5,207,FALSE,NA,"0.1.4"
"25458","646",2023-05-24 04:15:00,1202,1213,11,207,FALSE,NA,"0.1.4"
"25459","646",2023-05-24 04:30:00,1204,1213,9,207,FALSE,NA,"0.1.4"
"25460","646",2023-05-24 04:45:00,1208,1213,5,207,FALSE,NA,"0.1.4"
"25461","646",2023-05-24 05:00:00,1199,1213,14,207,FALSE,NA,"0.1.4"
"25462","646",2023-05-24 05:15:00,1139,1213,74,207,FALSE,NA,"0.1.4"
"25463","646",2023-05-24 05:30:00,1158,1213,55,207,FALSE,NA,"0.1.4"
"25464","646",2023-05-24 05:45:00,1141,1213,72,207,FALSE,NA,"0.1.4"
"25465","646",2023-05-24 06:00:00,1188,1213,25,207,FALSE,NA,"0.1.4"
"25466","646",2023-05-24 06:15:00,1141,1213,72,207,FALSE,NA,"0.1.4"
"25467","646",2023-05-24 06:30:00,1143,1213,70,207,FALSE,NA,"0.1.4"
"25468","646",2023-05-24 06:45:00,1131,1213,82,207,FALSE,NA,"0.1.4"
"25469","646",2023-05-24 07:00:00,1126,1213,87,207,FALSE,NA,"0.1.4"
"25470","646",2023-05-24 07:15:00,1146,1213,67,207,FALSE,NA,"0.1.4"
"25471","646",2023-05-24 07:30:00,1121,1213,92,207,FALSE,NA,"0.1.4"
"25472","646",2023-05-24 07:45:00,1135,1213,78,207,FALSE,NA,"0.1.4"
"25473","646",2023-05-24 08:00:00,1133,1213,80,207,FALSE,NA,"0.1.4"
"25474","646",2023-05-24 08:15:00,1132,1213,81,207,FALSE,NA,"0.1.4"
"25475","646",2023-05-24 08:30:00,1134,1213,79,207,FALSE,NA,"0.1.4"
"25476","646",2023-05-24 08:45:00,1144,1213,69,207,FALSE,NA,"0.1.4"
"25477","646",2023-05-24 09:00:00,1192,1213,21,207,FALSE,NA,"0.1.4"
"25478","646",2023-05-24 09:15:00,1133,1213,80,207,FALSE,NA,"0.1.4"
"25479","646",2023-05-24 09:30:00,1178,1213,35,207,FALSE,NA,"0.1.4"
"25480","646",2023-05-24 09:45:00,1217,1217,0,211,FALSE,NA,"0.1.4"
"25481","646",2023-05-24 10:00:00,1209,1217,8,211,FALSE,NA,"0.1.4"
"25482","646",2023-05-24 10:15:00,1144,1217,73,211,FALSE,NA,"0.1.4"
"25483","646",2023-05-24 10:30:00,1125,1217,92,211,FALSE,NA,"0.1.4"
"25484","646",2023-05-24 10:45:00,1146,1217,71,211,FALSE,NA,"0.1.4"
"25485","646",2023-05-24 11:00:00,1173,1217,44,211,FALSE,NA,"0.1.4"
"25486","646",2023-05-24 11:15:00,1213,1217,4,211,FALSE,NA,"0.1.4"
"25487","646",2023-05-24 11:30:00,1204,1217,13,211,TRUE,NA,"0.1.4"
"25488","646",2023-05-24 11:45:00,1175,1217,42,211,TRUE,NA,"0.1.4"
"25489","646",2023-05-24 12:00:00,1179,1217,38,211,TRUE,NA,"0.1.4"
"25490","646",2023-05-24 12:15:00,1189,1217,28,211,TRUE,NA,"0.1.4"
"25491","646",2023-05-24 12:30:00,1198,1217,19,211,TRUE,NA,"0.1.4"
"25492","646",2023-05-24 12:45:00,1203,1217,14,211,TRUE,NA,"0.1.4"
"25493","646",2023-05-24 13:00:00,1164,1217,53,211,TRUE,NA,"0.1.4"
"25494","646",2023-05-24 13:15:00,1210,1217,7,211,TRUE,NA,"0.1.4"
"25495","646",2023-05-24 13:30:00,1214,1217,3,211,TRUE,NA,"0.1.4"
"25496","646",2023-05-24 13:45:00,1219,1219,0,213,TRUE,NA,"0.1.4"
"25497","646",2023-05-24 14:00:00,1218,1219,1,213,TRUE,NA,"0.1.4"
"25498","646",2023-05-24 14:15:00,1225,1225,0,219,TRUE,NA,"0.1.4"
"25499","646",2023-05-24 14:30:00,1214,1225,11,219,FALSE,NA,"0.1.4"
"25500","646",2023-05-24 14:45:00,1198,1225,27,219,FALSE,NA,"0.1.4"
"25501","646",2023-05-24 15:00:00,1193,1225,32,219,FALSE,NA,"0.1.4"
"25502","646",2023-05-24 15:15:00,1202,1225,23,219,FALSE,NA,"0.1.4"
"25503","646",2023-05-24 15:30:00,1177,1225,48,219,FALSE,NA,"0.1.4"
"25504","646",2023-05-24 15:45:00,1197,1225,28,219,FALSE,NA,"0.1.4"
"25505","646",2023-05-24 16:00:00,1176,1225,49,219,FALSE,NA,"0.1.4"
"25506","646",2023-05-24 16:15:00,1182,1225,43,219,FALSE,NA,"0.1.4"
"25507","646",2023-05-24 16:30:00,1146,1225,79,219,FALSE,NA,"0.1.4"
"25508","646",2023-05-24 16:45:00,1168,1225,57,219,FALSE,NA,"0.1.4"
"25509","646",2023-05-24 17:00:00,1159,1225,66,219,FALSE,NA,"0.1.4"
"25510","646",2023-05-24 17:15:00,1201,1225,24,219,FALSE,NA,"0.1.4"
"25511","646",2023-05-24 17:30:00,1183,1225,42,219,FALSE,NA,"0.1.4"
"25512","646",2023-05-24 17:45:00,1158,1225,67,219,FALSE,NA,"0.1.4"
"25513","646",2023-05-24 18:00:00,1184,1225,41,219,FALSE,NA,"0.1.4"
"25514","646",2023-05-24 18:15:00,1201,1225,24,219,FALSE,NA,"0.1.4"
"25515","646",2023-05-24 18:30:00,1200,1225,25,219,FALSE,NA,"0.1.4"
"25516","646",2023-05-24 18:45:00,1178,1225,47,219,FALSE,NA,"0.1.4"
"25517","646",2023-05-24 19:00:00,1194,1225,31,219,FALSE,NA,"0.1.4"
"25518","646",2023-05-24 19:15:00,1205,1225,20,219,FALSE,NA,"0.1.4"
"25519","646",2023-05-24 19:30:00,1215,1225,10,219,FALSE,NA,"0.1.4"
"25520","646",2023-05-24 19:45:00,1210,1225,15,219,FALSE,NA,"0.1.4"
"25521","646",2023-05-24 20:00:00,1203,1225,22,219,FALSE,NA,"0.1.4"
"25522","646",2023-05-24 20:15:00,1172,1225,53,219,FALSE,NA,"0.1.4"
"25523","646",2023-05-24 20:30:00,1171,1225,54,219,FALSE,NA,"0.1.4"
"25524","646",2023-05-24 20:45:00,1215,1225,10,219,FALSE,NA,"0.1.4"
"25525","646",2023-05-24 21:00:00,1216,1225,9,219,FALSE,NA,"0.1.4"
"25526","646",2023-05-24 21:15:00,1198,1225,27,219,FALSE,NA,"0.1.4"
"25527","646",2023-05-24 21:30:00,1170,1225,55,219,FALSE,NA,"0.1.4"
"25528","646",2023-05-24 21:45:00,1191,1225,34,219,FALSE,NA,"0.1.4"
"25529","646",2023-05-24 22:00:00,1192,1225,33,219,FALSE,NA,"0.1.4"
"25530","646",2023-05-24 22:15:00,1200,1225,25,219,FALSE,NA,"0.1.4"
"25531","646",2023-05-24 22:30:00,1203,1225,22,219,FALSE,NA,"0.1.4"
"25532","646",2023-05-24 22:45:00,1180,1225,45,219,FALSE,NA,"0.1.4"
"25533","646",2023-05-24 23:00:00,1149,1225,76,219,FALSE,NA,"0.1.4"
"25534","646",2023-05-24 23:15:00,1213,1225,12,219,FALSE,NA,"0.1.4"
"25535","646",2023-05-24 23:30:00,1202,1225,23,219,FALSE,NA,"0.1.4"
"25536","646",2023-05-24 23:45:00,1216,1225,9,219,FALSE,NA,"0.1.4"
"25537","646",2023-05-25,1210,1225,15,219,FALSE,NA,"0.1.4"
"25538","646",2023-05-25 00:15:00,1211,1225,14,219,FALSE,NA,"0.1.4"
"25539","646",2023-05-25 00:30:00,1210,1225,15,219,FALSE,NA,"0.1.4"
"25540","646",2023-05-25 00:45:00,1222,1225,3,219,FALSE,NA,"0.1.4"
"25541","646",2023-05-25 01:00:00,1217,1225,8,219,FALSE,NA,"0.1.4"
"25542","646",2023-05-25 01:15:00,1204,1225,21,219,FALSE,NA,"0.1.4"
"25543","646",2023-05-25 01:30:00,1204,1225,21,219,FALSE,NA,"0.1.4"
"25544","646",2023-05-25 01:45:00,1203,1225,22,219,FALSE,NA,"0.1.4"
"25545","646",2023-05-25 02:00:00,1162,1225,63,219,FALSE,NA,"0.1.4"
"25546","646",2023-05-25 02:15:00,1194,1225,31,219,FALSE,NA,"0.1.4"
"25547","646",2023-05-25 02:30:00,1183,1225,42,219,FALSE,NA,"0.1.4"
"25548","646",2023-05-25 02:45:00,1194,1225,31,219,FALSE,NA,"0.1.4"
"25549","646",2023-05-25 03:00:00,1195,1225,30,219,FALSE,NA,"0.1.4"
"25550","646",2023-05-25 03:15:00,1170,1225,55,219,FALSE,NA,"0.1.4"
"25551","646",2023-05-25 03:30:00,1181,1225,44,219,FALSE,NA,"0.1.4"
"25552","646",2023-05-25 03:45:00,1211,1225,14,219,FALSE,NA,"0.1.4"
"25553","646",2023-05-25 04:00:00,1189,1225,36,219,FALSE,NA,"0.1.4"
"25554","646",2023-05-25 04:15:00,1170,1225,55,219,FALSE,NA,"0.1.4"
"25555","646",2023-05-25 04:30:00,1207,1225,18,219,FALSE,NA,"0.1.4"
"25556","646",2023-05-25 04:45:00,1190,1225,35,219,FALSE,NA,"0.1.4"
"25557","646",2023-05-25 05:00:00,1178,1225,47,219,FALSE,NA,"0.1.4"
"25558","646",2023-05-25 05:15:00,1179,1225,46,219,FALSE,NA,"0.1.4"
"25559","646",2023-05-25 05:30:00,1159,1225,66,219,FALSE,NA,"0.1.4"
"25560","646",2023-05-25 05:45:00,1162,1225,63,219,FALSE,NA,"0.1.4"
"25561","646",2023-05-25 06:00:00,1186,1225,39,219,FALSE,NA,"0.1.4"
"25562","646",2023-05-25 06:15:00,1218,1225,7,219,FALSE,NA,"0.1.4"
"25563","646",2023-05-25 06:30:00,1205,1225,20,219,FALSE,NA,"0.1.4"
"25564","646",2023-05-25 06:45:00,1221,1225,4,219,FALSE,NA,"0.1.4"
"25565","646",2023-05-25 07:00:00,1202,1225,23,219,FALSE,NA,"0.1.4"
"25566","646",2023-05-25 07:15:00,1159,1225,66,219,FALSE,NA,"0.1.4"
"25567","646",2023-05-25 07:30:00,1219,1225,6,219,FALSE,NA,"0.1.4"
"25568","646",2023-05-25 07:45:00,1229,1229,0,223,FALSE,NA,"0.1.4"
"25569","646",2023-05-25 08:00:00,1172,1229,57,223,FALSE,NA,"0.1.4"
"25570","646",2023-05-25 08:15:00,1221,1229,8,223,FALSE,NA,"0.1.4"
"25571","646",2023-05-25 08:30:00,1226,1229,3,223,FALSE,NA,"0.1.4"
"25572","646",2023-05-25 08:45:00,1229,1229,0,223,FALSE,NA,"0.1.4"
"25573","646",2023-05-25 09:00:00,1166,1229,63,223,FALSE,NA,"0.1.4"
"25574","646",2023-05-25 09:15:00,1213,1229,16,223,FALSE,NA,"0.1.4"
"25575","646",2023-05-25 09:30:00,1190,1229,39,223,FALSE,NA,"0.1.4"
"25576","646",2023-05-25 09:45:00,1166,1229,63,223,FALSE,NA,"0.1.4"
"25577","646",2023-05-25 10:00:00,1198,1229,31,223,FALSE,NA,"0.1.4"
"25578","646",2023-05-25 10:15:00,1213,1229,16,223,FALSE,NA,"0.1.4"
"25579","646",2023-05-25 10:30:00,1209,1229,20,223,FALSE,NA,"0.1.4"
"25580","646",2023-05-25 10:45:00,1171,1229,58,223,FALSE,NA,"0.1.4"
"25581","646",2023-05-25 11:00:00,1170,1229,59,223,FALSE,NA,"0.1.4"
"25582","646",2023-05-25 11:15:00,1169,1229,60,223,FALSE,NA,"0.1.4"
"25583","646",2023-05-25 11:30:00,1179,1229,50,223,FALSE,NA,"0.1.4"
"25584","646",2023-05-25 11:45:00,1168,1229,61,223,FALSE,NA,"0.1.4"
"25585","646",2023-05-25 12:00:00,1163,1229,66,223,FALSE,NA,"0.1.4"
"25586","646",2023-05-25 12:15:00,1205,1229,24,223,FALSE,NA,"0.1.4"
"25587","646",2023-05-25 12:30:00,1179,1229,50,223,FALSE,NA,"0.1.4"
"25588","646",2023-05-25 12:45:00,1173,1229,56,223,FALSE,NA,"0.1.4"
"25589","646",2023-05-25 13:00:00,1165,1229,64,223,FALSE,NA,"0.1.4"
"25590","646",2023-05-25 13:15:00,1193,1229,36,223,FALSE,NA,"0.1.4"
"25591","646",2023-05-25 13:30:00,1211,1229,18,223,FALSE,NA,"0.1.4"
"25592","646",2023-05-25 13:45:00,1175,1229,54,223,FALSE,NA,"0.1.4"
"25593","646",2023-05-25 14:00:00,1200,1229,29,223,FALSE,NA,"0.1.4"
"25594","646",2023-05-25 14:15:00,1156,1229,73,223,FALSE,NA,"0.1.4"
"25595","646",2023-05-25 14:30:00,1205,1229,24,223,FALSE,NA,"0.1.4"
"25596","646",2023-05-25 14:45:00,1230,1230,0,224,FALSE,NA,"0.1.4"
"25597","646",2023-05-25 15:00:00,1184,1230,46,224,FALSE,NA,"0.1.4"
"25598","646",2023-05-25 15:15:00,1220,1230,10,224,FALSE,NA,"0.1.4"
"25599","646",2023-05-25 15:30:00,1205,1230,25,224,FALSE,NA,"0.1.4"
"25600","646",2023-05-25 15:45:00,1181,1230,49,224,FALSE,NA,"0.1.4"
"25601","646",2023-05-25 16:00:00,1206,1230,24,224,FALSE,NA,"0.1.4"
"25602","646",2023-05-25 16:15:00,1190,1230,40,224,FALSE,NA,"0.1.4"
"25603","646",2023-05-25 16:30:00,1203,1230,27,224,FALSE,NA,"0.1.4"
"25604","646",2023-05-25 16:45:00,1204,1230,26,224,FALSE,NA,"0.1.4"
"25605","646",2023-05-25 17:00:00,1218,1230,12,224,FALSE,NA,"0.1.4"
"25606","646",2023-05-25 17:15:00,1170,1230,60,224,FALSE,NA,"0.1.4"
"25607","646",2023-05-25 17:30:00,1178,1230,52,224,FALSE,NA,"0.1.4"
"25608","646",2023-05-25 17:45:00,1163,1230,67,224,FALSE,NA,"0.1.4"
"25609","646",2023-05-25 18:00:00,1153,1230,77,224,FALSE,NA,"0.1.4"
"25610","646",2023-05-25 18:15:00,1156,1230,74,224,FALSE,NA,"0.1.4"
"25611","646",2023-05-25 18:30:00,1163,1230,67,224,FALSE,NA,"0.1.4"
"25612","646",2023-05-25 18:45:00,1152,1230,78,224,FALSE,NA,"0.1.4"
"25613","646",2023-05-25 19:00:00,1169,1230,61,224,FALSE,NA,"0.1.4"
"25614","646",2023-05-25 19:15:00,1167,1230,63,224,FALSE,NA,"0.1.4"
"25615","646",2023-05-25 19:30:00,1162,1230,68,224,FALSE,NA,"0.1.4"
"25616","646",2023-05-25 19:45:00,1160,1230,70,224,FALSE,NA,"0.1.4"
"25617","646",2023-05-25 20:00:00,1157,1230,73,224,FALSE,NA,"0.1.4"
"25618","646",2023-05-25 20:15:00,1158,1230,72,224,FALSE,NA,"0.1.4"
"25619","646",2023-05-25 20:30:00,1163,1230,67,224,FALSE,NA,"0.1.4"
"25620","646",2023-05-25 20:45:00,1153,1230,77,224,FALSE,NA,"0.1.4"
"25621","646",2023-05-25 21:00:00,1154,1230,76,224,FALSE,NA,"0.1.4"
"25622","646",2023-05-25 21:15:00,1157,1230,73,224,FALSE,NA,"0.1.4"
"25623","646",2023-05-25 21:30:00,1153,1230,77,224,FALSE,NA,"0.1.4"
"25624","646",2023-05-25 21:45:00,1155,1230,75,224,FALSE,NA,"0.1.4"
"25625","646",2023-05-25 22:00:00,1156,1230,74,224,FALSE,NA,"0.1.4"
"25626","646",2023-05-25 22:15:00,1154,1230,76,224,FALSE,NA,"0.1.4"
"25627","646",2023-05-25 22:30:00,1158,1230,72,224,FALSE,NA,"0.1.4"
"25628","646",2023-05-25 22:45:00,1154,1230,76,224,FALSE,NA,"0.1.4"
"25629","646",2023-05-25 23:00:00,1154,1230,76,224,FALSE,NA,"0.1.4"
"25630","646",2023-05-25 23:15:00,1156,1230,74,224,FALSE,NA,"0.1.4"
"25631","646",2023-05-25 23:30:00,1166,1230,64,224,FALSE,NA,"0.1.4"
"25632","646",2023-05-25 23:45:00,1152,1230,78,224,FALSE,NA,"0.1.4"
"25633","646",2023-05-26,1169,1230,61,224,FALSE,NA,"0.1.4"
"25634","646",2023-05-26 00:15:00,1179,1230,51,224,FALSE,NA,"0.1.4"
"25635","646",2023-05-26 00:30:00,1200,1230,30,224,FALSE,NA,"0.1.4"
"25636","646",2023-05-26 00:45:00,1173,1230,57,224,FALSE,NA,"0.1.4"
"25637","646",2023-05-26 01:00:00,1158,1230,72,224,FALSE,NA,"0.1.4"
"25638","646",2023-05-26 01:15:00,1152,1230,78,224,FALSE,NA,"0.1.4"
"25639","646",2023-05-26 01:30:00,1196,1230,34,224,FALSE,NA,"0.1.4"
"25640","646",2023-05-26 01:45:00,1182,1230,48,224,FALSE,NA,"0.1.4"
"25641","646",2023-05-26 02:00:00,1196,1230,34,224,FALSE,NA,"0.1.4"
"25642","646",2023-05-26 02:15:00,1206,1230,24,224,FALSE,NA,"0.1.4"
"25643","646",2023-05-26 02:30:00,1201,1230,29,224,FALSE,NA,"0.1.4"
"25644","646",2023-05-26 02:45:00,1180,1230,50,224,FALSE,NA,"0.1.4"
"25645","646",2023-05-26 03:00:00,1206,1230,24,224,FALSE,NA,"0.1.4"
"25646","646",2023-05-26 03:15:00,1191,1230,39,224,FALSE,NA,"0.1.4"
"25647","646",2023-05-26 03:30:00,1184,1230,46,224,FALSE,NA,"0.1.4"
"25648","646",2023-05-26 03:45:00,1171,1230,59,224,FALSE,NA,"0.1.4"
"25649","646",2023-05-26 04:00:00,1169,1230,61,224,FALSE,NA,"0.1.4"
"25650","646",2023-05-26 04:15:00,1170,1230,60,224,FALSE,NA,"0.1.4"
"25651","646",2023-05-26 04:30:00,1171,1230,59,224,FALSE,NA,"0.1.4"
"25652","646",2023-05-26 04:45:00,1155,1230,75,224,FALSE,NA,"0.1.4"
"25653","646",2023-05-26 05:00:00,1163,1230,67,224,FALSE,NA,"0.1.4"
"25654","646",2023-05-26 05:15:00,1155,1230,75,224,FALSE,NA,"0.1.4"
"25655","646",2023-05-26 05:30:00,1226,1230,4,224,FALSE,NA,"0.1.4"
"25656","646",2023-05-26 05:45:00,1231,1231,0,225,FALSE,NA,"0.1.4"
"25657","646",2023-05-26 06:00:00,1210,1231,21,225,FALSE,NA,"0.1.4"
"25658","646",2023-05-26 06:15:00,1170,1231,61,225,FALSE,NA,"0.1.4"
"25659","646",2023-05-26 06:30:00,1157,1231,74,225,FALSE,NA,"0.1.4"
"25660","646",2023-05-26 06:45:00,1152,1231,79,225,FALSE,NA,"0.1.4"
"25661","646",2023-05-26 07:00:00,1160,1231,71,225,FALSE,NA,"0.1.4"
"25662","646",2023-05-26 07:15:00,1223,1231,8,225,FALSE,NA,"0.1.4"
"25663","646",2023-05-26 07:30:00,1152,1231,79,225,FALSE,NA,"0.1.4"
"25664","646",2023-05-26 07:45:00,1152,1231,79,225,FALSE,NA,"0.1.4"
"25665","646",2023-05-26 08:00:00,1150,1231,81,225,FALSE,NA,"0.1.4"
"25666","646",2023-05-26 08:15:00,1151,1231,80,225,FALSE,NA,"0.1.4"
"25667","646",2023-05-26 08:30:00,1152,1231,79,225,FALSE,NA,"0.1.4"
"25668","646",2023-05-26 08:45:00,1162,1231,69,225,FALSE,NA,"0.1.4"
"25669","646",2023-05-26 09:00:00,1154,1231,77,225,FALSE,NA,"0.1.4"
"25670","646",2023-05-26 09:15:00,1185,1231,46,225,FALSE,NA,"0.1.4"
"25671","646",2023-05-26 09:30:00,1188,1231,43,225,FALSE,NA,"0.1.4"
"25672","646",2023-05-26 09:45:00,1182,1231,49,225,FALSE,NA,"0.1.4"
"25673","646",2023-05-26 10:00:00,1179,1231,52,225,FALSE,NA,"0.1.4"
"25674","646",2023-05-26 10:15:00,1180,1231,51,225,FALSE,NA,"0.1.4"
"25675","646",2023-05-26 10:30:00,1194,1231,37,225,FALSE,NA,"0.1.4"
"25676","646",2023-05-26 10:45:00,1186,1231,45,225,FALSE,NA,"0.1.4"
"25677","646",2023-05-26 11:00:00,1202,1231,29,225,FALSE,NA,"0.1.4"
"25678","646",2023-05-26 11:15:00,1198,1231,33,225,FALSE,NA,"0.1.4"
"25679","646",2023-05-26 11:30:00,1194,1231,37,225,FALSE,NA,"0.1.4"
"25680","646",2023-05-26 11:45:00,1213,1231,18,225,FALSE,NA,"0.1.4"
"25681","646",2023-05-26 12:00:00,1197,1231,34,225,FALSE,NA,"0.1.4"
"25682","646",2023-05-26 12:15:00,1191,1231,40,225,FALSE,NA,"0.1.4"
"25683","646",2023-05-26 12:30:00,1185,1231,46,225,FALSE,NA,"0.1.4"
"25684","646",2023-05-26 12:45:00,1197,1231,34,225,FALSE,NA,"0.1.4"
"25685","646",2023-05-26 13:00:00,1219,1231,12,225,FALSE,NA,"0.1.4"
"25686","646",2023-05-26 13:15:00,1180,1231,51,225,FALSE,NA,"0.1.4"
"25687","646",2023-05-26 13:30:00,1167,1231,64,225,FALSE,NA,"0.1.4"
"25688","646",2023-05-26 13:45:00,1179,1231,52,225,FALSE,NA,"0.1.4"
"25689","646",2023-05-26 14:00:00,1199,1231,32,225,FALSE,NA,"0.1.4"
"25690","646",2023-05-26 14:15:00,1208,1231,23,225,FALSE,NA,"0.1.4"
"25691","646",2023-05-26 14:30:00,1171,1231,60,225,FALSE,NA,"0.1.4"
"25692","646",2023-05-26 14:45:00,1169,1231,62,225,FALSE,NA,"0.1.4"
"25693","646",2023-05-26 15:00:00,1176,1231,55,225,FALSE,NA,"0.1.4"
"25694","646",2023-05-26 15:15:00,1169,1231,62,225,FALSE,NA,"0.1.4"
"25695","646",2023-05-26 15:30:00,1171,1231,60,225,FALSE,NA,"0.1.4"
"25696","646",2023-05-26 15:45:00,1178,1231,53,225,FALSE,NA,"0.1.4"
"25697","646",2023-05-26 16:00:00,1184,1231,47,225,FALSE,NA,"0.1.4"
"25698","646",2023-05-26 16:15:00,1191,1231,40,225,FALSE,NA,"0.1.4"
"25699","646",2023-05-26 16:30:00,1188,1231,43,225,FALSE,NA,"0.1.4"
"25700","646",2023-05-26 16:45:00,1205,1231,26,225,FALSE,NA,"0.1.4"
"25701","646",2023-05-26 17:00:00,1197,1231,34,225,FALSE,NA,"0.1.4"
"25702","646",2023-05-26 17:15:00,1198,1231,33,225,FALSE,NA,"0.1.4"
"25703","646",2023-05-26 17:30:00,1204,1231,27,225,FALSE,NA,"0.1.4"
"25704","646",2023-05-26 17:45:00,1178,1231,53,225,FALSE,NA,"0.1.4"
"25705","646",2023-05-26 18:00:00,1172,1231,59,225,FALSE,NA,"0.1.4"
"25706","646",2023-05-26 18:15:00,1182,1231,49,225,FALSE,NA,"0.1.4"
"25707","646",2023-05-26 18:30:00,1205,1231,26,225,FALSE,NA,"0.1.4"
"25708","646",2023-05-26 18:45:00,1186,1231,45,225,FALSE,NA,"0.1.4"
"25709","646",2023-05-26 19:00:00,1193,1231,38,225,FALSE,NA,"0.1.4"
"25710","646",2023-05-26 19:15:00,1184,1231,47,225,FALSE,NA,"0.1.4"
"25711","646",2023-05-26 19:30:00,1190,1231,41,225,FALSE,NA,"0.1.4"
"25712","646",2023-05-26 19:45:00,1185,1231,46,225,FALSE,NA,"0.1.4"
"25713","646",2023-05-26 20:00:00,1182,1231,49,225,FALSE,NA,"0.1.4"
"25714","646",2023-05-26 20:15:00,1192,1231,39,225,FALSE,NA,"0.1.4"
"25715","646",2023-05-26 20:30:00,1173,1231,58,225,FALSE,NA,"0.1.4"
"25716","646",2023-05-26 20:45:00,1204,1231,27,225,FALSE,NA,"0.1.4"
"25717","646",2023-05-26 21:00:00,1192,1231,39,225,FALSE,NA,"0.1.4"
"25718","646",2023-05-26 21:15:00,1178,1231,53,225,FALSE,NA,"0.1.4"
"25719","646",2023-05-26 21:30:00,1193,1231,38,225,FALSE,NA,"0.1.4"
"25720","646",2023-05-26 21:45:00,1189,1231,42,225,FALSE,NA,"0.1.4"
"25721","646",2023-05-26 22:00:00,1199,1231,32,225,FALSE,NA,"0.1.4"
"25722","646",2023-05-26 22:15:00,1195,1231,36,225,FALSE,NA,"0.1.4"
"25723","646",2023-05-26 22:30:00,1195,1231,36,225,FALSE,NA,"0.1.4"
"25724","646",2023-05-26 22:45:00,1195,1231,36,225,FALSE,NA,"0.1.4"
"25725","646",2023-05-26 23:00:00,1204,1231,27,225,FALSE,NA,"0.1.4"
"25726","646",2023-05-26 23:15:00,1198,1231,33,225,FALSE,NA,"0.1.4"
"25727","646",2023-05-26 23:30:00,1196,1231,35,225,FALSE,NA,"0.1.4"
"25728","646",2023-05-26 23:45:00,1195,1231,36,225,FALSE,NA,"0.1.4"
"25729","646",2023-05-27,1188,1231,43,225,FALSE,NA,"0.1.4"
"25730","646",2023-05-27 00:15:00,1200,1231,31,225,FALSE,NA,"0.1.4"
"25731","646",2023-05-27 00:30:00,1192,1231,39,225,FALSE,NA,"0.1.4"
"25732","646",2023-05-27 00:45:00,1198,1231,33,225,FALSE,NA,"0.1.4"
"25733","646",2023-05-27 01:00:00,1180,1231,51,225,FALSE,NA,"0.1.4"
"25734","646",2023-05-27 01:15:00,1218,1231,13,225,FALSE,NA,"0.1.4"
"25735","646",2023-05-27 01:30:00,1188,1231,43,225,FALSE,NA,"0.1.4"
"25736","646",2023-05-27 01:45:00,1174,1231,57,225,FALSE,NA,"0.1.4"
"25737","646",2023-05-27 02:00:00,1192,1231,39,225,FALSE,NA,"0.1.4"
"25738","646",2023-05-27 02:15:00,1194,1231,37,225,FALSE,NA,"0.1.4"
"25739","646",2023-05-27 02:30:00,1176,1231,55,225,FALSE,NA,"0.1.4"
"25740","646",2023-05-27 02:45:00,1196,1231,35,225,FALSE,NA,"0.1.4"
"25741","646",2023-05-27 03:00:00,1181,1231,50,225,FALSE,NA,"0.1.4"
"25742","646",2023-05-27 03:15:00,1188,1231,43,225,FALSE,NA,"0.1.4"
"25743","646",2023-05-27 03:30:00,1184,1231,47,225,FALSE,NA,"0.1.4"
"25744","646",2023-05-27 03:45:00,1186,1231,45,225,FALSE,NA,"0.1.4"
"25745","646",2023-05-27 04:00:00,1178,1231,53,225,FALSE,NA,"0.1.4"
"25746","646",2023-05-27 04:15:00,1182,1231,49,225,FALSE,NA,"0.1.4"
"25747","646",2023-05-27 04:30:00,1183,1231,48,225,FALSE,NA,"0.1.4"
"25748","646",2023-05-27 04:45:00,1185,1231,46,225,FALSE,NA,"0.1.4"
"25749","646",2023-05-27 05:00:00,1204,1231,27,225,FALSE,NA,"0.1.4"
"25750","646",2023-05-27 05:15:00,1180,1231,51,225,FALSE,NA,"0.1.4"
"25751","646",2023-05-27 05:30:00,1184,1231,47,225,FALSE,NA,"0.1.4"
"25752","646",2023-05-27 05:45:00,1208,1231,23,225,FALSE,NA,"0.1.4"
"25753","646",2023-05-27 06:00:00,1206,1231,25,225,FALSE,NA,"0.1.4"
"25754","646",2023-05-27 06:15:00,1187,1231,44,225,FALSE,NA,"0.1.4"
"25755","646",2023-05-27 06:30:00,1187,1231,44,225,FALSE,NA,"0.1.4"
"25756","646",2023-05-27 06:45:00,1193,1231,38,225,FALSE,NA,"0.1.4"
"25757","646",2023-05-27 07:00:00,1193,1231,38,225,FALSE,NA,"0.1.4"
"25758","646",2023-05-27 07:15:00,1223,1231,8,225,FALSE,NA,"0.1.4"
"25759","646",2023-05-27 07:30:00,1223,1231,8,225,FALSE,NA,"0.1.4"
"25760","646",2023-05-27 07:45:00,1229,1231,2,225,FALSE,NA,"0.1.4"
"25761","646",2023-05-27 08:00:00,1216,1231,15,225,FALSE,NA,"0.1.4"
"25762","646",2023-05-27 08:15:00,1217,1231,14,225,FALSE,NA,"0.1.4"
"25763","646",2023-05-27 08:30:00,1219,1231,12,225,FALSE,NA,"0.1.4"
"25764","646",2023-05-27 08:45:00,1226,1231,5,225,FALSE,NA,"0.1.4"
"25765","646",2023-05-27 09:00:00,1222,1231,9,225,FALSE,NA,"0.1.4"
"25766","646",2023-05-27 09:15:00,1217,1231,14,225,FALSE,NA,"0.1.4"
"25767","646",2023-05-27 09:30:00,1204,1231,27,225,FALSE,NA,"0.1.4"
"25768","646",2023-05-27 09:45:00,1186,1231,45,225,FALSE,NA,"0.1.4"
"25769","646",2023-05-27 10:00:00,1197,1231,34,225,FALSE,NA,"0.1.4"
"25770","646",2023-05-27 10:15:00,1205,1231,26,225,FALSE,NA,"0.1.4"
"25771","646",2023-05-27 10:30:00,1190,1231,41,225,FALSE,NA,"0.1.4"
"25772","646",2023-05-27 10:45:00,1194,1231,37,225,FALSE,NA,"0.1.4"
"25773","646",2023-05-27 11:00:00,1194,1231,37,225,FALSE,NA,"0.1.4"
"25774","646",2023-05-27 11:15:00,1201,1231,30,225,FALSE,NA,"0.1.4"
"25775","646",2023-05-27 11:30:00,1192,1231,39,225,FALSE,NA,"0.1.4"
"25776","646",2023-05-27 11:45:00,1184,1231,47,225,FALSE,NA,"0.1.4"
"25777","646",2023-05-27 12:00:00,1214,1231,17,225,FALSE,NA,"0.1.4"
"25778","646",2023-05-27 12:15:00,1189,1231,42,225,FALSE,NA,"0.1.4"
"25779","646",2023-05-27 12:30:00,1191,1231,40,225,FALSE,NA,"0.1.4"
"25780","646",2023-05-27 12:45:00,1188,1231,43,225,FALSE,NA,"0.1.4"
"25781","646",2023-05-27 13:00:00,1197,1231,34,225,FALSE,NA,"0.1.4"
"25782","646",2023-05-27 13:15:00,1196,1231,35,225,FALSE,NA,"0.1.4"
"25783","646",2023-05-27 13:30:00,1191,1231,40,225,FALSE,NA,"0.1.4"
"25784","646",2023-05-27 13:45:00,1213,1231,18,225,FALSE,NA,"0.1.4"
"25785","646",2023-05-27 14:00:00,1196,1231,35,225,FALSE,NA,"0.1.4"
"25786","646",2023-05-27 14:15:00,1180,1231,51,225,FALSE,NA,"0.1.4"
"25787","646",2023-05-27 14:30:00,1183,1231,48,225,FALSE,NA,"0.1.4"
"25788","646",2023-05-27 14:45:00,1198,1231,33,225,FALSE,NA,"0.1.4"
"25789","646",2023-05-27 15:00:00,1183,1231,48,225,FALSE,NA,"0.1.4"
"25790","646",2023-05-27 15:15:00,1186,1231,45,225,FALSE,NA,"0.1.4"
"25791","646",2023-05-27 15:30:00,1198,1231,33,225,FALSE,NA,"0.1.4"
"25792","646",2023-05-27 15:45:00,1189,1231,42,225,FALSE,NA,"0.1.4"
"25793","646",2023-05-27 16:00:00,1188,1231,43,225,FALSE,NA,"0.1.4"
"25794","646",2023-05-27 16:15:00,1189,1231,42,225,FALSE,NA,"0.1.4"
"25795","646",2023-05-27 16:30:00,1191,1231,40,225,FALSE,NA,"0.1.4"
"25796","646",2023-05-27 16:45:00,1192,1231,39,225,FALSE,NA,"0.1.4"
"25797","646",2023-05-27 17:00:00,1202,1231,29,225,FALSE,NA,"0.1.4"
"25798","646",2023-05-27 17:15:00,1201,1231,30,225,FALSE,NA,"0.1.4"
"25799","646",2023-05-27 17:30:00,1201,1231,30,225,FALSE,NA,"0.1.4"
"25800","646",2023-05-27 17:45:00,1192,1231,39,225,FALSE,NA,"0.1.4"
"25801","646",2023-05-27 18:00:00,1201,1231,30,225,FALSE,NA,"0.1.4"
"25802","646",2023-05-27 18:15:00,1191,1231,40,225,FALSE,NA,"0.1.4"
"25803","646",2023-05-27 18:30:00,1188,1231,43,225,FALSE,NA,"0.1.4"
"25804","646",2023-05-27 18:45:00,1185,1231,46,225,FALSE,NA,"0.1.4"
"25805","646",2023-05-27 19:00:00,1188,1231,43,225,FALSE,NA,"0.1.4"
"25806","646",2023-05-27 19:15:00,1188,1231,43,225,FALSE,NA,"0.1.4"
"25807","646",2023-05-27 19:30:00,1189,1231,42,225,FALSE,NA,"0.1.4"
"25808","646",2023-05-27 19:45:00,1190,1231,41,225,FALSE,NA,"0.1.4"
"25809","646",2023-05-27 20:00:00,1188,1231,43,225,FALSE,NA,"0.1.4"
"25810","646",2023-05-27 20:15:00,1188,1231,43,225,FALSE,NA,"0.1.4"
"25811","646",2023-05-27 20:30:00,1182,1231,49,225,FALSE,NA,"0.1.4"
"25812","646",2023-05-27 20:45:00,1183,1231,48,225,FALSE,NA,"0.1.4"
"25813","646",2023-05-27 21:00:00,1183,1231,48,225,FALSE,NA,"0.1.4"
"25814","646",2023-05-27 21:15:00,1185,1231,46,225,FALSE,NA,"0.1.4"
"25815","646",2023-05-27 21:30:00,1184,1231,47,225,FALSE,NA,"0.1.4"
"25816","646",2023-05-27 21:45:00,1183,1231,48,225,FALSE,NA,"0.1.4"
"25817","646",2023-05-27 22:00:00,1186,1231,45,225,FALSE,NA,"0.1.4"
"25818","646",2023-05-27 22:15:00,1183,1231,48,225,FALSE,NA,"0.1.4"
"25819","646",2023-05-27 22:30:00,1187,1231,44,225,FALSE,NA,"0.1.4"
"25820","646",2023-05-27 22:45:00,1184,1231,47,225,FALSE,NA,"0.1.4"
"25821","646",2023-05-27 23:00:00,1183,1231,48,225,FALSE,NA,"0.1.4"
"25822","646",2023-05-27 23:15:00,1193,1231,38,225,FALSE,NA,"0.1.4"
"25823","646",2023-05-27 23:30:00,1193,1231,38,225,FALSE,NA,"0.1.4"
"25824","646",2023-05-27 23:45:00,1187,1231,44,225,FALSE,NA,"0.1.4"
"25825","646",2023-05-28,1187,1231,44,225,FALSE,NA,"0.1.4"
"25826","646",2023-05-28 00:15:00,1182,1231,49,225,FALSE,NA,"0.1.4"
"25827","646",2023-05-28 00:30:00,1197,1231,34,225,FALSE,NA,"0.1.4"
"25828","646",2023-05-28 00:45:00,1183,1231,48,225,FALSE,NA,"0.1.4"
"25829","646",2023-05-28 01:00:00,1186,1231,45,225,FALSE,NA,"0.1.4"
"25830","646",2023-05-28 01:15:00,1182,1231,49,225,FALSE,NA,"0.1.4"
"25831","646",2023-05-28 01:30:00,1184,1231,47,225,FALSE,NA,"0.1.4"
"25832","646",2023-05-28 01:45:00,1188,1231,43,225,FALSE,NA,"0.1.4"
"25833","646",2023-05-28 02:00:00,1190,1231,41,225,FALSE,NA,"0.1.4"
"25834","646",2023-05-28 02:15:00,1185,1231,46,225,FALSE,NA,"0.1.4"
"25835","646",2023-05-28 02:30:00,1194,1231,37,225,FALSE,NA,"0.1.4"
"25836","646",2023-05-28 02:45:00,1191,1231,40,225,FALSE,NA,"0.1.4"
"25837","646",2023-05-28 03:00:00,1195,1231,36,225,FALSE,NA,"0.1.4"
"25838","646",2023-05-28 03:15:00,1194,1231,37,225,FALSE,NA,"0.1.4"
"25839","646",2023-05-28 03:30:00,1194,1231,37,225,FALSE,NA,"0.1.4"
"25840","646",2023-05-28 03:45:00,1190,1231,41,225,FALSE,NA,"0.1.4"
"25841","646",2023-05-28 04:00:00,1189,1231,42,225,FALSE,NA,"0.1.4"
"25842","646",2023-05-28 04:15:00,1195,1231,36,225,FALSE,NA,"0.1.4"
"25843","646",2023-05-28 04:30:00,1189,1231,42,225,FALSE,NA,"0.1.4"
"25844","646",2023-05-28 04:45:00,1182,1231,49,225,FALSE,NA,"0.1.4"
"25845","646",2023-05-28 05:00:00,1187,1231,44,225,FALSE,NA,"0.1.4"
"25846","646",2023-05-28 05:15:00,1187,1231,44,225,FALSE,NA,"0.1.4"
"25847","646",2023-05-28 05:30:00,1185,1231,46,225,FALSE,NA,"0.1.4"
"25848","646",2023-05-28 05:45:00,1188,1231,43,225,FALSE,NA,"0.1.4"
"25849","646",2023-05-28 06:00:00,1181,1231,50,225,FALSE,NA,"0.1.4"
"25850","646",2023-05-28 06:15:00,1184,1231,47,225,FALSE,NA,"0.1.4"
"25851","646",2023-05-28 06:30:00,1186,1231,45,225,FALSE,NA,"0.1.4"
"25852","646",2023-05-28 06:45:00,1184,1231,47,225,FALSE,NA,"0.1.4"
"25853","646",2023-05-28 07:00:00,1188,1231,43,225,FALSE,NA,"0.1.4"
"25854","646",2023-05-28 07:15:00,1195,1231,36,225,FALSE,NA,"0.1.4"
"25855","646",2023-05-28 07:30:00,1185,1231,46,225,FALSE,NA,"0.1.4"
"25856","646",2023-05-28 07:45:00,1191,1231,40,225,FALSE,NA,"0.1.4"
"25857","646",2023-05-28 08:00:00,1215,1231,16,225,FALSE,NA,"0.1.4"
"25858","646",2023-05-28 08:15:00,1186,1231,45,225,FALSE,NA,"0.1.4"
"25859","646",2023-05-28 08:30:00,1307,1307,0,301,FALSE,NA,"0.1.4"
"25860","646",2023-05-28 08:45:00,1312,1312,0,306,FALSE,NA,"0.1.4"
"25861","646",2023-05-28 09:00:00,1307,1312,5,306,FALSE,NA,"0.1.4"
"25862","646",2023-05-28 09:15:00,1305,1312,7,306,FALSE,NA,"0.1.4"
"25863","646",2023-05-28 09:30:00,1301,1312,11,306,FALSE,NA,"0.1.4"
"25864","646",2023-05-28 09:45:00,1308,1312,4,306,FALSE,NA,"0.1.4"
"25865","646",2023-05-28 10:00:00,1280,1312,32,306,FALSE,NA,"0.1.4"
"25866","646",2023-05-28 10:15:00,1293,1312,19,306,FALSE,NA,"0.1.4"
"25867","646",2023-05-28 10:30:00,1304,1312,8,306,FALSE,NA,"0.1.4"
"25868","646",2023-05-28 10:45:00,1307,1312,5,306,FALSE,NA,"0.1.4"
"25869","646",2023-05-28 11:00:00,1307,1312,5,306,FALSE,NA,"0.1.4"
"25870","646",2023-05-28 11:15:00,1308,1312,4,306,FALSE,NA,"0.1.4"
"25871","646",2023-05-28 11:30:00,1308,1312,4,306,FALSE,NA,"0.1.4"
"25872","646",2023-05-28 11:45:00,1303,1312,9,306,FALSE,NA,"0.1.4"
"25873","646",2023-05-28 12:00:00,1302,1312,10,306,FALSE,NA,"0.1.4"
"25874","646",2023-05-28 12:15:00,1306,1312,6,306,FALSE,NA,"0.1.4"
"25875","646",2023-05-28 12:30:00,1309,1312,3,306,FALSE,NA,"0.1.4"
"25876","646",2023-05-28 12:45:00,1305,1312,7,306,FALSE,NA,"0.1.4"
"25877","646",2023-05-28 13:00:00,1309,1312,3,306,FALSE,NA,"0.1.4"
"25878","646",2023-05-28 13:15:00,1309,1312,3,306,FALSE,NA,"0.1.4"
"25879","646",2023-05-28 13:30:00,1308,1312,4,306,FALSE,NA,"0.1.4"
"25880","646",2023-05-28 13:45:00,1307,1312,5,306,FALSE,NA,"0.1.4"
"25881","646",2023-05-28 14:00:00,1307,1312,5,306,FALSE,NA,"0.1.4"
"25882","646",2023-05-28 14:15:00,1308,1312,4,306,FALSE,NA,"0.1.4"
"25883","646",2023-05-28 14:30:00,1306,1312,6,306,FALSE,NA,"0.1.4"
"25884","646",2023-05-28 14:45:00,1305,1312,7,306,FALSE,NA,"0.1.4"
"25885","646",2023-05-28 15:00:00,1307,1312,5,306,FALSE,NA,"0.1.4"
"25886","646",2023-05-28 15:15:00,1307,1312,5,306,FALSE,NA,"0.1.4"
"25887","646",2023-05-28 15:30:00,1306,1312,6,306,FALSE,NA,"0.1.4"
"25888","646",2023-05-28 15:45:00,1306,1312,6,306,FALSE,NA,"0.1.4"
"25889","646",2023-05-28 16:00:00,1305,1312,7,306,FALSE,NA,"0.1.4"
"25890","646",2023-05-28 16:15:00,1307,1312,5,306,FALSE,NA,"0.1.4"
"25891","646",2023-05-28 16:30:00,1305,1312,7,306,FALSE,NA,"0.1.4"
"25892","646",2023-05-28 16:45:00,1304,1312,8,306,FALSE,NA,"0.1.4"
"25893","646",2023-05-28 17:00:00,1305,1312,7,306,FALSE,NA,"0.1.4"
"25894","646",2023-05-28 17:15:00,1305,1312,7,306,FALSE,NA,"0.1.4"
"25895","646",2023-05-28 17:30:00,1306,1312,6,306,FALSE,NA,"0.1.4"
"25896","646",2023-05-28 17:45:00,1291,1312,21,306,FALSE,NA,"0.1.4"
"25897","646",2023-05-28 18:00:00,1292,1312,20,306,FALSE,NA,"0.1.4"
"25898","646",2023-05-28 18:15:00,1245,1312,67,306,FALSE,NA,"0.1.4"
"25899","646",2023-05-28 18:30:00,1252,1312,60,306,FALSE,NA,"0.1.4"
"25900","646",2023-05-28 18:45:00,1292,1312,20,306,FALSE,NA,"0.1.4"
"25901","646",2023-05-28 19:00:00,1290,1312,22,306,FALSE,NA,"0.1.4"
"25902","646",2023-05-28 19:15:00,1304,1312,8,306,FALSE,NA,"0.1.4"
"25903","646",2023-05-28 19:30:00,1268,1312,44,306,FALSE,NA,"0.1.4"
"25904","646",2023-05-28 19:45:00,1294,1312,18,306,FALSE,NA,"0.1.4"
"25905","646",2023-05-28 20:00:00,1231,1312,81,306,FALSE,NA,"0.1.4"
"25906","646",2023-05-28 20:15:00,1290,1312,22,306,FALSE,NA,"0.1.4"
"25907","646",2023-05-28 20:30:00,1263,1312,49,306,FALSE,NA,"0.1.4"
"25908","646",2023-05-28 20:45:00,1295,1312,17,306,FALSE,NA,"0.1.4"
"25909","646",2023-05-28 21:00:00,1288,1312,24,306,FALSE,NA,"0.1.4"
"25910","646",2023-05-28 21:15:00,1287,1312,25,306,FALSE,NA,"0.1.4"
"25911","646",2023-05-28 21:30:00,1273,1312,39,306,FALSE,NA,"0.1.4"
"25912","646",2023-05-28 21:45:00,1260,1312,52,306,FALSE,NA,"0.1.4"
"25913","646",2023-05-28 22:00:00,1260,1312,52,306,FALSE,NA,"0.1.4"
"25914","646",2023-05-28 22:15:00,1269,1312,43,306,FALSE,NA,"0.1.4"
"25915","646",2023-05-28 22:30:00,1273,1312,39,306,FALSE,NA,"0.1.4"
"25916","646",2023-05-28 22:45:00,1245,1312,67,306,FALSE,NA,"0.1.4"
"25917","646",2023-05-28 23:00:00,1252,1312,60,306,FALSE,NA,"0.1.4"
"25918","646",2023-05-28 23:15:00,1258,1312,54,306,FALSE,NA,"0.1.4"
"25919","646",2023-05-28 23:30:00,1282,1312,30,306,FALSE,NA,"0.1.4"
"25920","646",2023-05-28 23:45:00,1281,1312,31,306,FALSE,NA,"0.1.4"
"25921","646",2023-05-29,1275,1312,37,306,FALSE,NA,"0.1.4"
"25922","646",2023-05-29 00:15:00,1279,1312,33,306,FALSE,NA,"0.1.4"
"25923","646",2023-05-29 00:30:00,1277,1312,35,306,FALSE,NA,"0.1.4"
"25924","646",2023-05-29 00:45:00,1232,1312,80,306,FALSE,NA,"0.1.4"
"25925","646",2023-05-29 01:00:00,1229,1312,83,306,FALSE,NA,"0.1.4"
"25926","646",2023-05-29 01:15:00,1227,1312,85,306,FALSE,NA,"0.1.4"
"25927","646",2023-05-29 01:30:00,1265,1312,47,306,FALSE,NA,"0.1.4"
"25928","646",2023-05-29 01:45:00,1279,1312,33,306,FALSE,NA,"0.1.4"
"25929","646",2023-05-29 02:00:00,1236,1312,76,306,FALSE,NA,"0.1.4"
"25930","646",2023-05-29 02:15:00,1225,1312,87,306,FALSE,NA,"0.1.4"
"25931","646",2023-05-29 02:30:00,1236,1312,76,306,FALSE,NA,"0.1.4"
"25932","646",2023-05-29 02:45:00,1222,1312,90,306,FALSE,NA,"0.1.4"
"25933","646",2023-05-29 03:00:00,1131,1312,181,306,FALSE,NA,"0.1.4"
"25934","646",2023-05-29 03:15:00,1278,1312,34,306,FALSE,NA,"0.1.4"
"25935","646",2023-05-29 03:30:00,1040,1312,272,306,FALSE,NA,"0.1.4"
"25936","646",2023-05-29 03:45:00,1161,1312,151,306,FALSE,NA,"0.1.4"
"25937","646",2023-05-29 04:00:00,1161,1312,151,306,FALSE,"jump1","0.1.4"
"25938","646",2023-05-29 04:15:00,1161,1312,151,306,FALSE,"jump1","0.1.4"
"25939","646",2023-05-29 04:30:00,1027,1312,285,306,FALSE,NA,"0.1.4"
"25940","646",2023-05-29 04:45:00,1059,1312,253,306,FALSE,NA,"0.1.4"
"25941","646",2023-05-29 05:00:00,1145,1312,167,306,FALSE,NA,"0.1.4"
"25942","646",2023-05-29 05:15:00,1145,1312,167,306,FALSE,"jump1","0.1.4"
"25943","646",2023-05-29 05:30:00,1640,1640,0,634,FALSE,NA,"0.1.4"
"25944","646",2023-05-29 05:45:00,1388,1640,252,634,FALSE,NA,"0.1.4"
"25945","646",2023-05-29 06:00:00,1735,1735,0,729,FALSE,NA,"0.1.4"
"25946","646",2023-05-29 06:15:00,1758,1758,0,752,FALSE,NA,"0.1.4"
"25947","646",2023-05-29 06:30:00,1813,1813,0,807,FALSE,NA,"0.1.4"
"25948","646",2023-05-29 06:45:00,1813,1813,0,807,FALSE,NA,"0.1.4"
"25949","646",2023-05-29 07:00:00,1831,1831,0,825,FALSE,NA,"0.1.4"
"25950","646",2023-05-29 07:15:00,1837,1837,0,831,FALSE,NA,"0.1.4"
"25951","646",2023-05-29 07:30:00,1813,1837,24,831,FALSE,NA,"0.1.4"
"25952","646",2023-05-29 07:45:00,1813,1837,24,831,FALSE,NA,"0.1.4"
"25953","646",2023-05-29 08:00:00,1807,1837,30,831,FALSE,NA,"0.1.4"
"25954","646",2023-05-29 08:15:00,1807,1837,30,831,FALSE,"jump1","0.1.4"
"25955","646",2023-05-29 08:30:00,1807,1837,30,831,FALSE,"jump1","0.1.4"
"25956","646",2023-05-29 08:45:00,1417,1837,420,831,FALSE,NA,"0.1.4"
"25957","646",2023-05-29 09:00:00,1216,1837,621,831,FALSE,NA,"0.1.4"
"25958","646",2023-05-29 09:15:00,1216,1837,621,831,FALSE,"jump1","0.1.4"
"25959","646",2023-05-29 09:30:00,1134,1837,703,831,FALSE,NA,"0.1.4"
"25960","646",2023-05-29 09:45:00,1194,1837,643,831,FALSE,NA,"0.1.4"
"25961","646",2023-05-29 10:00:00,1208,1837,629,831,FALSE,NA,"0.1.4"
"25962","646",2023-05-29 10:15:00,1258,1837,579,831,FALSE,NA,"0.1.4"
"25963","646",2023-05-29 10:30:00,1271,1837,566,831,FALSE,NA,"0.1.4"
"25964","646",2023-05-29 10:45:00,1194,1837,643,831,FALSE,NA,"0.1.4"
"25965","646",2023-05-29 11:00:00,1194,1837,643,831,FALSE,NA,"0.1.4"
"25966","646",2023-05-29 11:15:00,1239,1837,598,831,FALSE,NA,"0.1.4"
"25967","646",2023-05-29 11:30:00,1195,1837,642,831,FALSE,NA,"0.1.4"
"25968","646",2023-05-29 11:45:00,1196,1837,641,831,FALSE,NA,"0.1.4"
"25969","646",2023-05-29 12:00:00,1196,1837,641,831,FALSE,NA,"0.1.4"
"25970","646",2023-05-29 12:15:00,1199,1837,638,831,FALSE,NA,"0.1.4"
"25971","646",2023-05-29 12:30:00,1233,1837,604,831,FALSE,NA,"0.1.4"
"25972","646",2023-05-29 12:45:00,1196,1837,641,831,FALSE,NA,"0.1.4"
"25973","646",2023-05-29 13:00:00,1196,1837,641,831,FALSE,NA,"0.1.4"
"25974","646",2023-05-29 13:15:00,1196,1837,641,831,FALSE,NA,"0.1.4"
"25975","646",2023-05-29 13:30:00,1199,1837,638,831,FALSE,NA,"0.1.4"
"25976","646",2023-05-29 13:45:00,1236,1837,601,831,FALSE,NA,"0.1.4"
"25977","646",2023-05-29 14:00:00,1210,1837,627,831,FALSE,NA,"0.1.4"
"25978","646",2023-05-29 14:15:00,1222,1837,615,831,FALSE,NA,"0.1.4"
"25979","646",2023-05-29 14:30:00,1204,1837,633,831,FALSE,NA,"0.1.4"
"25980","646",2023-05-29 14:45:00,1203,1837,634,831,FALSE,NA,"0.1.4"
"25981","646",2023-05-29 15:00:00,1208,1837,629,831,FALSE,NA,"0.1.4"
"25982","646",2023-05-29 15:15:00,1221,1837,616,831,FALSE,NA,"0.1.4"
"25983","646",2023-05-29 15:30:00,1222,1837,615,831,FALSE,NA,"0.1.4"
"25984","646",2023-05-29 15:45:00,1206,1837,631,831,FALSE,NA,"0.1.4"
"25985","646",2023-05-29 16:00:00,1202,1837,635,831,FALSE,NA,"0.1.4"
"25986","646",2023-05-29 16:15:00,1205,1837,632,831,FALSE,NA,"0.1.4"
"25987","646",2023-05-29 16:30:00,1222,1837,615,831,FALSE,NA,"0.1.4"
"25988","646",2023-05-29 16:45:00,1209,1837,628,831,FALSE,NA,"0.1.4"
"25989","646",2023-05-29 17:00:00,1212,1837,625,831,FALSE,NA,"0.1.4"
"25990","646",2023-05-29 17:15:00,1204,1837,633,831,FALSE,NA,"0.1.4"
"25991","646",2023-05-29 17:30:00,1206,1837,631,831,FALSE,NA,"0.1.4"
"25992","646",2023-05-29 17:45:00,1205,1837,632,831,FALSE,NA,"0.1.4"
"25993","646",2023-05-29 18:00:00,1204,1837,633,831,FALSE,NA,"0.1.4"
"25994","646",2023-05-29 18:15:00,1204,1837,633,831,FALSE,NA,"0.1.4"
"25995","646",2023-05-29 18:30:00,1205,1837,632,831,FALSE,NA,"0.1.4"
"25996","646",2023-05-29 18:45:00,1204,1837,633,831,FALSE,NA,"0.1.4"
"25997","646",2023-05-29 19:00:00,1211,1837,626,831,FALSE,NA,"0.1.4"
"25998","646",2023-05-29 19:15:00,1212,1837,625,831,FALSE,NA,"0.1.4"
"25999","646",2023-05-29 19:30:00,1216,1837,621,831,FALSE,NA,"0.1.4"
"26000","646",2023-05-29 19:45:00,1212,1837,625,831,FALSE,NA,"0.1.4"
"26001","646",2023-05-29 20:00:00,1211,1837,626,831,FALSE,NA,"0.1.4"
"26002","646",2023-05-29 20:15:00,1203,1837,634,831,FALSE,NA,"0.1.4"
"26003","646",2023-05-29 20:30:00,1204,1837,633,831,FALSE,NA,"0.1.4"
"26004","646",2023-05-29 20:45:00,1209,1837,628,831,FALSE,NA,"0.1.4"
"26005","646",2023-05-29 21:00:00,1210,1837,627,831,FALSE,NA,"0.1.4"
"26006","646",2023-05-29 21:15:00,1215,1837,622,831,FALSE,NA,"0.1.4"
"26007","646",2023-05-29 21:30:00,1209,1837,628,831,FALSE,NA,"0.1.4"
"26008","646",2023-05-29 21:45:00,1205,1837,632,831,FALSE,NA,"0.1.4"
"26009","646",2023-05-29 22:00:00,1212,1837,625,831,FALSE,NA,"0.1.4"
"26010","646",2023-05-29 22:15:00,1217,1837,620,831,FALSE,NA,"0.1.4"
"26011","646",2023-05-29 22:30:00,1219,1837,618,831,FALSE,NA,"0.1.4"
"26012","646",2023-05-29 22:45:00,1217,1837,620,831,FALSE,NA,"0.1.4"
"26013","646",2023-05-29 23:00:00,1217,1837,620,831,FALSE,NA,"0.1.4"
"26014","646",2023-05-29 23:15:00,1225,1837,612,831,FALSE,NA,"0.1.4"
"26015","646",2023-05-29 23:30:00,1236,1837,601,831,FALSE,NA,"0.1.4"
"26016","646",2023-05-29 23:45:00,1215,1837,622,831,FALSE,NA,"0.1.4"
"26017","646",2023-05-30,1216,1837,621,831,FALSE,NA,"0.1.4"
"26018","646",2023-05-30 00:15:00,1225,1837,612,831,FALSE,NA,"0.1.4"
"26019","646",2023-05-30 00:30:00,1225,1837,612,831,FALSE,NA,"0.1.4"
"26020","646",2023-05-30 00:45:00,1212,1837,625,831,FALSE,NA,"0.1.4"
"26021","646",2023-05-30 01:00:00,1232,1837,605,831,FALSE,NA,"0.1.4"
"26022","646",2023-05-30 01:15:00,1225,1837,612,831,FALSE,NA,"0.1.4"
"26023","646",2023-05-30 01:30:00,1210,1837,627,831,FALSE,NA,"0.1.4"
"26024","646",2023-05-30 01:45:00,1224,1837,613,831,FALSE,NA,"0.1.4"
"26025","646",2023-05-30 02:00:00,1232,1837,605,831,FALSE,NA,"0.1.4"
"26026","646",2023-05-30 02:15:00,1230,1837,607,831,FALSE,NA,"0.1.4"
"26027","646",2023-05-30 02:30:00,1221,1837,616,831,FALSE,NA,"0.1.4"
"26028","646",2023-05-30 02:45:00,1219,1837,618,831,FALSE,NA,"0.1.4"
"26029","646",2023-05-30 03:00:00,1220,1837,617,831,FALSE,NA,"0.1.4"
"26030","646",2023-05-30 03:15:00,1231,1837,606,831,FALSE,NA,"0.1.4"
"26031","646",2023-05-30 03:30:00,1239,1837,598,831,FALSE,NA,"0.1.4"
"26032","646",2023-05-30 03:45:00,1254,1837,583,831,FALSE,NA,"0.1.4"
"26033","646",2023-05-30 04:00:00,1239,1837,598,831,FALSE,NA,"0.1.4"
"26034","646",2023-05-30 04:15:00,1242,1837,595,831,FALSE,NA,"0.1.4"
"26035","646",2023-05-30 04:30:00,1240,1837,597,831,FALSE,NA,"0.1.4"
"26036","646",2023-05-30 04:45:00,1239,1837,598,831,FALSE,NA,"0.1.4"
"26037","646",2023-05-30 05:00:00,1231,1837,606,831,FALSE,NA,"0.1.4"
"26038","646",2023-05-30 05:15:00,1230,1837,607,831,FALSE,NA,"0.1.4"
"26039","646",2023-05-30 05:30:00,1274,1837,563,831,FALSE,NA,"0.1.4"
"26040","646",2023-05-30 05:45:00,1251,1837,586,831,FALSE,NA,"0.1.4"
"26041","646",2023-05-30 06:00:00,1278,1837,559,831,FALSE,NA,"0.1.4"
"26042","646",2023-05-30 06:15:00,1283,1837,554,831,FALSE,NA,"0.1.4"
"26043","646",2023-05-30 06:30:00,1270,1837,567,831,FALSE,NA,"0.1.4"
"26044","646",2023-05-30 06:45:00,1289,1837,548,831,FALSE,NA,"0.1.4"
"26045","646",2023-05-30 07:00:00,1267,1837,570,831,FALSE,NA,"0.1.4"
"26046","646",2023-05-30 07:15:00,1269,1837,568,831,FALSE,NA,"0.1.4"
"26047","646",2023-05-30 07:30:00,1258,1837,579,831,FALSE,NA,"0.1.4"
"26048","646",2023-05-30 07:45:00,1208,1837,629,831,FALSE,NA,"0.1.4"
"26049","646",2023-05-30 08:00:00,1235,1837,602,831,FALSE,NA,"0.1.4"
"26050","646",2023-05-30 08:15:00,1226,1837,611,831,FALSE,NA,"0.1.4"
"26051","646",2023-05-30 08:30:00,1212,1837,625,831,FALSE,NA,"0.1.4"
"26052","646",2023-05-30 08:45:00,1224,1837,613,831,FALSE,NA,"0.1.4"
"26053","646",2023-05-30 09:00:00,1223,1837,614,831,FALSE,NA,"0.1.4"
"26054","646",2023-05-30 09:15:00,1209,1837,628,831,FALSE,NA,"0.1.4"
"26055","646",2023-05-30 09:30:00,1222,1837,615,831,FALSE,NA,"0.1.4"
"26056","646",2023-05-30 09:45:00,1234,1837,603,831,FALSE,NA,"0.1.4"
"26057","646",2023-05-30 10:00:00,1215,1837,622,831,FALSE,NA,"0.1.4"
"26058","646",2023-05-30 10:15:00,1240,1837,597,831,FALSE,NA,"0.1.4"
"26059","646",2023-05-30 10:30:00,1250,1837,587,831,FALSE,NA,"0.1.4"
"26060","646",2023-05-30 10:45:00,1204,1837,633,831,FALSE,NA,"0.1.4"
"26061","646",2023-05-30 11:00:00,1213,1837,624,831,FALSE,NA,"0.1.4"
"26062","646",2023-05-30 11:15:00,1218,1837,619,831,FALSE,NA,"0.1.4"
"26063","646",2023-05-30 11:30:00,1262,1837,575,831,FALSE,NA,"0.1.4"
"26064","646",2023-05-30 11:45:00,1228,1837,609,831,FALSE,NA,"0.1.4"
"26065","646",2023-05-30 12:00:00,1228,1837,609,831,FALSE,NA,"0.1.4"
"26066","646",2023-05-30 12:15:00,1253,1837,584,831,FALSE,NA,"0.1.4"
"26067","646",2023-05-30 12:30:00,1228,1837,609,831,FALSE,NA,"0.1.4"
"26068","646",2023-05-30 12:45:00,1254,1837,583,831,FALSE,NA,"0.1.4"
"26069","646",2023-05-30 13:00:00,1288,1837,549,831,FALSE,NA,"0.1.4"
"26070","646",2023-05-30 13:15:00,1285,1837,552,831,FALSE,NA,"0.1.4"
"26071","646",2023-05-30 13:30:00,1276,1837,561,831,FALSE,NA,"0.1.4"
"26072","646",2023-05-30 13:45:00,1225,1837,612,831,FALSE,NA,"0.1.4"
"26073","646",2023-05-30 14:00:00,1278,1837,559,831,FALSE,NA,"0.1.4"
"26074","646",2023-05-30 14:15:00,1243,1837,594,831,FALSE,NA,"0.1.4"
"26075","646",2023-05-30 14:30:00,1236,1837,601,831,FALSE,NA,"0.1.4"
"26076","646",2023-05-30 14:45:00,1231,1837,606,831,FALSE,NA,"0.1.4"
"26077","646",2023-05-30 15:00:00,1232,1837,605,831,FALSE,NA,"0.1.4"
"26078","646",2023-05-30 15:15:00,1243,1837,594,831,FALSE,NA,"0.1.4"
"26079","646",2023-05-30 15:30:00,1270,1837,567,831,FALSE,NA,"0.1.4"
"26080","646",2023-05-30 15:45:00,1248,1837,589,831,FALSE,NA,"0.1.4"
"26081","646",2023-05-30 16:00:00,1281,1837,556,831,FALSE,NA,"0.1.4"
"26082","646",2023-05-30 16:15:00,1294,1837,543,831,FALSE,NA,"0.1.4"
"26083","646",2023-05-30 16:30:00,1295,1837,542,831,FALSE,NA,"0.1.4"
"26084","646",2023-05-30 16:45:00,1290,1837,547,831,FALSE,NA,"0.1.4"
"26085","646",2023-05-30 17:00:00,1288,1837,549,831,FALSE,NA,"0.1.4"
"26086","646",2023-05-30 17:15:00,1286,1837,551,831,FALSE,NA,"0.1.4"
"26087","646",2023-05-30 17:30:00,1287,1837,550,831,FALSE,NA,"0.1.4"
"26088","646",2023-05-30 17:45:00,1290,1837,547,831,FALSE,NA,"0.1.4"
"26089","646",2023-05-30 18:00:00,1292,1837,545,831,FALSE,NA,"0.1.4"
"26090","646",2023-05-30 18:15:00,1294,1837,543,831,FALSE,NA,"0.1.4"
"26091","646",2023-05-30 18:30:00,1294,1837,543,831,FALSE,NA,"0.1.4"
"26092","646",2023-05-30 18:45:00,1297,1837,540,831,FALSE,NA,"0.1.4"
"26093","646",2023-05-30 19:00:00,1290,1837,547,831,FALSE,NA,"0.1.4"
"26094","646",2023-05-30 19:15:00,1286,1837,551,831,FALSE,NA,"0.1.4"
"26095","646",2023-05-30 19:30:00,1287,1837,550,831,FALSE,NA,"0.1.4"
"26096","646",2023-05-30 19:45:00,1275,1837,562,831,FALSE,NA,"0.1.4"
"26097","646",2023-05-30 20:00:00,1293,1837,544,831,FALSE,NA,"0.1.4"
"26098","646",2023-05-30 20:15:00,1280,1837,557,831,FALSE,NA,"0.1.4"
"26099","646",2023-05-30 20:30:00,1270,1837,567,831,FALSE,NA,"0.1.4"
"26100","646",2023-05-30 20:45:00,1254,1837,583,831,FALSE,NA,"0.1.4"
"26101","646",2023-05-30 21:00:00,1280,1837,557,831,FALSE,NA,"0.1.4"
"26102","646",2023-05-30 21:15:00,1261,1837,576,831,FALSE,NA,"0.1.4"
"26103","646",2023-05-30 21:30:00,1263,1837,574,831,FALSE,NA,"0.1.4"
"26104","646",2023-05-30 21:45:00,1264,1837,573,831,FALSE,NA,"0.1.4"
"26105","646",2023-05-30 22:00:00,1266,1837,571,831,FALSE,NA,"0.1.4"
"26106","646",2023-05-30 22:15:00,1284,1837,553,831,FALSE,NA,"0.1.4"
"26107","646",2023-05-30 22:30:00,1288,1837,549,831,FALSE,NA,"0.1.4"
"26108","646",2023-05-30 22:45:00,1296,1837,541,831,FALSE,NA,"0.1.4"
"26109","646",2023-05-30 23:00:00,1286,1837,551,831,FALSE,NA,"0.1.4"
"26110","646",2023-05-30 23:15:00,1249,1837,588,831,FALSE,NA,"0.1.4"
"26111","646",2023-05-30 23:30:00,1271,1837,566,831,FALSE,NA,"0.1.4"
"26112","646",2023-05-30 23:45:00,1266,1837,571,831,FALSE,NA,"0.1.4"
"26113","646",2023-05-31,1271,1837,566,831,FALSE,NA,"0.1.4"
"26114","646",2023-05-31 00:15:00,1255,1837,582,831,FALSE,NA,"0.1.4"
"26115","646",2023-05-31 00:30:00,1243,1837,594,831,FALSE,NA,"0.1.4"
"26116","646",2023-05-31 00:45:00,1272,1837,565,831,FALSE,NA,"0.1.4"
"26117","646",2023-05-31 01:00:00,1256,1837,581,831,FALSE,NA,"0.1.4"
"26118","646",2023-05-31 01:15:00,1280,1837,557,831,FALSE,NA,"0.1.4"
"26119","646",2023-05-31 01:30:00,1273,1837,564,831,FALSE,NA,"0.1.4"
"26120","646",2023-05-31 01:45:00,1282,1837,555,831,FALSE,NA,"0.1.4"
"26121","646",2023-05-31 02:00:00,1245,1837,592,831,FALSE,NA,"0.1.4"
"26122","646",2023-05-31 02:15:00,1253,1837,584,831,FALSE,NA,"0.1.4"
"26123","646",2023-05-31 02:30:00,1255,1837,582,831,FALSE,NA,"0.1.4"
"26124","646",2023-05-31 02:45:00,1254,1837,583,831,FALSE,NA,"0.1.4"
"26125","646",2023-05-31 03:00:00,1274,1837,563,831,FALSE,NA,"0.1.4"
"26126","646",2023-05-31 03:15:00,1244,1837,593,831,FALSE,NA,"0.1.4"
"26127","646",2023-05-31 03:30:00,1237,1837,600,831,FALSE,NA,"0.1.4"
"26128","646",2023-05-31 03:45:00,1234,1837,603,831,FALSE,NA,"0.1.4"
"26129","646",2023-05-31 04:00:00,1243,1837,594,831,FALSE,NA,"0.1.4"
"26130","646",2023-05-31 04:15:00,1263,1837,574,831,FALSE,NA,"0.1.4"
"26131","646",2023-05-31 04:30:00,1236,1837,601,831,FALSE,NA,"0.1.4"
"26132","646",2023-05-31 04:45:00,1249,1837,588,831,FALSE,NA,"0.1.4"
"26133","646",2023-05-31 05:00:00,1240,1837,597,831,FALSE,NA,"0.1.4"
"26134","646",2023-05-31 05:15:00,1270,1837,567,831,FALSE,NA,"0.1.4"
"26135","646",2023-05-31 05:30:00,1243,1837,594,831,FALSE,NA,"0.1.4"
"26136","646",2023-05-31 05:45:00,1245,1837,592,831,FALSE,NA,"0.1.4"
"26137","646",2023-05-31 06:00:00,1263,1837,574,831,FALSE,NA,"0.1.4"
"26138","646",2023-05-31 06:15:00,1240,1837,597,831,FALSE,NA,"0.1.4"
"26139","646",2023-05-31 06:30:00,1258,1837,579,831,FALSE,NA,"0.1.4"
"26140","646",2023-05-31 06:45:00,1260,1837,577,831,FALSE,NA,"0.1.4"
"26141","646",2023-05-31 07:00:00,1274,1837,563,831,FALSE,NA,"0.1.4"
"26142","646",2023-05-31 07:15:00,1270,1837,567,831,FALSE,NA,"0.1.4"
"26143","646",2023-05-31 07:30:00,1244,1837,593,831,FALSE,NA,"0.1.4"
"26144","646",2023-05-31 07:45:00,1262,1837,575,831,FALSE,NA,"0.1.4"
"26145","646",2023-05-31 08:00:00,1249,1837,588,831,FALSE,NA,"0.1.4"
"26146","646",2023-05-31 08:15:00,1267,1837,570,831,FALSE,NA,"0.1.4"
"26147","646",2023-05-31 08:30:00,1275,1837,562,831,FALSE,NA,"0.1.4"
"26148","646",2023-05-31 08:45:00,1278,1837,559,831,FALSE,NA,"0.1.4"
"26149","646",2023-05-31 09:00:00,1278,1837,559,831,FALSE,NA,"0.1.4"
"26150","646",2023-05-31 09:15:00,1278,1837,559,831,FALSE,NA,"0.1.4"
"26151","646",2023-05-31 09:30:00,1259,1837,578,831,FALSE,NA,"0.1.4"
"26152","646",2023-05-31 09:45:00,1269,1837,568,831,FALSE,NA,"0.1.4"
"26153","646",2023-05-31 10:00:00,1268,1837,569,831,FALSE,NA,"0.1.4"
"26154","646",2023-05-31 10:15:00,1265,1837,572,831,FALSE,NA,"0.1.4"
"26155","646",2023-05-31 10:30:00,1265,1837,572,831,FALSE,NA,"0.1.4"
"26156","646",2023-05-31 10:45:00,1267,1837,570,831,FALSE,NA,"0.1.4"
"26157","646",2023-05-31 11:00:00,1252,1837,585,831,FALSE,NA,"0.1.4"
"26158","646",2023-05-31 11:15:00,1251,1837,586,831,FALSE,NA,"0.1.4"
"26159","646",2023-05-31 11:30:00,1269,1837,568,831,FALSE,NA,"0.1.4"
"26160","646",2023-05-31 11:45:00,1259,1837,578,831,FALSE,NA,"0.1.4"
"26161","646",2023-05-31 12:00:00,1254,1837,583,831,FALSE,NA,"0.1.4"
"26162","646",2023-05-31 12:15:00,1259,1837,578,831,FALSE,NA,"0.1.4"
"26163","646",2023-05-31 12:30:00,1258,1837,579,831,FALSE,NA,"0.1.4"
"26164","646",2023-05-31 12:45:00,1252,1837,585,831,FALSE,NA,"0.1.4"
"26165","646",2023-05-31 13:00:00,1255,1837,582,831,FALSE,NA,"0.1.4"
"26166","646",2023-05-31 13:15:00,1249,1837,588,831,FALSE,NA,"0.1.4"
"26167","646",2023-05-31 13:30:00,1249,1837,588,831,FALSE,NA,"0.1.4"
"26168","646",2023-05-31 13:45:00,1249,1837,588,831,FALSE,NA,"0.1.4"
"26169","646",2023-05-31 14:00:00,1249,1837,588,831,FALSE,NA,"0.1.4"
"26170","646",2023-05-31 14:15:00,1249,1837,588,831,FALSE,NA,"0.1.4"
"26171","646",2023-05-31 14:30:00,1249,1837,588,831,FALSE,NA,"0.1.4"
"26172","646",2023-05-31 14:45:00,1249,1837,588,831,FALSE,NA,"0.1.4"
"26173","646",2023-05-31 15:00:00,1249,1837,588,831,FALSE,NA,"0.1.4"
"26174","646",2023-05-31 15:15:00,1249,1837,588,831,FALSE,NA,"0.1.4"
"26175","646",2023-05-31 15:30:00,1249,1837,588,831,FALSE,NA,"0.1.4"
"26176","646",2023-05-31 15:45:00,1249,1837,588,831,FALSE,NA,"0.1.4"
"26177","646",2023-05-31 16:00:00,1250,1837,587,831,FALSE,NA,"0.1.4"
"26178","646",2023-05-31 16:15:00,1250,1837,587,831,FALSE,NA,"0.1.4"
"26179","646",2023-05-31 16:30:00,1250,1837,587,831,FALSE,NA,"0.1.4"
"26180","646",2023-05-31 16:45:00,1250,1837,587,831,FALSE,NA,"0.1.4"
"26181","646",2023-05-31 17:00:00,1250,1837,587,831,FALSE,NA,"0.1.4"
"26182","646",2023-05-31 17:15:00,1249,1837,588,831,FALSE,NA,"0.1.4"
"26183","646",2023-05-31 17:30:00,1249,1837,588,831,FALSE,NA,"0.1.4"
"26184","646",2023-05-31 17:45:00,1249,1837,588,831,FALSE,NA,"0.1.4"
"26185","646",2023-05-31 18:00:00,1250,1837,587,831,FALSE,NA,"0.1.4"
"26186","646",2023-05-31 18:15:00,1269,1837,568,831,FALSE,NA,"0.1.4"
"26187","646",2023-05-31 18:30:00,1249,1837,588,831,FALSE,NA,"0.1.4"
"26188","646",2023-05-31 18:45:00,1263,1837,574,831,FALSE,NA,"0.1.4"
"26189","646",2023-05-31 19:00:00,1251,1837,586,831,FALSE,NA,"0.1.4"
"26190","646",2023-05-31 19:15:00,1252,1837,585,831,FALSE,NA,"0.1.4"
"26191","646",2023-05-31 19:30:00,1253,1837,584,831,FALSE,NA,"0.1.4"
"26192","646",2023-05-31 19:45:00,1285,1837,552,831,FALSE,NA,"0.1.4"
"26193","646",2023-05-31 20:00:00,1261,1837,576,831,FALSE,NA,"0.1.4"
"26194","646",2023-05-31 20:15:00,1254,1837,583,831,FALSE,NA,"0.1.4"
"26195","646",2023-05-31 20:30:00,1251,1837,586,831,FALSE,NA,"0.1.4"
"26196","646",2023-05-31 20:45:00,1252,1837,585,831,FALSE,NA,"0.1.4"
"26197","646",2023-05-31 21:00:00,1246,1837,591,831,FALSE,NA,"0.1.4"
"26198","646",2023-05-31 21:15:00,1274,1837,563,831,FALSE,NA,"0.1.4"
"26199","646",2023-05-31 21:30:00,1273,1837,564,831,FALSE,NA,"0.1.4"
"26200","646",2023-05-31 21:45:00,1263,1837,574,831,FALSE,NA,"0.1.4"
"26201","646",2023-05-31 22:00:00,1266,1837,571,831,FALSE,NA,"0.1.4"
"26202","646",2023-05-31 22:15:00,1263,1837,574,831,FALSE,NA,"0.1.4"
"26203","646",2023-05-31 22:30:00,1253,1837,584,831,FALSE,NA,"0.1.4"
"26204","646",2023-05-31 22:45:00,1250,1837,587,831,FALSE,NA,"0.1.4"
"26205","646",2023-05-31 23:00:00,1283,1837,554,831,FALSE,NA,"0.1.4"
"26206","646",2023-05-31 23:15:00,1244,1837,593,831,FALSE,NA,"0.1.4"
"26207","646",2023-05-31 23:30:00,1240,1837,597,831,FALSE,NA,"0.1.4"
"26208","646",2023-05-31 23:45:00,1290,1837,547,831,FALSE,NA,"0.1.4"
"26209","646",2023-06-01,1260,1837,577,831,FALSE,NA,"0.1.4"
"26210","646",2023-06-01 00:15:00,1238,1837,599,831,FALSE,NA,"0.1.4"
"26211","646",2023-06-01 00:30:00,1249,1837,588,831,FALSE,NA,"0.1.4"
"26212","646",2023-06-01 00:45:00,1248,1837,589,831,FALSE,NA,"0.1.4"
"26213","646",2023-06-01 01:00:00,1269,1837,568,831,FALSE,NA,"0.1.4"
"26214","646",2023-06-01 01:15:00,1249,1837,588,831,FALSE,NA,"0.1.4"
"26215","646",2023-06-01 01:30:00,1248,1837,589,831,FALSE,NA,"0.1.4"
"26216","646",2023-06-01 01:45:00,1054,1837,783,831,FALSE,NA,"0.1.4"
"26217","646",2023-06-01 02:00:00,1227,1837,610,831,FALSE,NA,"0.1.4"
"26218","646",2023-06-01 02:15:00,737,1837,1100,831,FALSE,NA,"0.1.4"
"26219","646",2023-06-01 02:30:00,752,1837,1085,831,FALSE,NA,"0.1.4"
"26220","646",2023-06-01 02:45:00,878,1837,959,831,FALSE,NA,"0.1.4"
"26221","646",2023-06-01 03:00:00,724,1837,1113,831,FALSE,NA,"0.1.4"
"26222","646",2023-06-01 03:15:00,724,1837,1113,831,FALSE,"jump1","0.1.4"
"26223","646",2023-06-01 03:30:00,701,1837,1136,831,FALSE,NA,"0.1.4"
"26224","646",2023-06-01 03:45:00,710,1837,1127,831,FALSE,NA,"0.1.4"
"26225","646",2023-06-01 04:00:00,710,1837,1127,831,FALSE,NA,"0.1.4"
"26226","646",2023-06-01 04:15:00,710,1837,1127,831,FALSE,NA,"0.1.4"
"26227","646",2023-06-01 04:30:00,710,1837,1127,831,FALSE,NA,"0.1.4"
"26228","646",2023-06-01 04:45:00,708,1837,1129,831,FALSE,NA,"0.1.4"
"26229","646",2023-06-01 05:00:00,709,1837,1128,831,FALSE,NA,"0.1.4"
"26230","646",2023-06-01 05:15:00,708,1837,1129,831,FALSE,NA,"0.1.4"
"26231","646",2023-06-01 05:30:00,704,1837,1133,831,FALSE,NA,"0.1.4"
"26232","646",2023-06-01 05:45:00,248,1837,1589,831,FALSE,NA,"0.1.4"
"26233","646",2023-06-01 06:00:00,28,1837,1809,831,FALSE,NA,"0.1.4"
"26234","646",2023-06-01 06:15:00,28,1837,1809,831,FALSE,"jump1","0.1.4"
"26235","646",2023-06-01 06:30:00,14,1837,1823,831,FALSE,NA,"0.1.4"
"26236","646",2023-06-01 06:45:00,27,1837,1810,831,FALSE,NA,"0.1.4"
"26237","646",2023-06-01 07:00:00,27,1837,1810,831,FALSE,NA,"0.1.4"
"26238","646",2023-06-01 07:15:00,28,1837,1809,831,FALSE,NA,"0.1.4"
"26239","646",2023-06-01 07:30:00,31,1837,1806,831,FALSE,NA,"0.1.4"
"26240","646",2023-06-01 07:45:00,28,1837,1809,831,FALSE,NA,"0.1.4"
"26241","646",2023-06-01 08:00:00,28,1837,1809,831,FALSE,NA,"0.1.4"
"26242","646",2023-06-01 08:15:00,28,1837,1809,831,FALSE,NA,"0.1.4"
"26243","646",2023-06-01 08:30:00,29,1837,1808,831,FALSE,NA,"0.1.4"
"26244","646",2023-06-01 08:45:00,28,1837,1809,831,FALSE,NA,"0.1.4"
"26245","646",2023-06-01 09:00:00,28,1837,1809,831,FALSE,NA,"0.1.4"
"26246","646",2023-06-01 09:15:00,28,1837,1809,831,FALSE,NA,"0.1.4"
"26247","646",2023-06-01 09:30:00,28,1837,1809,831,FALSE,NA,"0.1.4"
"26248","646",2023-06-01 09:45:00,29,1837,1808,831,FALSE,NA,"0.1.4"
"26249","646",2023-06-01 10:00:00,26,1837,1811,831,FALSE,NA,"0.1.4"
"26250","646",2023-06-01 10:15:00,15,1837,1822,831,FALSE,NA,"0.1.4"
"26251","646",2023-06-01 10:30:00,19,1837,1818,831,FALSE,NA,"0.1.4"
"26252","646",2023-06-01 10:45:00,29,1837,1808,831,TRUE,NA,"0.1.4"
"26253","646",2023-06-01 11:00:00,28,1837,1809,831,TRUE,NA,"0.1.4"
"26254","646",2023-06-01 11:15:00,28,1837,1809,831,TRUE,NA,"0.1.4"
"26255","646",2023-06-01 11:30:00,56,1837,1781,831,TRUE,NA,"0.1.4"
"26256","646",2023-06-01 11:45:00,28,1837,1809,831,TRUE,NA,"0.1.4"
"26257","646",2023-06-01 12:00:00,32,1837,1805,831,TRUE,NA,"0.1.4"
"26258","646",2023-06-01 12:15:00,29,1837,1808,831,TRUE,NA,"0.1.4"
"26259","646",2023-06-01 12:30:00,28,1837,1809,831,TRUE,NA,"0.1.4"
"26260","646",2023-06-01 12:45:00,28,1837,1809,831,TRUE,NA,"0.1.4"
"26261","646",2023-06-01 13:00:00,29,1837,1808,831,TRUE,NA,"0.1.4"
"26262","646",2023-06-01 13:15:00,30,1837,1807,831,TRUE,NA,"0.1.4"
"26263","646",2023-06-01 13:30:00,28,1837,1809,831,TRUE,NA,"0.1.4"
"26264","646",2023-06-01 13:45:00,28,1837,1809,831,TRUE,NA,"0.1.4"
"26265","646",2023-06-01 14:00:00,28,1837,1809,831,TRUE,NA,"0.1.4"
"26266","646",2023-06-01 14:15:00,28,1837,1809,831,TRUE,NA,"0.1.4"
"26267","646",2023-06-01 14:30:00,28,1837,1809,831,FALSE,NA,"0.1.4"
"26268","646",2023-06-01 14:45:00,28,1837,1809,831,FALSE,NA,"0.1.4"
"26269","646",2023-06-01 15:00:00,28,1837,1809,831,FALSE,NA,"0.1.4"
"26270","646",2023-06-01 15:15:00,28,1837,1809,831,FALSE,NA,"0.1.4"
"26271","646",2023-06-01 15:30:00,30,1837,1807,831,FALSE,NA,"0.1.4"
"26272","646",2023-06-01 15:45:00,31,1837,1806,831,FALSE,NA,"0.1.4"
"26273","646",2023-06-01 16:00:00,33,1837,1804,831,FALSE,NA,"0.1.4"
"26274","646",2023-06-01 16:15:00,30,1837,1807,831,FALSE,NA,"0.1.4"
"26275","646",2023-06-01 16:30:00,29,1837,1808,831,FALSE,NA,"0.1.4"
"26276","646",2023-06-01 16:45:00,29,1837,1808,831,FALSE,NA,"0.1.4"
"26277","646",2023-06-01 17:00:00,43,1837,1794,831,FALSE,NA,"0.1.4"
"26278","646",2023-06-01 17:15:00,43,1837,1794,831,FALSE,NA,"0.1.4"
"26279","646",2023-06-01 17:30:00,31,1837,1806,831,FALSE,NA,"0.1.4"
"26280","646",2023-06-01 17:45:00,32,1837,1805,831,FALSE,NA,"0.1.4"
"26281","646",2023-06-01 18:00:00,47,1837,1790,831,FALSE,NA,"0.1.4"
"26282","646",2023-06-01 18:15:00,-15,1837,1852,831,FALSE,NA,"0.1.4"
"26283","646",2023-06-01 18:30:00,66,1837,1771,831,FALSE,NA,"0.1.4"
"26284","646",2023-06-01 18:45:00,88,1837,1749,831,FALSE,NA,"0.1.4"
"26285","646",2023-06-01 19:00:00,70,1837,1767,831,FALSE,NA,"0.1.4"
"26286","646",2023-06-01 19:15:00,51,1837,1786,831,FALSE,NA,"0.1.4"
"26287","646",2023-06-01 19:30:00,36,1837,1801,831,FALSE,NA,"0.1.4"
"26288","646",2023-06-01 19:45:00,56,1837,1781,831,FALSE,NA,"0.1.4"
"26289","646",2023-06-01 20:00:00,69,1837,1768,831,FALSE,NA,"0.1.4"
"26290","646",2023-06-01 20:15:00,-151,1837,1988,831,FALSE,NA,"0.1.4"
"26291","646",2023-06-01 20:30:00,17,1837,1820,831,FALSE,NA,"0.1.4"
"26292","646",2023-06-01 20:45:00,50,1837,1787,831,FALSE,NA,"0.1.4"
"26293","646",2023-06-01 21:00:00,106,1837,1731,831,FALSE,NA,"0.1.4"
"26294","646",2023-06-01 21:15:00,-17,1837,1854,831,FALSE,NA,"0.1.4"
"26295","646",2023-06-01 21:30:00,73,1837,1764,831,FALSE,NA,"0.1.4"
"26296","646",2023-06-01 21:45:00,35,1837,1802,831,FALSE,NA,"0.1.4"
"26297","646",2023-06-01 22:00:00,50,1837,1787,831,FALSE,NA,"0.1.4"
"26298","646",2023-06-01 22:15:00,43,1837,1794,831,FALSE,NA,"0.1.4"
"26299","646",2023-06-01 22:30:00,29,1837,1808,831,FALSE,NA,"0.1.4"
"26300","646",2023-06-01 22:45:00,-68,1837,1905,831,FALSE,NA,"0.1.4"
"26301","646",2023-06-01 23:00:00,46,1837,1791,831,FALSE,NA,"0.1.4"
"26302","646",2023-06-01 23:15:00,55,1837,1782,831,FALSE,NA,"0.1.4"
"26303","646",2023-06-01 23:30:00,29,1837,1808,831,FALSE,NA,"0.1.4"
"26304","646",2023-06-01 23:45:00,30,1837,1807,831,FALSE,NA,"0.1.4"
"26305","646",2023-06-02,29,1837,1808,831,FALSE,NA,"0.1.4"
"26306","646",2023-06-02 00:15:00,31,1837,1806,831,FALSE,NA,"0.1.4"
"26307","646",2023-06-02 00:30:00,-76,1837,1913,831,FALSE,NA,"0.1.4"
"26308","646",2023-06-02 00:45:00,8,1837,1829,831,FALSE,NA,"0.1.4"
"26309","646",2023-06-02 01:00:00,13,1837,1824,831,FALSE,NA,"0.1.4"
"26310","646",2023-06-02 01:15:00,53,1837,1784,831,FALSE,NA,"0.1.4"
"26311","646",2023-06-02 01:30:00,-43,1837,1880,831,FALSE,NA,"0.1.4"
"26312","646",2023-06-02 01:45:00,57,1837,1780,831,FALSE,NA,"0.1.4"
"26313","646",2023-06-02 02:00:00,57,1837,1780,831,FALSE,NA,"0.1.4"
"26314","646",2023-06-02 02:15:00,57,1837,1780,831,FALSE,NA,"0.1.4"
"26315","646",2023-06-02 02:30:00,57,1837,1780,831,FALSE,NA,"0.1.4"
"26316","646",2023-06-02 02:45:00,79,1837,1758,831,FALSE,NA,"0.1.4"
"26317","646",2023-06-02 03:00:00,57,1837,1780,831,FALSE,NA,"0.1.4"
"26318","646",2023-06-02 03:15:00,57,1837,1780,831,FALSE,NA,"0.1.4"
"26319","646",2023-06-02 03:30:00,34,1837,1803,831,FALSE,NA,"0.1.4"
"26320","646",2023-06-02 03:45:00,57,1837,1780,831,FALSE,NA,"0.1.4"
"26321","646",2023-06-02 04:00:00,57,1837,1780,831,FALSE,NA,"0.1.4"
"26322","646",2023-06-02 04:15:00,52,1837,1785,831,FALSE,NA,"0.1.4"
"26323","646",2023-06-02 04:30:00,38,1837,1799,831,FALSE,NA,"0.1.4"
"26324","646",2023-06-02 04:45:00,57,1837,1780,831,FALSE,NA,"0.1.4"
"26325","646",2023-06-02 05:00:00,57,1837,1780,831,FALSE,NA,"0.1.4"
"26326","646",2023-06-02 05:15:00,52,1837,1785,831,FALSE,NA,"0.1.4"
"26327","646",2023-06-02 05:30:00,67,1837,1770,831,FALSE,NA,"0.1.4"
"26328","646",2023-06-02 05:45:00,63,1837,1774,831,FALSE,NA,"0.1.4"
"26329","646",2023-06-02 06:00:00,57,1837,1780,831,FALSE,NA,"0.1.4"
"26330","646",2023-06-02 06:15:00,78,1837,1759,831,FALSE,NA,"0.1.4"
"26331","646",2023-06-02 06:30:00,-14,1837,1851,831,FALSE,NA,"0.1.4"
"26332","646",2023-06-02 06:45:00,61,1837,1776,831,FALSE,NA,"0.1.4"
"26333","646",2023-06-02 07:00:00,61,1837,1776,831,FALSE,NA,"0.1.4"
"26334","646",2023-06-02 07:15:00,60,1837,1777,831,FALSE,NA,"0.1.4"
"26335","646",2023-06-02 07:30:00,65,1837,1772,831,FALSE,NA,"0.1.4"
"26336","646",2023-06-02 07:45:00,-333,1837,2170,831,FALSE,NA,"0.1.4"
"26337","646",2023-06-02 08:00:00,-366,1837,2203,831,FALSE,NA,"0.1.4"
"26338","646",2023-06-02 08:15:00,25,1837,1812,831,FALSE,NA,"0.1.4"
"26339","646",2023-06-02 08:30:00,166,1837,1671,831,FALSE,NA,"0.1.4"
"26340","646",2023-06-02 08:45:00,-48,1837,1885,831,FALSE,NA,"0.1.4"
"26341","646",2023-06-02 09:00:00,97,1837,1740,831,FALSE,NA,"0.1.4"
"26342","646",2023-06-02 09:15:00,164,1837,1673,831,FALSE,NA,"0.1.4"
"26343","646",2023-06-02 09:30:00,166,1837,1671,831,FALSE,NA,"0.1.4"
"26344","646",2023-06-02 09:45:00,164,1837,1673,831,FALSE,NA,"0.1.4"
"26345","646",2023-06-02 10:00:00,166,1837,1671,831,FALSE,NA,"0.1.4"
"26346","646",2023-06-02 10:15:00,166,1837,1671,831,FALSE,NA,"0.1.4"
"26347","646",2023-06-02 10:30:00,94,1837,1743,831,FALSE,NA,"0.1.4"
"26348","646",2023-06-02 10:45:00,103,1837,1734,831,FALSE,NA,"0.1.4"
"26349","646",2023-06-02 11:00:00,150,1837,1687,831,FALSE,NA,"0.1.4"
"26350","646",2023-06-02 11:15:00,76,1837,1761,831,FALSE,NA,"0.1.4"
"26351","646",2023-06-02 11:30:00,70,1837,1767,831,FALSE,NA,"0.1.4"
"26352","646",2023-06-02 11:45:00,51,1837,1786,831,FALSE,NA,"0.1.4"
"26353","646",2023-06-02 12:00:00,101,1837,1736,831,FALSE,NA,"0.1.4"
"26354","646",2023-06-02 12:15:00,143,1837,1694,831,FALSE,NA,"0.1.4"
"26355","646",2023-06-02 12:30:00,65,1837,1772,831,FALSE,NA,"0.1.4"
"26356","646",2023-06-02 12:45:00,57,1837,1780,831,FALSE,NA,"0.1.4"
"26357","646",2023-06-02 13:00:00,-74,1837,1911,831,FALSE,NA,"0.1.4"
"26358","646",2023-06-02 13:15:00,120,1837,1717,831,FALSE,NA,"0.1.4"
"26359","646",2023-06-02 13:30:00,166,1837,1671,831,FALSE,NA,"0.1.4"
"26360","646",2023-06-02 13:45:00,117,1837,1720,831,FALSE,NA,"0.1.4"
"26361","646",2023-06-02 14:00:00,125,1837,1712,831,FALSE,NA,"0.1.4"
"26362","646",2023-06-02 14:15:00,75,1837,1762,831,FALSE,NA,"0.1.4"
"26363","646",2023-06-02 14:30:00,151,1837,1686,831,FALSE,NA,"0.1.4"
"26364","646",2023-06-02 14:45:00,133,1837,1704,831,FALSE,NA,"0.1.4"
"26365","646",2023-06-02 15:00:00,145,1837,1692,831,FALSE,NA,"0.1.4"
"26366","646",2023-06-02 15:15:00,146,1837,1691,831,FALSE,NA,"0.1.4"
"26367","646",2023-06-02 15:30:00,156,1837,1681,831,FALSE,NA,"0.1.4"
"26368","646",2023-06-02 15:45:00,158,1837,1679,831,FALSE,NA,"0.1.4"
"26369","646",2023-06-02 16:00:00,167,1837,1670,831,FALSE,NA,"0.1.4"
"26370","646",2023-06-02 16:15:00,167,1837,1670,831,FALSE,NA,"0.1.4"
"26371","646",2023-06-02 16:30:00,-176,1837,2013,831,FALSE,NA,"0.1.4"
"26372","646",2023-06-02 16:45:00,167,1837,1670,831,FALSE,NA,"0.1.4"
"26373","646",2023-06-02 17:00:00,66,1837,1771,831,FALSE,NA,"0.1.4"
"26374","646",2023-06-02 17:15:00,71,1837,1766,831,FALSE,NA,"0.1.4"
"26375","646",2023-06-02 17:30:00,70,1837,1767,831,FALSE,NA,"0.1.4"
"26376","646",2023-06-02 17:45:00,86,1837,1751,831,FALSE,NA,"0.1.4"
"26377","646",2023-06-02 18:00:00,70,1837,1767,831,FALSE,NA,"0.1.4"
"26378","646",2023-06-02 18:15:00,48,1837,1789,831,FALSE,NA,"0.1.4"
"26379","646",2023-06-02 18:30:00,89,1837,1748,831,FALSE,NA,"0.1.4"
"26380","646",2023-06-02 18:45:00,80,1837,1757,831,FALSE,NA,"0.1.4"
"26381","646",2023-06-02 19:00:00,67,1837,1770,831,FALSE,NA,"0.1.4"
"26382","646",2023-06-02 19:15:00,167,1837,1670,831,FALSE,NA,"0.1.4"
"26383","646",2023-06-02 19:30:00,165,1837,1672,831,FALSE,NA,"0.1.4"
"26384","646",2023-06-02 19:45:00,11,1837,1826,831,FALSE,NA,"0.1.4"
"26385","646",2023-06-02 20:00:00,69,1837,1768,831,FALSE,NA,"0.1.4"
"26386","646",2023-06-02 20:15:00,68,1837,1769,831,FALSE,NA,"0.1.4"
"26387","646",2023-06-02 20:30:00,83,1837,1754,831,FALSE,NA,"0.1.4"
"26388","646",2023-06-02 20:45:00,115,1837,1722,831,FALSE,NA,"0.1.4"
"26389","646",2023-06-02 21:00:00,159,1837,1678,831,FALSE,NA,"0.1.4"
"26390","646",2023-06-02 21:15:00,103,1837,1734,831,FALSE,NA,"0.1.4"
"26391","646",2023-06-02 21:30:00,120,1837,1717,831,FALSE,NA,"0.1.4"
"26392","646",2023-06-02 21:45:00,90,1837,1747,831,FALSE,NA,"0.1.4"
"26393","646",2023-06-02 22:00:00,86,1837,1751,831,FALSE,NA,"0.1.4"
"26394","646",2023-06-02 22:15:00,58,1837,1779,831,FALSE,NA,"0.1.4"
"26395","646",2023-06-02 22:30:00,83,1837,1754,831,FALSE,NA,"0.1.4"
"26396","646",2023-06-02 22:45:00,88,1837,1749,831,FALSE,NA,"0.1.4"
"26397","646",2023-06-02 23:00:00,100,1837,1737,831,FALSE,NA,"0.1.4"
"26398","646",2023-06-02 23:15:00,154,1837,1683,831,FALSE,NA,"0.1.4"
"26399","646",2023-06-02 23:30:00,158,1837,1679,831,FALSE,NA,"0.1.4"
"26400","646",2023-06-02 23:45:00,167,1837,1670,831,FALSE,NA,"0.1.4"
"26401","646",2023-06-03,166,1837,1671,831,FALSE,NA,"0.1.4"
"26402","646",2023-06-03 00:15:00,148,1837,1689,831,FALSE,NA,"0.1.4"
"26403","646",2023-06-03 00:30:00,140,1837,1697,831,FALSE,NA,"0.1.4"
"26404","646",2023-06-03 00:45:00,120,1837,1717,831,FALSE,NA,"0.1.4"
"26405","646",2023-06-03 01:00:00,116,1837,1721,831,FALSE,NA,"0.1.4"
"26406","646",2023-06-03 01:15:00,109,1837,1728,831,FALSE,NA,"0.1.4"
"26407","646",2023-06-03 01:30:00,164,1837,1673,831,FALSE,NA,"0.1.4"
"26408","646",2023-06-03 01:45:00,162,1837,1675,831,FALSE,NA,"0.1.4"
"26409","646",2023-06-03 02:00:00,141,1837,1696,831,FALSE,NA,"0.1.4"
"26410","646",2023-06-03 02:15:00,70,1837,1767,831,FALSE,NA,"0.1.4"
"26411","646",2023-06-03 02:30:00,128,1837,1709,831,FALSE,NA,"0.1.4"
"26412","646",2023-06-03 02:45:00,125,1837,1712,831,FALSE,NA,"0.1.4"
"26413","646",2023-06-03 03:00:00,128,1837,1709,831,FALSE,NA,"0.1.4"
"26414","646",2023-06-03 03:15:00,160,1837,1677,831,FALSE,NA,"0.1.4"
"26415","646",2023-06-03 03:30:00,166,1837,1671,831,FALSE,NA,"0.1.4"
"26416","646",2023-06-03 03:45:00,154,1837,1683,831,FALSE,NA,"0.1.4"
"26417","646",2023-06-03 04:00:00,150,1837,1687,831,FALSE,NA,"0.1.4"
"26418","646",2023-06-03 04:15:00,127,1837,1710,831,FALSE,NA,"0.1.4"
"26419","646",2023-06-03 04:30:00,152,1837,1685,831,FALSE,NA,"0.1.4"
"26420","646",2023-06-03 04:45:00,166,1837,1671,831,FALSE,NA,"0.1.4"
"26421","646",2023-06-03 05:00:00,165,1837,1672,831,FALSE,NA,"0.1.4"
"26422","646",2023-06-03 05:15:00,143,1837,1694,831,FALSE,NA,"0.1.4"
"26423","646",2023-06-03 05:30:00,139,1837,1698,831,FALSE,NA,"0.1.4"
"26424","646",2023-06-03 05:45:00,145,1837,1692,831,FALSE,NA,"0.1.4"
"26425","646",2023-06-03 06:00:00,145,1837,1692,831,FALSE,NA,"0.1.4"
"26426","646",2023-06-03 06:15:00,150,1837,1687,831,FALSE,NA,"0.1.4"
"26427","646",2023-06-03 06:30:00,158,1837,1679,831,FALSE,NA,"0.1.4"
"26428","646",2023-06-03 06:45:00,114,1837,1723,831,FALSE,NA,"0.1.4"
"26429","646",2023-06-03 07:00:00,166,1837,1671,831,FALSE,NA,"0.1.4"
"26430","646",2023-06-03 07:15:00,140,1837,1697,831,FALSE,NA,"0.1.4"
"26431","646",2023-06-03 07:30:00,144,1837,1693,831,FALSE,NA,"0.1.4"
"26432","646",2023-06-03 07:45:00,127,1837,1710,831,FALSE,NA,"0.1.4"
"26433","646",2023-06-03 08:00:00,121,1837,1716,831,FALSE,NA,"0.1.4"
"26434","646",2023-06-03 08:15:00,137,1837,1700,831,FALSE,NA,"0.1.4"
"26435","646",2023-06-03 08:30:00,126,1837,1711,831,FALSE,NA,"0.1.4"
"26436","646",2023-06-03 08:45:00,158,1837,1679,831,FALSE,NA,"0.1.4"
"26437","646",2023-06-03 09:00:00,158,1837,1679,831,FALSE,NA,"0.1.4"
"26438","646",2023-06-03 09:15:00,165,1837,1672,831,FALSE,NA,"0.1.4"
"26439","646",2023-06-03 09:30:00,166,1837,1671,831,FALSE,NA,"0.1.4"
"26440","646",2023-06-03 09:45:00,166,1837,1671,831,FALSE,NA,"0.1.4"
"26441","646",2023-06-03 10:00:00,166,1837,1671,831,FALSE,NA,"0.1.4"
"26442","646",2023-06-03 10:15:00,165,1837,1672,831,FALSE,NA,"0.1.4"
"26443","646",2023-06-03 10:30:00,167,1837,1670,831,FALSE,NA,"0.1.4"
"26444","646",2023-06-03 10:45:00,107,1837,1730,831,FALSE,NA,"0.1.4"
"26445","646",2023-06-03 11:00:00,166,1837,1671,831,FALSE,NA,"0.1.4"
"26446","646",2023-06-03 11:15:00,133,1837,1704,831,FALSE,NA,"0.1.4"
"26447","646",2023-06-03 11:30:00,110,1837,1727,831,FALSE,NA,"0.1.4"
"26448","646",2023-06-03 11:45:00,129,1837,1708,831,FALSE,NA,"0.1.4"
"26449","646",2023-06-03 12:00:00,124,1837,1713,831,FALSE,NA,"0.1.4"
"26450","646",2023-06-03 12:15:00,129,1837,1708,831,FALSE,NA,"0.1.4"
"26451","646",2023-06-03 12:30:00,165,1837,1672,831,FALSE,NA,"0.1.4"
"26452","646",2023-06-03 12:45:00,131,1837,1706,831,FALSE,NA,"0.1.4"
"26453","646",2023-06-03 13:00:00,167,1837,1670,831,FALSE,NA,"0.1.4"
"26454","646",2023-06-03 13:15:00,167,1837,1670,831,FALSE,NA,"0.1.4"
"26455","646",2023-06-03 13:30:00,127,1837,1710,831,FALSE,NA,"0.1.4"
"26456","646",2023-06-03 13:45:00,123,1837,1714,831,FALSE,NA,"0.1.4"
"26457","646",2023-06-03 14:00:00,128,1837,1709,831,FALSE,NA,"0.1.4"
"26458","646",2023-06-03 14:15:00,122,1837,1715,831,FALSE,NA,"0.1.4"
"26459","646",2023-06-03 14:30:00,121,1837,1716,831,FALSE,NA,"0.1.4"
"26460","646",2023-06-03 14:45:00,118,1837,1719,831,FALSE,NA,"0.1.4"
"26461","646",2023-06-03 15:00:00,118,1837,1719,831,FALSE,NA,"0.1.4"
"26462","646",2023-06-03 15:15:00,118,1837,1719,831,FALSE,NA,"0.1.4"
"26463","646",2023-06-03 15:30:00,117,1837,1720,831,FALSE,NA,"0.1.4"
"26464","646",2023-06-03 15:45:00,118,1837,1719,831,FALSE,NA,"0.1.4"
"26465","646",2023-06-03 16:00:00,121,1837,1716,831,FALSE,NA,"0.1.4"
"26466","646",2023-06-03 16:15:00,123,1837,1714,831,FALSE,NA,"0.1.4"
"26467","646",2023-06-03 16:30:00,128,1837,1709,831,FALSE,NA,"0.1.4"
"26468","646",2023-06-03 16:45:00,134,1837,1703,831,FALSE,NA,"0.1.4"
"26469","646",2023-06-03 17:00:00,127,1837,1710,831,FALSE,NA,"0.1.4"
"26470","646",2023-06-03 17:15:00,128,1837,1709,831,FALSE,NA,"0.1.4"
"26471","646",2023-06-03 17:30:00,117,1837,1720,831,FALSE,NA,"0.1.4"
"26472","646",2023-06-03 17:45:00,110,1837,1727,831,FALSE,NA,"0.1.4"
"26473","646",2023-06-03 18:00:00,99,1837,1738,831,FALSE,NA,"0.1.4"
"26474","646",2023-06-03 18:15:00,89,1837,1748,831,FALSE,NA,"0.1.4"
"26475","646",2023-06-03 18:30:00,111,1837,1726,831,FALSE,NA,"0.1.4"
"26476","646",2023-06-03 18:45:00,113,1837,1724,831,FALSE,NA,"0.1.4"
"26477","646",2023-06-03 19:00:00,90,1837,1747,831,FALSE,NA,"0.1.4"
"26478","646",2023-06-03 19:15:00,108,1837,1729,831,FALSE,NA,"0.1.4"
"26479","646",2023-06-03 19:30:00,101,1837,1736,831,FALSE,NA,"0.1.4"
"26480","646",2023-06-03 19:45:00,101,1837,1736,831,FALSE,NA,"0.1.4"
"26481","646",2023-06-03 20:00:00,75,1837,1762,831,FALSE,NA,"0.1.4"
"26482","646",2023-06-03 20:15:00,83,1837,1754,831,FALSE,NA,"0.1.4"
"26483","646",2023-06-03 20:30:00,74,1837,1763,831,FALSE,NA,"0.1.4"
"26484","646",2023-06-03 20:45:00,78,1837,1759,831,FALSE,NA,"0.1.4"
"26485","646",2023-06-03 21:00:00,73,1837,1764,831,FALSE,NA,"0.1.4"
"26486","646",2023-06-03 21:15:00,71,1837,1766,831,FALSE,NA,"0.1.4"
"26487","646",2023-06-03 21:30:00,72,1837,1765,831,FALSE,NA,"0.1.4"
"26488","646",2023-06-03 21:45:00,71,1837,1766,831,FALSE,NA,"0.1.4"
"26489","646",2023-06-03 22:00:00,72,1837,1765,831,FALSE,NA,"0.1.4"
"26490","646",2023-06-03 22:15:00,73,1837,1764,831,FALSE,NA,"0.1.4"
"26491","646",2023-06-03 22:30:00,73,1837,1764,831,FALSE,NA,"0.1.4"
"26492","646",2023-06-03 22:45:00,73,1837,1764,831,FALSE,NA,"0.1.4"
"26493","646",2023-06-03 23:00:00,73,1837,1764,831,FALSE,NA,"0.1.4"
"26494","646",2023-06-03 23:15:00,75,1837,1762,831,FALSE,NA,"0.1.4"
"26495","646",2023-06-03 23:30:00,72,1837,1765,831,FALSE,NA,"0.1.4"
"26496","646",2023-06-03 23:45:00,68,1837,1769,831,FALSE,NA,"0.1.4"
"26497","646",2023-06-04,73,1837,1764,831,FALSE,NA,"0.1.4"
"26498","646",2023-06-04 00:15:00,73,1837,1764,831,FALSE,NA,"0.1.4"
"26499","646",2023-06-04 00:30:00,74,1837,1763,831,FALSE,NA,"0.1.4"
"26500","646",2023-06-04 00:45:00,73,1837,1764,831,FALSE,NA,"0.1.4"
"26501","646",2023-06-04 01:00:00,72,1837,1765,831,FALSE,NA,"0.1.4"
"26502","646",2023-06-04 01:15:00,73,1837,1764,831,FALSE,NA,"0.1.4"
"26503","646",2023-06-04 01:30:00,72,1837,1765,831,FALSE,NA,"0.1.4"
"26504","646",2023-06-04 01:45:00,73,1837,1764,831,FALSE,NA,"0.1.4"
"26505","646",2023-06-04 02:00:00,63,1837,1774,831,FALSE,NA,"0.1.4"
"26506","646",2023-06-04 02:15:00,69,1837,1768,831,FALSE,NA,"0.1.4"
"26507","646",2023-06-04 02:30:00,71,1837,1766,831,FALSE,NA,"0.1.4"
"26508","646",2023-06-04 02:45:00,69,1837,1768,831,FALSE,NA,"0.1.4"
"26509","646",2023-06-04 03:00:00,77,1837,1760,831,FALSE,NA,"0.1.4"
"26510","646",2023-06-04 03:15:00,70,1837,1767,831,FALSE,NA,"0.1.4"
"26511","646",2023-06-04 03:30:00,70,1837,1767,831,FALSE,NA,"0.1.4"
"26512","646",2023-06-04 03:45:00,69,1837,1768,831,FALSE,NA,"0.1.4"
"26513","646",2023-06-04 04:00:00,69,1837,1768,831,FALSE,NA,"0.1.4"
"26514","646",2023-06-04 04:15:00,70,1837,1767,831,FALSE,NA,"0.1.4"
"26515","646",2023-06-04 04:30:00,71,1837,1766,831,FALSE,NA,"0.1.4"
"26516","646",2023-06-04 04:45:00,74,1837,1763,831,FALSE,NA,"0.1.4"
"26517","646",2023-06-04 05:00:00,101,1837,1736,831,FALSE,NA,"0.1.4"
"26518","646",2023-06-04 05:15:00,70,1837,1767,831,FALSE,NA,"0.1.4"
"26519","646",2023-06-04 05:30:00,94,1837,1743,831,FALSE,NA,"0.1.4"
"26520","646",2023-06-04 05:45:00,70,1837,1767,831,FALSE,NA,"0.1.4"
"26521","646",2023-06-04 06:00:00,71,1837,1766,831,FALSE,NA,"0.1.4"
"26522","646",2023-06-04 06:15:00,73,1837,1764,831,FALSE,NA,"0.1.4"
"26523","646",2023-06-04 06:30:00,115,1837,1722,831,FALSE,NA,"0.1.4"
"26524","646",2023-06-04 06:45:00,76,1837,1761,831,FALSE,NA,"0.1.4"
"26525","646",2023-06-04 07:00:00,80,1837,1757,831,FALSE,NA,"0.1.4"
"26526","646",2023-06-04 07:15:00,72,1837,1765,831,FALSE,NA,"0.1.4"
"26527","646",2023-06-04 07:30:00,86,1837,1751,831,FALSE,NA,"0.1.4"
"26528","646",2023-06-04 07:45:00,81,1837,1756,831,FALSE,NA,"0.1.4"
"26529","646",2023-06-04 08:00:00,114,1837,1723,831,FALSE,NA,"0.1.4"
"26530","646",2023-06-04 08:15:00,94,1837,1743,831,FALSE,NA,"0.1.4"
"26531","646",2023-06-04 08:30:00,92,1837,1745,831,FALSE,NA,"0.1.4"
"26532","646",2023-06-04 08:45:00,109,1837,1728,831,FALSE,NA,"0.1.4"
"26533","646",2023-06-04 09:00:00,92,1837,1745,831,FALSE,NA,"0.1.4"
"26534","646",2023-06-04 09:15:00,103,1837,1734,831,FALSE,NA,"0.1.4"
"26535","646",2023-06-04 09:30:00,99,1837,1738,831,FALSE,NA,"0.1.4"
"26536","646",2023-06-04 09:45:00,112,1837,1725,831,FALSE,NA,"0.1.4"
"26537","646",2023-06-04 10:00:00,113,1837,1724,831,FALSE,NA,"0.1.4"
"26538","646",2023-06-04 10:15:00,88,1837,1749,831,FALSE,NA,"0.1.4"
"26539","646",2023-06-04 10:30:00,103,1837,1734,831,FALSE,NA,"0.1.4"
"26540","646",2023-06-04 10:45:00,111,1837,1726,831,FALSE,NA,"0.1.4"
"26541","646",2023-06-04 11:00:00,114,1837,1723,831,FALSE,NA,"0.1.4"
"26542","646",2023-06-04 11:15:00,121,1837,1716,831,FALSE,NA,"0.1.4"
"26543","646",2023-06-04 11:30:00,121,1837,1716,831,FALSE,NA,"0.1.4"
"26544","646",2023-06-04 11:45:00,120,1837,1717,831,FALSE,NA,"0.1.4"
"26545","646",2023-06-04 12:00:00,94,1837,1743,831,FALSE,NA,"0.1.4"
"26546","646",2023-06-04 12:15:00,80,1837,1757,831,FALSE,NA,"0.1.4"
"26547","646",2023-06-04 12:30:00,114,1837,1723,831,FALSE,NA,"0.1.4"
"26548","646",2023-06-04 12:45:00,77,1837,1760,831,FALSE,NA,"0.1.4"
"26549","646",2023-06-04 13:00:00,85,1837,1752,831,FALSE,NA,"0.1.4"
"26550","646",2023-06-04 13:15:00,102,1837,1735,831,FALSE,NA,"0.1.4"
"26551","646",2023-06-04 13:30:00,82,1837,1755,831,FALSE,NA,"0.1.4"
"26552","646",2023-06-04 13:45:00,86,1837,1751,831,FALSE,NA,"0.1.4"
"26553","646",2023-06-04 14:00:00,104,1837,1733,831,FALSE,NA,"0.1.4"
"26554","646",2023-06-04 14:15:00,179,1837,1658,831,FALSE,NA,"0.1.4"
"26555","646",2023-06-04 14:30:00,68,1837,1769,831,FALSE,NA,"0.1.4"
"26556","646",2023-06-04 14:45:00,78,1837,1759,831,FALSE,NA,"0.1.4"
"26557","646",2023-06-04 15:00:00,76,1837,1761,831,FALSE,NA,"0.1.4"
"26558","646",2023-06-04 15:15:00,75,1837,1762,831,FALSE,NA,"0.1.4"
"26559","646",2023-06-04 15:30:00,76,1837,1761,831,FALSE,NA,"0.1.4"
"26560","646",2023-06-04 15:45:00,82,1837,1755,831,FALSE,NA,"0.1.4"
"26561","646",2023-06-04 16:00:00,70,1837,1767,831,FALSE,NA,"0.1.4"
"26562","646",2023-06-04 16:15:00,121,1837,1716,831,FALSE,NA,"0.1.4"
"26563","646",2023-06-04 16:30:00,73,1837,1764,831,FALSE,NA,"0.1.4"
"26564","646",2023-06-04 16:45:00,73,1837,1764,831,FALSE,NA,"0.1.4"
"26565","646",2023-06-04 17:00:00,66,1837,1771,831,FALSE,NA,"0.1.4"
"26566","646",2023-06-04 17:15:00,76,1837,1761,831,FALSE,NA,"0.1.4"
"26567","646",2023-06-04 17:30:00,76,1837,1761,831,FALSE,NA,"0.1.4"
"26568","646",2023-06-04 17:45:00,74,1837,1763,831,FALSE,NA,"0.1.4"
"26569","646",2023-06-04 18:00:00,79,1837,1758,831,FALSE,NA,"0.1.4"
"26570","646",2023-06-04 18:15:00,82,1837,1755,831,FALSE,NA,"0.1.4"
"26571","646",2023-06-04 18:30:00,101,1837,1736,831,FALSE,NA,"0.1.4"
"26572","646",2023-06-04 18:45:00,78,1837,1759,831,FALSE,NA,"0.1.4"
"26573","646",2023-06-04 19:00:00,68,1837,1769,831,FALSE,NA,"0.1.4"
"26574","646",2023-06-04 19:15:00,82,1837,1755,831,FALSE,NA,"0.1.4"
"26575","646",2023-06-04 19:30:00,78,1837,1759,831,FALSE,NA,"0.1.4"
"26576","646",2023-06-04 19:45:00,82,1837,1755,831,FALSE,NA,"0.1.4"
"26577","646",2023-06-04 20:00:00,84,1837,1753,831,FALSE,NA,"0.1.4"
"26578","646",2023-06-04 20:15:00,70,1837,1767,831,FALSE,NA,"0.1.4"
"26579","646",2023-06-04 20:30:00,70,1837,1767,831,FALSE,NA,"0.1.4"
"26580","646",2023-06-04 20:45:00,71,1837,1766,831,FALSE,NA,"0.1.4"
"26581","646",2023-06-04 21:00:00,95,1837,1742,831,FALSE,NA,"0.1.4"
"26582","646",2023-06-04 21:15:00,20,1837,1817,831,FALSE,NA,"0.1.4"
"26583","646",2023-06-04 21:30:00,45,1837,1792,831,FALSE,NA,"0.1.4"
"26584","646",2023-06-04 21:45:00,93,1837,1744,831,FALSE,NA,"0.1.4"
"26585","646",2023-06-04 22:00:00,89,1837,1748,831,FALSE,NA,"0.1.4"
"26586","646",2023-06-04 22:15:00,73,1837,1764,831,FALSE,NA,"0.1.4"
"26587","646",2023-06-04 22:30:00,70,1837,1767,831,FALSE,NA,"0.1.4"
"26588","646",2023-06-04 22:45:00,88,1837,1749,831,FALSE,NA,"0.1.4"
"26589","646",2023-06-04 23:00:00,94,1837,1743,831,FALSE,NA,"0.1.4"
"26590","646",2023-06-04 23:15:00,99,1837,1738,831,FALSE,NA,"0.1.4"
"26591","646",2023-06-04 23:30:00,97,1837,1740,831,FALSE,NA,"0.1.4"
"26592","646",2023-06-04 23:45:00,94,1837,1743,831,FALSE,NA,"0.1.4"
"26593","646",2023-06-05,92,1837,1745,831,FALSE,NA,"0.1.4"
"26594","646",2023-06-05 00:15:00,93,1837,1744,831,FALSE,NA,"0.1.4"
"26595","646",2023-06-05 00:30:00,91,1837,1746,831,FALSE,NA,"0.1.4"
"26596","646",2023-06-05 00:45:00,100,1837,1737,831,FALSE,NA,"0.1.4"
"26597","646",2023-06-05 01:00:00,142,1837,1695,831,FALSE,NA,"0.1.4"
"26598","646",2023-06-05 01:15:00,101,1837,1736,831,FALSE,NA,"0.1.4"
"26599","646",2023-06-05 01:30:00,64,1837,1773,831,FALSE,NA,"0.1.4"
"26600","646",2023-06-05 01:45:00,94,1837,1743,831,FALSE,NA,"0.1.4"
"26601","646",2023-06-05 02:00:00,104,1837,1733,831,FALSE,NA,"0.1.4"
"26602","646",2023-06-05 02:15:00,100,1837,1737,831,FALSE,NA,"0.1.4"
"26603","646",2023-06-05 02:30:00,-191,1837,2028,831,FALSE,NA,"0.1.4"
"26604","646",2023-06-05 02:45:00,-210,1837,2047,831,FALSE,NA,"0.1.4"
"26605","646",2023-06-05 03:00:00,125,1837,1712,831,FALSE,NA,"0.1.4"
"26606","646",2023-06-05 03:15:00,125,1837,1712,831,FALSE,NA,"0.1.4"
"26607","646",2023-06-05 03:30:00,87,1837,1750,831,FALSE,NA,"0.1.4"
"26608","646",2023-06-05 03:45:00,84,1837,1753,831,FALSE,NA,"0.1.4"
"26609","646",2023-06-05 04:00:00,81,1837,1756,831,FALSE,NA,"0.1.4"
"26610","646",2023-06-05 04:15:00,124,1837,1713,831,FALSE,NA,"0.1.4"
"26611","646",2023-06-05 04:30:00,195,1837,1642,831,FALSE,NA,"0.1.4"
"26612","646",2023-06-05 04:45:00,203,1837,1634,831,FALSE,NA,"0.1.4"
"26613","646",2023-06-05 05:00:00,-271,1837,2108,831,FALSE,NA,"0.1.4"
"26614","646",2023-06-05 05:15:00,204,1837,1633,831,FALSE,NA,"0.1.4"
"26615","646",2023-06-05 05:30:00,189,1837,1648,831,FALSE,NA,"0.1.4"
"26616","646",2023-06-05 05:45:00,201,1837,1636,831,FALSE,NA,"0.1.4"
"26617","646",2023-06-05 06:00:00,195,1837,1642,831,FALSE,NA,"0.1.4"
"26618","646",2023-06-05 06:15:00,205,1837,1632,831,FALSE,NA,"0.1.4"
"26619","646",2023-06-05 06:30:00,109,1837,1728,831,FALSE,NA,"0.1.4"
"26620","646",2023-06-05 06:45:00,92,1837,1745,831,FALSE,NA,"0.1.4"
"26621","646",2023-06-05 07:00:00,161,1837,1676,831,FALSE,NA,"0.1.4"
"26622","646",2023-06-05 07:15:00,121,1837,1716,831,FALSE,NA,"0.1.4"
"26623","646",2023-06-05 07:30:00,98,1837,1739,831,FALSE,NA,"0.1.4"
"26624","646",2023-06-05 07:45:00,164,1837,1673,831,FALSE,NA,"0.1.4"
"26625","646",2023-06-05 08:00:00,15,1837,1822,831,FALSE,NA,"0.1.4"
"26626","646",2023-06-05 08:15:00,114,1837,1723,831,FALSE,NA,"0.1.4"
"26627","646",2023-06-05 08:30:00,114,1837,1723,831,FALSE,NA,"0.1.4"
"26628","646",2023-06-05 08:45:00,131,1837,1706,831,FALSE,NA,"0.1.4"
"26629","646",2023-06-05 09:00:00,148,1837,1689,831,FALSE,NA,"0.1.4"
"26630","646",2023-06-05 09:15:00,112,1837,1725,831,FALSE,NA,"0.1.4"
"26631","646",2023-06-05 09:30:00,116,1837,1721,831,FALSE,NA,"0.1.4"
"26632","646",2023-06-05 09:45:00,113,1837,1724,831,FALSE,NA,"0.1.4"
"26633","646",2023-06-05 10:00:00,13,1837,1824,831,FALSE,NA,"0.1.4"
"26634","646",2023-06-05 10:15:00,85,1837,1752,831,FALSE,NA,"0.1.4"
"26635","646",2023-06-05 10:30:00,105,1837,1732,831,FALSE,NA,"0.1.4"
"26636","646",2023-06-05 10:45:00,58,1837,1779,831,FALSE,NA,"0.1.4"
"26637","646",2023-06-05 11:00:00,108,1837,1729,831,FALSE,NA,"0.1.4"
"26638","646",2023-06-05 11:15:00,28,1837,1809,831,FALSE,NA,"0.1.4"
"26639","646",2023-06-05 11:30:00,-42,1837,1879,831,FALSE,NA,"0.1.4"
"26640","646",2023-06-05 11:45:00,-284,1837,2121,831,FALSE,NA,"0.1.4"
"26641","646",2023-06-05 12:00:00,198,1837,1639,831,FALSE,NA,"0.1.4"
"26642","646",2023-06-05 12:15:00,147,1837,1690,831,FALSE,NA,"0.1.4"
"26643","646",2023-06-05 12:30:00,112,1837,1725,831,FALSE,NA,"0.1.4"
"26644","646",2023-06-05 12:45:00,-17,1837,1854,831,FALSE,NA,"0.1.4"
"26645","646",2023-06-05 13:00:00,167,1837,1670,831,FALSE,NA,"0.1.4"
"26646","646",2023-06-05 13:15:00,181,1837,1656,831,FALSE,NA,"0.1.4"
"26647","646",2023-06-05 13:30:00,154,1837,1683,831,FALSE,NA,"0.1.4"
"26648","646",2023-06-05 13:45:00,114,1837,1723,831,FALSE,NA,"0.1.4"
"26649","646",2023-06-05 14:00:00,119,1837,1718,831,FALSE,NA,"0.1.4"
"26650","646",2023-06-05 14:15:00,104,1837,1733,831,FALSE,NA,"0.1.4"
"26651","646",2023-06-05 14:30:00,139,1837,1698,831,FALSE,NA,"0.1.4"
"26652","646",2023-06-05 14:45:00,101,1837,1736,831,FALSE,NA,"0.1.4"
"26653","646",2023-06-05 15:00:00,102,1837,1735,831,FALSE,NA,"0.1.4"
"26654","646",2023-06-05 15:15:00,102,1837,1735,831,FALSE,NA,"0.1.4"
"26655","646",2023-06-05 15:30:00,102,1837,1735,831,FALSE,NA,"0.1.4"
"26656","646",2023-06-05 15:45:00,100,1837,1737,831,FALSE,NA,"0.1.4"
"26657","646",2023-06-05 16:00:00,110,1837,1727,831,FALSE,NA,"0.1.4"
"26658","646",2023-06-05 16:15:00,103,1837,1734,831,FALSE,NA,"0.1.4"
"26659","646",2023-06-05 16:30:00,41,1837,1796,831,FALSE,NA,"0.1.4"
"26660","646",2023-06-05 16:45:00,-17,1837,1854,831,FALSE,NA,"0.1.4"
"26661","646",2023-06-05 17:00:00,114,1837,1723,831,FALSE,NA,"0.1.4"
"26662","646",2023-06-05 17:15:00,109,1837,1728,831,FALSE,NA,"0.1.4"
"26663","646",2023-06-05 17:30:00,124,1837,1713,831,FALSE,NA,"0.1.4"
"26664","646",2023-06-05 17:45:00,128,1837,1709,831,FALSE,NA,"0.1.4"
"26665","646",2023-06-05 18:00:00,101,1837,1736,831,FALSE,NA,"0.1.4"
"26666","646",2023-06-05 18:15:00,122,1837,1715,831,FALSE,NA,"0.1.4"
"26667","646",2023-06-05 18:30:00,108,1837,1729,831,FALSE,NA,"0.1.4"
"26668","646",2023-06-05 18:45:00,127,1837,1710,831,FALSE,NA,"0.1.4"
"26669","646",2023-06-05 19:00:00,106,1837,1731,831,FALSE,NA,"0.1.4"
"26670","646",2023-06-05 19:15:00,106,1837,1731,831,FALSE,NA,"0.1.4"
"26671","646",2023-06-05 19:30:00,106,1837,1731,831,FALSE,NA,"0.1.4"
"26672","646",2023-06-05 19:45:00,109,1837,1728,831,FALSE,NA,"0.1.4"
"26673","646",2023-06-05 20:00:00,120,1837,1717,831,FALSE,NA,"0.1.4"
"26674","646",2023-06-05 20:15:00,119,1837,1718,831,FALSE,NA,"0.1.4"
"26675","646",2023-06-05 20:30:00,112,1837,1725,831,FALSE,NA,"0.1.4"
"26676","646",2023-06-05 20:45:00,107,1837,1730,831,FALSE,NA,"0.1.4"
"26677","646",2023-06-05 21:00:00,107,1837,1730,831,FALSE,NA,"0.1.4"
"26678","646",2023-06-05 21:15:00,106,1837,1731,831,FALSE,NA,"0.1.4"
"26679","646",2023-06-05 21:30:00,108,1837,1729,831,FALSE,NA,"0.1.4"
"26680","646",2023-06-05 21:45:00,108,1837,1729,831,FALSE,NA,"0.1.4"
"26681","646",2023-06-05 22:00:00,108,1837,1729,831,FALSE,NA,"0.1.4"
"26682","646",2023-06-05 22:15:00,130,1837,1707,831,FALSE,NA,"0.1.4"
"26683","646",2023-06-05 22:30:00,113,1837,1724,831,FALSE,NA,"0.1.4"
"26684","646",2023-06-05 22:45:00,104,1837,1733,831,FALSE,NA,"0.1.4"
"26685","646",2023-06-05 23:00:00,110,1837,1727,831,FALSE,NA,"0.1.4"
"26686","646",2023-06-05 23:15:00,113,1837,1724,831,FALSE,NA,"0.1.4"
"26687","646",2023-06-05 23:30:00,148,1837,1689,831,FALSE,NA,"0.1.4"
"26688","646",2023-06-05 23:45:00,151,1837,1686,831,FALSE,NA,"0.1.4"
"26689","646",2023-06-06,108,1837,1729,831,FALSE,NA,"0.1.4"
"26690","646",2023-06-06 00:15:00,108,1837,1729,831,FALSE,NA,"0.1.4"
"26691","646",2023-06-06 00:30:00,107,1837,1730,831,FALSE,NA,"0.1.4"
"26692","646",2023-06-06 00:45:00,108,1837,1729,831,FALSE,NA,"0.1.4"
"26693","646",2023-06-06 01:00:00,107,1837,1730,831,FALSE,NA,"0.1.4"
"26694","646",2023-06-06 01:15:00,142,1837,1695,831,FALSE,NA,"0.1.4"
"26695","646",2023-06-06 01:30:00,114,1837,1723,831,FALSE,NA,"0.1.4"
"26696","646",2023-06-06 01:45:00,108,1837,1729,831,FALSE,NA,"0.1.4"
"26697","646",2023-06-06 02:00:00,108,1837,1729,831,FALSE,NA,"0.1.4"
"26698","646",2023-06-06 02:15:00,142,1837,1695,831,FALSE,NA,"0.1.4"
"26699","646",2023-06-06 02:30:00,143,1837,1694,831,FALSE,NA,"0.1.4"
"26700","646",2023-06-06 02:45:00,155,1837,1682,831,FALSE,NA,"0.1.4"
"26701","646",2023-06-06 03:00:00,154,1837,1683,831,FALSE,NA,"0.1.4"
"26702","646",2023-06-06 03:15:00,167,1837,1670,831,FALSE,NA,"0.1.4"
"26703","646",2023-06-06 03:30:00,142,1837,1695,831,FALSE,NA,"0.1.4"
"26704","646",2023-06-06 03:45:00,110,1837,1727,831,FALSE,NA,"0.1.4"
"26705","646",2023-06-06 04:00:00,113,1837,1724,831,FALSE,NA,"0.1.4"
"26706","646",2023-06-06 04:15:00,167,1837,1670,831,FALSE,NA,"0.1.4"
"26707","646",2023-06-06 04:30:00,165,1837,1672,831,FALSE,NA,"0.1.4"
"26708","646",2023-06-06 04:45:00,141,1837,1696,831,FALSE,NA,"0.1.4"
"26709","646",2023-06-06 05:00:00,110,1837,1727,831,FALSE,NA,"0.1.4"
"26710","646",2023-06-06 05:15:00,112,1837,1725,831,FALSE,NA,"0.1.4"
"26711","646",2023-06-06 05:30:00,149,1837,1688,831,FALSE,NA,"0.1.4"
"26712","646",2023-06-06 05:45:00,139,1837,1698,831,FALSE,NA,"0.1.4"
"26713","646",2023-06-06 06:00:00,148,1837,1689,831,FALSE,NA,"0.1.4"
"26714","646",2023-06-06 06:15:00,169,1837,1668,831,FALSE,NA,"0.1.4"
"26715","646",2023-06-06 06:30:00,170,1837,1667,831,FALSE,NA,"0.1.4"
"26716","646",2023-06-06 06:45:00,172,1837,1665,831,FALSE,NA,"0.1.4"
"26717","646",2023-06-06 07:00:00,160,1837,1677,831,FALSE,NA,"0.1.4"
"26718","646",2023-06-06 07:15:00,172,1837,1665,831,FALSE,NA,"0.1.4"
"26719","646",2023-06-06 07:30:00,182,1837,1655,831,FALSE,NA,"0.1.4"
"26720","646",2023-06-06 07:45:00,206,1837,1631,831,FALSE,NA,"0.1.4"
"26721","646",2023-06-06 08:00:00,182,1837,1655,831,FALSE,NA,"0.1.4"
"26722","646",2023-06-06 08:15:00,179,1837,1658,831,FALSE,NA,"0.1.4"
"26723","646",2023-06-06 08:30:00,205,1837,1632,831,FALSE,NA,"0.1.4"
"26724","646",2023-06-06 08:45:00,163,1837,1674,831,FALSE,NA,"0.1.4"
"26725","646",2023-06-06 09:00:00,171,1837,1666,831,FALSE,NA,"0.1.4"
"26726","646",2023-06-06 09:15:00,168,1837,1669,831,FALSE,NA,"0.1.4"
"26727","646",2023-06-06 09:30:00,189,1837,1648,831,FALSE,NA,"0.1.4"
"26728","646",2023-06-06 09:45:00,154,1837,1683,831,FALSE,NA,"0.1.4"
"26729","646",2023-06-06 10:00:00,180,1837,1657,831,FALSE,NA,"0.1.4"
"26730","646",2023-06-06 10:15:00,207,1837,1630,831,FALSE,NA,"0.1.4"
"26731","646",2023-06-06 10:30:00,208,1837,1629,831,FALSE,NA,"0.1.4"
"26732","646",2023-06-06 10:45:00,204,1837,1633,831,FALSE,NA,"0.1.4"
"26733","646",2023-06-06 11:00:00,208,1837,1629,831,FALSE,NA,"0.1.4"
"26734","646",2023-06-06 11:15:00,204,1837,1633,831,FALSE,NA,"0.1.4"
"26735","646",2023-06-06 11:30:00,207,1837,1630,831,FALSE,NA,"0.1.4"
"26736","646",2023-06-06 11:45:00,182,1837,1655,831,FALSE,NA,"0.1.4"
"26737","646",2023-06-06 12:00:00,174,1837,1663,831,FALSE,NA,"0.1.4"
"26738","646",2023-06-06 12:15:00,158,1837,1679,831,FALSE,NA,"0.1.4"
"26739","646",2023-06-06 12:30:00,179,1837,1658,831,FALSE,NA,"0.1.4"
"26740","646",2023-06-06 12:45:00,148,1837,1689,831,FALSE,NA,"0.1.4"
"26741","646",2023-06-06 13:00:00,159,1837,1678,831,FALSE,NA,"0.1.4"
"26742","646",2023-06-06 13:15:00,133,1837,1704,831,FALSE,NA,"0.1.4"
"26743","646",2023-06-06 13:30:00,133,1837,1704,831,FALSE,NA,"0.1.4"
"26744","646",2023-06-06 13:45:00,140,1837,1697,831,FALSE,NA,"0.1.4"
"26745","646",2023-06-06 14:00:00,136,1837,1701,831,FALSE,NA,"0.1.4"
"26746","646",2023-06-06 14:15:00,138,1837,1699,831,FALSE,NA,"0.1.4"
"26747","646",2023-06-06 14:30:00,137,1837,1700,831,FALSE,NA,"0.1.4"
"26748","646",2023-06-06 14:45:00,136,1837,1701,831,FALSE,NA,"0.1.4"
"26749","646",2023-06-06 15:00:00,136,1837,1701,831,FALSE,NA,"0.1.4"
"26750","646",2023-06-06 15:15:00,136,1837,1701,831,FALSE,NA,"0.1.4"
"26751","646",2023-06-06 15:30:00,136,1837,1701,831,FALSE,NA,"0.1.4"
"26752","646",2023-06-06 15:45:00,136,1837,1701,831,FALSE,NA,"0.1.4"
"26753","646",2023-06-06 16:00:00,136,1837,1701,831,FALSE,NA,"0.1.4"
"26754","646",2023-06-06 16:15:00,136,1837,1701,831,FALSE,NA,"0.1.4"
"26755","646",2023-06-06 16:30:00,137,1837,1700,831,FALSE,NA,"0.1.4"
"26756","646",2023-06-06 16:45:00,136,1837,1701,831,FALSE,NA,"0.1.4"
"26757","646",2023-06-06 17:00:00,133,1837,1704,831,FALSE,NA,"0.1.4"
"26758","646",2023-06-06 17:15:00,138,1837,1699,831,FALSE,NA,"0.1.4"
"26759","646",2023-06-06 17:30:00,143,1837,1694,831,FALSE,NA,"0.1.4"
"26760","646",2023-06-06 17:45:00,142,1837,1695,831,FALSE,NA,"0.1.4"
"26761","646",2023-06-06 18:00:00,140,1837,1697,831,FALSE,NA,"0.1.4"
"26762","646",2023-06-06 18:15:00,132,1837,1705,831,FALSE,NA,"0.1.4"
"26763","646",2023-06-06 18:30:00,135,1837,1702,831,FALSE,NA,"0.1.4"
"26764","646",2023-06-06 18:45:00,137,1837,1700,831,FALSE,NA,"0.1.4"
"26765","646",2023-06-06 19:00:00,136,1837,1701,831,FALSE,NA,"0.1.4"
"26766","646",2023-06-06 19:15:00,133,1837,1704,831,FALSE,NA,"0.1.4"
"26767","646",2023-06-06 19:30:00,140,1837,1697,831,FALSE,NA,"0.1.4"
"26768","646",2023-06-06 19:45:00,134,1837,1703,831,FALSE,NA,"0.1.4"
"26769","646",2023-06-06 20:00:00,135,1837,1702,831,FALSE,NA,"0.1.4"
"26770","646",2023-06-06 20:15:00,132,1837,1705,831,FALSE,NA,"0.1.4"
"26771","646",2023-06-06 20:30:00,134,1837,1703,831,FALSE,NA,"0.1.4"
"26772","646",2023-06-06 20:45:00,135,1837,1702,831,FALSE,NA,"0.1.4"
"26773","646",2023-06-06 21:00:00,134,1837,1703,831,FALSE,NA,"0.1.4"
"26774","646",2023-06-06 21:15:00,133,1837,1704,831,FALSE,NA,"0.1.4"
"26775","646",2023-06-06 21:30:00,134,1837,1703,831,FALSE,NA,"0.1.4"
"26776","646",2023-06-06 21:45:00,134,1837,1703,831,FALSE,NA,"0.1.4"
"26777","646",2023-06-06 22:00:00,133,1837,1704,831,FALSE,NA,"0.1.4"
"26778","646",2023-06-06 22:15:00,132,1837,1705,831,FALSE,NA,"0.1.4"
"26779","646",2023-06-06 22:30:00,131,1837,1706,831,FALSE,NA,"0.1.4"
"26780","646",2023-06-06 22:45:00,131,1837,1706,831,FALSE,NA,"0.1.4"
"26781","646",2023-06-06 23:00:00,132,1837,1705,831,FALSE,NA,"0.1.4"
"26782","646",2023-06-06 23:15:00,132,1837,1705,831,FALSE,NA,"0.1.4"
"26783","646",2023-06-06 23:30:00,134,1837,1703,831,FALSE,NA,"0.1.4"
"26784","646",2023-06-06 23:45:00,132,1837,1705,831,FALSE,NA,"0.1.4"
"26785","646",2023-06-07,132,1837,1705,831,FALSE,NA,"0.1.4"
"26786","646",2023-06-07 00:15:00,133,1837,1704,831,FALSE,NA,"0.1.4"
"26787","646",2023-06-07 00:30:00,133,1837,1704,831,FALSE,NA,"0.1.4"
"26788","646",2023-06-07 00:45:00,132,1837,1705,831,FALSE,NA,"0.1.4"
"26789","646",2023-06-07 01:00:00,133,1837,1704,831,FALSE,NA,"0.1.4"
"26790","646",2023-06-07 01:15:00,125,1837,1712,831,FALSE,NA,"0.1.4"
"26791","646",2023-06-07 01:30:00,94,1837,1743,831,FALSE,NA,"0.1.4"
"26792","646",2023-06-07 01:45:00,135,1837,1702,831,FALSE,NA,"0.1.4"
"26793","646",2023-06-07 02:00:00,128,1837,1709,831,FALSE,NA,"0.1.4"
"26794","646",2023-06-07 02:15:00,132,1837,1705,831,FALSE,NA,"0.1.4"
"26795","646",2023-06-07 02:30:00,114,1837,1723,831,FALSE,NA,"0.1.4"
"26796","646",2023-06-07 02:45:00,126,1837,1711,831,FALSE,NA,"0.1.4"
"26797","646",2023-06-07 03:00:00,25,1837,1812,831,FALSE,NA,"0.1.4"
"26798","646",2023-06-07 03:15:00,147,1837,1690,831,FALSE,NA,"0.1.4"
"26799","646",2023-06-07 03:30:00,18,1837,1819,831,FALSE,NA,"0.1.4"
"26800","646",2023-06-07 03:45:00,141,1837,1696,831,FALSE,NA,"0.1.4"
"26801","646",2023-06-07 04:00:00,120,1837,1717,831,FALSE,NA,"0.1.4"
"26802","646",2023-06-07 04:15:00,48,1837,1789,831,FALSE,NA,"0.1.4"
"26803","646",2023-06-07 04:30:00,141,1837,1696,831,FALSE,NA,"0.1.4"
"26804","646",2023-06-07 04:45:00,138,1837,1699,831,FALSE,NA,"0.1.4"
"26805","646",2023-06-07 05:00:00,145,1837,1692,831,FALSE,NA,"0.1.4"
"26806","646",2023-06-07 05:15:00,141,1837,1696,831,FALSE,NA,"0.1.4"
"26807","646",2023-06-07 05:30:00,139,1837,1698,831,FALSE,NA,"0.1.4"
"26808","646",2023-06-07 05:45:00,142,1837,1695,831,FALSE,NA,"0.1.4"
"26809","646",2023-06-07 06:00:00,151,1837,1686,831,FALSE,NA,"0.1.4"
"26810","646",2023-06-07 06:15:00,139,1837,1698,831,FALSE,NA,"0.1.4"
"26811","646",2023-06-07 06:30:00,141,1837,1696,831,FALSE,NA,"0.1.4"
"26812","646",2023-06-07 06:45:00,125,1837,1712,831,FALSE,NA,"0.1.4"
"26813","646",2023-06-07 07:00:00,143,1837,1694,831,FALSE,NA,"0.1.4"
"26814","646",2023-06-07 07:15:00,155,1837,1682,831,FALSE,NA,"0.1.4"
"26815","646",2023-06-07 07:30:00,145,1837,1692,831,FALSE,NA,"0.1.4"
"26816","646",2023-06-07 07:45:00,72,1837,1765,831,FALSE,NA,"0.1.4"
"26817","646",2023-06-07 08:00:00,138,1837,1699,831,FALSE,NA,"0.1.4"
"26818","646",2023-06-07 08:15:00,169,1837,1668,831,FALSE,NA,"0.1.4"
"26819","646",2023-06-07 08:30:00,165,1837,1672,831,FALSE,NA,"0.1.4"
"26820","646",2023-06-07 08:45:00,174,1837,1663,831,FALSE,NA,"0.1.4"
"26821","646",2023-06-07 09:00:00,152,1837,1685,831,FALSE,NA,"0.1.4"
"26822","646",2023-06-07 09:15:00,177,1837,1660,831,FALSE,NA,"0.1.4"
"26823","646",2023-06-07 09:30:00,175,1837,1662,831,FALSE,NA,"0.1.4"
"26824","646",2023-06-07 09:45:00,152,1837,1685,831,FALSE,NA,"0.1.4"
"26825","646",2023-06-07 10:00:00,160,1837,1677,831,FALSE,NA,"0.1.4"
"26826","646",2023-06-07 10:15:00,190,1837,1647,831,FALSE,NA,"0.1.4"
"26827","646",2023-06-07 10:30:00,163,1837,1674,831,FALSE,NA,"0.1.4"
"26828","646",2023-06-07 10:45:00,157,1837,1680,831,FALSE,NA,"0.1.4"
"26829","646",2023-06-07 11:00:00,158,1837,1679,831,FALSE,NA,"0.1.4"
"26830","646",2023-06-07 11:15:00,154,1837,1683,831,FALSE,NA,"0.1.4"
"26831","646",2023-06-07 11:30:00,157,1837,1680,831,FALSE,NA,"0.1.4"
"26832","646",2023-06-07 11:45:00,155,1837,1682,831,FALSE,NA,"0.1.4"
"26833","646",2023-06-07 12:00:00,154,1837,1683,831,FALSE,NA,"0.1.4"
"26834","646",2023-06-07 12:15:00,161,1837,1676,831,FALSE,NA,"0.1.4"
"26835","646",2023-06-07 12:30:00,160,1837,1677,831,FALSE,NA,"0.1.4"
"26836","646",2023-06-07 12:45:00,156,1837,1681,831,FALSE,NA,"0.1.4"
"26837","646",2023-06-07 13:00:00,176,1837,1661,831,FALSE,NA,"0.1.4"
"26838","646",2023-06-07 13:15:00,180,1837,1657,831,FALSE,NA,"0.1.4"
"26839","646",2023-06-07 13:30:00,152,1837,1685,831,FALSE,NA,"0.1.4"
"26840","646",2023-06-07 13:45:00,167,1837,1670,831,FALSE,NA,"0.1.4"
"26841","646",2023-06-07 14:00:00,148,1837,1689,831,FALSE,NA,"0.1.4"
"26842","646",2023-06-07 14:15:00,152,1837,1685,831,FALSE,NA,"0.1.4"
"26843","646",2023-06-07 14:30:00,229,1837,1608,831,FALSE,NA,"0.1.4"
"26844","646",2023-06-07 14:45:00,174,1837,1663,831,FALSE,NA,"0.1.4"
"26845","646",2023-06-07 15:00:00,157,1837,1680,831,FALSE,NA,"0.1.4"
"26846","646",2023-06-07 15:15:00,154,1837,1683,831,FALSE,NA,"0.1.4"
"26847","646",2023-06-07 15:30:00,161,1837,1676,831,FALSE,NA,"0.1.4"
"26848","646",2023-06-07 15:45:00,161,1837,1676,831,FALSE,NA,"0.1.4"
"26849","646",2023-06-07 16:00:00,163,1837,1674,831,FALSE,NA,"0.1.4"
"26850","646",2023-06-07 16:15:00,163,1837,1674,831,FALSE,NA,"0.1.4"
"26851","646",2023-06-07 16:30:00,162,1837,1675,831,FALSE,NA,"0.1.4"
"26852","646",2023-06-07 16:45:00,161,1837,1676,831,FALSE,NA,"0.1.4"
"26853","646",2023-06-07 17:00:00,161,1837,1676,831,FALSE,NA,"0.1.4"
"26854","646",2023-06-07 17:15:00,162,1837,1675,831,FALSE,NA,"0.1.4"
"26855","646",2023-06-07 17:30:00,161,1837,1676,831,FALSE,NA,"0.1.4"
"26856","646",2023-06-07 17:45:00,182,1837,1655,831,FALSE,NA,"0.1.4"
"26857","646",2023-06-07 18:00:00,183,1837,1654,831,FALSE,NA,"0.1.4"
"26858","646",2023-06-07 18:15:00,194,1837,1643,831,FALSE,NA,"0.1.4"
"26859","646",2023-06-07 18:30:00,188,1837,1649,831,FALSE,NA,"0.1.4"
"26860","646",2023-06-07 18:45:00,175,1837,1662,831,FALSE,NA,"0.1.4"
"26861","646",2023-06-07 19:00:00,147,1837,1690,831,FALSE,NA,"0.1.4"
"26862","646",2023-06-07 19:15:00,154,1837,1683,831,FALSE,NA,"0.1.4"
"26863","646",2023-06-07 19:30:00,154,1837,1683,831,FALSE,NA,"0.1.4"
"26864","646",2023-06-07 19:45:00,153,1837,1684,831,FALSE,NA,"0.1.4"
"26865","646",2023-06-07 20:00:00,154,1837,1683,831,FALSE,NA,"0.1.4"
"26866","646",2023-06-07 20:15:00,164,1837,1673,831,FALSE,NA,"0.1.4"
"26867","646",2023-06-07 20:30:00,158,1837,1679,831,FALSE,NA,"0.1.4"
"26868","646",2023-06-07 20:45:00,148,1837,1689,831,FALSE,NA,"0.1.4"
"26869","646",2023-06-07 21:00:00,145,1837,1692,831,FALSE,NA,"0.1.4"
"26870","646",2023-06-07 21:15:00,106,1837,1731,831,FALSE,NA,"0.1.4"
"26871","646",2023-06-07 21:30:00,200,1837,1637,831,FALSE,NA,"0.1.4"
"26872","646",2023-06-07 21:45:00,207,1837,1630,831,FALSE,NA,"0.1.4"
"26873","646",2023-06-07 22:00:00,179,1837,1658,831,FALSE,NA,"0.1.4"
"26874","646",2023-06-07 22:15:00,232,1837,1605,831,FALSE,NA,"0.1.4"
"26875","646",2023-06-07 22:30:00,227,1837,1610,831,FALSE,NA,"0.1.4"
"26876","646",2023-06-07 22:45:00,198,1837,1639,831,FALSE,NA,"0.1.4"
"26877","646",2023-06-07 23:00:00,148,1837,1689,831,FALSE,NA,"0.1.4"
"26878","646",2023-06-07 23:15:00,189,1837,1648,831,FALSE,NA,"0.1.4"
"26879","646",2023-06-07 23:30:00,224,1837,1613,831,FALSE,NA,"0.1.4"
"26880","646",2023-06-07 23:45:00,166,1837,1671,831,FALSE,NA,"0.1.4"
"26881","646",2023-06-08,217,1837,1620,831,FALSE,NA,"0.1.4"
"26882","646",2023-06-08 00:15:00,226,1837,1611,831,FALSE,NA,"0.1.4"
"26883","646",2023-06-08 00:30:00,19,1837,1818,831,FALSE,NA,"0.1.4"
"26884","646",2023-06-08 00:45:00,-8,1837,1845,831,FALSE,NA,"0.1.4"
"26885","646",2023-06-08 01:00:00,14,1837,1823,831,FALSE,NA,"0.1.4"
"26886","646",2023-06-08 01:15:00,-5,1837,1842,831,FALSE,NA,"0.1.4"
"26887","646",2023-06-08 01:30:00,-12,1837,1849,831,FALSE,NA,"0.1.4"
"26888","646",2023-06-08 01:45:00,-15,1837,1852,831,FALSE,NA,"0.1.4"
"26889","646",2023-06-08 02:00:00,-15,1837,1852,831,FALSE,"jump1","0.1.4"
"26890","646",2023-06-08 02:15:00,46,1837,1791,831,FALSE,NA,"0.1.4"
"26891","646",2023-06-08 02:30:00,228.5,1837,1608.5,831,FALSE,"out1, fill","0.1.4"
"26892","646",2023-06-08 02:45:00,411,1837,1426,831,FALSE,NA,"0.1.4"
"26893","646",2023-06-08 03:00:00,166,1837,1671,831,FALSE,NA,"0.1.4"
"26894","646",2023-06-08 03:15:00,66,1837,1771,831,FALSE,NA,"0.1.4"
"26895","646",2023-06-08 03:30:00,177,1837,1660,831,FALSE,NA,"0.1.4"
"26896","646",2023-06-08 03:45:00,-121,1837,1958,831,FALSE,NA,"0.1.4"
"26897","646",2023-06-08 04:00:00,106,1837,1731,831,FALSE,NA,"0.1.4"
"26898","646",2023-06-08 04:15:00,-11,1837,1848,831,FALSE,NA,"0.1.4"
"26899","646",2023-06-08 04:30:00,442,1837,1395,831,FALSE,NA,"0.1.4"
"26900","646",2023-06-08 04:45:00,663,1837,1174,831,FALSE,NA,"0.1.4"
"26901","646",2023-06-08 05:00:00,338.5,1837,1498.5,831,FALSE,"out1, fill","0.1.4"
"26902","646",2023-06-08 05:15:00,14,1837,1823,831,FALSE,NA,"0.1.4"
"26903","646",2023-06-08 05:30:00,171,1837,1666,831,FALSE,NA,"0.1.4"
"26904","646",2023-06-08 05:45:00,-19,1837,1856,831,FALSE,NA,"0.1.4"
"26905","646",2023-06-08 06:00:00,281,1837,1556,831,FALSE,NA,"0.1.4"
"26906","646",2023-06-08 06:15:00,-92,1837,1929,831,FALSE,NA,"0.1.4"
"26907","646",2023-06-08 06:30:00,364.5,1837,1472.5,831,FALSE,"out1, fill","0.1.4"
"26908","646",2023-06-08 06:45:00,821,1837,1016,831,FALSE,NA,"0.1.4"
"26909","646",2023-06-08 07:00:00,765,1837,1072,831,FALSE,NA,"0.1.4"
"26910","646",2023-06-08 07:15:00,821,1837,1016,831,FALSE,NA,"0.1.4"
"26911","646",2023-06-08 07:30:00,821,1837,1016,831,FALSE,NA,"0.1.4"
"26912","646",2023-06-08 07:45:00,821,1837,1016,831,FALSE,NA,"0.1.4"
"26913","646",2023-06-08 08:00:00,459,1837,1378,831,FALSE,NA,"0.1.4"
"26914","646",2023-06-08 08:15:00,821,1837,1016,831,FALSE,NA,"0.1.4"
"26915","646",2023-06-08 08:30:00,820,1837,1017,831,FALSE,NA,"0.1.4"
"26916","646",2023-06-08 08:45:00,823,1837,1014,831,FALSE,NA,"0.1.4"
"26917","646",2023-06-08 09:00:00,821,1837,1016,831,FALSE,NA,"0.1.4"
"26918","646",2023-06-08 09:15:00,823,1837,1014,831,FALSE,NA,"0.1.4"
"26919","646",2023-06-08 09:30:00,823,1837,1014,831,FALSE,NA,"0.1.4"
"26920","646",2023-06-08 09:45:00,821,1837,1016,831,FALSE,NA,"0.1.4"
"26921","646",2023-06-08 10:00:00,823,1837,1014,831,FALSE,NA,"0.1.4"
"26922","646",2023-06-08 10:15:00,823,1837,1014,831,FALSE,NA,"0.1.4"
"26923","646",2023-06-08 10:30:00,826,1837,1011,831,FALSE,NA,"0.1.4"
"26924","646",2023-06-08 10:45:00,824,1837,1013,831,FALSE,NA,"0.1.4"
"26925","646",2023-06-08 11:00:00,826,1837,1011,831,FALSE,NA,"0.1.4"
"26926","646",2023-06-08 11:15:00,823,1837,1014,831,FALSE,NA,"0.1.4"
"26927","646",2023-06-08 11:30:00,660,1837,1177,831,FALSE,NA,"0.1.4"
"26928","646",2023-06-08 11:45:00,820,1837,1017,831,FALSE,NA,"0.1.4"
"26929","646",2023-06-08 12:00:00,826,1837,1011,831,FALSE,NA,"0.1.4"
"26930","646",2023-06-08 12:15:00,826,1837,1011,831,FALSE,NA,"0.1.4"
"26931","646",2023-06-08 12:30:00,701,1837,1136,831,FALSE,NA,"0.1.4"
"26932","646",2023-06-08 12:45:00,821,1837,1016,831,FALSE,NA,"0.1.4"
"26933","646",2023-06-08 13:00:00,812,1837,1025,831,FALSE,NA,"0.1.4"
"26934","646",2023-06-08 13:15:00,800,1837,1037,831,FALSE,NA,"0.1.4"
"26935","646",2023-06-08 13:30:00,815,1837,1022,831,FALSE,NA,"0.1.4"
"26936","646",2023-06-08 13:45:00,823,1837,1014,831,FALSE,NA,"0.1.4"
"26937","646",2023-06-08 14:00:00,829,1837,1008,831,FALSE,NA,"0.1.4"
"26938","646",2023-06-08 14:15:00,832,1837,1005,831,FALSE,NA,"0.1.4"
"26939","646",2023-06-08 14:30:00,820,1837,1017,831,FALSE,NA,"0.1.4"
"26940","646",2023-06-08 14:45:00,821,1837,1016,831,FALSE,NA,"0.1.4"
"26941","646",2023-06-08 15:00:00,830,1837,1007,831,FALSE,NA,"0.1.4"
"26942","646",2023-06-08 15:15:00,830,1837,1007,831,FALSE,NA,"0.1.4"
"26943","646",2023-06-08 15:30:00,829,1837,1008,831,FALSE,NA,"0.1.4"
"26944","646",2023-06-08 15:45:00,829,1837,1008,831,FALSE,NA,"0.1.4"
"26945","646",2023-06-08 16:00:00,829,1837,1008,831,FALSE,NA,"0.1.4"
"26946","646",2023-06-08 16:15:00,829,1837,1008,831,FALSE,NA,"0.1.4"
"26947","646",2023-06-08 16:30:00,829,1837,1008,831,FALSE,NA,"0.1.4"
"26948","646",2023-06-08 16:45:00,830,1837,1007,831,FALSE,NA,"0.1.4"
"26949","646",2023-06-08 17:00:00,823,1837,1014,831,FALSE,NA,"0.1.4"
"26950","646",2023-06-08 17:15:00,825,1837,1012,831,FALSE,NA,"0.1.4"
"26951","646",2023-06-08 17:30:00,826,1837,1011,831,FALSE,NA,"0.1.4"
"26952","646",2023-06-08 17:45:00,827,1837,1010,831,FALSE,NA,"0.1.4"
"26953","646",2023-06-08 18:00:00,830,1837,1007,831,FALSE,NA,"0.1.4"
"26954","646",2023-06-08 18:15:00,830,1837,1007,831,FALSE,NA,"0.1.4"
"26955","646",2023-06-08 18:30:00,815,1837,1022,831,FALSE,NA,"0.1.4"
"26956","646",2023-06-08 18:45:00,594,1837,1243,831,FALSE,NA,"0.1.4"
"26957","646",2023-06-08 19:00:00,745,1837,1092,831,FALSE,NA,"0.1.4"
"26958","646",2023-06-08 19:15:00,760,1837,1077,831,FALSE,NA,"0.1.4"
"26959","646",2023-06-08 19:30:00,678,1837,1159,831,FALSE,NA,"0.1.4"
"26960","646",2023-06-08 19:45:00,828,1837,1009,831,FALSE,NA,"0.1.4"
"26961","646",2023-06-08 20:00:00,829,1837,1008,831,FALSE,NA,"0.1.4"
"26962","646",2023-06-08 20:15:00,827,1837,1010,831,FALSE,NA,"0.1.4"
"26963","646",2023-06-08 20:30:00,793,1837,1044,831,FALSE,NA,"0.1.4"
"26964","646",2023-06-08 20:45:00,702,1837,1135,831,FALSE,NA,"0.1.4"
"26965","646",2023-06-08 21:00:00,816,1837,1021,831,FALSE,NA,"0.1.4"
"26966","646",2023-06-08 21:15:00,819,1837,1018,831,FALSE,NA,"0.1.4"
"26967","646",2023-06-08 21:30:00,818,1837,1019,831,FALSE,NA,"0.1.4"
"26968","646",2023-06-08 21:45:00,823,1837,1014,831,FALSE,NA,"0.1.4"
"26969","646",2023-06-08 22:00:00,823,1837,1014,831,FALSE,NA,"0.1.4"
"26970","646",2023-06-08 22:15:00,820,1837,1017,831,FALSE,NA,"0.1.4"
"26971","646",2023-06-08 22:30:00,820,1837,1017,831,FALSE,NA,"0.1.4"
"26972","646",2023-06-08 22:45:00,820,1837,1017,831,FALSE,NA,"0.1.4"
"26973","646",2023-06-08 23:00:00,820,1837,1017,831,FALSE,NA,"0.1.4"
"26974","646",2023-06-08 23:15:00,821,1837,1016,831,FALSE,NA,"0.1.4"
"26975","646",2023-06-08 23:30:00,821,1837,1016,831,FALSE,NA,"0.1.4"
"26976","646",2023-06-08 23:45:00,822,1837,1015,831,FALSE,NA,"0.1.4"
"26977","646",2023-06-09,821,1837,1016,831,FALSE,NA,"0.1.4"
"26978","646",2023-06-09 00:15:00,820,1837,1017,831,FALSE,NA,"0.1.4"
"26979","646",2023-06-09 00:30:00,821,1837,1016,831,FALSE,NA,"0.1.4"
"26980","646",2023-06-09 00:45:00,824,1837,1013,831,FALSE,NA,"0.1.4"
"26981","646",2023-06-09 01:00:00,822,1837,1015,831,FALSE,NA,"0.1.4"
"26982","646",2023-06-09 01:15:00,822,1837,1015,831,FALSE,NA,"0.1.4"
"26983","646",2023-06-09 01:30:00,834,1837,1003,831,FALSE,NA,"0.1.4"
"26984","646",2023-06-09 01:45:00,831,1837,1006,831,FALSE,NA,"0.1.4"
"26985","646",2023-06-09 02:00:00,831,1837,1006,831,FALSE,NA,"0.1.4"
"26986","646",2023-06-09 02:15:00,822,1837,1015,831,FALSE,NA,"0.1.4"
"26987","646",2023-06-09 02:30:00,821,1837,1016,831,FALSE,NA,"0.1.4"
"26988","646",2023-06-09 02:45:00,830,1837,1007,831,FALSE,NA,"0.1.4"
"26989","646",2023-06-09 03:00:00,821,1837,1016,831,FALSE,NA,"0.1.4"
"26990","646",2023-06-09 03:15:00,823,1837,1014,831,FALSE,NA,"0.1.4"
"26991","646",2023-06-09 03:30:00,820,1837,1017,831,FALSE,NA,"0.1.4"
"26992","646",2023-06-09 03:45:00,820,1837,1017,831,FALSE,NA,"0.1.4"
"26993","646",2023-06-09 04:00:00,819,1837,1018,831,FALSE,NA,"0.1.4"
"26994","646",2023-06-09 04:15:00,829,1837,1008,831,FALSE,NA,"0.1.4"
"26995","646",2023-06-09 04:30:00,819,1837,1018,831,FALSE,NA,"0.1.4"
"26996","646",2023-06-09 04:45:00,822,1837,1015,831,FALSE,NA,"0.1.4"
"26997","646",2023-06-09 05:00:00,820,1837,1017,831,FALSE,NA,"0.1.4"
"26998","646",2023-06-09 05:15:00,827,1837,1010,831,FALSE,NA,"0.1.4"
"26999","646",2023-06-09 05:30:00,817,1837,1020,831,FALSE,NA,"0.1.4"
"27000","646",2023-06-09 05:45:00,818,1837,1019,831,FALSE,NA,"0.1.4"
"27001","646",2023-06-09 06:00:00,827,1837,1010,831,FALSE,NA,"0.1.4"
"27002","646",2023-06-09 06:15:00,828,1837,1009,831,FALSE,NA,"0.1.4"
"27003","646",2023-06-09 06:30:00,820,1837,1017,831,FALSE,NA,"0.1.4"
"27004","646",2023-06-09 06:45:00,829,1837,1008,831,FALSE,NA,"0.1.4"
"27005","646",2023-06-09 07:00:00,759,1837,1078,831,FALSE,NA,"0.1.4"
"27006","646",2023-06-09 07:15:00,824,1837,1013,831,FALSE,NA,"0.1.4"
"27007","646",2023-06-09 07:30:00,829,1837,1008,831,FALSE,NA,"0.1.4"
"27008","646",2023-06-09 07:45:00,831,1837,1006,831,FALSE,NA,"0.1.4"
"27009","646",2023-06-09 08:00:00,832,1837,1005,831,FALSE,NA,"0.1.4"
"27010","646",2023-06-09 08:15:00,830,1837,1007,831,FALSE,NA,"0.1.4"
"27011","646",2023-06-09 08:30:00,831,1837,1006,831,FALSE,NA,"0.1.4"
"27012","646",2023-06-09 08:45:00,811,1837,1026,831,FALSE,NA,"0.1.4"
"27013","646",2023-06-09 09:00:00,827,1837,1010,831,FALSE,NA,"0.1.4"
"27014","646",2023-06-09 09:15:00,831,1837,1006,831,FALSE,NA,"0.1.4"
"27015","646",2023-06-09 09:30:00,829,1837,1008,831,FALSE,NA,"0.1.4"
"27016","646",2023-06-09 09:45:00,827,1837,1010,831,FALSE,NA,"0.1.4"
"27017","646",2023-06-09 10:00:00,828,1837,1009,831,FALSE,NA,"0.1.4"
"27018","646",2023-06-09 10:15:00,853,1837,984,831,FALSE,NA,"0.1.4"
"27019","646",2023-06-09 10:30:00,831,1837,1006,831,FALSE,NA,"0.1.4"
"27020","646",2023-06-09 10:45:00,834,1837,1003,831,FALSE,NA,"0.1.4"
"27021","646",2023-06-09 11:00:00,846,1837,991,831,FALSE,NA,"0.1.4"
"27022","646",2023-06-09 11:15:00,837,1837,1000,831,FALSE,NA,"0.1.4"
"27023","646",2023-06-09 11:30:00,840,1837,997,831,FALSE,NA,"0.1.4"
"27024","646",2023-06-09 11:45:00,839,1837,998,831,FALSE,NA,"0.1.4"
"27025","646",2023-06-09 12:00:00,839,1837,998,831,FALSE,NA,"0.1.4"
"27026","646",2023-06-09 12:15:00,838,1837,999,831,FALSE,NA,"0.1.4"
"27027","646",2023-06-09 12:30:00,835,1837,1002,831,FALSE,NA,"0.1.4"
"27028","646",2023-06-09 12:45:00,856,1837,981,831,FALSE,NA,"0.1.4"
"27029","646",2023-06-09 13:00:00,832,1837,1005,831,FALSE,NA,"0.1.4"
"27030","646",2023-06-09 13:15:00,833,1837,1004,831,FALSE,NA,"0.1.4"
"27031","646",2023-06-09 13:30:00,832,1837,1005,831,FALSE,NA,"0.1.4"
"27032","646",2023-06-09 13:45:00,833,1837,1004,831,FALSE,NA,"0.1.4"
"27033","646",2023-06-09 14:00:00,876,1837,961,831,FALSE,NA,"0.1.4"
"27034","646",2023-06-09 14:15:00,876,1837,961,831,FALSE,NA,"0.1.4"
"27035","646",2023-06-09 14:30:00,881,1837,956,831,FALSE,NA,"0.1.4"
"27036","646",2023-06-09 14:45:00,878,1837,959,831,FALSE,NA,"0.1.4"
"27037","646",2023-06-09 15:00:00,911,1837,926,831,FALSE,NA,"0.1.4"
"27038","646",2023-06-09 15:15:00,851,1837,986,831,FALSE,NA,"0.1.4"
"27039","646",2023-06-09 15:30:00,858,1837,979,831,FALSE,NA,"0.1.4"
"27040","646",2023-06-09 15:45:00,877,1837,960,831,FALSE,NA,"0.1.4"
"27041","646",2023-06-09 16:00:00,877,1837,960,831,FALSE,NA,"0.1.4"
"27042","646",2023-06-09 16:15:00,921,1837,916,831,FALSE,NA,"0.1.4"
"27043","646",2023-06-09 16:30:00,905,1837,932,831,FALSE,NA,"0.1.4"
"27044","646",2023-06-09 16:45:00,900,1837,937,831,FALSE,NA,"0.1.4"
"27045","646",2023-06-09 17:00:00,891,1837,946,831,FALSE,NA,"0.1.4"
"27046","646",2023-06-09 17:15:00,890,1837,947,831,FALSE,NA,"0.1.4"
"27047","646",2023-06-09 17:30:00,888,1837,949,831,FALSE,NA,"0.1.4"
"27048","646",2023-06-09 17:45:00,912,1837,925,831,FALSE,NA,"0.1.4"
"27049","646",2023-06-09 18:00:00,913,1837,924,831,FALSE,NA,"0.1.4"
"27050","646",2023-06-09 18:15:00,907,1837,930,831,FALSE,NA,"0.1.4"
"27051","646",2023-06-09 18:30:00,901,1837,936,831,FALSE,NA,"0.1.4"
"27052","646",2023-06-09 18:45:00,899,1837,938,831,FALSE,NA,"0.1.4"
"27053","646",2023-06-09 19:00:00,896,1837,941,831,FALSE,NA,"0.1.4"
"27054","646",2023-06-09 19:15:00,888,1837,949,831,FALSE,NA,"0.1.4"
"27055","646",2023-06-09 19:30:00,884,1837,953,831,FALSE,NA,"0.1.4"
"27056","646",2023-06-09 19:45:00,886,1837,951,831,FALSE,NA,"0.1.4"
"27057","646",2023-06-09 20:00:00,892,1837,945,831,FALSE,NA,"0.1.4"
"27058","646",2023-06-09 20:15:00,894,1837,943,831,FALSE,NA,"0.1.4"
"27059","646",2023-06-09 20:30:00,892,1837,945,831,FALSE,NA,"0.1.4"
"27060","646",2023-06-09 20:45:00,886,1837,951,831,FALSE,NA,"0.1.4"
"27061","646",2023-06-09 21:00:00,915,1837,922,831,FALSE,NA,"0.1.4"
"27062","646",2023-06-09 21:15:00,864,1837,973,831,FALSE,NA,"0.1.4"
"27063","646",2023-06-09 21:30:00,888,1837,949,831,FALSE,NA,"0.1.4"
"27064","646",2023-06-09 21:45:00,890,1837,947,831,FALSE,NA,"0.1.4"
"27065","646",2023-06-09 22:00:00,907,1837,930,831,FALSE,NA,"0.1.4"
"27066","646",2023-06-09 22:15:00,905,1837,932,831,FALSE,NA,"0.1.4"
"27067","646",2023-06-09 22:30:00,902,1837,935,831,FALSE,NA,"0.1.4"
"27068","646",2023-06-09 22:45:00,903,1837,934,831,FALSE,NA,"0.1.4"
"27069","646",2023-06-09 23:00:00,895,1837,942,831,FALSE,NA,"0.1.4"
"27070","646",2023-06-09 23:15:00,894,1837,943,831,FALSE,NA,"0.1.4"
"27071","646",2023-06-09 23:30:00,895,1837,942,831,FALSE,NA,"0.1.4"
"27072","646",2023-06-09 23:45:00,912,1837,925,831,FALSE,NA,"0.1.4"
"27073","646",2023-06-10,913,1837,924,831,FALSE,NA,"0.1.4"
"27074","646",2023-06-10 00:15:00,900,1837,937,831,FALSE,NA,"0.1.4"
"27075","646",2023-06-10 00:30:00,899,1837,938,831,FALSE,NA,"0.1.4"
"27076","646",2023-06-10 00:45:00,901,1837,936,831,FALSE,NA,"0.1.4"
"27077","646",2023-06-10 01:00:00,907,1837,930,831,FALSE,NA,"0.1.4"
"27078","646",2023-06-10 01:15:00,944,1837,893,831,FALSE,NA,"0.1.4"
"27079","646",2023-06-10 01:30:00,898,1837,939,831,FALSE,NA,"0.1.4"
"27080","646",2023-06-10 01:45:00,882,1837,955,831,FALSE,NA,"0.1.4"
"27081","646",2023-06-10 02:00:00,955,1837,882,831,FALSE,NA,"0.1.4"
"27082","646",2023-06-10 02:15:00,959,1837,878,831,FALSE,NA,"0.1.4"
"27083","646",2023-06-10 02:30:00,943,1837,894,831,FALSE,NA,"0.1.4"
"27084","646",2023-06-10 02:45:00,951,1837,886,831,FALSE,NA,"0.1.4"
"27085","646",2023-06-10 03:00:00,933,1837,904,831,FALSE,NA,"0.1.4"
"27086","646",2023-06-10 03:15:00,908,1837,929,831,FALSE,NA,"0.1.4"
"27087","646",2023-06-10 03:30:00,883,1837,954,831,FALSE,NA,"0.1.4"
"27088","646",2023-06-10 03:45:00,890,1837,947,831,FALSE,NA,"0.1.4"
"27089","646",2023-06-10 04:00:00,888,1837,949,831,FALSE,NA,"0.1.4"
"27090","646",2023-06-10 04:15:00,867,1837,970,831,FALSE,NA,"0.1.4"
"27091","646",2023-06-10 04:30:00,858,1837,979,831,FALSE,NA,"0.1.4"
"27092","646",2023-06-10 04:45:00,893,1837,944,831,FALSE,NA,"0.1.4"
"27093","646",2023-06-10 05:00:00,894,1837,943,831,FALSE,NA,"0.1.4"
"27094","646",2023-06-10 05:15:00,951,1837,886,831,FALSE,NA,"0.1.4"
"27095","646",2023-06-10 05:30:00,883,1837,954,831,FALSE,NA,"0.1.4"
"27096","646",2023-06-10 05:45:00,857,1837,980,831,FALSE,NA,"0.1.4"
"27097","646",2023-06-10 06:00:00,855,1837,982,831,FALSE,NA,"0.1.4"
"27098","646",2023-06-10 06:15:00,863,1837,974,831,FALSE,NA,"0.1.4"
"27099","646",2023-06-10 06:30:00,866,1837,971,831,FALSE,NA,"0.1.4"
"27100","646",2023-06-10 06:45:00,836,1837,1001,831,FALSE,NA,"0.1.4"
"27101","646",2023-06-10 07:00:00,866,1837,971,831,FALSE,NA,"0.1.4"
"27102","646",2023-06-10 07:15:00,833,1837,1004,831,FALSE,NA,"0.1.4"
"27103","646",2023-06-10 07:30:00,846,1837,991,831,FALSE,NA,"0.1.4"
"27104","646",2023-06-10 07:45:00,842,1837,995,831,FALSE,NA,"0.1.4"
"27105","646",2023-06-10 08:00:00,837,1837,1000,831,FALSE,NA,"0.1.4"
"27106","646",2023-06-10 08:15:00,867,1837,970,831,FALSE,NA,"0.1.4"
"27107","646",2023-06-10 08:30:00,799,1837,1038,831,FALSE,NA,"0.1.4"
"27108","646",2023-06-10 08:45:00,832,1837,1005,831,FALSE,NA,"0.1.4"
"27109","646",2023-06-10 09:00:00,870,1837,967,831,FALSE,NA,"0.1.4"
"27110","646",2023-06-10 09:15:00,871,1837,966,831,FALSE,NA,"0.1.4"
"27111","646",2023-06-10 09:30:00,691,1837,1146,831,FALSE,NA,"0.1.4"
"27112","646",2023-06-10 09:45:00,893,1837,944,831,FALSE,NA,"0.1.4"
"27113","646",2023-06-10 10:00:00,930,1837,907,831,FALSE,NA,"0.1.4"
"27114","646",2023-06-10 10:15:00,917,1837,920,831,FALSE,NA,"0.1.4"
"27115","646",2023-06-10 10:30:00,939,1837,898,831,FALSE,NA,"0.1.4"
"27116","646",2023-06-10 10:45:00,886,1837,951,831,FALSE,NA,"0.1.4"
"27117","646",2023-06-10 11:00:00,916,1837,921,831,FALSE,NA,"0.1.4"
"27118","646",2023-06-10 11:15:00,865,1837,972,831,FALSE,NA,"0.1.4"
"27119","646",2023-06-10 11:30:00,873,1837,964,831,FALSE,NA,"0.1.4"
"27120","646",2023-06-10 11:45:00,883,1837,954,831,FALSE,NA,"0.1.4"
"27121","646",2023-06-10 12:00:00,907,1837,930,831,FALSE,NA,"0.1.4"
"27122","646",2023-06-10 12:15:00,841,1837,996,831,FALSE,NA,"0.1.4"
"27123","646",2023-06-10 12:30:00,891,1837,946,831,FALSE,NA,"0.1.4"
"27124","646",2023-06-10 12:45:00,884,1837,953,831,FALSE,NA,"0.1.4"
"27125","646",2023-06-10 13:00:00,593,1837,1244,831,FALSE,NA,"0.1.4"
"27126","646",2023-06-10 13:15:00,356,1837,1481,831,FALSE,NA,"0.1.4"
"27127","646",2023-06-10 13:30:00,381,1837,1456,831,FALSE,NA,"0.1.4"
"27128","646",2023-06-10 13:45:00,874,1837,963,831,FALSE,NA,"0.1.4"
"27129","646",2023-06-10 14:00:00,854,1837,983,831,FALSE,NA,"0.1.4"
"27130","646",2023-06-10 14:15:00,864,1837,973,831,FALSE,NA,"0.1.4"
"27131","646",2023-06-10 14:30:00,850,1837,987,831,FALSE,NA,"0.1.4"
"27132","646",2023-06-10 14:45:00,772,1837,1065,831,FALSE,NA,"0.1.4"
"27133","646",2023-06-10 15:00:00,874,1837,963,831,FALSE,NA,"0.1.4"
"27134","646",2023-06-10 15:15:00,887,1837,950,831,FALSE,NA,"0.1.4"
"27135","646",2023-06-10 15:30:00,885,1837,952,831,FALSE,NA,"0.1.4"
"27136","646",2023-06-10 15:45:00,886,1837,951,831,FALSE,NA,"0.1.4"
"27137","646",2023-06-10 16:00:00,887,1837,950,831,FALSE,NA,"0.1.4"
"27138","646",2023-06-10 16:15:00,871,1837,966,831,FALSE,NA,"0.1.4"
"27139","646",2023-06-10 16:30:00,880,1837,957,831,FALSE,NA,"0.1.4"
"27140","646",2023-06-10 16:45:00,882,1837,955,831,FALSE,NA,"0.1.4"
"27141","646",2023-06-10 17:00:00,880,1837,957,831,FALSE,NA,"0.1.4"
"27142","646",2023-06-10 17:15:00,880,1837,957,831,FALSE,NA,"0.1.4"
"27143","646",2023-06-10 17:30:00,856,1837,981,831,FALSE,NA,"0.1.4"
"27144","646",2023-06-10 17:45:00,878,1837,959,831,FALSE,NA,"0.1.4"
"27145","646",2023-06-10 18:00:00,884,1837,953,831,FALSE,NA,"0.1.4"
"27146","646",2023-06-10 18:15:00,885,1837,952,831,FALSE,NA,"0.1.4"
"27147","646",2023-06-10 18:30:00,878,1837,959,831,FALSE,NA,"0.1.4"
"27148","646",2023-06-10 18:45:00,862,1837,975,831,FALSE,NA,"0.1.4"
"27149","646",2023-06-10 19:00:00,886,1837,951,831,FALSE,NA,"0.1.4"
"27150","646",2023-06-10 19:15:00,885,1837,952,831,FALSE,NA,"0.1.4"
"27151","646",2023-06-10 19:30:00,886,1837,951,831,FALSE,NA,"0.1.4"
"27152","646",2023-06-10 19:45:00,876,1837,961,831,FALSE,NA,"0.1.4"
"27153","646",2023-06-10 20:00:00,833,1837,1004,831,FALSE,NA,"0.1.4"
"27154","646",2023-06-10 20:15:00,793,1837,1044,831,FALSE,NA,"0.1.4"
"27155","646",2023-06-10 20:30:00,861,1837,976,831,FALSE,NA,"0.1.4"
"27156","646",2023-06-10 20:45:00,874,1837,963,831,FALSE,NA,"0.1.4"
"27157","646",2023-06-10 21:00:00,879,1837,958,831,FALSE,NA,"0.1.4"
"27158","646",2023-06-10 21:15:00,868,1837,969,831,FALSE,NA,"0.1.4"
"27159","646",2023-06-10 21:30:00,878,1837,959,831,FALSE,NA,"0.1.4"
"27160","646",2023-06-10 21:45:00,870,1837,967,831,FALSE,NA,"0.1.4"
"27161","646",2023-06-10 22:00:00,887,1837,950,831,FALSE,NA,"0.1.4"
"27162","646",2023-06-10 22:15:00,905,1837,932,831,FALSE,NA,"0.1.4"
"27163","646",2023-06-10 22:30:00,882,1837,955,831,FALSE,NA,"0.1.4"
"27164","646",2023-06-10 22:45:00,880,1837,957,831,FALSE,NA,"0.1.4"
"27165","646",2023-06-10 23:00:00,871,1837,966,831,FALSE,NA,"0.1.4"
"27166","646",2023-06-10 23:15:00,869,1837,968,831,FALSE,NA,"0.1.4"
"27167","646",2023-06-10 23:30:00,905,1837,932,831,FALSE,NA,"0.1.4"
"27168","646",2023-06-10 23:45:00,734,1837,1103,831,FALSE,NA,"0.1.4"
"27169","646",2023-06-11,868,1837,969,831,FALSE,NA,"0.1.4"
"27170","646",2023-06-11 00:15:00,894,1837,943,831,FALSE,NA,"0.1.4"
"27171","646",2023-06-11 00:30:00,857,1837,980,831,FALSE,NA,"0.1.4"
"27172","646",2023-06-11 00:45:00,686,1837,1151,831,FALSE,NA,"0.1.4"
"27173","646",2023-06-11 01:00:00,620,1837,1217,831,FALSE,NA,"0.1.4"
"27174","646",2023-06-11 01:15:00,871,1837,966,831,FALSE,NA,"0.1.4"
"27175","646",2023-06-11 01:30:00,810,1837,1027,831,FALSE,NA,"0.1.4"
"27176","646",2023-06-11 01:45:00,848,1837,989,831,FALSE,NA,"0.1.4"
"27177","646",2023-06-11 02:00:00,840,1837,997,831,FALSE,NA,"0.1.4"
"27178","646",2023-06-11 02:15:00,807,1837,1030,831,FALSE,NA,"0.1.4"
"27179","646",2023-06-11 02:30:00,836,1837,1001,831,FALSE,NA,"0.1.4"
"27180","646",2023-06-11 02:45:00,858,1837,979,831,FALSE,NA,"0.1.4"
"27181","646",2023-06-11 03:00:00,836,1837,1001,831,FALSE,NA,"0.1.4"
"27182","646",2023-06-11 03:15:00,597,1837,1240,831,FALSE,NA,"0.1.4"
"27183","646",2023-06-11 03:30:00,660,1837,1177,831,FALSE,NA,"0.1.4"
"27184","646",2023-06-11 03:45:00,868,1837,969,831,FALSE,NA,"0.1.4"
"27185","646",2023-06-11 04:00:00,867,1837,970,831,FALSE,NA,"0.1.4"
"27186","646",2023-06-11 04:15:00,865,1837,972,831,FALSE,NA,"0.1.4"
"27187","646",2023-06-11 04:30:00,899,1837,938,831,FALSE,NA,"0.1.4"
"27188","646",2023-06-11 04:45:00,880,1837,957,831,FALSE,NA,"0.1.4"
"27189","646",2023-06-11 05:00:00,855,1837,982,831,FALSE,NA,"0.1.4"
"27190","646",2023-06-11 05:15:00,876,1837,961,831,FALSE,NA,"0.1.4"
"27191","646",2023-06-11 05:30:00,888,1837,949,831,FALSE,NA,"0.1.4"
"27192","646",2023-06-11 05:45:00,864,1837,973,831,FALSE,NA,"0.1.4"
"27193","646",2023-06-11 06:00:00,898,1837,939,831,FALSE,NA,"0.1.4"
"27194","646",2023-06-11 06:15:00,886,1837,951,831,FALSE,NA,"0.1.4"
"27195","646",2023-06-11 06:30:00,913,1837,924,831,FALSE,NA,"0.1.4"
"27196","646",2023-06-11 06:45:00,917,1837,920,831,FALSE,NA,"0.1.4"
"27197","646",2023-06-11 07:00:00,919,1837,918,831,FALSE,NA,"0.1.4"
"27198","646",2023-06-11 07:15:00,915,1837,922,831,FALSE,NA,"0.1.4"
"27199","646",2023-06-11 07:30:00,901,1837,936,831,FALSE,NA,"0.1.4"
"27200","646",2023-06-11 07:45:00,529,1837,1308,831,FALSE,NA,"0.1.4"
"27201","646",2023-06-11 08:00:00,826,1837,1011,831,FALSE,NA,"0.1.4"
"27202","646",2023-06-11 08:15:00,826,1837,1011,831,FALSE,"jump1","0.1.4"
"27203","646",2023-06-11 08:30:00,826,1837,1011,831,FALSE,"jump1","0.1.4"
"27204","646",2023-06-11 08:45:00,898,1837,939,831,FALSE,NA,"0.1.4"
"27205","646",2023-06-11 09:00:00,742,1837,1095,831,FALSE,NA,"0.1.4"
"27206","646",2023-06-11 09:15:00,808,1837,1029,831,FALSE,NA,"0.1.4"
"27207","646",2023-06-11 09:30:00,807,1837,1030,831,FALSE,NA,"0.1.4"
"27208","646",2023-06-11 09:45:00,807,1837,1030,831,FALSE,NA,"0.1.4"
"27209","646",2023-06-11 10:00:00,889,1837,948,831,FALSE,NA,"0.1.4"
"27210","646",2023-06-11 10:15:00,836,1837,1001,831,FALSE,NA,"0.1.4"
"27211","646",2023-06-11 10:30:00,808,1837,1029,831,FALSE,NA,"0.1.4"
"27212","646",2023-06-11 10:45:00,568,1837,1269,831,FALSE,NA,"0.1.4"
"27213","646",2023-06-11 11:00:00,797,1837,1040,831,FALSE,NA,"0.1.4"
"27214","646",2023-06-11 11:15:00,750,1837,1087,831,FALSE,NA,"0.1.4"
"27215","646",2023-06-11 11:30:00,853,1837,984,831,FALSE,NA,"0.1.4"
"27216","646",2023-06-11 11:45:00,854,1837,983,831,FALSE,NA,"0.1.4"
"27217","646",2023-06-11 12:00:00,855,1837,982,831,FALSE,NA,"0.1.4"
"27218","646",2023-06-11 12:15:00,855,1837,982,831,FALSE,NA,"0.1.4"
"27219","646",2023-06-11 12:30:00,855,1837,982,831,FALSE,NA,"0.1.4"
"27220","646",2023-06-11 12:45:00,854,1837,983,831,FALSE,NA,"0.1.4"
"27221","646",2023-06-11 13:00:00,850,1837,987,831,FALSE,NA,"0.1.4"
"27222","646",2023-06-11 13:15:00,855,1837,982,831,FALSE,NA,"0.1.4"
"27223","646",2023-06-11 13:30:00,835,1837,1002,831,FALSE,NA,"0.1.4"
"27224","646",2023-06-11 13:45:00,825,1837,1012,831,FALSE,NA,"0.1.4"
"27225","646",2023-06-11 14:00:00,855,1837,982,831,FALSE,NA,"0.1.4"
"27226","646",2023-06-11 14:15:00,828,1837,1009,831,FALSE,NA,"0.1.4"
"27227","646",2023-06-11 14:30:00,641,1837,1196,831,FALSE,NA,"0.1.4"
"27228","646",2023-06-11 14:45:00,667,1837,1170,831,FALSE,NA,"0.1.4"
"27229","646",2023-06-11 15:00:00,721,1837,1116,831,FALSE,NA,"0.1.4"
"27230","646",2023-06-11 15:15:00,765,1837,1072,831,FALSE,NA,"0.1.4"
"27231","646",2023-06-11 15:30:00,827,1837,1010,831,FALSE,NA,"0.1.4"
"27232","646",2023-06-11 15:45:00,673,1837,1164,831,FALSE,NA,"0.1.4"
"27233","646",2023-06-11 16:00:00,785,1837,1052,831,FALSE,NA,"0.1.4"
"27234","646",2023-06-11 16:15:00,822,1837,1015,831,FALSE,NA,"0.1.4"
"27235","646",2023-06-11 16:30:00,805,1837,1032,831,FALSE,NA,"0.1.4"
"27236","646",2023-06-11 16:45:00,849,1837,988,831,FALSE,NA,"0.1.4"
"27237","646",2023-06-11 17:00:00,855,1837,982,831,FALSE,NA,"0.1.4"
"27238","646",2023-06-11 17:15:00,839,1837,998,831,FALSE,NA,"0.1.4"
"27239","646",2023-06-11 17:30:00,820,1837,1017,831,FALSE,NA,"0.1.4"
"27240","646",2023-06-11 17:45:00,855,1837,982,831,FALSE,NA,"0.1.4"
"27241","646",2023-06-11 18:00:00,824,1837,1013,831,FALSE,NA,"0.1.4"
"27242","646",2023-06-11 18:15:00,826,1837,1011,831,FALSE,NA,"0.1.4"
"27243","646",2023-06-11 18:30:00,847,1837,990,831,FALSE,NA,"0.1.4"
"27244","646",2023-06-11 18:45:00,849,1837,988,831,FALSE,NA,"0.1.4"
"27245","646",2023-06-11 19:00:00,851,1837,986,831,FALSE,NA,"0.1.4"
"27246","646",2023-06-11 19:15:00,855,1837,982,831,FALSE,NA,"0.1.4"
"27247","646",2023-06-11 19:30:00,497,1837,1340,831,FALSE,NA,"0.1.4"
"27248","646",2023-06-11 19:45:00,855,1837,982,831,FALSE,NA,"0.1.4"
"27249","646",2023-06-11 20:00:00,855,1837,982,831,FALSE,NA,"0.1.4"
"27250","646",2023-06-11 20:15:00,855,1837,982,831,FALSE,NA,"0.1.4"
"27251","646",2023-06-11 20:30:00,851,1837,986,831,FALSE,NA,"0.1.4"
"27252","646",2023-06-11 20:45:00,855,1837,982,831,FALSE,NA,"0.1.4"
"27253","646",2023-06-11 21:00:00,852,1837,985,831,FALSE,NA,"0.1.4"
"27254","646",2023-06-11 21:15:00,855,1837,982,831,FALSE,NA,"0.1.4"
"27255","646",2023-06-11 21:30:00,852,1837,985,831,FALSE,NA,"0.1.4"
"27256","646",2023-06-11 21:45:00,854,1837,983,831,FALSE,NA,"0.1.4"
"27257","646",2023-06-11 22:00:00,834,1837,1003,831,FALSE,NA,"0.1.4"
"27258","646",2023-06-11 22:15:00,855,1837,982,831,FALSE,NA,"0.1.4"
"27259","646",2023-06-11 22:30:00,836,1837,1001,831,FALSE,NA,"0.1.4"
"27260","646",2023-06-11 22:45:00,843,1837,994,831,FALSE,NA,"0.1.4"
"27261","646",2023-06-11 23:00:00,853,1837,984,831,FALSE,NA,"0.1.4"
"27262","646",2023-06-11 23:15:00,853,1837,984,831,FALSE,NA,"0.1.4"
"27263","646",2023-06-11 23:30:00,854,1837,983,831,FALSE,NA,"0.1.4"
"27264","646",2023-06-11 23:45:00,854,1837,983,831,FALSE,NA,"0.1.4"
"27265","646",2023-06-12,853,1837,984,831,FALSE,NA,"0.1.4"
"27266","646",2023-06-12 00:15:00,854,1837,983,831,FALSE,NA,"0.1.4"
"27267","646",2023-06-12 00:30:00,852,1837,985,831,FALSE,NA,"0.1.4"
"27268","646",2023-06-12 00:45:00,843,1837,994,831,FALSE,NA,"0.1.4"
"27269","646",2023-06-12 01:00:00,852,1837,985,831,FALSE,NA,"0.1.4"
"27270","646",2023-06-12 01:15:00,853,1837,984,831,FALSE,NA,"0.1.4"
"27271","646",2023-06-12 01:30:00,852,1837,985,831,FALSE,NA,"0.1.4"
"27272","646",2023-06-12 01:45:00,853,1837,984,831,FALSE,NA,"0.1.4"
"27273","646",2023-06-12 02:00:00,850,1837,987,831,FALSE,NA,"0.1.4"
"27274","646",2023-06-12 02:15:00,852,1837,985,831,FALSE,NA,"0.1.4"
"27275","646",2023-06-12 02:30:00,855,1837,982,831,FALSE,NA,"0.1.4"
"27276","646",2023-06-12 02:45:00,855,1837,982,831,FALSE,NA,"0.1.4"
"27277","646",2023-06-12 03:00:00,855,1837,982,831,FALSE,NA,"0.1.4"
"27278","646",2023-06-12 03:15:00,844,1837,993,831,FALSE,NA,"0.1.4"
"27279","646",2023-06-12 03:30:00,855,1837,982,831,FALSE,NA,"0.1.4"
"27280","646",2023-06-12 03:45:00,856,1837,981,831,FALSE,NA,"0.1.4"
"27281","646",2023-06-12 04:00:00,856,1837,981,831,FALSE,NA,"0.1.4"
"27282","646",2023-06-12 04:15:00,856,1837,981,831,FALSE,NA,"0.1.4"
"27283","646",2023-06-12 04:30:00,856,1837,981,831,FALSE,NA,"0.1.4"
"27284","646",2023-06-12 04:45:00,855,1837,982,831,FALSE,NA,"0.1.4"
"27285","646",2023-06-12 05:00:00,856,1837,981,831,FALSE,NA,"0.1.4"
"27286","646",2023-06-12 05:15:00,855,1837,982,831,FALSE,NA,"0.1.4"
"27287","646",2023-06-12 05:30:00,855,1837,982,831,FALSE,NA,"0.1.4"
"27288","646",2023-06-12 05:45:00,856,1837,981,831,FALSE,NA,"0.1.4"
"27289","646",2023-06-12 06:00:00,856,1837,981,831,FALSE,NA,"0.1.4"
"27290","646",2023-06-12 06:15:00,856,1837,981,831,FALSE,NA,"0.1.4"
"27291","646",2023-06-12 06:30:00,856,1837,981,831,FALSE,NA,"0.1.4"
"27292","646",2023-06-12 06:45:00,854,1837,983,831,FALSE,NA,"0.1.4"
"27293","646",2023-06-12 07:00:00,856,1837,981,831,FALSE,NA,"0.1.4"
"27294","646",2023-06-12 07:15:00,856,1837,981,831,FALSE,NA,"0.1.4"
"27295","646",2023-06-12 07:30:00,856,1837,981,831,FALSE,NA,"0.1.4"
"27296","646",2023-06-12 07:45:00,856,1837,981,831,FALSE,NA,"0.1.4"
"27297","646",2023-06-12 08:00:00,856,1837,981,831,FALSE,NA,"0.1.4"
"27298","646",2023-06-12 08:15:00,856,1837,981,831,FALSE,NA,"0.1.4"
"27299","646",2023-06-12 08:30:00,856,1837,981,831,FALSE,NA,"0.1.4"
"27300","646",2023-06-12 08:45:00,856,1837,981,831,FALSE,NA,"0.1.4"
"27301","646",2023-06-12 09:00:00,855,1837,982,831,FALSE,NA,"0.1.4"
"27302","646",2023-06-12 09:15:00,856,1837,981,831,FALSE,NA,"0.1.4"
"27303","646",2023-06-12 09:30:00,816,1837,1021,831,FALSE,NA,"0.1.4"
"27304","646",2023-06-12 09:45:00,856,1837,981,831,FALSE,NA,"0.1.4"
"27305","646",2023-06-12 10:00:00,841,1837,996,831,FALSE,NA,"0.1.4"
"27306","646",2023-06-12 10:15:00,718,1837,1119,831,FALSE,NA,"0.1.4"
"27307","646",2023-06-12 10:30:00,836,1837,1001,831,FALSE,NA,"0.1.4"
"27308","646",2023-06-12 10:45:00,689,1837,1148,831,FALSE,NA,"0.1.4"
"27309","646",2023-06-12 11:00:00,820,1837,1017,831,FALSE,NA,"0.1.4"
"27310","646",2023-06-12 11:15:00,830,1837,1007,831,FALSE,NA,"0.1.4"
"27311","646",2023-06-12 11:30:00,744,1837,1093,831,FALSE,NA,"0.1.4"
"27312","646",2023-06-12 11:45:00,744,1837,1093,831,FALSE,NA,"0.1.4"
"27313","646",2023-06-12 12:00:00,854,1837,983,831,FALSE,NA,"0.1.4"
"27314","646",2023-06-12 12:15:00,856,1837,981,831,FALSE,NA,"0.1.4"
"27315","646",2023-06-12 12:30:00,836,1837,1001,831,FALSE,NA,"0.1.4"
"27316","646",2023-06-12 12:45:00,823,1837,1014,831,FALSE,NA,"0.1.4"
"27317","646",2023-06-12 13:00:00,839,1837,998,831,FALSE,NA,"0.1.4"
"27318","646",2023-06-12 13:15:00,855,1837,982,831,FALSE,NA,"0.1.4"
"27319","646",2023-06-12 13:30:00,857,1837,980,831,FALSE,NA,"0.1.4"
"27320","646",2023-06-12 13:45:00,854,1837,983,831,FALSE,NA,"0.1.4"
"27321","646",2023-06-12 14:00:00,854,1837,983,831,FALSE,NA,"0.1.4"
"27322","646",2023-06-12 14:15:00,857,1837,980,831,FALSE,NA,"0.1.4"
"27323","646",2023-06-12 14:30:00,857,1837,980,831,FALSE,NA,"0.1.4"
"27324","646",2023-06-12 14:45:00,857,1837,980,831,FALSE,NA,"0.1.4"
"27325","646",2023-06-12 15:00:00,856,1837,981,831,FALSE,NA,"0.1.4"
"27326","646",2023-06-12 15:15:00,857,1837,980,831,FALSE,NA,"0.1.4"
"27327","646",2023-06-12 15:30:00,857,1837,980,831,FALSE,NA,"0.1.4"
"27328","646",2023-06-12 15:45:00,857,1837,980,831,FALSE,NA,"0.1.4"
"27329","646",2023-06-12 16:00:00,857,1837,980,831,FALSE,NA,"0.1.4"
"27330","646",2023-06-12 16:15:00,856,1837,981,831,FALSE,NA,"0.1.4"
"27331","646",2023-06-12 16:30:00,857,1837,980,831,FALSE,NA,"0.1.4"
"27332","646",2023-06-12 16:45:00,856,1837,981,831,FALSE,NA,"0.1.4"
"27333","646",2023-06-12 17:00:00,857,1837,980,831,FALSE,NA,"0.1.4"
"27334","646",2023-06-12 17:15:00,856,1837,981,831,FALSE,NA,"0.1.4"
"27335","646",2023-06-12 17:30:00,856,1837,981,831,FALSE,NA,"0.1.4"
"27336","646",2023-06-12 17:45:00,857,1837,980,831,FALSE,NA,"0.1.4"
"27337","646",2023-06-12 18:00:00,861,1837,976,831,FALSE,NA,"0.1.4"
"27338","646",2023-06-12 18:15:00,852,1837,985,831,FALSE,NA,"0.1.4"
"27339","646",2023-06-12 18:30:00,856,1837,981,831,FALSE,NA,"0.1.4"
"27340","646",2023-06-12 18:45:00,853,1837,984,831,FALSE,NA,"0.1.4"
"27341","646",2023-06-12 19:00:00,857,1837,980,831,FALSE,NA,"0.1.4"
"27342","646",2023-06-12 19:15:00,858,1837,979,831,FALSE,NA,"0.1.4"
"27343","646",2023-06-12 19:30:00,857,1837,980,831,FALSE,NA,"0.1.4"
"27344","646",2023-06-12 19:45:00,857,1837,980,831,FALSE,NA,"0.1.4"
"27345","646",2023-06-12 20:00:00,857,1837,980,831,FALSE,NA,"0.1.4"
"27346","646",2023-06-12 20:15:00,856,1837,981,831,FALSE,NA,"0.1.4"
"27347","646",2023-06-12 20:30:00,857,1837,980,831,FALSE,NA,"0.1.4"
"27348","646",2023-06-12 20:45:00,857,1837,980,831,FALSE,NA,"0.1.4"
"27349","646",2023-06-12 21:00:00,855,1837,982,831,FALSE,NA,"0.1.4"
"27350","646",2023-06-12 21:15:00,856,1837,981,831,FALSE,NA,"0.1.4"
"27351","646",2023-06-12 21:30:00,856,1837,981,831,FALSE,NA,"0.1.4"
"27352","646",2023-06-12 21:45:00,856,1837,981,831,FALSE,NA,"0.1.4"
"27353","646",2023-06-12 22:00:00,856,1837,981,831,FALSE,NA,"0.1.4"
"27354","646",2023-06-12 22:15:00,855,1837,982,831,FALSE,NA,"0.1.4"
"27355","646",2023-06-12 22:30:00,855,1837,982,831,FALSE,NA,"0.1.4"
"27356","646",2023-06-12 22:45:00,856,1837,981,831,FALSE,NA,"0.1.4"
"27357","646",2023-06-12 23:00:00,855,1837,982,831,FALSE,NA,"0.1.4"
"27358","646",2023-06-12 23:15:00,852,1837,985,831,FALSE,NA,"0.1.4"
"27359","646",2023-06-12 23:30:00,855,1837,982,831,FALSE,NA,"0.1.4"
"27360","646",2023-06-12 23:45:00,855,1837,982,831,FALSE,NA,"0.1.4"
"27361","646",2023-06-13,856,1837,981,831,FALSE,NA,"0.1.4"
"27362","646",2023-06-13 00:15:00,856,1837,981,831,FALSE,NA,"0.1.4"
"27363","646",2023-06-13 00:30:00,856,1837,981,831,FALSE,NA,"0.1.4"
"27364","646",2023-06-13 00:45:00,856,1837,981,831,FALSE,NA,"0.1.4"
"27365","646",2023-06-13 01:00:00,856,1837,981,831,FALSE,NA,"0.1.4"
"27366","646",2023-06-13 01:15:00,856,1837,981,831,FALSE,NA,"0.1.4"
"27367","646",2023-06-13 01:30:00,856,1837,981,831,FALSE,NA,"0.1.4"
"27368","646",2023-06-13 01:45:00,856,1837,981,831,FALSE,NA,"0.1.4"
"27369","646",2023-06-13 02:00:00,856,1837,981,831,FALSE,NA,"0.1.4"
"27370","646",2023-06-13 02:15:00,855,1837,982,831,FALSE,NA,"0.1.4"
"27371","646",2023-06-13 02:30:00,855,1837,982,831,FALSE,NA,"0.1.4"
"27372","646",2023-06-13 02:45:00,856,1837,981,831,FALSE,NA,"0.1.4"
"27373","646",2023-06-13 03:00:00,856,1837,981,831,FALSE,NA,"0.1.4"
"27374","646",2023-06-13 03:15:00,856,1837,981,831,FALSE,NA,"0.1.4"
"27375","646",2023-06-13 03:30:00,855,1837,982,831,FALSE,NA,"0.1.4"
"27376","646",2023-06-13 03:45:00,857,1837,980,831,FALSE,NA,"0.1.4"
"27377","646",2023-06-13 04:00:00,855,1837,982,831,FALSE,NA,"0.1.4"
"27378","646",2023-06-13 04:15:00,856,1837,981,831,FALSE,NA,"0.1.4"
"27379","646",2023-06-13 04:30:00,856,1837,981,831,FALSE,NA,"0.1.4"
"27380","646",2023-06-13 04:45:00,840,1837,997,831,FALSE,NA,"0.1.4"
"27381","646",2023-06-13 05:00:00,852,1837,985,831,FALSE,NA,"0.1.4"
"27382","646",2023-06-13 05:15:00,855,1837,982,831,FALSE,NA,"0.1.4"
"27383","646",2023-06-13 05:30:00,854,1837,983,831,FALSE,NA,"0.1.4"
"27384","646",2023-06-13 05:45:00,849,1837,988,831,FALSE,NA,"0.1.4"
"27385","646",2023-06-13 06:00:00,858,1837,979,831,FALSE,NA,"0.1.4"
"27386","646",2023-06-13 06:15:00,860,1837,977,831,FALSE,NA,"0.1.4"
"27387","646",2023-06-13 06:30:00,861,1837,976,831,FALSE,NA,"0.1.4"
"27388","646",2023-06-13 06:45:00,859,1837,978,831,FALSE,NA,"0.1.4"
"27389","646",2023-06-13 07:00:00,864,1837,973,831,FALSE,NA,"0.1.4"
"27390","646",2023-06-13 07:15:00,854,1837,983,831,FALSE,NA,"0.1.4"
"27391","646",2023-06-13 07:30:00,856,1837,981,831,FALSE,NA,"0.1.4"
"27392","646",2023-06-13 07:45:00,854,1837,983,831,FALSE,NA,"0.1.4"
"27393","646",2023-06-13 08:00:00,857,1837,980,831,FALSE,NA,"0.1.4"
"27394","646",2023-06-13 08:15:00,904,1837,933,831,FALSE,NA,"0.1.4"
"27395","646",2023-06-13 08:30:00,853,1837,984,831,FALSE,NA,"0.1.4"
"27396","646",2023-06-13 08:45:00,858,1837,979,831,FALSE,NA,"0.1.4"
"27397","646",2023-06-13 09:00:00,893,1837,944,831,FALSE,NA,"0.1.4"
"27398","646",2023-06-13 09:15:00,857,1837,980,831,FALSE,NA,"0.1.4"
"27399","646",2023-06-13 09:30:00,866,1837,971,831,FALSE,NA,"0.1.4"
"27400","646",2023-06-13 09:45:00,893,1837,944,831,FALSE,NA,"0.1.4"
"27401","646",2023-06-13 10:00:00,871,1837,966,831,FALSE,NA,"0.1.4"
"27402","646",2023-06-13 10:15:00,851,1837,986,831,FALSE,NA,"0.1.4"
"27403","646",2023-06-13 10:30:00,854,1837,983,831,FALSE,NA,"0.1.4"
"27404","646",2023-06-13 10:45:00,509,1837,1328,831,FALSE,NA,"0.1.4"
"27405","646",2023-06-13 11:00:00,886,1837,951,831,FALSE,NA,"0.1.4"
"27406","646",2023-06-13 11:15:00,813,1837,1024,831,FALSE,NA,"0.1.4"
"27407","646",2023-06-13 11:30:00,837,1837,1000,831,FALSE,NA,"0.1.4"
"27408","646",2023-06-13 11:45:00,874,1837,963,831,FALSE,NA,"0.1.4"
"27409","646",2023-06-13 12:00:00,873,1837,964,831,FALSE,NA,"0.1.4"
"27410","646",2023-06-13 12:15:00,871,1837,966,831,FALSE,NA,"0.1.4"
"27411","646",2023-06-13 12:30:00,872,1837,965,831,FALSE,NA,"0.1.4"
"27412","646",2023-06-13 12:45:00,878,1837,959,831,FALSE,NA,"0.1.4"
"27413","646",2023-06-13 13:00:00,877,1837,960,831,FALSE,NA,"0.1.4"
"27414","646",2023-06-13 13:15:00,879,1837,958,831,FALSE,NA,"0.1.4"
"27415","646",2023-06-13 13:30:00,872,1837,965,831,FALSE,NA,"0.1.4"
"27416","646",2023-06-13 13:45:00,875,1837,962,831,FALSE,NA,"0.1.4"
"27417","646",2023-06-13 14:00:00,876,1837,961,831,FALSE,NA,"0.1.4"
"27418","646",2023-06-13 14:15:00,890,1837,947,831,FALSE,NA,"0.1.4"
"27419","646",2023-06-13 14:30:00,889,1837,948,831,FALSE,NA,"0.1.4"
"27420","646",2023-06-13 14:45:00,888,1837,949,831,FALSE,NA,"0.1.4"
"27421","646",2023-06-13 15:00:00,888,1837,949,831,FALSE,NA,"0.1.4"
"27422","646",2023-06-13 15:15:00,888,1837,949,831,FALSE,NA,"0.1.4"
"27423","646",2023-06-13 15:30:00,888,1837,949,831,FALSE,NA,"0.1.4"
"27424","646",2023-06-13 15:45:00,888,1837,949,831,FALSE,NA,"0.1.4"
"27425","646",2023-06-13 16:00:00,888,1837,949,831,FALSE,NA,"0.1.4"
"27426","646",2023-06-13 16:15:00,888,1837,949,831,FALSE,NA,"0.1.4"
"27427","646",2023-06-13 16:30:00,888,1837,949,831,FALSE,NA,"0.1.4"
"27428","646",2023-06-13 16:45:00,888,1837,949,831,FALSE,NA,"0.1.4"
"27429","646",2023-06-13 17:00:00,888,1837,949,831,FALSE,NA,"0.1.4"
"27430","646",2023-06-13 17:15:00,888,1837,949,831,FALSE,NA,"0.1.4"
"27431","646",2023-06-13 17:30:00,888,1837,949,831,FALSE,NA,"0.1.4"
"27432","646",2023-06-13 17:45:00,886,1837,951,831,FALSE,NA,"0.1.4"
"27433","646",2023-06-13 18:00:00,886,1837,951,831,FALSE,NA,"0.1.4"
"27434","646",2023-06-13 18:15:00,887,1837,950,831,FALSE,NA,"0.1.4"
"27435","646",2023-06-13 18:30:00,887,1837,950,831,FALSE,NA,"0.1.4"
"27436","646",2023-06-13 18:45:00,879,1837,958,831,FALSE,NA,"0.1.4"
"27437","646",2023-06-13 19:00:00,877,1837,960,831,FALSE,NA,"0.1.4"
"27438","646",2023-06-13 19:15:00,876,1837,961,831,FALSE,NA,"0.1.4"
"27439","646",2023-06-13 19:30:00,877,1837,960,831,FALSE,NA,"0.1.4"
"27440","646",2023-06-13 19:45:00,877,1837,960,831,FALSE,NA,"0.1.4"
"27441","646",2023-06-13 20:00:00,877,1837,960,831,FALSE,NA,"0.1.4"
"27442","646",2023-06-13 20:15:00,877,1837,960,831,FALSE,NA,"0.1.4"
"27443","646",2023-06-13 20:30:00,877,1837,960,831,FALSE,NA,"0.1.4"
"27444","646",2023-06-13 20:45:00,881,1837,956,831,FALSE,NA,"0.1.4"
"27445","646",2023-06-13 21:00:00,882,1837,955,831,FALSE,NA,"0.1.4"
"27446","646",2023-06-13 21:15:00,878,1837,959,831,FALSE,NA,"0.1.4"
"27447","646",2023-06-13 21:30:00,878,1837,959,831,FALSE,NA,"0.1.4"
"27448","646",2023-06-13 21:45:00,878,1837,959,831,FALSE,NA,"0.1.4"
"27449","646",2023-06-13 22:00:00,877,1837,960,831,FALSE,NA,"0.1.4"
"27450","646",2023-06-13 22:15:00,877,1837,960,831,FALSE,NA,"0.1.4"
"27451","646",2023-06-13 22:30:00,878,1837,959,831,FALSE,NA,"0.1.4"
"27452","646",2023-06-13 22:45:00,877,1837,960,831,FALSE,NA,"0.1.4"
"27453","646",2023-06-13 23:00:00,877,1837,960,831,FALSE,NA,"0.1.4"
"27454","646",2023-06-13 23:15:00,880,1837,957,831,FALSE,NA,"0.1.4"
"27455","646",2023-06-13 23:30:00,886,1837,951,831,FALSE,NA,"0.1.4"
"27456","646",2023-06-13 23:45:00,893,1837,944,831,FALSE,NA,"0.1.4"
"27457","646",2023-06-14,890,1837,947,831,FALSE,NA,"0.1.4"
"27458","646",2023-06-14 00:15:00,869,1837,968,831,FALSE,NA,"0.1.4"
"27459","646",2023-06-14 00:30:00,876,1837,961,831,FALSE,NA,"0.1.4"
"27460","646",2023-06-14 00:45:00,880,1837,957,831,FALSE,NA,"0.1.4"
"27461","646",2023-06-14 01:00:00,887,1837,950,831,FALSE,NA,"0.1.4"
"27462","646",2023-06-14 01:15:00,883,1837,954,831,FALSE,NA,"0.1.4"
"27463","646",2023-06-14 01:30:00,909,1837,928,831,FALSE,NA,"0.1.4"
"27464","646",2023-06-14 01:45:00,881,1837,956,831,FALSE,NA,"0.1.4"
"27465","646",2023-06-14 02:00:00,887,1837,950,831,FALSE,NA,"0.1.4"
"27466","646",2023-06-14 02:15:00,890,1837,947,831,FALSE,NA,"0.1.4"
"27467","646",2023-06-14 02:30:00,881,1837,956,831,FALSE,NA,"0.1.4"
"27468","646",2023-06-14 02:45:00,884,1837,953,831,FALSE,NA,"0.1.4"
"27469","646",2023-06-14 03:00:00,891,1837,946,831,FALSE,NA,"0.1.4"
"27470","646",2023-06-14 03:15:00,889,1837,948,831,FALSE,NA,"0.1.4"
"27471","646",2023-06-14 03:30:00,894,1837,943,831,FALSE,NA,"0.1.4"
"27472","646",2023-06-14 03:45:00,894,1837,943,831,FALSE,NA,"0.1.4"
"27473","646",2023-06-14 04:00:00,894,1837,943,831,FALSE,NA,"0.1.4"
"27474","646",2023-06-14 04:15:00,894,1837,943,831,FALSE,NA,"0.1.4"
"27475","646",2023-06-14 04:30:00,894,1837,943,831,FALSE,NA,"0.1.4"
"27476","646",2023-06-14 04:45:00,894,1837,943,831,FALSE,NA,"0.1.4"
"27477","646",2023-06-14 05:00:00,892,1837,945,831,FALSE,NA,"0.1.4"
"27478","646",2023-06-14 05:15:00,894,1837,943,831,FALSE,NA,"0.1.4"
"27479","646",2023-06-14 05:30:00,615,1837,1222,831,FALSE,NA,"0.1.4"
"27480","646",2023-06-14 05:45:00,886,1837,951,831,FALSE,NA,"0.1.4"
"27481","646",2023-06-14 06:00:00,618,1837,1219,831,FALSE,NA,"0.1.4"
"27482","646",2023-06-14 06:15:00,892,1837,945,831,FALSE,NA,"0.1.4"
"27483","646",2023-06-14 06:30:00,894,1837,943,831,FALSE,NA,"0.1.4"
"27484","646",2023-06-14 06:45:00,894,1837,943,831,FALSE,NA,"0.1.4"
"27485","646",2023-06-14 07:00:00,861,1837,976,831,FALSE,NA,"0.1.4"
"27486","646",2023-06-14 07:15:00,894,1837,943,831,FALSE,NA,"0.1.4"
"27487","646",2023-06-14 07:30:00,894,1837,943,831,FALSE,NA,"0.1.4"
"27488","646",2023-06-14 07:45:00,894,1837,943,831,FALSE,NA,"0.1.4"
"27489","646",2023-06-14 08:00:00,894,1837,943,831,FALSE,NA,"0.1.4"
"27490","646",2023-06-14 08:15:00,902,1837,935,831,FALSE,NA,"0.1.4"
"27491","646",2023-06-14 08:30:00,897,1837,940,831,FALSE,NA,"0.1.4"
"27492","646",2023-06-14 08:45:00,899,1837,938,831,FALSE,NA,"0.1.4"
"27493","646",2023-06-14 09:00:00,894,1837,943,831,FALSE,NA,"0.1.4"
"27494","646",2023-06-14 09:15:00,893,1837,944,831,FALSE,NA,"0.1.4"
"27495","646",2023-06-14 09:30:00,898,1837,939,831,FALSE,NA,"0.1.4"
"27496","646",2023-06-14 09:45:00,885,1837,952,831,FALSE,NA,"0.1.4"
"27497","646",2023-06-14 10:00:00,883,1837,954,831,FALSE,NA,"0.1.4"
"27498","646",2023-06-14 10:15:00,885,1837,952,831,FALSE,NA,"0.1.4"
"27499","646",2023-06-14 10:30:00,925,1837,912,831,FALSE,NA,"0.1.4"
"27500","646",2023-06-14 10:45:00,883,1837,954,831,FALSE,NA,"0.1.4"
"27501","646",2023-06-14 11:00:00,954,1837,883,831,FALSE,NA,"0.1.4"
"27502","646",2023-06-14 11:15:00,896,1837,941,831,FALSE,NA,"0.1.4"
"27503","646",2023-06-14 11:30:00,951,1837,886,831,FALSE,NA,"0.1.4"
"27504","646",2023-06-14 11:45:00,978,1837,859,831,FALSE,NA,"0.1.4"
"27505","646",2023-06-14 12:00:00,947,1837,890,831,FALSE,NA,"0.1.4"
"27506","646",2023-06-14 12:15:00,945,1837,892,831,FALSE,NA,"0.1.4"
"27507","646",2023-06-14 12:30:00,925.666666666667,1837,911.333333333333,831,FALSE,"out1, fill","0.1.4"
"27508","646",2023-06-14 12:45:00,906.333333333333,1837,930.666666666667,831,FALSE,"out1, fill","0.1.4"
"27509","646",2023-06-14 13:00:00,887,1837,950,831,FALSE,NA,"0.1.4"
"27510","646",2023-06-14 13:15:00,707,1837,1130,831,FALSE,NA,"0.1.4"
"27511","646",2023-06-14 13:30:00,883,1837,954,831,FALSE,NA,"0.1.4"
"27512","646",2023-06-14 13:45:00,971,1837,866,831,FALSE,NA,"0.1.4"
"27513","646",2023-06-14 14:00:00,657,1837,1180,831,FALSE,NA,"0.1.4"
"27514","646",2023-06-14 14:15:00,923,1837,914,831,FALSE,NA,"0.1.4"
"27515","646",2023-06-14 14:30:00,990,1837,847,831,FALSE,NA,"0.1.4"
"27516","646",2023-06-14 14:45:00,1005,1837,832,831,FALSE,NA,"0.1.4"
"27517","646",2023-06-14 15:00:00,996,1837,841,831,FALSE,NA,"0.1.4"
"27518","646",2023-06-14 15:15:00,989,1837,848,831,FALSE,NA,"0.1.4"
"27519","646",2023-06-14 15:30:00,989,1837,848,831,FALSE,NA,"0.1.4"
"27520","646",2023-06-14 15:45:00,987,1837,850,831,FALSE,NA,"0.1.4"
"27521","646",2023-06-14 16:00:00,976,1837,861,831,FALSE,NA,"0.1.4"
"27522","646",2023-06-14 16:15:00,999,1837,838,831,FALSE,NA,"0.1.4"
"27523","646",2023-06-14 16:30:00,1002,1837,835,831,FALSE,NA,"0.1.4"
"27524","646",2023-06-14 16:45:00,1002,1837,835,831,FALSE,NA,"0.1.4"
"27525","646",2023-06-14 17:00:00,996,1837,841,831,FALSE,NA,"0.1.4"
"27526","646",2023-06-14 17:15:00,1005,1837,832,831,FALSE,NA,"0.1.4"
"27527","646",2023-06-14 17:30:00,1002,1837,835,831,FALSE,NA,"0.1.4"
"27528","646",2023-06-14 17:45:00,994,1837,843,831,FALSE,NA,"0.1.4"
"27529","646",2023-06-14 18:00:00,963,1837,874,831,FALSE,NA,"0.1.4"
"27530","646",2023-06-14 18:15:00,949,1837,888,831,FALSE,NA,"0.1.4"
"27531","646",2023-06-14 18:30:00,942,1837,895,831,FALSE,NA,"0.1.4"
"27532","646",2023-06-14 18:45:00,945,1837,892,831,FALSE,NA,"0.1.4"
"27533","646",2023-06-14 19:00:00,946,1837,891,831,FALSE,NA,"0.1.4"
"27534","646",2023-06-14 19:15:00,943,1837,894,831,FALSE,NA,"0.1.4"
"27535","646",2023-06-14 19:30:00,889,1837,948,831,FALSE,NA,"0.1.4"
"27536","646",2023-06-14 19:45:00,951,1837,886,831,FALSE,NA,"0.1.4"
"27537","646",2023-06-14 20:00:00,938,1837,899,831,FALSE,NA,"0.1.4"
"27538","646",2023-06-14 20:15:00,933,1837,904,831,FALSE,NA,"0.1.4"
"27539","646",2023-06-14 20:30:00,915,1837,922,831,FALSE,NA,"0.1.4"
"27540","646",2023-06-14 20:45:00,964,1837,873,831,FALSE,NA,"0.1.4"
"27541","646",2023-06-14 21:00:00,976,1837,861,831,FALSE,NA,"0.1.4"
"27542","646",2023-06-14 21:15:00,973,1837,864,831,FALSE,NA,"0.1.4"
"27543","646",2023-06-14 21:30:00,935,1837,902,831,FALSE,NA,"0.1.4"
"27544","646",2023-06-14 21:45:00,940,1837,897,831,FALSE,NA,"0.1.4"
"27545","646",2023-06-14 22:00:00,942,1837,895,831,FALSE,NA,"0.1.4"
"27546","646",2023-06-14 22:15:00,945,1837,892,831,FALSE,NA,"0.1.4"
"27547","646",2023-06-14 22:30:00,905,1837,932,831,FALSE,NA,"0.1.4"
"27548","646",2023-06-14 22:45:00,906,1837,931,831,FALSE,NA,"0.1.4"
"27549","646",2023-06-14 23:00:00,911,1837,926,831,FALSE,NA,"0.1.4"
"27550","646",2023-06-14 23:15:00,911,1837,926,831,FALSE,NA,"0.1.4"
"27551","646",2023-06-14 23:30:00,892,1837,945,831,FALSE,NA,"0.1.4"
"27552","646",2023-06-14 23:45:00,910,1837,927,831,FALSE,NA,"0.1.4"
"27553","646",2023-06-15,907,1837,930,831,FALSE,NA,"0.1.4"
"27554","646",2023-06-15 00:15:00,904,1837,933,831,FALSE,NA,"0.1.4"
"27555","646",2023-06-15 00:30:00,918,1837,919,831,FALSE,NA,"0.1.4"
"27556","646",2023-06-15 00:45:00,897,1837,940,831,FALSE,NA,"0.1.4"
"27557","646",2023-06-15 01:00:00,919,1837,918,831,FALSE,NA,"0.1.4"
"27558","646",2023-06-15 01:15:00,885,1837,952,831,FALSE,NA,"0.1.4"
"27559","646",2023-06-15 01:30:00,880,1837,957,831,FALSE,NA,"0.1.4"
"27560","646",2023-06-15 01:45:00,885,1837,952,831,FALSE,NA,"0.1.4"
"27561","646",2023-06-15 02:00:00,930,1837,907,831,FALSE,NA,"0.1.4"
"27562","646",2023-06-15 02:15:00,588,1837,1249,831,FALSE,NA,"0.1.4"
"27563","646",2023-06-15 02:30:00,969,1837,868,831,FALSE,NA,"0.1.4"
"27564","646",2023-06-15 02:45:00,953,1837,884,831,FALSE,NA,"0.1.4"
"27565","646",2023-06-15 03:00:00,928,1837,909,831,FALSE,NA,"0.1.4"
"27566","646",2023-06-15 03:15:00,913,1837,924,831,FALSE,NA,"0.1.4"
"27567","646",2023-06-15 03:30:00,885,1837,952,831,FALSE,NA,"0.1.4"
"27568","646",2023-06-15 03:45:00,969,1837,868,831,FALSE,NA,"0.1.4"
"27569","646",2023-06-15 04:00:00,947,1837,890,831,FALSE,NA,"0.1.4"
"27570","646",2023-06-15 04:15:00,1004,1837,833,831,FALSE,NA,"0.1.4"
"27571","646",2023-06-15 04:30:00,958,1837,879,831,FALSE,NA,"0.1.4"
"27572","646",2023-06-15 04:45:00,930,1837,907,831,FALSE,NA,"0.1.4"
"27573","646",2023-06-15 05:00:00,1005,1837,832,831,FALSE,NA,"0.1.4"
"27574","646",2023-06-15 05:15:00,995,1837,842,831,FALSE,NA,"0.1.4"
"27575","646",2023-06-15 05:30:00,1004,1837,833,831,FALSE,NA,"0.1.4"
"27576","646",2023-06-15 05:45:00,1003,1837,834,831,FALSE,NA,"0.1.4"
"27577","646",2023-06-15 06:00:00,1002,1837,835,831,FALSE,NA,"0.1.4"
"27578","646",2023-06-15 06:15:00,997,1837,840,831,FALSE,NA,"0.1.4"
"27579","646",2023-06-15 06:30:00,926,1837,911,831,FALSE,NA,"0.1.4"
"27580","646",2023-06-15 06:45:00,1002,1837,835,831,FALSE,NA,"0.1.4"
"27581","646",2023-06-15 07:00:00,997,1837,840,831,FALSE,NA,"0.1.4"
"27582","646",2023-06-15 07:15:00,915,1837,922,831,FALSE,NA,"0.1.4"
"27583","646",2023-06-15 07:30:00,975,1837,862,831,FALSE,NA,"0.1.4"
"27584","646",2023-06-15 07:45:00,948,1837,889,831,FALSE,NA,"0.1.4"
"27585","646",2023-06-15 08:00:00,1005,1837,832,831,FALSE,NA,"0.1.4"
"27586","646",2023-06-15 08:15:00,937,1837,900,831,FALSE,NA,"0.1.4"
"27587","646",2023-06-15 08:30:00,889,1837,948,831,FALSE,NA,"0.1.4"
"27588","646",2023-06-15 08:45:00,683,1837,1154,831,FALSE,NA,"0.1.4"
"27589","646",2023-06-15 09:00:00,930,1837,907,831,FALSE,NA,"0.1.4"
"27590","646",2023-06-15 09:15:00,936,1837,901,831,FALSE,NA,"0.1.4"
"27591","646",2023-06-15 09:30:00,719,1837,1118,831,FALSE,NA,"0.1.4"
"27592","646",2023-06-15 09:45:00,548,1837,1289,831,FALSE,NA,"0.1.4"
"27593","646",2023-06-15 10:00:00,638,1837,1199,831,FALSE,NA,"0.1.4"
"27594","646",2023-06-15 10:15:00,885,1837,952,831,FALSE,NA,"0.1.4"
"27595","646",2023-06-15 10:30:00,922,1837,915,831,FALSE,NA,"0.1.4"
"27596","646",2023-06-15 10:45:00,882,1837,955,831,FALSE,NA,"0.1.4"
"27597","646",2023-06-15 11:00:00,885,1837,952,831,FALSE,NA,"0.1.4"
"27598","646",2023-06-15 11:15:00,927,1837,910,831,FALSE,NA,"0.1.4"
"27599","646",2023-06-15 11:30:00,908,1837,929,831,FALSE,NA,"0.1.4"
"27600","646",2023-06-15 11:45:00,869,1837,968,831,FALSE,NA,"0.1.4"
"27601","646",2023-06-15 12:00:00,879,1837,958,831,FALSE,NA,"0.1.4"
"27602","646",2023-06-15 12:15:00,886,1837,951,831,FALSE,NA,"0.1.4"
"27603","646",2023-06-15 12:30:00,890,1837,947,831,FALSE,NA,"0.1.4"
"27604","646",2023-06-15 12:45:00,669,1837,1168,831,FALSE,"out1, fill","0.1.4"
"27605","646",2023-06-15 13:00:00,448,1837,1389,831,FALSE,NA,"0.1.4"
"27606","646",2023-06-15 13:15:00,161,1837,1676,831,FALSE,NA,"0.1.4"
"27607","646",2023-06-15 13:30:00,300,1837,1537,831,FALSE,NA,"0.1.4"
"27608","646",2023-06-15 13:45:00,300,1837,1537,831,FALSE,"jump1","0.1.4"
"27609","646",2023-06-15 14:00:00,300,1837,1537,831,FALSE,"jump1","0.1.4"
"27610","646",2023-06-15 14:15:00,435,1837,1402,831,FALSE,NA,"0.1.4"
"27611","646",2023-06-15 14:30:00,683,1837,1154,831,FALSE,NA,"0.1.4"
"27612","646",2023-06-15 14:45:00,1098,1837,739,831,FALSE,NA,"0.1.4"
"27613","646",2023-06-15 15:00:00,1070,1837,767,831,FALSE,NA,"0.1.4"
"27614","646",2023-06-15 15:15:00,1064,1837,773,831,FALSE,NA,"0.1.4"
"27615","646",2023-06-15 15:30:00,1061,1837,776,831,FALSE,NA,"0.1.4"
"27616","646",2023-06-15 15:45:00,1072,1837,765,831,FALSE,NA,"0.1.4"
"27617","646",2023-06-15 16:00:00,1074,1837,763,831,FALSE,NA,"0.1.4"
"27618","646",2023-06-15 16:15:00,1080,1837,757,831,FALSE,NA,"0.1.4"
"27619","646",2023-06-15 16:30:00,1070,1837,767,831,FALSE,NA,"0.1.4"
"27620","646",2023-06-15 16:45:00,1025,1837,812,831,FALSE,NA,"0.1.4"
"27621","646",2023-06-15 17:00:00,1025,1837,812,831,FALSE,"jump1","0.1.4"
"27622","646",2023-06-15 17:15:00,1025,1837,812,831,FALSE,"jump1","0.1.4"
"27623","646",2023-06-15 17:30:00,625,1837,1212,831,FALSE,NA,"0.1.4"
"27624","646",2023-06-15 17:45:00,735,1837,1102,831,FALSE,NA,"0.1.4"
"27625","646",2023-06-15 18:00:00,1098,1837,739,831,FALSE,NA,"0.1.4"
"27626","646",2023-06-15 18:15:00,1098,1837,739,831,FALSE,"jump1","0.1.4"
"27627","646",2023-06-15 18:30:00,1098,1837,739,831,FALSE,"jump1","0.1.4"
"27628","646",2023-06-15 18:45:00,618,1837,1219,831,FALSE,NA,"0.1.4"
"27629","646",2023-06-15 19:00:00,731,1837,1106,831,FALSE,NA,"0.1.4"
"27630","646",2023-06-15 19:15:00,565,1837,1272,831,FALSE,NA,"0.1.4"
"27631","646",2023-06-15 19:30:00,1048,1837,789,831,FALSE,NA,"0.1.4"
"27632","646",2023-06-15 19:45:00,677,1837,1160,831,FALSE,NA,"0.1.4"
"27633","646",2023-06-15 20:00:00,620,1837,1217,831,FALSE,NA,"0.1.4"
"27634","646",2023-06-15 20:15:00,793,1837,1044,831,FALSE,NA,"0.1.4"
"27635","646",2023-06-15 20:30:00,525,1837,1312,831,FALSE,NA,"0.1.4"
"27636","646",2023-06-15 20:45:00,704,1837,1133,831,FALSE,NA,"0.1.4"
"27637","646",2023-06-15 21:00:00,434,1837,1403,831,FALSE,NA,"0.1.4"
"27638","646",2023-06-15 21:15:00,537,1837,1300,831,FALSE,NA,"0.1.4"
"27639","646",2023-06-15 21:30:00,403,1837,1434,831,FALSE,NA,"0.1.4"
"27640","646",2023-06-15 21:45:00,453,1837,1384,831,FALSE,NA,"0.1.4"
"27641","646",2023-06-15 22:00:00,631,1837,1206,831,FALSE,NA,"0.1.4"
"27642","646",2023-06-15 22:15:00,647,1837,1190,831,FALSE,NA,"0.1.4"
"27643","646",2023-06-15 22:30:00,1014,1837,823,831,FALSE,NA,"0.1.4"
"27644","646",2023-06-15 22:45:00,1023,1837,814,831,FALSE,NA,"0.1.4"
"27645","646",2023-06-15 23:00:00,1075,1837,762,831,FALSE,NA,"0.1.4"
"27646","646",2023-06-15 23:15:00,1075,1837,762,831,FALSE,NA,"0.1.4"
"27647","646",2023-06-15 23:30:00,1056,1837,781,831,FALSE,NA,"0.1.4"
"27648","646",2023-06-15 23:45:00,838,1837,999,831,FALSE,NA,"0.1.4"
"27649","646",2023-06-16,1065,1837,772,831,FALSE,NA,"0.1.4"
"27650","646",2023-06-16 00:15:00,1030,1837,807,831,FALSE,NA,"0.1.4"
"27651","646",2023-06-16 00:30:00,1030,1837,807,831,FALSE,"jump1","0.1.4"
"27652","646",2023-06-16 00:45:00,1144,1837,693,831,FALSE,NA,"0.1.4"
"27653","646",2023-06-16 01:00:00,1405,1837,432,831,FALSE,NA,"0.1.4"
"27654","646",2023-06-16 01:15:00,959,1837,878,831,FALSE,NA,"0.1.4"
"27655","646",2023-06-16 01:30:00,959,1837,878,831,FALSE,"jump1","0.1.4"
"27656","646",2023-06-16 01:45:00,959,1837,878,831,FALSE,"jump1","0.1.4"
"27657","646",2023-06-16 02:00:00,783,1837,1054,831,FALSE,NA,"0.1.4"
"27658","646",2023-06-16 02:15:00,860,1837,977,831,FALSE,NA,"0.1.4"
"27659","646",2023-06-16 02:30:00,764.666666666667,1837,1072.33333333333,831,FALSE,"out1, fill","0.1.4"
"27660","646",2023-06-16 02:45:00,669.333333333333,1837,1167.66666666667,831,FALSE,"out1, fill","0.1.4"
"27661","646",2023-06-16 03:00:00,574,1837,1263,831,FALSE,NA,"0.1.4"
"27662","646",2023-06-16 03:15:00,653,1837,1184,831,FALSE,NA,"0.1.4"
"27663","646",2023-06-16 03:30:00,852,1837,985,831,FALSE,NA,"0.1.4"
"27664","646",2023-06-16 03:45:00,1248.5,1837,588.5,831,FALSE,"out1, fill","0.1.4"
"27665","646",2023-06-16 04:00:00,1645,1837,192,831,FALSE,NA,"0.1.4"
"27666","646",2023-06-16 04:15:00,1645,1837,192,831,FALSE,"jump1","0.1.4"
"27667","646",2023-06-16 04:30:00,1645,1837,192,831,FALSE,"jump1","0.1.4"
"27668","646",2023-06-16 04:45:00,1514.75,1837,322.25,831,FALSE,"out1, fill","0.1.4"
"27669","646",2023-06-16 05:00:00,1384.5,1837,452.5,831,FALSE,"out1, fill","0.1.4"
"27670","646",2023-06-16 05:15:00,1254.25,1837,582.75,831,FALSE,"out1, fill","0.1.4"
"27671","646",2023-06-16 05:30:00,1124,1837,713,831,FALSE,"out1, fill","0.1.4"
"27672","646",2023-06-16 05:45:00,993.75,1837,843.25,831,FALSE,"out1, fill","0.1.4"
"27673","646",2023-06-16 06:00:00,863.5,1837,973.5,831,FALSE,"out1, fill","0.1.4"
"27674","646",2023-06-16 06:15:00,733.25,1837,1103.75,831,FALSE,"out1, fill","0.1.4"
"27675","646",2023-06-16 06:30:00,603,1837,1234,831,FALSE,NA,"0.1.4"
"27676","646",2023-06-16 06:45:00,665,1837,1172,831,FALSE,NA,"0.1.4"
"27677","646",2023-06-16 07:00:00,752,1837,1085,831,FALSE,NA,"0.1.4"
"27678","646",2023-06-16 07:15:00,623,1837,1214,831,FALSE,NA,"0.1.4"
"27679","646",2023-06-16 07:30:00,623,1837,1214,831,FALSE,"jump1","0.1.4"
"27680","646",2023-06-16 07:45:00,623,1837,1214,831,FALSE,"jump1","0.1.4"
"27681","646",2023-06-16 08:00:00,1043,1837,794,831,FALSE,"out1, fill","0.1.4"
"27682","646",2023-06-16 08:15:00,1463,1837,374,831,FALSE,NA,"0.1.4"
"27683","646",2023-06-16 08:30:00,1724,1837,113,831,FALSE,NA,"0.1.4"
"27684","646",2023-06-16 08:45:00,1782,1837,55,831,FALSE,NA,"0.1.4"
"27685","646",2023-06-16 09:00:00,1782,1837,55,831,FALSE,NA,"0.1.4"
"27686","646",2023-06-16 09:15:00,1375,1837,462,831,FALSE,NA,"0.1.4"
"27687","646",2023-06-16 09:30:00,1175,1837,662,831,FALSE,NA,"0.1.4"
"27688","646",2023-06-16 09:45:00,863,1837,974,831,FALSE,NA,"0.1.4"
"27689","646",2023-06-16 10:00:00,1076.5,1837,760.5,831,FALSE,"out1, fill","0.1.4"
"27690","646",2023-06-16 10:15:00,1290,1837,547,831,FALSE,NA,"0.1.4"
"27691","646",2023-06-16 10:30:00,1290,1837,547,831,FALSE,"jump1","0.1.4"
"27692","646",2023-06-16 10:45:00,1290,1837,547,831,FALSE,"jump1","0.1.4"
"27693","646",2023-06-16 11:00:00,1753,1837,84,831,FALSE,NA,"0.1.4"
"27694","646",2023-06-16 11:15:00,1753,1837,84,831,FALSE,"jump1","0.1.4"
"27695","646",2023-06-16 11:30:00,1753,1837,84,831,FALSE,"jump1","0.1.4"
"27696","646",2023-06-16 11:45:00,1731.66666666667,1837,105.333333333333,831,FALSE,"out1, fill","0.1.4"
"27697","646",2023-06-16 12:00:00,1710.33333333333,1837,126.666666666667,831,FALSE,"out1, fill","0.1.4"
"27698","646",2023-06-16 12:15:00,1689,1837,148,831,FALSE,NA,"0.1.4"
"27699","646",2023-06-16 12:30:00,1297,1837,540,831,FALSE,NA,"0.1.4"
"27700","646",2023-06-16 12:45:00,1781,1837,56,831,FALSE,NA,"0.1.4"
"27701","646",2023-06-16 13:00:00,1647,1837,190,831,FALSE,NA,"0.1.4"
"27702","646",2023-06-16 13:15:00,1692,1837,145,831,FALSE,"out1, fill","0.1.4"
"27703","646",2023-06-16 13:30:00,1737,1837,100,831,FALSE,"out1, fill","0.1.4"
"27704","646",2023-06-16 13:45:00,1782,1837,55,831,FALSE,NA,"0.1.4"
"27705","646",2023-06-16 14:00:00,1781,1837,56,831,FALSE,NA,"0.1.4"
"27706","646",2023-06-16 14:15:00,1781,1837,56,831,FALSE,NA,"0.1.4"
"27707","646",2023-06-16 14:30:00,1778,1837,59,831,FALSE,NA,"0.1.4"
"27708","646",2023-06-16 14:45:00,1779,1837,58,831,FALSE,NA,"0.1.4"
"27709","646",2023-06-16 15:00:00,1778,1837,59,831,FALSE,NA,"0.1.4"
"27710","646",2023-06-16 15:15:00,1778,1837,59,831,FALSE,NA,"0.1.4"
"27711","646",2023-06-16 15:30:00,1777,1837,60,831,FALSE,NA,"0.1.4"
"27712","646",2023-06-16 15:45:00,1775,1837,62,831,FALSE,NA,"0.1.4"
"27713","646",2023-06-16 16:00:00,1776,1837,61,831,FALSE,NA,"0.1.4"
"27714","646",2023-06-16 16:15:00,1775,1837,62,831,FALSE,NA,"0.1.4"
"27715","646",2023-06-16 16:30:00,1775,1837,62,831,FALSE,NA,"0.1.4"
"27716","646",2023-06-16 16:45:00,1774,1837,63,831,FALSE,NA,"0.1.4"
"27717","646",2023-06-16 17:00:00,1774,1837,63,831,FALSE,NA,"0.1.4"
"27718","646",2023-06-16 17:15:00,1766,1837,71,831,FALSE,NA,"0.1.4"
"27719","646",2023-06-16 17:30:00,1780,1837,57,831,FALSE,NA,"0.1.4"
"27720","646",2023-06-16 17:45:00,1697,1837,140,831,FALSE,NA,"0.1.4"
"27721","646",2023-06-16 18:00:00,1754,1837,83,831,FALSE,NA,"0.1.4"
"27722","646",2023-06-16 18:15:00,1602,1837,235,831,FALSE,NA,"0.1.4"
"27723","646",2023-06-16 18:30:00,1726,1837,111,831,FALSE,NA,"0.1.4"
"27724","646",2023-06-16 18:45:00,1586,1837,251,831,FALSE,NA,"0.1.4"
"27725","646",2023-06-16 19:00:00,1754,1837,83,831,FALSE,NA,"0.1.4"
"27726","646",2023-06-16 19:15:00,1755,1837,82,831,FALSE,NA,"0.1.4"
"27727","646",2023-06-16 19:30:00,1759,1837,78,831,FALSE,NA,"0.1.4"
"27728","646",2023-06-16 19:45:00,1771,1837,66,831,FALSE,NA,"0.1.4"
"27729","646",2023-06-16 20:00:00,1779,1837,58,831,FALSE,NA,"0.1.4"
"27730","646",2023-06-16 20:15:00,1758,1837,79,831,FALSE,NA,"0.1.4"
"27731","646",2023-06-16 20:30:00,1765,1837,72,831,FALSE,NA,"0.1.4"
"27732","646",2023-06-16 20:45:00,1749,1837,88,831,FALSE,NA,"0.1.4"
"27733","646",2023-06-16 21:00:00,1779,1837,58,831,FALSE,NA,"0.1.4"
"27734","646",2023-06-16 21:15:00,1777,1837,60,831,FALSE,NA,"0.1.4"
"27735","646",2023-06-16 21:30:00,1775,1837,62,831,FALSE,NA,"0.1.4"
"27736","646",2023-06-16 21:45:00,1771,1837,66,831,FALSE,NA,"0.1.4"
"27737","646",2023-06-16 22:00:00,1767,1837,70,831,FALSE,NA,"0.1.4"
"27738","646",2023-06-16 22:15:00,1763,1837,74,831,FALSE,NA,"0.1.4"
"27739","646",2023-06-16 22:30:00,1762,1837,75,831,FALSE,NA,"0.1.4"
"27740","646",2023-06-16 22:45:00,1763,1837,74,831,FALSE,NA,"0.1.4"
"27741","646",2023-06-16 23:00:00,1764,1837,73,831,FALSE,NA,"0.1.4"
"27742","646",2023-06-16 23:15:00,1763,1837,74,831,FALSE,NA,"0.1.4"
"27743","646",2023-06-16 23:30:00,1762,1837,75,831,FALSE,NA,"0.1.4"
"27744","646",2023-06-16 23:45:00,1762,1837,75,831,FALSE,NA,"0.1.4"
"27745","646",2023-06-17,1763,1837,74,831,FALSE,NA,"0.1.4"
"27746","646",2023-06-17 00:15:00,1774,1837,63,831,FALSE,NA,"0.1.4"
"27747","646",2023-06-17 00:30:00,1759,1837,78,831,FALSE,NA,"0.1.4"
"27748","646",2023-06-17 00:45:00,1759,1837,78,831,FALSE,NA,"0.1.4"
"27749","646",2023-06-17 01:00:00,1760,1837,77,831,FALSE,NA,"0.1.4"
"27750","646",2023-06-17 01:15:00,1769,1837,68,831,FALSE,NA,"0.1.4"
"27751","646",2023-06-17 01:30:00,1759,1837,78,831,FALSE,NA,"0.1.4"
"27752","646",2023-06-17 01:45:00,1761,1837,76,831,FALSE,NA,"0.1.4"
"27753","646",2023-06-17 02:00:00,1761,1837,76,831,FALSE,NA,"0.1.4"
"27754","646",2023-06-17 02:15:00,1761,1837,76,831,FALSE,NA,"0.1.4"
"27755","646",2023-06-17 02:30:00,1764,1837,73,831,FALSE,NA,"0.1.4"
"27756","646",2023-06-17 02:45:00,1765,1837,72,831,FALSE,NA,"0.1.4"
"27757","646",2023-06-17 03:00:00,1771,1837,66,831,FALSE,NA,"0.1.4"
"27758","646",2023-06-17 03:15:00,1775,1837,62,831,FALSE,NA,"0.1.4"
"27759","646",2023-06-17 03:30:00,1770,1837,67,831,FALSE,NA,"0.1.4"
"27760","646",2023-06-17 03:45:00,1761,1837,76,831,FALSE,NA,"0.1.4"
"27761","646",2023-06-17 04:00:00,1774,1837,63,831,FALSE,NA,"0.1.4"
"27762","646",2023-06-17 04:15:00,1776,1837,61,831,FALSE,NA,"0.1.4"
"27763","646",2023-06-17 04:30:00,1781,1837,56,831,FALSE,NA,"0.1.4"
"27764","646",2023-06-17 04:45:00,1774,1837,63,831,FALSE,NA,"0.1.4"
"27765","646",2023-06-17 05:00:00,1778,1837,59,831,FALSE,NA,"0.1.4"
"27766","646",2023-06-17 05:15:00,1777,1837,60,831,FALSE,NA,"0.1.4"
"27767","646",2023-06-17 05:30:00,1771,1837,66,831,FALSE,NA,"0.1.4"
"27768","646",2023-06-17 05:45:00,1775,1837,62,831,FALSE,NA,"0.1.4"
"27769","646",2023-06-17 06:00:00,1776,1837,61,831,FALSE,NA,"0.1.4"
"27770","646",2023-06-17 06:15:00,1767,1837,70,831,FALSE,NA,"0.1.4"
"27771","646",2023-06-17 06:30:00,1772,1837,65,831,FALSE,NA,"0.1.4"
"27772","646",2023-06-17 06:45:00,1774,1837,63,831,FALSE,NA,"0.1.4"
"27773","646",2023-06-17 07:00:00,1776,1837,61,831,FALSE,NA,"0.1.4"
"27774","646",2023-06-17 07:15:00,1782,1837,55,831,FALSE,NA,"0.1.4"
"27775","646",2023-06-17 07:30:00,1781,1837,56,831,FALSE,NA,"0.1.4"
"27776","646",2023-06-17 07:45:00,1782,1837,55,831,FALSE,NA,"0.1.4"
"27777","646",2023-06-17 08:00:00,1782,1837,55,831,FALSE,NA,"0.1.4"
"27778","646",2023-06-17 08:15:00,1782,1837,55,831,FALSE,NA,"0.1.4"
"27779","646",2023-06-17 08:30:00,1376,1837,461,831,FALSE,NA,"0.1.4"
"27780","646",2023-06-17 08:45:00,1779,1837,58,831,FALSE,NA,"0.1.4"
"27781","646",2023-06-17 09:00:00,1777,1837,60,831,FALSE,NA,"0.1.4"
"27782","646",2023-06-17 09:15:00,1778,1837,59,831,FALSE,NA,"0.1.4"
"27783","646",2023-06-17 09:30:00,1774,1837,63,831,FALSE,NA,"0.1.4"
"27784","646",2023-06-17 09:45:00,1777,1837,60,831,FALSE,NA,"0.1.4"
"27785","646",2023-06-17 10:00:00,1783,1837,54,831,FALSE,NA,"0.1.4"
"27786","646",2023-06-17 10:15:00,1792,1837,45,831,FALSE,NA,"0.1.4"
"27787","646",2023-06-17 10:30:00,1778,1837,59,831,FALSE,NA,"0.1.4"
"27788","646",2023-06-17 10:45:00,1795,1837,42,831,FALSE,NA,"0.1.4"
"27789","646",2023-06-17 11:00:00,1778,1837,59,831,FALSE,NA,"0.1.4"
"27790","646",2023-06-17 11:15:00,1779,1837,58,831,FALSE,NA,"0.1.4"
"27791","646",2023-06-17 11:30:00,1785,1837,52,831,FALSE,NA,"0.1.4"
"27792","646",2023-06-17 11:45:00,1797,1837,40,831,FALSE,NA,"0.1.4"
"27793","646",2023-06-17 12:00:00,1780,1837,57,831,FALSE,NA,"0.1.4"
"27794","646",2023-06-17 12:15:00,1779,1837,58,831,FALSE,NA,"0.1.4"
"27795","646",2023-06-17 12:30:00,1787,1837,50,831,FALSE,NA,"0.1.4"
"27796","646",2023-06-17 12:45:00,1787,1837,50,831,FALSE,NA,"0.1.4"
"27797","646",2023-06-17 13:00:00,1778,1837,59,831,FALSE,NA,"0.1.4"
"27798","646",2023-06-17 13:15:00,1797,1837,40,831,FALSE,NA,"0.1.4"
"27799","646",2023-06-17 13:30:00,1796,1837,41,831,FALSE,NA,"0.1.4"
"27800","646",2023-06-17 13:45:00,1793,1837,44,831,FALSE,NA,"0.1.4"
"27801","646",2023-06-17 14:00:00,1785,1837,52,831,FALSE,NA,"0.1.4"
"27802","646",2023-06-17 14:15:00,1786,1837,51,831,FALSE,NA,"0.1.4"
"27803","646",2023-06-17 14:30:00,1785,1837,52,831,FALSE,NA,"0.1.4"
"27804","646",2023-06-17 14:45:00,1802,1837,35,831,FALSE,NA,"0.1.4"
"27805","646",2023-06-17 15:00:00,1801,1837,36,831,FALSE,NA,"0.1.4"
"27806","646",2023-06-17 15:15:00,1805,1837,32,831,FALSE,NA,"0.1.4"
"27807","646",2023-06-17 15:30:00,1792,1837,45,831,FALSE,NA,"0.1.4"
"27808","646",2023-06-17 15:45:00,1794,1837,43,831,FALSE,NA,"0.1.4"
"27809","646",2023-06-17 16:00:00,1791,1837,46,831,FALSE,NA,"0.1.4"
"27810","646",2023-06-17 16:15:00,1796,1837,41,831,FALSE,NA,"0.1.4"
"27811","646",2023-06-17 16:30:00,1798,1837,39,831,FALSE,NA,"0.1.4"
"27812","646",2023-06-17 16:45:00,1799,1837,38,831,FALSE,NA,"0.1.4"
"27813","646",2023-06-17 17:00:00,1799,1837,38,831,FALSE,NA,"0.1.4"
"27814","646",2023-06-17 17:15:00,1802,1837,35,831,FALSE,NA,"0.1.4"
"27815","646",2023-06-17 17:30:00,1802,1837,35,831,FALSE,NA,"0.1.4"
"27816","646",2023-06-17 17:45:00,1803,1837,34,831,FALSE,NA,"0.1.4"
"27817","646",2023-06-17 18:00:00,1801,1837,36,831,FALSE,NA,"0.1.4"
"27818","646",2023-06-17 18:15:00,1799,1837,38,831,FALSE,NA,"0.1.4"
"27819","646",2023-06-17 18:30:00,1798,1837,39,831,FALSE,NA,"0.1.4"
"27820","646",2023-06-17 18:45:00,1783,1837,54,831,FALSE,NA,"0.1.4"
"27821","646",2023-06-17 19:00:00,1775,1837,62,831,FALSE,NA,"0.1.4"
"27822","646",2023-06-17 19:15:00,1775,1837,62,831,FALSE,NA,"0.1.4"
"27823","646",2023-06-17 19:30:00,1778,1837,59,831,FALSE,NA,"0.1.4"
"27824","646",2023-06-17 19:45:00,1770,1837,67,831,FALSE,NA,"0.1.4"
"27825","646",2023-06-17 20:00:00,1771,1837,66,831,FALSE,NA,"0.1.4"
"27826","646",2023-06-17 20:15:00,1771,1837,66,831,FALSE,NA,"0.1.4"
"27827","646",2023-06-17 20:30:00,1772,1837,65,831,FALSE,NA,"0.1.4"
"27828","646",2023-06-17 20:45:00,1772,1837,65,831,FALSE,NA,"0.1.4"
"27829","646",2023-06-17 21:00:00,1772,1837,65,831,FALSE,NA,"0.1.4"
"27830","646",2023-06-17 21:15:00,1773,1837,64,831,FALSE,NA,"0.1.4"
"27831","646",2023-06-17 21:30:00,1774,1837,63,831,FALSE,NA,"0.1.4"
"27832","646",2023-06-17 21:45:00,1774,1837,63,831,FALSE,NA,"0.1.4"
"27833","646",2023-06-17 22:00:00,1772,1837,65,831,FALSE,NA,"0.1.4"
"27834","646",2023-06-17 22:15:00,1772,1837,65,831,FALSE,NA,"0.1.4"
"27835","646",2023-06-17 22:30:00,1772,1837,65,831,FALSE,NA,"0.1.4"
"27836","646",2023-06-17 22:45:00,1772,1837,65,831,FALSE,NA,"0.1.4"
"27837","646",2023-06-17 23:00:00,1771,1837,66,831,FALSE,NA,"0.1.4"
"27838","646",2023-06-17 23:15:00,1769,1837,68,831,FALSE,NA,"0.1.4"
"27839","646",2023-06-17 23:30:00,1769,1837,68,831,FALSE,NA,"0.1.4"
"27840","646",2023-06-17 23:45:00,1769,1837,68,831,FALSE,NA,"0.1.4"
"27841","646",2023-06-18,1769,1837,68,831,FALSE,NA,"0.1.4"
"27842","646",2023-06-18 00:15:00,1769,1837,68,831,FALSE,NA,"0.1.4"
"27843","646",2023-06-18 00:30:00,1777,1837,60,831,FALSE,NA,"0.1.4"
"27844","646",2023-06-18 00:45:00,1790,1837,47,831,FALSE,NA,"0.1.4"
"27845","646",2023-06-18 01:00:00,1786,1837,51,831,FALSE,NA,"0.1.4"
"27846","646",2023-06-18 01:15:00,1793,1837,44,831,FALSE,NA,"0.1.4"
"27847","646",2023-06-18 01:30:00,1794,1837,43,831,FALSE,NA,"0.1.4"
"27848","646",2023-06-18 01:45:00,1774,1837,63,831,FALSE,NA,"0.1.4"
"27849","646",2023-06-18 02:00:00,1789,1837,48,831,FALSE,NA,"0.1.4"
"27850","646",2023-06-18 02:15:00,1790,1837,47,831,FALSE,NA,"0.1.4"
"27851","646",2023-06-18 02:30:00,1806,1837,31,831,FALSE,NA,"0.1.4"
"27852","646",2023-06-18 02:45:00,1790,1837,47,831,FALSE,NA,"0.1.4"
"27853","646",2023-06-18 03:00:00,1798,1837,39,831,FALSE,NA,"0.1.4"
"27854","646",2023-06-18 03:15:00,1796,1837,41,831,FALSE,NA,"0.1.4"
"27855","646",2023-06-18 03:30:00,1799,1837,38,831,FALSE,NA,"0.1.4"
"27856","646",2023-06-18 03:45:00,1796,1837,41,831,FALSE,NA,"0.1.4"
"27857","646",2023-06-18 04:00:00,1794,1837,43,831,FALSE,NA,"0.1.4"
"27858","646",2023-06-18 04:15:00,1791,1837,46,831,FALSE,NA,"0.1.4"
"27859","646",2023-06-18 04:30:00,1804,1837,33,831,FALSE,NA,"0.1.4"
"27860","646",2023-06-18 04:45:00,1805,1837,32,831,FALSE,NA,"0.1.4"
"27861","646",2023-06-18 05:00:00,1793,1837,44,831,FALSE,NA,"0.1.4"
"27862","646",2023-06-18 05:15:00,1821,1837,16,831,FALSE,NA,"0.1.4"
"27863","646",2023-06-18 05:30:00,1814,1837,23,831,FALSE,NA,"0.1.4"
"27864","646",2023-06-18 05:45:00,1795,1837,42,831,FALSE,NA,"0.1.4"
"27865","646",2023-06-18 06:00:00,1793,1837,44,831,FALSE,NA,"0.1.4"
"27866","646",2023-06-18 06:15:00,1799,1837,38,831,FALSE,NA,"0.1.4"
"27867","646",2023-06-18 06:30:00,1800,1837,37,831,FALSE,NA,"0.1.4"
"27868","646",2023-06-18 06:45:00,1798,1837,39,831,FALSE,NA,"0.1.4"
"27869","646",2023-06-18 07:00:00,1797,1837,40,831,FALSE,NA,"0.1.4"
"27870","646",2023-06-18 07:15:00,1783,1837,54,831,FALSE,NA,"0.1.4"
"27871","646",2023-06-18 07:30:00,1804,1837,33,831,FALSE,NA,"0.1.4"
"27872","646",2023-06-18 07:45:00,1791,1837,46,831,FALSE,NA,"0.1.4"
"27873","646",2023-06-18 08:00:00,1794.6,1837,42.4000000000001,831,FALSE,"out1, fill","0.1.4"
"27874","646",2023-06-18 08:15:00,1798.2,1837,38.8,831,FALSE,"out1, fill","0.1.4"
"27875","646",2023-06-18 08:30:00,1801.8,1837,35.2,831,FALSE,"out1, fill","0.1.4"
"27876","646",2023-06-18 08:45:00,1805.4,1837,31.5999999999999,831,FALSE,"out1, fill","0.1.4"
"27877","646",2023-06-18 09:00:00,1809,1837,28,831,FALSE,NA,"0.1.4"
"27878","646",2023-06-18 09:15:00,1792,1837,45,831,FALSE,NA,"0.1.4"
"27879","646",2023-06-18 09:30:00,1809,1837,28,831,FALSE,NA,"0.1.4"
"27880","646",2023-06-18 09:45:00,1805,1837,32,831,FALSE,NA,"0.1.4"
"27881","646",2023-06-18 10:00:00,1806,1837,31,831,FALSE,NA,"0.1.4"
"27882","646",2023-06-18 10:15:00,1704,1837,133,831,FALSE,NA,"0.1.4"
"27883","646",2023-06-18 10:30:00,1794,1837,43,831,FALSE,NA,"0.1.4"
"27884","646",2023-06-18 10:45:00,1811,1837,26,831,FALSE,NA,"0.1.4"
"27885","646",2023-06-18 11:00:00,1808,1837,29,831,FALSE,NA,"0.1.4"
"27886","646",2023-06-18 11:15:00,1810,1837,27,831,FALSE,NA,"0.1.4"
"27887","646",2023-06-18 11:30:00,1764,1837,73,831,FALSE,NA,"0.1.4"
"27888","646",2023-06-18 11:45:00,1625,1837,212,831,FALSE,NA,"0.1.4"
"27889","646",2023-06-18 12:00:00,1544,1837,293,831,FALSE,NA,"0.1.4"
"27890","646",2023-06-18 12:15:00,1803,1837,34,831,FALSE,NA,"0.1.4"
"27891","646",2023-06-18 12:30:00,1570,1837,267,831,FALSE,NA,"0.1.4"
"27892","646",2023-06-18 12:45:00,1729,1837,108,831,FALSE,NA,"0.1.4"
"27893","646",2023-06-18 13:00:00,1815,1837,22,831,FALSE,NA,"0.1.4"
"27894","646",2023-06-18 13:15:00,1810,1837,27,831,FALSE,NA,"0.1.4"
"27895","646",2023-06-18 13:30:00,1746,1837,91,831,FALSE,NA,"0.1.4"
"27896","646",2023-06-18 13:45:00,1813,1837,24,831,FALSE,NA,"0.1.4"
"27897","646",2023-06-18 14:00:00,1815,1837,22,831,FALSE,NA,"0.1.4"
"27898","646",2023-06-18 14:15:00,1793,1837,44,831,FALSE,NA,"0.1.4"
"27899","646",2023-06-18 14:30:00,1811,1837,26,831,FALSE,NA,"0.1.4"
"27900","646",2023-06-18 14:45:00,1814,1837,23,831,FALSE,NA,"0.1.4"
"27901","646",2023-06-18 15:00:00,1813,1837,24,831,FALSE,NA,"0.1.4"
"27902","646",2023-06-18 15:15:00,1813,1837,24,831,FALSE,NA,"0.1.4"
"27903","646",2023-06-18 15:30:00,1813,1837,24,831,FALSE,NA,"0.1.4"
"27904","646",2023-06-18 15:45:00,1813,1837,24,831,FALSE,NA,"0.1.4"
"27905","646",2023-06-18 16:00:00,1814,1837,23,831,FALSE,NA,"0.1.4"
"27906","646",2023-06-18 16:15:00,1824,1837,13,831,FALSE,NA,"0.1.4"
"27907","646",2023-06-18 16:30:00,1858,1858,0,852,FALSE,NA,"0.1.4"
"27908","646",2023-06-18 16:45:00,1867,1867,0,861,FALSE,NA,"0.1.4"
"27909","646",2023-06-18 17:00:00,1894,1894,0,888,FALSE,NA,"0.1.4"
"27910","646",2023-06-18 17:15:00,1883,1894,11,888,FALSE,NA,"0.1.4"
"27911","646",2023-06-18 17:30:00,1885,1894,9,888,FALSE,NA,"0.1.4"
"27912","646",2023-06-18 17:45:00,1865,1894,29,888,FALSE,NA,"0.1.4"
"27913","646",2023-06-18 18:00:00,1880,1894,14,888,FALSE,NA,"0.1.4"
"27914","646",2023-06-18 18:15:00,1913,1913,0,907,FALSE,NA,"0.1.4"
"27915","646",2023-06-18 18:30:00,1858,1913,55,907,FALSE,NA,"0.1.4"
"27916","646",2023-06-18 18:45:00,1795,1913,118,907,FALSE,NA,"0.1.4"
"27917","646",2023-06-18 19:00:00,1813,1913,100,907,FALSE,NA,"0.1.4"
"27918","646",2023-06-18 19:15:00,1812,1913,101,907,FALSE,NA,"0.1.4"
"27919","646",2023-06-18 19:30:00,1744.66666666667,1913,168.333333333333,907,FALSE,"out1, fill","0.1.4"
"27920","646",2023-06-18 19:45:00,1677.33333333333,1913,235.666666666667,907,FALSE,"out1, fill","0.1.4"
"27921","646",2023-06-18 20:00:00,1610,1913,303,907,FALSE,NA,"0.1.4"
"27922","646",2023-06-18 20:15:00,1730,1913,183,907,FALSE,NA,"0.1.4"
"27923","646",2023-06-18 20:30:00,1796,1913,117,907,FALSE,NA,"0.1.4"
"27924","646",2023-06-18 20:45:00,1803,1913,110,907,FALSE,NA,"0.1.4"
"27925","646",2023-06-18 21:00:00,1809,1913,104,907,FALSE,NA,"0.1.4"
"27926","646",2023-06-18 21:15:00,1813,1913,100,907,FALSE,NA,"0.1.4"
"27927","646",2023-06-18 21:30:00,1813,1913,100,907,FALSE,NA,"0.1.4"
"27928","646",2023-06-18 21:45:00,1813,1913,100,907,FALSE,NA,"0.1.4"
"27929","646",2023-06-18 22:00:00,1813,1913,100,907,FALSE,NA,"0.1.4"
"27930","646",2023-06-18 22:15:00,1813,1913,100,907,FALSE,NA,"0.1.4"
"27931","646",2023-06-18 22:30:00,1809,1913,104,907,FALSE,NA,"0.1.4"
"27932","646",2023-06-18 22:45:00,1813,1913,100,907,FALSE,NA,"0.1.4"
"27933","646",2023-06-18 23:00:00,1813,1913,100,907,FALSE,NA,"0.1.4"
"27934","646",2023-06-18 23:15:00,1813,1913,100,907,FALSE,NA,"0.1.4"
"27935","646",2023-06-18 23:30:00,1815,1913,98,907,FALSE,NA,"0.1.4"
"27936","646",2023-06-18 23:45:00,1819,1913,94,907,FALSE,NA,"0.1.4"
"27937","646",2023-06-19,1814,1913,99,907,FALSE,NA,"0.1.4"
"27938","646",2023-06-19 00:15:00,1809,1913,104,907,FALSE,NA,"0.1.4"
"27939","646",2023-06-19 00:30:00,1806,1913,107,907,FALSE,NA,"0.1.4"
"27940","646",2023-06-19 00:45:00,1805,1913,108,907,FALSE,NA,"0.1.4"
"27941","646",2023-06-19 01:00:00,1810,1913,103,907,FALSE,NA,"0.1.4"
"27942","646",2023-06-19 01:15:00,1811,1913,102,907,FALSE,NA,"0.1.4"
"27943","646",2023-06-19 01:30:00,1811,1913,102,907,FALSE,NA,"0.1.4"
"27944","646",2023-06-19 01:45:00,1813,1913,100,907,FALSE,NA,"0.1.4"
"27945","646",2023-06-19 02:00:00,1814,1913,99,907,FALSE,NA,"0.1.4"
"27946","646",2023-06-19 02:15:00,1814,1913,99,907,FALSE,NA,"0.1.4"
"27947","646",2023-06-19 02:30:00,1812,1913,101,907,FALSE,NA,"0.1.4"
"27948","646",2023-06-19 02:45:00,1631,1913,282,907,FALSE,NA,"0.1.4"
"27949","646",2023-06-19 03:00:00,1260,1913,653,907,FALSE,NA,"0.1.4"
"27950","646",2023-06-19 03:15:00,1260,1913,653,907,FALSE,"jump1","0.1.4"
"27951","646",2023-06-19 03:30:00,1260,1913,653,907,FALSE,NA,"0.1.4"
"27952","646",2023-06-19 03:45:00,1265,1913,648,907,FALSE,NA,"0.1.4"
"27953","646",2023-06-19 04:00:00,1265,1913,648,907,FALSE,NA,"0.1.4"
"27954","646",2023-06-19 04:15:00,958.75,1913,954.25,907,FALSE,"out1, fill","0.1.4"
"27955","646",2023-06-19 04:30:00,652.5,1913,1260.5,907,FALSE,"out1, fill","0.1.4"
"27956","646",2023-06-19 04:45:00,346.25,1913,1566.75,907,FALSE,"out1, fill","0.1.4"
"27957","646",2023-06-19 05:00:00,40,1913,1873,907,FALSE,NA,"0.1.4"
"27958","646",2023-06-19 05:15:00,-168,1913,2081,907,FALSE,NA,"0.1.4"
"27959","646",2023-06-19 05:30:00,-132,1913,2045,907,FALSE,NA,"0.1.4"
"27960","646",2023-06-19 05:45:00,-241,1913,2154,907,FALSE,NA,"0.1.4"
"27961","646",2023-06-19 06:00:00,-208,1913,2121,907,FALSE,NA,"0.1.4"
"27962","646",2023-06-19 06:15:00,-188,1913,2101,907,FALSE,NA,"0.1.4"
"27963","646",2023-06-19 06:30:00,-21,1913,1934,907,FALSE,NA,"0.1.4"
"27964","646",2023-06-19 06:45:00,-149,1913,2062,907,FALSE,NA,"0.1.4"
"27965","646",2023-06-19 07:00:00,0,1913,1913,907,FALSE,NA,"0.1.4"
"27966","646",2023-06-19 07:15:00,-10,1913,1923,907,FALSE,NA,"0.1.4"
"27967","646",2023-06-19 07:30:00,-10,1913,1923,907,FALSE,"out1, fill","0.1.4"
"27968","646",2023-06-19 07:45:00,-10,1913,1923,907,FALSE,"jump1","0.1.4"
"27969","646",2023-06-19 08:00:00,15,1913,1898,907,FALSE,NA,"0.1.4"
"27970","646",2023-06-19 08:15:00,15,1913,1898,907,FALSE,NA,"0.1.4"
"27971","646",2023-06-19 08:30:00,10,1913,1903,907,FALSE,NA,"0.1.4"
"27972","646",2023-06-19 08:45:00,-58,1913,1971,907,FALSE,NA,"0.1.4"
"27973","646",2023-06-19 09:00:00,-101,1913,2014,907,FALSE,NA,"0.1.4"
"27974","646",2023-06-19 09:15:00,-59,1913,1972,907,FALSE,NA,"0.1.4"
"27975","646",2023-06-19 09:30:00,-56,1913,1969,907,FALSE,NA,"0.1.4"
"27976","646",2023-06-19 09:45:00,-58,1913,1971,907,FALSE,NA,"0.1.4"
"27977","646",2023-06-19 10:00:00,-51,1913,1964,907,FALSE,NA,"0.1.4"
"27978","646",2023-06-19 10:15:00,-52,1913,1965,907,FALSE,NA,"0.1.4"
"27979","646",2023-06-19 10:30:00,-50,1913,1963,907,FALSE,NA,"0.1.4"
"27980","646",2023-06-19 10:45:00,-45,1913,1958,907,FALSE,NA,"0.1.4"
"27981","646",2023-06-19 11:00:00,-58,1913,1971,907,FALSE,NA,"0.1.4"
"27982","646",2023-06-19 11:15:00,-58,1913,1971,907,FALSE,NA,"0.1.4"
"27983","646",2023-06-19 11:30:00,-58,1913,1971,907,FALSE,NA,"0.1.4"
"27984","646",2023-06-19 11:45:00,-151,1913,2064,907,FALSE,NA,"0.1.4"
"27985","646",2023-06-19 12:00:00,-171,1913,2084,907,FALSE,NA,"0.1.4"
"27986","646",2023-06-19 12:15:00,-111,1913,2024,907,FALSE,NA,"0.1.4"
"27987","646",2023-06-19 12:30:00,-57,1913,1970,907,FALSE,NA,"0.1.4"
"27988","646",2023-06-19 12:45:00,-48,1913,1961,907,FALSE,NA,"0.1.4"
"27989","646",2023-06-19 13:00:00,-70,1913,1983,907,FALSE,NA,"0.1.4"
"27990","646",2023-06-19 13:15:00,-270,1913,2183,907,FALSE,NA,"0.1.4"
"27991","646",2023-06-19 13:30:00,-178,1913,2091,907,FALSE,"out1, fill","0.1.4"
"27992","646",2023-06-19 13:45:00,-86,1913,1999,907,FALSE,"out1, fill","0.1.4"
"27993","646",2023-06-19 14:00:00,6,1913,1907,907,FALSE,NA,"0.1.4"
"27994","646",2023-06-19 14:15:00,-14,1913,1927,907,FALSE,NA,"0.1.4"
"27995","646",2023-06-19 14:30:00,-228,1913,2141,907,FALSE,NA,"0.1.4"
"27996","646",2023-06-19 14:45:00,-16,1913,1929,907,FALSE,NA,"0.1.4"
"27997","646",2023-06-19 15:00:00,-34.7142857142857,1913,1947.71428571429,907,FALSE,"out1, fill","0.1.4"
"27998","646",2023-06-19 15:15:00,-53.4285714285714,1913,1966.42857142857,907,FALSE,"out1, fill","0.1.4"
"27999","646",2023-06-19 15:30:00,-72.1428571428571,1913,1985.14285714286,907,FALSE,"out1, fill","0.1.4"
"28000","646",2023-06-19 15:45:00,-90.8571428571428,1913,2003.85714285714,907,FALSE,"out1, fill","0.1.4"
"28001","646",2023-06-19 16:00:00,-109.571428571429,1913,2022.57142857143,907,FALSE,"out1, fill","0.1.4"
"28002","646",2023-06-19 16:15:00,-128.285714285714,1913,2041.28571428571,907,FALSE,"out1, fill","0.1.4"
"28003","646",2023-06-19 16:30:00,-147,1913,2060,907,FALSE,NA,"0.1.4"
"28004","646",2023-06-19 16:45:00,27,1913,1886,907,FALSE,NA,"0.1.4"
"28005","646",2023-06-19 17:00:00,-156,1913,2069,907,FALSE,NA,"0.1.4"
"28006","646",2023-06-19 17:15:00,-58,1913,1971,907,FALSE,NA,"0.1.4"
"28007","646",2023-06-19 17:30:00,-47,1913,1960,907,FALSE,NA,"0.1.4"
"28008","646",2023-06-19 17:45:00,-5,1913,1918,907,FALSE,NA,"0.1.4"
"28009","646",2023-06-19 18:00:00,-5,1913,1918,907,FALSE,"jump1","0.1.4"
"28010","646",2023-06-19 18:15:00,-362,1913,2275,907,FALSE,NA,"0.1.4"
"28011","646",2023-06-19 18:30:00,-274,1913,2187,907,FALSE,NA,"0.1.4"
"28012","646",2023-06-19 18:45:00,28,1913,1885,907,FALSE,NA,"0.1.4"
"28013","646",2023-06-19 19:00:00,28,1913,1885,907,FALSE,"jump1","0.1.4"
"28014","646",2023-06-19 19:15:00,-113,1913,2026,907,FALSE,"out1, fill","0.1.4"
"28015","646",2023-06-19 19:30:00,-254,1913,2167,907,FALSE,NA,"0.1.4"
"28016","646",2023-06-19 19:45:00,-689,1913,2602,907,FALSE,NA,"0.1.4"
"28017","646",2023-06-19 20:00:00,-721,1913,2634,907,FALSE,NA,"0.1.4"
"28018","646",2023-06-19 20:15:00,-519,1913,2432,907,FALSE,NA,"0.1.4"
"28019","646",2023-06-19 20:30:00,-159,1913,2072,907,FALSE,NA,"0.1.4"
"28020","646",2023-06-19 20:45:00,-473,1913,2386,907,FALSE,NA,"0.1.4"
"28021","646",2023-06-19 21:00:00,-349,1913,2262,907,FALSE,NA,"0.1.4"
"28022","646",2023-06-19 21:15:00,-228,1913,2141,907,FALSE,NA,"0.1.4"
"28023","646",2023-06-19 21:30:00,1,1913,1912,907,FALSE,NA,"0.1.4"
"28024","646",2023-06-19 21:45:00,-106,1913,2019,907,FALSE,NA,"0.1.4"
"28025","646",2023-06-19 22:00:00,-22,1913,1935,907,FALSE,NA,"0.1.4"
"28026","646",2023-06-19 22:15:00,-75,1913,1988,907,FALSE,NA,"0.1.4"
"28027","646",2023-06-19 22:30:00,-466,1913,2379,907,FALSE,NA,"0.1.4"
"28028","646",2023-06-19 22:45:00,-184,1913,2097,907,FALSE,NA,"0.1.4"
"28029","646",2023-06-19 23:00:00,-75,1913,1988,907,FALSE,NA,"0.1.4"
"28030","646",2023-06-19 23:15:00,-324,1913,2237,907,FALSE,NA,"0.1.4"
"28031","646",2023-06-19 23:30:00,-101,1913,2014,907,FALSE,NA,"0.1.4"
"28032","646",2023-06-19 23:45:00,-14,1913,1927,907,FALSE,NA,"0.1.4"
"28033","646",2023-06-20,4,1913,1909,907,FALSE,NA,"0.1.4"
"28034","646",2023-06-20 00:15:00,-9,1913,1922,907,FALSE,NA,"0.1.4"
"28035","646",2023-06-20 00:30:00,-1,1913,1914,907,FALSE,NA,"0.1.4"
"28036","646",2023-06-20 00:45:00,1,1913,1912,907,FALSE,NA,"0.1.4"
"28037","646",2023-06-20 01:00:00,-125,1913,2038,907,FALSE,NA,"0.1.4"
"28038","646",2023-06-20 01:15:00,2,1913,1911,907,FALSE,NA,"0.1.4"
"28039","646",2023-06-20 01:30:00,-151,1913,2064,907,FALSE,NA,"0.1.4"
"28040","646",2023-06-20 01:45:00,3,1913,1910,907,FALSE,NA,"0.1.4"
"28041","646",2023-06-20 02:00:00,-494,1913,2407,907,FALSE,NA,"0.1.4"
"28042","646",2023-06-20 02:15:00,-728,1913,2641,907,FALSE,NA,"0.1.4"
"28043","646",2023-06-20 02:30:00,-728,1913,2641,907,FALSE,"jump1","0.1.4"
"28044","646",2023-06-20 02:45:00,-628,1913,2541,907,FALSE,NA,"0.1.4"
"28045","646",2023-06-20 03:00:00,-772,1913,2685,907,FALSE,NA,"0.1.4"
"28046","646",2023-06-20 03:15:00,-310,1913,2223,907,FALSE,NA,"0.1.4"
"28047","646",2023-06-20 03:30:00,-661,1913,2574,907,FALSE,NA,"0.1.4"
"28048","646",2023-06-20 03:45:00,-824,1913,2737,907,FALSE,NA,"0.1.4"
"28049","646",2023-06-20 04:00:00,-811,1913,2724,907,FALSE,NA,"0.1.4"
"28050","646",2023-06-20 04:15:00,-637,1913,2550,907,FALSE,NA,"0.1.4"
"28051","646",2023-06-20 04:30:00,-293,1913,2206,907,FALSE,NA,"0.1.4"
"28052","646",2023-06-20 04:45:00,-707,1913,2620,907,FALSE,NA,"0.1.4"
"28053","646",2023-06-20 05:00:00,-613,1913,2526,907,FALSE,NA,"0.1.4"
"28054","646",2023-06-20 05:15:00,-489,1913,2402,907,FALSE,NA,"0.1.4"
"28055","646",2023-06-20 05:30:00,-546,1913,2459,907,FALSE,NA,"0.1.4"
"28056","646",2023-06-20 05:45:00,-177,1913,2090,907,FALSE,"out1, fill","0.1.4"
"28057","646",2023-06-20 06:00:00,192,1913,1721,907,FALSE,NA,"0.1.4"
"28058","646",2023-06-20 06:15:00,192,1913,1721,907,FALSE,"jump1","0.1.4"
"28059","646",2023-06-20 06:30:00,278,1913,1635,907,FALSE,NA,"0.1.4"
"28060","646",2023-06-20 06:45:00,278,1913,1635,907,FALSE,"out1, fill","0.1.4"
"28061","646",2023-06-20 07:00:00,278,1913,1635,907,FALSE,"jump1","0.1.4"
"28062","646",2023-06-20 07:15:00,283,1913,1630,907,FALSE,NA,"0.1.4"
"28063","646",2023-06-20 07:30:00,270,1913,1643,907,FALSE,NA,"0.1.4"
"28064","646",2023-06-20 07:45:00,280,1913,1633,907,FALSE,NA,"0.1.4"
"28065","646",2023-06-20 08:00:00,283,1913,1630,907,FALSE,NA,"0.1.4"
"28066","646",2023-06-20 08:15:00,280,1913,1633,907,FALSE,NA,"0.1.4"
"28067","646",2023-06-20 08:30:00,236,1913,1677,907,FALSE,NA,"0.1.4"
"28068","646",2023-06-20 08:45:00,281,1913,1632,907,FALSE,NA,"0.1.4"
"28069","646",2023-06-20 09:00:00,225,1913,1688,907,FALSE,NA,"0.1.4"
"28070","646",2023-06-20 09:15:00,229,1913,1684,907,FALSE,NA,"0.1.4"
"28071","646",2023-06-20 09:30:00,277,1913,1636,907,FALSE,NA,"0.1.4"
"28072","646",2023-06-20 09:45:00,168,1913,1745,907,FALSE,NA,"0.1.4"
"28073","646",2023-06-20 10:00:00,267,1913,1646,907,FALSE,NA,"0.1.4"
"28074","646",2023-06-20 10:15:00,192,1913,1721,907,FALSE,NA,"0.1.4"
"28075","646",2023-06-20 10:30:00,256,1913,1657,907,FALSE,NA,"0.1.4"
"28076","646",2023-06-20 10:45:00,231,1913,1682,907,FALSE,NA,"0.1.4"
"28077","646",2023-06-20 11:00:00,190,1913,1723,907,FALSE,NA,"0.1.4"
"28078","646",2023-06-20 11:15:00,269,1913,1644,907,FALSE,NA,"0.1.4"
"28079","646",2023-06-20 11:30:00,-41,1913,1954,907,FALSE,NA,"0.1.4"
"28080","646",2023-06-20 11:45:00,-412,1913,2325,907,FALSE,NA,"0.1.4"
"28081","646",2023-06-20 12:00:00,-740,1913,2653,907,FALSE,NA,"0.1.4"
"28082","646",2023-06-20 12:15:00,-740,1913,2653,907,FALSE,"jump1","0.1.4"
"28083","646",2023-06-20 12:30:00,-740,1913,2653,907,FALSE,"jump1","0.1.4"
"28084","646",2023-06-20 12:45:00,-640.333333333333,1913,2553.33333333333,907,FALSE,"out1, fill","0.1.4"
"28085","646",2023-06-20 13:00:00,-540.666666666667,1913,2453.66666666667,907,FALSE,"out1, fill","0.1.4"
"28086","646",2023-06-20 13:15:00,-441,1913,2354,907,FALSE,"out1, fill","0.1.4"
"28087","646",2023-06-20 13:30:00,-341.333333333333,1913,2254.33333333333,907,FALSE,"out1, fill","0.1.4"
"28088","646",2023-06-20 13:45:00,-241.666666666667,1913,2154.66666666667,907,FALSE,"out1, fill","0.1.4"
"28089","646",2023-06-20 14:00:00,-142,1913,2055,907,FALSE,"out1, fill","0.1.4"
"28090","646",2023-06-20 14:15:00,-42.3333333333334,1913,1955.33333333333,907,FALSE,"out1, fill","0.1.4"
"28091","646",2023-06-20 14:30:00,57.3333333333333,1913,1855.66666666667,907,FALSE,"out1, fill","0.1.4"
"28092","646",2023-06-20 14:45:00,157,1913,1756,907,FALSE,NA,"0.1.4"
"28093","646",2023-06-20 15:00:00,281,1913,1632,907,FALSE,NA,"0.1.4"
"28094","646",2023-06-20 15:15:00,277,1913,1636,907,FALSE,NA,"0.1.4"
"28095","646",2023-06-20 15:30:00,165.9,1913,1747.1,907,FALSE,"out1, fill","0.1.4"
"28096","646",2023-06-20 15:45:00,54.8,1913,1858.2,907,FALSE,"out1, fill","0.1.4"
"28097","646",2023-06-20 16:00:00,-56.3,1913,1969.3,907,FALSE,"out1, fill","0.1.4"
"28098","646",2023-06-20 16:15:00,-167.4,1913,2080.4,907,FALSE,"out1, fill","0.1.4"
"28099","646",2023-06-20 16:30:00,-278.5,1913,2191.5,907,FALSE,"out1, fill","0.1.4"
"28100","646",2023-06-20 16:45:00,-389.6,1913,2302.6,907,FALSE,"out1, fill","0.1.4"
"28101","646",2023-06-20 17:00:00,-500.7,1913,2413.7,907,FALSE,"out1, fill","0.1.4"
"28102","646",2023-06-20 17:15:00,-611.8,1913,2524.8,907,FALSE,"out1, fill","0.1.4"
"28103","646",2023-06-20 17:30:00,-722.9,1913,2635.9,907,FALSE,"out1, fill","0.1.4"
"28104","646",2023-06-20 17:45:00,-834,1913,2747,907,FALSE,NA,"0.1.4"
"28105","646",2023-06-20 18:00:00,-403,1913,2316,907,FALSE,NA,"0.1.4"
"28106","646",2023-06-20 18:15:00,-403,1913,2316,907,FALSE,"jump1","0.1.4"
"28107","646",2023-06-20 18:30:00,-475,1913,2388,907,FALSE,NA,"0.1.4"
"28108","646",2023-06-20 18:45:00,-554,1913,2467,907,FALSE,NA,"0.1.4"
"28109","646",2023-06-20 19:00:00,-1011,1913,2924,907,FALSE,NA,"0.1.4"
"28110","646",2023-06-20 19:15:00,-1011,1913,2924,907,FALSE,"jump1","0.1.4"
"28111","646",2023-06-20 19:30:00,-1010,1913,2923,907,FALSE,NA,"0.1.4"
"28112","646",2023-06-20 19:45:00,-1010,1913,2923,907,FALSE,NA,"0.1.4"
"28113","646",2023-06-20 20:00:00,-1010,1913,2923,907,FALSE,NA,"0.1.4"
"28114","646",2023-06-20 20:15:00,-1010,1913,2923,907,FALSE,NA,"0.1.4"
"28115","646",2023-06-20 20:30:00,-1011,1913,2924,907,FALSE,NA,"0.1.4"
"28116","646",2023-06-20 20:45:00,-1012,1913,2925,907,FALSE,NA,"0.1.4"
"28117","646",2023-06-20 21:00:00,-1011,1913,2924,907,FALSE,NA,"0.1.4"
"28118","646",2023-06-20 21:15:00,-1011,1913,2924,907,FALSE,NA,"0.1.4"
"28119","646",2023-06-20 21:30:00,-1011,1913,2924,907,FALSE,NA,"0.1.4"
"28120","646",2023-06-20 21:45:00,-1011,1913,2924,907,FALSE,NA,"0.1.4"
"28121","646",2023-06-20 22:00:00,-1010,1913,2923,907,FALSE,NA,"0.1.4"
"28122","646",2023-06-20 22:15:00,-1011,1913,2924,907,FALSE,NA,"0.1.4"
"28123","646",2023-06-20 22:30:00,-1011,1913,2924,907,FALSE,"jump1","0.1.4"
"28124","646",2023-06-20 22:45:00,-1011,1913,2924,907,FALSE,"jump1","0.1.4"
"28125","646",2023-06-20 23:00:00,-1012,1913,2925,907,FALSE,NA,"0.1.4"
"28126","646",2023-06-20 23:15:00,-1012,1913,2925,907,FALSE,NA,"0.1.4"
"28127","646",2023-06-20 23:30:00,-1046,1913,2959,907,FALSE,NA,"0.1.4"
"28128","646",2023-06-20 23:45:00,-1044,1913,2957,907,FALSE,NA,"0.1.4"
"28129","646",2023-06-21,-1014,1913,2927,907,FALSE,NA,"0.1.4"
"28130","646",2023-06-21 00:15:00,-1031,1913,2944,907,FALSE,NA,"0.1.4"
"28131","646",2023-06-21 00:30:00,-1013,1913,2926,907,FALSE,NA,"0.1.4"
"28132","646",2023-06-21 00:45:00,-1013,1913,2926,907,FALSE,NA,"0.1.4"
"28133","646",2023-06-21 01:00:00,-1013,1913,2926,907,FALSE,NA,"0.1.4"
"28134","646",2023-06-21 01:15:00,-1261.5,1913,3174.5,907,FALSE,"out1, fill","0.1.4"
"28135","646",2023-06-21 01:30:00,-1510,1913,3423,907,FALSE,NA,"0.1.4"
"28136","646",2023-06-21 01:45:00,-1575,1913,3488,907,FALSE,NA,"0.1.4"
"28137","646",2023-06-21 02:00:00,-1575,1913,3488,907,FALSE,"jump1","0.1.4"
"28138","646",2023-06-21 02:15:00,-1091,1913,3004,907,FALSE,NA,"0.1.4"
"28139","646",2023-06-21 02:30:00,-1119,1913,3032,907,FALSE,NA,"0.1.4"
"28140","646",2023-06-21 02:45:00,-1119,1913,3032,907,FALSE,"jump1","0.1.4"
"28141","646",2023-06-21 03:00:00,-1192,1913,3105,907,FALSE,NA,"0.1.4"
"28142","646",2023-06-21 03:15:00,-1192,1913,3105,907,FALSE,"jump1","0.1.4"
"28143","646",2023-06-21 03:30:00,-936,1913,2849,907,FALSE,NA,"0.1.4"
"28144","646",2023-06-21 03:45:00,-1220,1913,3133,907,FALSE,NA,"0.1.4"
"28145","646",2023-06-21 04:00:00,-1475,1913,3388,907,FALSE,NA,"0.1.4"
"28146","646",2023-06-21 04:15:00,-1306.25,1913,3219.25,907,FALSE,"out1, fill","0.1.4"
"28147","646",2023-06-21 04:30:00,-1137.5,1913,3050.5,907,FALSE,"out1, fill","0.1.4"
"28148","646",2023-06-21 04:45:00,-968.75,1913,2881.75,907,FALSE,"out1, fill","0.1.4"
"28149","646",2023-06-21 05:00:00,-800,1913,2713,907,FALSE,NA,"0.1.4"
"28150","646",2023-06-21 05:15:00,-568,1913,2481,907,FALSE,NA,"0.1.4"
"28151","646",2023-06-21 05:30:00,-568,1913,2481,907,FALSE,NA,"0.1.4"
"28152","646",2023-06-21 05:45:00,-620,1913,2533,907,FALSE,NA,"0.1.4"
"28153","646",2023-06-21 06:00:00,-568,1913,2481,907,FALSE,NA,"0.1.4"
"28154","646",2023-06-21 06:15:00,-564,1913,2477,907,FALSE,NA,"0.1.4"
"28155","646",2023-06-21 06:30:00,-564,1913,2477,907,FALSE,"out1, fill","0.1.4"
"28156","646",2023-06-21 06:45:00,-564,1913,2477,907,FALSE,"jump1","0.1.4"
"28157","646",2023-06-21 07:00:00,-680,1913,2593,907,FALSE,NA,"0.1.4"
"28158","646",2023-06-21 07:15:00,-628,1913,2541,907,FALSE,NA,"0.1.4"
"28159","646",2023-06-21 07:30:00,-674,1913,2587,907,FALSE,NA,"0.1.4"
"28160","646",2023-06-21 07:45:00,-716,1913,2629,907,FALSE,NA,"0.1.4"
"28161","646",2023-06-21 08:00:00,-680,1913,2593,907,FALSE,NA,"0.1.4"
"28162","646",2023-06-21 08:15:00,-706,1913,2619,907,FALSE,NA,"0.1.4"
"28163","646",2023-06-21 08:30:00,-705,1913,2618,907,FALSE,NA,"0.1.4"
"28164","646",2023-06-21 08:45:00,-543,1913,2456,907,FALSE,NA,"0.1.4"
"28165","646",2023-06-21 09:00:00,-634,1913,2547,907,FALSE,NA,"0.1.4"
"28166","646",2023-06-21 09:15:00,-689,1913,2602,907,FALSE,NA,"0.1.4"
"28167","646",2023-06-21 09:30:00,-689,1913,2602,907,FALSE,"jump1","0.1.4"
"28168","646",2023-06-21 09:45:00,-689,1913,2602,907,FALSE,"jump1","0.1.4"
"28169","646",2023-06-21 10:00:00,-689,1913,2602,907,FALSE,"jump1","0.1.4"
"28170","646",2023-06-21 10:15:00,-891.5,1913,2804.5,907,TRUE,"out1, fill","0.1.4"
"28171","646",2023-06-21 10:30:00,-1094,1913,3007,907,TRUE,NA,"0.1.4"
"28172","646",2023-06-21 10:45:00,-1157,1913,3070,907,TRUE,NA,"0.1.4"
"28173","646",2023-06-21 11:00:00,-1087,1913,3000,907,TRUE,NA,"0.1.4"
"28174","646",2023-06-21 11:15:00,-1170,1913,3083,907,TRUE,NA,"0.1.4"
"28175","646",2023-06-21 11:30:00,-1154,1913,3067,907,TRUE,NA,"0.1.4"
"28176","646",2023-06-21 11:45:00,-1154,1913,3067,907,TRUE,"out1, fill","0.1.4"
"28177","646",2023-06-21 12:00:00,-1154,1913,3067,907,TRUE,"jump1","0.1.4"
"28178","646",2023-06-21 12:15:00,-1149,1913,3062,907,TRUE,NA,"0.1.4"
"28179","646",2023-06-21 12:30:00,-1149,1913,3062,907,TRUE,NA,"0.1.4"
"28180","646",2023-06-21 12:45:00,-1149,1913,3062,907,TRUE,"out1, fill","0.1.4"
"28181","646",2023-06-21 13:00:00,-1149,1913,3062,907,TRUE,"jump1","0.1.4"
"28182","646",2023-06-21 13:15:00,-999,1913,2912,907,TRUE,NA,"0.1.4"
"28183","646",2023-06-21 13:30:00,-703,1913,2616,907,TRUE,NA,"0.1.4"
"28184","646",2023-06-21 13:45:00,-1069.5,1913,2982.5,907,TRUE,"out1, fill","0.1.4"
"28185","646",2023-06-21 14:00:00,-1436,1913,3349,907,TRUE,NA,"0.1.4"
"28186","646",2023-06-21 14:15:00,-1364,1913,3277,907,TRUE,NA,"0.1.4"
"28187","646",2023-06-21 14:30:00,-1459,1913,3372,907,TRUE,NA,"0.1.4"
"28188","646",2023-06-21 14:45:00,-1423,1913,3336,907,TRUE,NA,"0.1.4"
"28189","646",2023-06-21 15:00:00,-1378,1913,3291,907,FALSE,NA,"0.1.4"
"28190","646",2023-06-21 15:15:00,-1370,1913,3283,907,FALSE,NA,"0.1.4"
"28191","646",2023-06-21 15:30:00,-1368,1913,3281,907,FALSE,NA,"0.1.4"
"28192","646",2023-06-21 15:45:00,-1367,1913,3280,907,FALSE,NA,"0.1.4"
"28193","646",2023-06-21 16:00:00,-1205,1913,3118,907,FALSE,"out1, fill","0.1.4"
"28194","646",2023-06-21 16:15:00,-1043,1913,2956,907,FALSE,NA,"0.1.4"
"28195","646",2023-06-21 16:30:00,-811,1913,2724,907,FALSE,NA,"0.1.4"
"28196","646",2023-06-21 16:45:00,-425,1913,2338,907,FALSE,NA,"0.1.4"
"28197","646",2023-06-21 17:00:00,-252,1913,2165,907,FALSE,NA,"0.1.4"
"28198","646",2023-06-21 17:15:00,-376,1913,2289,907,FALSE,NA,"0.1.4"
"28199","646",2023-06-21 17:30:00,64,1913,1849,907,FALSE,NA,"0.1.4"
"28200","646",2023-06-21 17:45:00,65,1913,1848,907,FALSE,NA,"0.1.4"
"28201","646",2023-06-21 18:00:00,65,1913,1848,907,FALSE,NA,"0.1.4"
"28202","646",2023-06-21 18:15:00,65,1913,1848,907,FALSE,NA,"0.1.4"
"28203","646",2023-06-21 18:30:00,65,1913,1848,907,FALSE,NA,"0.1.4"
"28204","646",2023-06-21 18:45:00,56,1913,1857,907,FALSE,NA,"0.1.4"
"28205","646",2023-06-21 19:00:00,59,1913,1854,907,FALSE,NA,"0.1.4"
"28206","646",2023-06-21 19:15:00,84,1913,1829,907,FALSE,NA,"0.1.4"
"28207","646",2023-06-21 19:30:00,84,1913,1829,907,FALSE,NA,"0.1.4"
"28208","646",2023-06-21 19:45:00,87,1913,1826,907,FALSE,NA,"0.1.4"
"28209","646",2023-06-21 20:00:00,92,1913,1821,907,FALSE,NA,"0.1.4"
"28210","646",2023-06-21 20:15:00,92,1913,1821,907,FALSE,NA,"0.1.4"
"28211","646",2023-06-21 20:30:00,91,1913,1822,907,FALSE,NA,"0.1.4"
"28212","646",2023-06-21 20:45:00,40.3333333333333,1913,1872.66666666667,907,FALSE,"out1, fill","0.1.4"
"28213","646",2023-06-21 21:00:00,-10.3333333333333,1913,1923.33333333333,907,FALSE,"out1, fill","0.1.4"
"28214","646",2023-06-21 21:15:00,-61,1913,1974,907,FALSE,NA,"0.1.4"
"28215","646",2023-06-21 21:30:00,87,1913,1826,907,FALSE,NA,"0.1.4"
"28216","646",2023-06-21 21:45:00,-220,1913,2133,907,FALSE,NA,"0.1.4"
"28217","646",2023-06-21 22:00:00,57,1913,1856,907,FALSE,NA,"0.1.4"
"28218","646",2023-06-21 22:15:00,7,1913,1906,907,FALSE,NA,"0.1.4"
"28219","646",2023-06-21 22:30:00,-31,1913,1944,907,FALSE,NA,"0.1.4"
"28220","646",2023-06-21 22:45:00,45,1913,1868,907,FALSE,NA,"0.1.4"
"28221","646",2023-06-21 23:00:00,91,1913,1822,907,FALSE,NA,"0.1.4"
"28222","646",2023-06-21 23:15:00,93,1913,1820,907,FALSE,NA,"0.1.4"
"28223","646",2023-06-21 23:30:00,90,1913,1823,907,FALSE,NA,"0.1.4"
"28224","646",2023-06-21 23:45:00,94,1913,1819,907,FALSE,NA,"0.1.4"
"28225","646",2023-06-22,93,1913,1820,907,FALSE,NA,"0.1.4"
"28226","646",2023-06-22 00:15:00,-277,1913,2190,907,FALSE,"out1, fill","0.1.4"
"28227","646",2023-06-22 00:30:00,-647,1913,2560,907,FALSE,NA,"0.1.4"
"28228","646",2023-06-22 00:45:00,-619,1913,2532,907,FALSE,NA,"0.1.4"
"28229","646",2023-06-22 01:00:00,-562,1913,2475,907,FALSE,NA,"0.1.4"
"28230","646",2023-06-22 01:15:00,-562,1913,2475,907,FALSE,"jump1","0.1.4"
"28231","646",2023-06-22 01:30:00,-575,1913,2488,907,FALSE,NA,"0.1.4"
"28232","646",2023-06-22 01:45:00,-540,1913,2453,907,FALSE,NA,"0.1.4"
"28233","646",2023-06-22 02:00:00,-531,1913,2444,907,FALSE,NA,"0.1.4"
"28234","646",2023-06-22 02:15:00,-977,1913,2890,907,FALSE,NA,"0.1.4"
"28235","646",2023-06-22 02:30:00,-545,1913,2458,907,FALSE,NA,"0.1.4"
"28236","646",2023-06-22 02:45:00,-540,1913,2453,907,FALSE,"out1, fill","0.1.4"
"28237","646",2023-06-22 03:00:00,-535,1913,2448,907,FALSE,"out1, fill","0.1.4"
"28238","646",2023-06-22 03:15:00,-530,1913,2443,907,FALSE,NA,"0.1.4"
"28239","646",2023-06-22 03:30:00,-530,1913,2443,907,FALSE,NA,"0.1.4"
"28240","646",2023-06-22 03:45:00,-530,1913,2443,907,FALSE,NA,"0.1.4"
"28241","646",2023-06-22 04:00:00,-531,1913,2444,907,FALSE,NA,"0.1.4"
"28242","646",2023-06-22 04:15:00,-534,1913,2447,907,FALSE,NA,"0.1.4"
"28243","646",2023-06-22 04:30:00,-557,1913,2470,907,FALSE,NA,"0.1.4"
"28244","646",2023-06-22 04:45:00,-530,1913,2443,907,FALSE,NA,"0.1.4"
"28245","646",2023-06-22 05:00:00,-530,1913,2443,907,FALSE,NA,"0.1.4"
"28246","646",2023-06-22 05:15:00,-863.5,1913,2776.5,907,FALSE,"out1, fill","0.1.4"
"28247","646",2023-06-22 05:30:00,-1197,1913,3110,907,FALSE,NA,"0.1.4"
"28248","646",2023-06-22 05:45:00,-1197,1913,3110,907,FALSE,"jump1","0.1.4"
"28249","646",2023-06-22 06:00:00,-1196,1913,3109,907,FALSE,NA,"0.1.4"
"28250","646",2023-06-22 06:15:00,-1203,1913,3116,907,FALSE,NA,"0.1.4"
"28251","646",2023-06-22 06:30:00,-1200,1913,3113,907,FALSE,NA,"0.1.4"
"28252","646",2023-06-22 06:45:00,-1204,1913,3117,907,FALSE,NA,"0.1.4"
"28253","646",2023-06-22 07:00:00,-1243,1913,3156,907,FALSE,NA,"0.1.4"
"28254","646",2023-06-22 07:15:00,-1196,1913,3109,907,FALSE,NA,"0.1.4"
"28255","646",2023-06-22 07:30:00,-1418,1913,3331,907,FALSE,NA,"0.1.4"
"28256","646",2023-06-22 07:45:00,-1473,1913,3386,907,FALSE,NA,"0.1.4"
"28257","646",2023-06-22 08:00:00,-1390,1913,3303,907,FALSE,NA,"0.1.4"
"28258","646",2023-06-22 08:15:00,-1222,1913,3135,907,FALSE,NA,"0.1.4"
"28259","646",2023-06-22 08:30:00,-1197,1913,3110,907,FALSE,NA,"0.1.4"
"28260","646",2023-06-22 08:45:00,-1197,1913,3110,907,FALSE,"jump1","0.1.4"
"28261","646",2023-06-22 09:00:00,-1197,1913,3110,907,FALSE,"jump1","0.1.4"
"28262","646",2023-06-22 09:15:00,-1197,1913,3110,907,FALSE,"out1, fill","0.1.4"
"28263","646",2023-06-22 09:30:00,-1197,1913,3110,907,FALSE,"jump1","0.1.4"
"28264","646",2023-06-22 09:45:00,-1218,1913,3131,907,FALSE,NA,"0.1.4"
"28265","646",2023-06-22 10:00:00,-1218,1913,3131,907,FALSE,"jump1","0.1.4"
"28266","646",2023-06-22 10:15:00,-1218,1913,3131,907,FALSE,"jump1","0.1.4"
"28267","646",2023-06-22 10:30:00,-1356,1913,3269,907,FALSE,NA,"0.1.4"
"28268","646",2023-06-22 10:45:00,-1221,1913,3134,907,FALSE,NA,"0.1.4"
"28269","646",2023-06-22 11:00:00,-1219,1913,3132,907,FALSE,NA,"0.1.4"
"28270","646",2023-06-22 11:15:00,-1219,1913,3132,907,FALSE,NA,"0.1.4"
"28271","646",2023-06-22 11:30:00,-1220,1913,3133,907,FALSE,NA,"0.1.4"
"28272","646",2023-06-22 11:45:00,-1219,1913,3132,907,FALSE,NA,"0.1.4"
"28273","646",2023-06-22 12:00:00,-1252,1913,3165,907,FALSE,NA,"0.1.4"
"28274","646",2023-06-22 12:15:00,-1224,1913,3137,907,FALSE,NA,"0.1.4"
"28275","646",2023-06-22 12:30:00,-1316,1913,3229,907,FALSE,NA,"0.1.4"
"28276","646",2023-06-22 12:45:00,-1548,1913,3461,907,FALSE,NA,"0.1.4"
"28277","646",2023-06-22 13:00:00,-1894,1913,3807,907,FALSE,NA,"0.1.4"
"28278","646",2023-06-22 13:15:00,-1894,1913,3807,907,FALSE,"jump1","0.1.4"
"28279","646",2023-06-22 13:30:00,-1894,1913,3807,907,FALSE,NA,"0.1.4"
"28280","646",2023-06-22 13:45:00,-1894,1913,3807,907,FALSE,NA,"0.1.4"
"28281","646",2023-06-22 14:00:00,-1895,1913,3808,907,FALSE,NA,"0.1.4"
"28282","646",2023-06-22 14:15:00,-1895,1913,3808,907,FALSE,NA,"0.1.4"
"28283","646",2023-06-22 14:30:00,-1895,1913,3808,907,FALSE,NA,"0.1.4"
"28284","646",2023-06-22 14:45:00,-1895,1913,3808,907,FALSE,NA,"0.1.4"
"28285","646",2023-06-22 15:00:00,-1894,1913,3807,907,FALSE,NA,"0.1.4"
"28286","646",2023-06-22 15:15:00,-1895,1913,3808,907,FALSE,NA,"0.1.4"
"28287","646",2023-06-22 15:30:00,-1895,1913,3808,907,FALSE,NA,"0.1.4"
"28288","646",2023-06-22 15:45:00,-1917,1913,3830,907,FALSE,NA,"0.1.4"
"28289","646",2023-06-22 16:00:00,-1912,1913,3825,907,FALSE,NA,"0.1.4"
"28290","646",2023-06-22 16:15:00,-1906.66666666667,1913,3819.66666666667,907,FALSE,"out1, fill","0.1.4"
"28291","646",2023-06-22 16:30:00,-1901.33333333333,1913,3814.33333333333,907,FALSE,"out1, fill","0.1.4"
"28292","646",2023-06-22 16:45:00,-1896,1913,3809,907,FALSE,NA,"0.1.4"
"28293","646",2023-06-22 17:00:00,-1895,1913,3808,907,FALSE,NA,"0.1.4"
"28294","646",2023-06-22 17:15:00,-1895,1913,3808,907,FALSE,NA,"0.1.4"
"28295","646",2023-06-22 17:30:00,-1895,1913,3808,907,FALSE,"out1, fill","0.1.4"
"28296","646",2023-06-22 17:45:00,-1895,1913,3808,907,FALSE,"out1, fill","0.1.4"
"28297","646",2023-06-22 18:00:00,-1895,1913,3808,907,FALSE,NA,"0.1.4"
"28298","646",2023-06-22 18:15:00,-1895,1913,3808,907,FALSE,NA,"0.1.4"
"28299","646",2023-06-22 18:30:00,-1897,1913,3810,907,FALSE,NA,"0.1.4"
"28300","646",2023-06-22 18:45:00,-1895,1913,3808,907,FALSE,NA,"0.1.4"
"28301","646",2023-06-22 19:00:00,-1895,1913,3808,907,FALSE,NA,"0.1.4"
"28302","646",2023-06-22 19:15:00,-1895,1913,3808,907,FALSE,NA,"0.1.4"
"28303","646",2023-06-22 19:30:00,-1895,1913,3808,907,FALSE,NA,"0.1.4"
"28304","646",2023-06-22 19:45:00,-1895,1913,3808,907,FALSE,NA,"0.1.4"
"28305","646",2023-06-22 20:00:00,-1898,1913,3811,907,FALSE,NA,"0.1.4"
"28306","646",2023-06-22 20:15:00,-1897,1913,3810,907,FALSE,NA,"0.1.4"
"28307","646",2023-06-22 20:30:00,-1895,1913,3808,907,FALSE,NA,"0.1.4"
"28308","646",2023-06-22 20:45:00,-1895,1913,3808,907,FALSE,NA,"0.1.4"
"28309","646",2023-06-22 21:00:00,-1895,1913,3808,907,FALSE,NA,"0.1.4"
"28310","646",2023-06-22 21:15:00,-1895,1913,3808,907,FALSE,NA,"0.1.4"
"28311","646",2023-06-22 21:30:00,-1895,1913,3808,907,FALSE,NA,"0.1.4"
"28312","646",2023-06-22 21:45:00,-1895,1913,3808,907,FALSE,NA,"0.1.4"
"28313","646",2023-06-22 22:00:00,-1895,1913,3808,907,FALSE,NA,"0.1.4"
"28314","646",2023-06-22 22:15:00,-1895,1913,3808,907,FALSE,NA,"0.1.4"
"28315","646",2023-06-22 22:30:00,-1895,1913,3808,907,FALSE,NA,"0.1.4"
"28316","646",2023-06-22 22:45:00,-1895,1913,3808,907,FALSE,NA,"0.1.4"
"28317","646",2023-06-22 23:00:00,-1895,1913,3808,907,FALSE,NA,"0.1.4"
"28318","646",2023-06-22 23:15:00,-1895,1913,3808,907,FALSE,NA,"0.1.4"
"28319","646",2023-06-22 23:30:00,-1894,1913,3807,907,FALSE,NA,"0.1.4"
"28320","646",2023-06-22 23:45:00,-1895,1913,3808,907,FALSE,NA,"0.1.4"
"28321","646",2023-06-23,-1895,1913,3808,907,FALSE,NA,"0.1.4"
"28322","646",2023-06-23 00:15:00,-1895,1913,3808,907,FALSE,NA,"0.1.4"
"28323","646",2023-06-23 00:30:00,-1906,1913,3819,907,FALSE,NA,"0.1.4"
"28324","646",2023-06-23 00:45:00,-1906,1913,3819,907,FALSE,NA,"0.1.4"
"28325","646",2023-06-23 01:00:00,-1898,1913,3811,907,FALSE,NA,"0.1.4"
"28326","646",2023-06-23 01:15:00,-2285,1913,4198,907,FALSE,NA,"0.1.4"
"28327","646",2023-06-23 01:30:00,-1897,1913,3810,907,FALSE,NA,"0.1.4"
"28328","646",2023-06-23 01:45:00,-1897,1913,3810,907,FALSE,NA,"0.1.4"
"28329","646",2023-06-23 02:00:00,-1897,1913,3810,907,FALSE,NA,"0.1.4"
"28330","646",2023-06-23 02:15:00,-1898,1913,3811,907,FALSE,NA,"0.1.4"
"28331","646",2023-06-23 02:30:00,-1899,1913,3812,907,FALSE,NA,"0.1.4"
"28332","646",2023-06-23 02:45:00,-1899,1913,3812,907,FALSE,NA,"0.1.4"
"28333","646",2023-06-23 03:00:00,-1899,1913,3812,907,FALSE,NA,"0.1.4"
"28334","646",2023-06-23 03:15:00,-1944,1913,3857,907,FALSE,NA,"0.1.4"
"28335","646",2023-06-23 03:30:00,-1928,1913,3841,907,FALSE,NA,"0.1.4"
"28336","646",2023-06-23 03:45:00,-1895,1913,3808,907,FALSE,NA,"0.1.4"
"28337","646",2023-06-23 04:00:00,-2016,1913,3929,907,FALSE,NA,"0.1.4"
"28338","646",2023-06-23 04:15:00,-2235,1913,4148,907,FALSE,NA,"0.1.4"
"28339","646",2023-06-23 04:30:00,-2325,1913,4238,907,FALSE,NA,"0.1.4"
"28340","646",2023-06-23 04:45:00,-2325,1913,4238,907,FALSE,"jump1","0.1.4"
"28341","646",2023-06-23 05:00:00,-2174.33333333333,1913,4087.33333333333,907,FALSE,"out1, fill","0.1.4"
"28342","646",2023-06-23 05:15:00,-2023.66666666667,1913,3936.66666666667,907,FALSE,"out1, fill","0.1.4"
"28343","646",2023-06-23 05:30:00,-1873,1913,3786,907,FALSE,NA,"0.1.4"
"28344","646",2023-06-23 05:45:00,-2329,1913,4242,907,FALSE,NA,"0.1.4"
"28345","646",2023-06-23 06:00:00,-2214,1913,4127,907,FALSE,NA,"0.1.4"
"28346","646",2023-06-23 06:15:00,-2024,1913,3937,907,FALSE,NA,"0.1.4"
"28347","646",2023-06-23 06:30:00,-1924,1913,3837,907,FALSE,NA,"0.1.4"
"28348","646",2023-06-23 06:45:00,-2327,1913,4240,907,FALSE,NA,"0.1.4"
"28349","646",2023-06-23 07:00:00,-2355,1913,4268,907,FALSE,NA,"0.1.4"
"28350","646",2023-06-23 07:15:00,-2290,1913,4203,907,FALSE,NA,"0.1.4"
"28351","646",2023-06-23 07:30:00,-2160,1913,4073,907,FALSE,NA,"0.1.4"
"28352","646",2023-06-23 07:45:00,-1806,1913,3719,907,FALSE,NA,"0.1.4"
"28353","646",2023-06-23 08:00:00,-2219.5,1913,4132.5,907,FALSE,"out1, fill","0.1.4"
"28354","646",2023-06-23 08:15:00,-2633,1913,4546,907,FALSE,NA,"0.1.4"
"28355","646",2023-06-23 08:30:00,-2679,1913,4592,907,FALSE,NA,"0.1.4"
"28356","646",2023-06-23 08:45:00,-2389,1913,4302,907,FALSE,NA,"0.1.4"
"28357","646",2023-06-23 09:00:00,-2147,1913,4060,907,FALSE,NA,"0.1.4"
"28358","646",2023-06-23 09:15:00,-2539,1913,4452,907,FALSE,NA,"0.1.4"
"28359","646",2023-06-23 09:30:00,-2386.66666666667,1913,4299.66666666667,907,FALSE,"out1, fill","0.1.4"
"28360","646",2023-06-23 09:45:00,-2234.33333333333,1913,4147.33333333333,907,FALSE,"out1, fill","0.1.4"
"28361","646",2023-06-23 10:00:00,-2082,1913,3995,907,FALSE,NA,"0.1.4"
"28362","646",2023-06-23 10:15:00,-2150,1913,4063,907,FALSE,NA,"0.1.4"
"28363","646",2023-06-23 10:30:00,-2607,1913,4520,907,FALSE,NA,"0.1.4"
"28364","646",2023-06-23 10:45:00,-2618.33333333333,1913,4531.33333333333,907,FALSE,"out1, fill","0.1.4"
"28365","646",2023-06-23 11:00:00,-2629.66666666667,1913,4542.66666666667,907,FALSE,"out1, fill","0.1.4"
"28366","646",2023-06-23 11:15:00,-2641,1913,4554,907,FALSE,NA,"0.1.4"
"28367","646",2023-06-23 11:30:00,-2275,1913,4188,907,FALSE,NA,"0.1.4"
"28368","646",2023-06-23 11:45:00,-2322,1913,4235,907,FALSE,NA,"0.1.4"
"28369","646",2023-06-23 12:00:00,-2337,1913,4250,907,FALSE,NA,"0.1.4"
"28370","646",2023-06-23 12:15:00,-2175,1913,4088,907,FALSE,"out1, fill","0.1.4"
"28371","646",2023-06-23 12:30:00,-2013,1913,3926,907,FALSE,"out1, fill","0.1.4"
"28372","646",2023-06-23 12:45:00,-1851,1913,3764,907,FALSE,"out1, fill","0.1.4"
"28373","646",2023-06-23 13:00:00,-1689,1913,3602,907,FALSE,"out1, fill","0.1.4"
"28374","646",2023-06-23 13:15:00,-1527,1913,3440,907,FALSE,"out1, fill","0.1.4"
"28375","646",2023-06-23 13:30:00,-1365,1913,3278,907,FALSE,NA,"0.1.4"
"28376","646",2023-06-23 13:45:00,-1364,1913,3277,907,FALSE,NA,"0.1.4"
"28377","646",2023-06-23 14:00:00,-1352,1913,3265,907,FALSE,NA,"0.1.4"
"28378","646",2023-06-23 14:15:00,-1343,1913,3256,907,FALSE,NA,"0.1.4"
"28379","646",2023-06-23 14:30:00,-1307,1913,3220,907,FALSE,NA,"0.1.4"
"28380","646",2023-06-23 14:45:00,-1362,1913,3275,907,FALSE,NA,"0.1.4"
"28381","646",2023-06-23 15:00:00,-1316,1913,3229,907,FALSE,NA,"0.1.4"
"28382","646",2023-06-23 15:15:00,-1481,1913,3394,907,FALSE,NA,"0.1.4"
"28383","646",2023-06-23 15:30:00,-1281,1913,3194,907,FALSE,NA,"0.1.4"
"28384","646",2023-06-23 15:45:00,-1265,1913,3178,907,FALSE,NA,"0.1.4"
"28385","646",2023-06-23 16:00:00,-1335,1913,3248,907,FALSE,NA,"0.1.4"
"28386","646",2023-06-23 16:15:00,-1361.75,1913,3274.75,907,FALSE,"out1, fill","0.1.4"
"28387","646",2023-06-23 16:30:00,-1388.5,1913,3301.5,907,FALSE,"out1, fill","0.1.4"
"28388","646",2023-06-23 16:45:00,-1415.25,1913,3328.25,907,FALSE,"out1, fill","0.1.4"
"28389","646",2023-06-23 17:00:00,-1442,1913,3355,907,FALSE,NA,"0.1.4"
"28390","646",2023-06-23 17:15:00,-1435,1913,3348,907,FALSE,NA,"0.1.4"
"28391","646",2023-06-23 17:30:00,-1242,1913,3155,907,FALSE,NA,"0.1.4"
"28392","646",2023-06-23 17:45:00,-1242,1913,3155,907,FALSE,NA,"0.1.4"
"28393","646",2023-06-23 18:00:00,-1256,1913,3169,907,FALSE,NA,"0.1.4"
"28394","646",2023-06-23 18:15:00,-1257,1913,3170,907,FALSE,"out1, fill","0.1.4"
"28395","646",2023-06-23 18:30:00,-1258,1913,3171,907,FALSE,"out1, fill","0.1.4"
"28396","646",2023-06-23 18:45:00,-1259,1913,3172,907,FALSE,"out1, fill","0.1.4"
"28397","646",2023-06-23 19:00:00,-1260,1913,3173,907,FALSE,"out1, fill","0.1.4"
"28398","646",2023-06-23 19:15:00,-1261,1913,3174,907,FALSE,"out1, fill","0.1.4"
"28399","646",2023-06-23 19:30:00,-1262,1913,3175,907,FALSE,NA,"0.1.4"
"28400","646",2023-06-23 19:45:00,-1245,1913,3158,907,FALSE,NA,"0.1.4"
"28401","646",2023-06-23 20:00:00,-1325,1913,3238,907,FALSE,NA,"0.1.4"
"28402","646",2023-06-23 20:15:00,-1273,1913,3186,907,FALSE,NA,"0.1.4"
"28403","646",2023-06-23 20:30:00,-1273,1913,3186,907,FALSE,"out1, fill","0.1.4"
"28404","646",2023-06-23 20:45:00,-1273,1913,3186,907,FALSE,"jump1","0.1.4"
"28405","646",2023-06-23 21:00:00,-1273,1913,3186,907,FALSE,"jump1","0.1.4"
"28406","646",2023-06-23 21:15:00,-1273,1913,3186,907,FALSE,"jump1","0.1.4"
"28407","646",2023-06-23 21:30:00,-1259,1913,3172,907,FALSE,NA,"0.1.4"
"28408","646",2023-06-23 21:45:00,-1259,1913,3172,907,FALSE,NA,"0.1.4"
"28409","646",2023-06-23 22:00:00,-1260,1913,3173,907,FALSE,NA,"0.1.4"
"28410","646",2023-06-23 22:15:00,-1258,1913,3171,907,FALSE,NA,"0.1.4"
"28411","646",2023-06-23 22:30:00,-1259,1913,3172,907,FALSE,NA,"0.1.4"
"28412","646",2023-06-23 22:45:00,-1259,1913,3172,907,FALSE,"jump1","0.1.4"
"28413","646",2023-06-23 23:00:00,-1259,1913,3172,907,FALSE,"jump1","0.1.4"
"28414","646",2023-06-23 23:15:00,-1259,1913,3172,907,FALSE,"out1, fill","0.1.4"
"28415","646",2023-06-23 23:30:00,-1259,1913,3172,907,FALSE,"jump1","0.1.4"
"28416","646",2023-06-23 23:45:00,-1425,1913,3338,907,FALSE,NA,"0.1.4"
"28417","646",2023-06-24,-1375,1913,3288,907,FALSE,NA,"0.1.4"
"28418","646",2023-06-24 00:15:00,-1516,1913,3429,907,FALSE,NA,"0.1.4"
"28419","646",2023-06-24 00:30:00,-1628.28571428571,1913,3541.28571428571,907,FALSE,"out1, fill","0.1.4"
"28420","646",2023-06-24 00:45:00,-1740.57142857143,1913,3653.57142857143,907,FALSE,"out1, fill","0.1.4"
"28421","646",2023-06-24 01:00:00,-1852.85714285714,1913,3765.85714285714,907,FALSE,"out1, fill","0.1.4"
"28422","646",2023-06-24 01:15:00,-1965.14285714286,1913,3878.14285714286,907,FALSE,"out1, fill","0.1.4"
"28423","646",2023-06-24 01:30:00,-2077.42857142857,1913,3990.42857142857,907,FALSE,"out1, fill","0.1.4"
"28424","646",2023-06-24 01:45:00,-2189.71428571429,1913,4102.71428571429,907,FALSE,"out1, fill","0.1.4"
"28425","646",2023-06-24 02:00:00,-2302,1913,4215,907,FALSE,NA,"0.1.4"
"28426","646",2023-06-24 02:15:00,-2416,1913,4329,907,FALSE,NA,"0.1.4"
"28427","646",2023-06-24 02:30:00,-2219,1913,4132,907,FALSE,NA,"0.1.4"
"28428","646",2023-06-24 02:45:00,-2201,1913,4114,907,FALSE,NA,"0.1.4"
"28429","646",2023-06-24 03:00:00,-2377,1913,4290,907,FALSE,NA,"0.1.4"
"28430","646",2023-06-24 03:15:00,-2260,1913,4173,907,FALSE,NA,"0.1.4"
"28431","646",2023-06-24 03:30:00,-2565,1913,4478,907,FALSE,NA,"0.1.4"
"28432","646",2023-06-24 03:45:00,-2205,1913,4118,907,FALSE,NA,"0.1.4"
"28433","646",2023-06-24 04:00:00,-2387,1913,4300,907,FALSE,NA,"0.1.4"
"28434","646",2023-06-24 04:15:00,-2394.33333333333,1913,4307.33333333333,907,FALSE,"out1, fill","0.1.4"
"28435","646",2023-06-24 04:30:00,-2401.66666666667,1913,4314.66666666667,907,FALSE,"out1, fill","0.1.4"
"28436","646",2023-06-24 04:45:00,-2409,1913,4322,907,FALSE,"out1, fill","0.1.4"
"28437","646",2023-06-24 05:00:00,-2416.33333333333,1913,4329.33333333333,907,FALSE,"out1, fill","0.1.4"
"28438","646",2023-06-24 05:15:00,-2423.66666666667,1913,4336.66666666667,907,FALSE,"out1, fill","0.1.4"
"28439","646",2023-06-24 05:30:00,-2431,1913,4344,907,FALSE,"out1, fill","0.1.4"
"28440","646",2023-06-24 05:45:00,-2438.33333333333,1913,4351.33333333333,907,FALSE,"out1, fill","0.1.4"
"28441","646",2023-06-24 06:00:00,-2445.66666666667,1913,4358.66666666667,907,FALSE,"out1, fill","0.1.4"
"28442","646",2023-06-24 06:15:00,-2453,1913,4366,907,FALSE,"out1, fill","0.1.4"
"28443","646",2023-06-24 06:30:00,-2460.33333333333,1913,4373.33333333333,907,FALSE,"out1, fill","0.1.4"
"28444","646",2023-06-24 06:45:00,-2467.66666666667,1913,4380.66666666667,907,FALSE,"out1, fill","0.1.4"
"28445","646",2023-06-24 07:00:00,-2475,1913,4388,907,FALSE,NA,"0.1.4"
"28446","646",2023-06-24 07:15:00,-2326,1913,4239,907,FALSE,NA,"0.1.4"
"28447","646",2023-06-24 07:30:00,-2524,1913,4437,907,FALSE,NA,"0.1.4"
"28448","646",2023-06-24 07:45:00,-2598,1913,4511,907,FALSE,NA,"0.1.4"
"28449","646",2023-06-24 08:00:00,-2606,1913,4519,907,FALSE,NA,"0.1.4"
"28450","646",2023-06-24 08:15:00,-2257,1913,4170,907,FALSE,NA,"0.1.4"
"28451","646",2023-06-24 08:30:00,-2235,1913,4148,907,FALSE,NA,"0.1.4"
"28452","646",2023-06-24 08:45:00,-2375,1913,4288,907,FALSE,NA,"0.1.4"
"28453","646",2023-06-24 09:00:00,-2560,1913,4473,907,FALSE,NA,"0.1.4"
"28454","646",2023-06-24 09:15:00,-2100,1913,4013,907,FALSE,NA,"0.1.4"
"28455","646",2023-06-24 09:30:00,-2296,1913,4209,907,FALSE,NA,"0.1.4"
"28456","646",2023-06-24 09:45:00,-2210,1913,4123,907,FALSE,NA,"0.1.4"
"28457","646",2023-06-24 10:00:00,-2648,1913,4561,907,FALSE,NA,"0.1.4"
"28458","646",2023-06-24 10:15:00,-2279,1913,4192,907,FALSE,NA,"0.1.4"
"28459","646",2023-06-24 10:30:00,-2588,1913,4501,907,FALSE,NA,"0.1.4"
"28460","646",2023-06-24 10:45:00,-2104,1913,4017,907,FALSE,NA,"0.1.4"
"28461","646",2023-06-24 11:00:00,-1910,1913,3823,907,FALSE,NA,"0.1.4"
"28462","646",2023-06-24 11:15:00,-2052,1913,3965,907,FALSE,NA,"0.1.4"
"28463","646",2023-06-24 11:30:00,-1605,1913,3518,907,FALSE,"out1, fill","0.1.4"
"28464","646",2023-06-24 11:45:00,-1158,1913,3071,907,FALSE,NA,"0.1.4"
"28465","646",2023-06-24 12:00:00,-1158,1913,3071,907,FALSE,NA,"0.1.4"
"28466","646",2023-06-24 12:15:00,-1554,1913,3467,907,FALSE,NA,"0.1.4"
"28467","646",2023-06-24 12:30:00,-1173,1913,3086,907,FALSE,NA,"0.1.4"
"28468","646",2023-06-24 12:45:00,-1309,1913,3222,907,FALSE,NA,"0.1.4"
"28469","646",2023-06-24 13:00:00,-1157,1913,3070,907,FALSE,NA,"0.1.4"
"28470","646",2023-06-24 13:15:00,-1171,1913,3084,907,FALSE,NA,"0.1.4"
"28471","646",2023-06-24 13:30:00,-1158,1913,3071,907,FALSE,NA,"0.1.4"
"28472","646",2023-06-24 13:45:00,-1160,1913,3073,907,FALSE,NA,"0.1.4"
"28473","646",2023-06-24 14:00:00,-1154,1913,3067,907,FALSE,NA,"0.1.4"
"28474","646",2023-06-24 14:15:00,-1155,1913,3068,907,FALSE,NA,"0.1.4"
"28475","646",2023-06-24 14:30:00,-1153,1913,3066,907,FALSE,NA,"0.1.4"
"28476","646",2023-06-24 14:45:00,-1154,1913,3067,907,FALSE,NA,"0.1.4"
"28477","646",2023-06-24 15:00:00,-1154,1913,3067,907,FALSE,NA,"0.1.4"
"28478","646",2023-06-24 15:15:00,-1154,1913,3067,907,FALSE,NA,"0.1.4"
"28479","646",2023-06-24 15:30:00,-1153,1913,3066,907,FALSE,NA,"0.1.4"
"28480","646",2023-06-24 15:45:00,-1153,1913,3066,907,FALSE,NA,"0.1.4"
"28481","646",2023-06-24 16:00:00,-1153,1913,3066,907,FALSE,NA,"0.1.4"
"28482","646",2023-06-24 16:15:00,-1153,1913,3066,907,FALSE,NA,"0.1.4"
"28483","646",2023-06-24 16:30:00,-1153,1913,3066,907,FALSE,NA,"0.1.4"
"28484","646",2023-06-24 16:45:00,-1153,1913,3066,907,FALSE,NA,"0.1.4"
"28485","646",2023-06-24 17:00:00,-1151,1913,3064,907,FALSE,NA,"0.1.4"
"28486","646",2023-06-24 17:15:00,-1154,1913,3067,907,FALSE,NA,"0.1.4"
"28487","646",2023-06-24 17:30:00,-1158,1913,3071,907,FALSE,NA,"0.1.4"
"28488","646",2023-06-24 17:45:00,-1154,1913,3067,907,FALSE,NA,"0.1.4"
"28489","646",2023-06-24 18:00:00,-1154,1913,3067,907,FALSE,NA,"0.1.4"
"28490","646",2023-06-24 18:15:00,-1155,1913,3068,907,FALSE,NA,"0.1.4"
"28491","646",2023-06-24 18:30:00,-1153,1913,3066,907,FALSE,NA,"0.1.4"
"28492","646",2023-06-24 18:45:00,-1156,1913,3069,907,FALSE,NA,"0.1.4"
"28493","646",2023-06-24 19:00:00,-1156,1913,3069,907,FALSE,NA,"0.1.4"
"28494","646",2023-06-24 19:15:00,-1157,1913,3070,907,FALSE,NA,"0.1.4"
"28495","646",2023-06-24 19:30:00,-1155,1913,3068,907,FALSE,NA,"0.1.4"
"28496","646",2023-06-24 19:45:00,-1154,1913,3067,907,FALSE,NA,"0.1.4"
"28497","646",2023-06-24 20:00:00,-1150,1913,3063,907,FALSE,NA,"0.1.4"
"28498","646",2023-06-24 20:15:00,-1150,1913,3063,907,FALSE,NA,"0.1.4"
"28499","646",2023-06-24 20:30:00,-1151,1913,3064,907,FALSE,NA,"0.1.4"
"28500","646",2023-06-24 20:45:00,-1152,1913,3065,907,FALSE,NA,"0.1.4"
"28501","646",2023-06-24 21:00:00,-1150,1913,3063,907,FALSE,NA,"0.1.4"
"28502","646",2023-06-24 21:15:00,-1152,1913,3065,907,FALSE,NA,"0.1.4"
"28503","646",2023-06-24 21:30:00,-1160,1913,3073,907,FALSE,NA,"0.1.4"
"28504","646",2023-06-24 21:45:00,-1150,1913,3063,907,FALSE,NA,"0.1.4"
"28505","646",2023-06-24 22:00:00,-1148,1913,3061,907,FALSE,NA,"0.1.4"
"28506","646",2023-06-24 22:15:00,-1148,1913,3061,907,FALSE,NA,"0.1.4"
"28507","646",2023-06-24 22:30:00,-1148,1913,3061,907,FALSE,NA,"0.1.4"
"28508","646",2023-06-24 22:45:00,-1148,1913,3061,907,FALSE,NA,"0.1.4"
"28509","646",2023-06-24 23:00:00,-1148,1913,3061,907,FALSE,NA,"0.1.4"
"28510","646",2023-06-24 23:15:00,-1154,1913,3067,907,FALSE,NA,"0.1.4"
"28511","646",2023-06-24 23:30:00,-1154,1913,3067,907,FALSE,NA,"0.1.4"
"28512","646",2023-06-24 23:45:00,-1156,1913,3069,907,FALSE,NA,"0.1.4"
"28513","646",2023-06-25,-1154,1913,3067,907,FALSE,NA,"0.1.4"
"28514","646",2023-06-25 00:15:00,-1154,1913,3067,907,FALSE,NA,"0.1.4"
"28515","646",2023-06-25 00:30:00,-1154,1913,3067,907,FALSE,NA,"0.1.4"
"28516","646",2023-06-25 00:45:00,-1154,1913,3067,907,FALSE,NA,"0.1.4"
"28517","646",2023-06-25 01:00:00,-1153,1913,3066,907,FALSE,NA,"0.1.4"
"28518","646",2023-06-25 01:15:00,-1151,1913,3064,907,FALSE,NA,"0.1.4"
"28519","646",2023-06-25 01:30:00,-1153,1913,3066,907,FALSE,NA,"0.1.4"
"28520","646",2023-06-25 01:45:00,-1160,1913,3073,907,FALSE,NA,"0.1.4"
"28521","646",2023-06-25 02:00:00,-1171,1913,3084,907,FALSE,NA,"0.1.4"
"28522","646",2023-06-25 02:15:00,-1303,1913,3216,907,FALSE,NA,"0.1.4"
"28523","646",2023-06-25 02:30:00,-1183,1913,3096,907,FALSE,NA,"0.1.4"
"28524","646",2023-06-25 02:45:00,-1183,1913,3096,907,FALSE,"jump1","0.1.4"
"28525","646",2023-06-25 03:00:00,-1183,1913,3096,907,FALSE,"jump1","0.1.4"
"28526","646",2023-06-25 03:15:00,-1180,1913,3093,907,FALSE,NA,"0.1.4"
"28527","646",2023-06-25 03:30:00,-1192,1913,3105,907,FALSE,NA,"0.1.4"
"28528","646",2023-06-25 03:45:00,-1171,1913,3084,907,FALSE,NA,"0.1.4"
"28529","646",2023-06-25 04:00:00,-1191,1913,3104,907,FALSE,NA,"0.1.4"
"28530","646",2023-06-25 04:15:00,-1181,1913,3094,907,FALSE,NA,"0.1.4"
"28531","646",2023-06-25 04:30:00,-1207,1913,3120,907,FALSE,NA,"0.1.4"
"28532","646",2023-06-25 04:45:00,-1270,1913,3183,907,FALSE,NA,"0.1.4"
"28533","646",2023-06-25 05:00:00,-1186,1913,3099,907,FALSE,NA,"0.1.4"
"28534","646",2023-06-25 05:15:00,-1194,1913,3107,907,FALSE,NA,"0.1.4"
"28535","646",2023-06-25 05:30:00,-1184,1913,3097,907,FALSE,NA,"0.1.4"
"28536","646",2023-06-25 05:45:00,-1181,1913,3094,907,FALSE,NA,"0.1.4"
"28537","646",2023-06-25 06:00:00,-1181,1913,3094,907,FALSE,"out1, fill","0.1.4"
"28538","646",2023-06-25 06:15:00,-1181,1913,3094,907,FALSE,"jump1","0.1.4"
"28539","646",2023-06-25 06:30:00,-1023,1913,2936,907,FALSE,NA,"0.1.4"
"28540","646",2023-06-25 06:45:00,-1225,1913,3138,907,FALSE,NA,"0.1.4"
"28541","646",2023-06-25 07:00:00,-943,1913,2856,907,FALSE,NA,"0.1.4"
"28542","646",2023-06-25 07:15:00,-943,1913,2856,907,FALSE,"out1, fill","0.1.4"
"28543","646",2023-06-25 07:30:00,-943,1913,2856,907,FALSE,"jump1","0.1.4"
"28544","646",2023-06-25 07:45:00,-942,1913,2855,907,FALSE,NA,"0.1.4"
"28545","646",2023-06-25 08:00:00,-982,1913,2895,907,FALSE,NA,"0.1.4"
"28546","646",2023-06-25 08:15:00,-957,1913,2870,907,FALSE,NA,"0.1.4"
"28547","646",2023-06-25 08:30:00,-943,1913,2856,907,FALSE,NA,"0.1.4"
"28548","646",2023-06-25 08:45:00,-969,1913,2882,907,FALSE,NA,"0.1.4"
"28549","646",2023-06-25 09:00:00,-945,1913,2858,907,FALSE,NA,"0.1.4"
"28550","646",2023-06-25 09:15:00,-952,1913,2865,907,FALSE,NA,"0.1.4"
"28551","646",2023-06-25 09:30:00,-947,1913,2860,907,FALSE,NA,"0.1.4"
"28552","646",2023-06-25 09:45:00,-1000,1913,2913,907,FALSE,NA,"0.1.4"
"28553","646",2023-06-25 10:00:00,-942,1913,2855,907,FALSE,NA,"0.1.4"
"28554","646",2023-06-25 10:15:00,-941,1913,2854,907,FALSE,NA,"0.1.4"
"28555","646",2023-06-25 10:30:00,-941,1913,2854,907,FALSE,NA,"0.1.4"
"28556","646",2023-06-25 10:45:00,-941,1913,2854,907,FALSE,NA,"0.1.4"
"28557","646",2023-06-25 11:00:00,-941,1913,2854,907,FALSE,NA,"0.1.4"
"28558","646",2023-06-25 11:15:00,-969,1913,2882,907,FALSE,NA,"0.1.4"
"28559","646",2023-06-25 11:30:00,-941,1913,2854,907,FALSE,NA,"0.1.4"
"28560","646",2023-06-25 11:45:00,-941,1913,2854,907,FALSE,NA,"0.1.4"
"28561","646",2023-06-25 12:00:00,-941,1913,2854,907,FALSE,NA,"0.1.4"
"28562","646",2023-06-25 12:15:00,-941,1913,2854,907,FALSE,NA,"0.1.4"
"28563","646",2023-06-25 12:30:00,-941,1913,2854,907,FALSE,NA,"0.1.4"
"28564","646",2023-06-25 12:45:00,-1068,1913,2981,907,FALSE,NA,"0.1.4"
"28565","646",2023-06-25 13:00:00,-1343,1913,3256,907,FALSE,NA,"0.1.4"
"28566","646",2023-06-25 13:15:00,-1602,1913,3515,907,FALSE,NA,"0.1.4"
"28567","646",2023-06-25 13:30:00,-1602,1913,3515,907,FALSE,"jump1","0.1.4"
"28568","646",2023-06-25 13:45:00,-1981.5,1913,3894.5,907,FALSE,"out1, fill","0.1.4"
"28569","646",2023-06-25 14:00:00,-2361,1913,4274,907,FALSE,NA,"0.1.4"
"28570","646",2023-06-25 14:15:00,-1973,1913,3886,907,FALSE,NA,"0.1.4"
"28571","646",2023-06-25 14:30:00,-1620,1913,3533,907,FALSE,NA,"0.1.4"
"28572","646",2023-06-25 14:45:00,-1607,1913,3520,907,FALSE,NA,"0.1.4"
"28573","646",2023-06-25 15:00:00,-1605,1913,3518,907,FALSE,NA,"0.1.4"
"28574","646",2023-06-25 15:15:00,-1616,1913,3529,907,FALSE,NA,"0.1.4"
"28575","646",2023-06-25 15:30:00,-1610,1913,3523,907,FALSE,NA,"0.1.4"
"28576","646",2023-06-25 15:45:00,-1603,1913,3516,907,FALSE,NA,"0.1.4"
"28577","646",2023-06-25 16:00:00,-1602,1913,3515,907,FALSE,NA,"0.1.4"
"28578","646",2023-06-25 16:15:00,-1613,1913,3526,907,FALSE,NA,"0.1.4"
"28579","646",2023-06-25 16:30:00,-1605,1913,3518,907,FALSE,NA,"0.1.4"
"28580","646",2023-06-25 16:45:00,-1605,1913,3518,907,FALSE,NA,"0.1.4"
"28581","646",2023-06-25 17:00:00,-1601,1913,3514,907,FALSE,NA,"0.1.4"
"28582","646",2023-06-25 17:15:00,-1603,1913,3516,907,FALSE,NA,"0.1.4"
"28583","646",2023-06-25 17:30:00,-1604,1913,3517,907,FALSE,NA,"0.1.4"
"28584","646",2023-06-25 17:45:00,-1603,1913,3516,907,FALSE,NA,"0.1.4"
"28585","646",2023-06-25 18:00:00,-1602,1913,3515,907,FALSE,NA,"0.1.4"
"28586","646",2023-06-25 18:15:00,-1602,1913,3515,907,FALSE,NA,"0.1.4"
"28587","646",2023-06-25 18:30:00,-1602,1913,3515,907,FALSE,NA,"0.1.4"
"28588","646",2023-06-25 18:45:00,-1601,1913,3514,907,FALSE,NA,"0.1.4"
"28589","646",2023-06-25 19:00:00,-1602,1913,3515,907,FALSE,NA,"0.1.4"
"28590","646",2023-06-25 19:15:00,-1603,1913,3516,907,FALSE,NA,"0.1.4"
"28591","646",2023-06-25 19:30:00,-1602,1913,3515,907,FALSE,NA,"0.1.4"
"28592","646",2023-06-25 19:45:00,-1602,1913,3515,907,FALSE,NA,"0.1.4"
"28593","646",2023-06-25 20:00:00,-1602,1913,3515,907,FALSE,NA,"0.1.4"
"28594","646",2023-06-25 20:15:00,-1602,1913,3515,907,FALSE,NA,"0.1.4"
"28595","646",2023-06-25 20:30:00,-1601,1913,3514,907,FALSE,NA,"0.1.4"
"28596","646",2023-06-25 20:45:00,-1600,1913,3513,907,FALSE,NA,"0.1.4"
"28597","646",2023-06-25 21:00:00,-1600,1913,3513,907,FALSE,NA,"0.1.4"
"28598","646",2023-06-25 21:15:00,-1600,1913,3513,907,FALSE,NA,"0.1.4"
"28599","646",2023-06-25 21:30:00,-1602,1913,3515,907,FALSE,NA,"0.1.4"
"28600","646",2023-06-25 21:45:00,-1602,1913,3515,907,FALSE,NA,"0.1.4"
"28601","646",2023-06-25 22:00:00,-1602,1913,3515,907,FALSE,NA,"0.1.4"
"28602","646",2023-06-25 22:15:00,-1602,1913,3515,907,FALSE,NA,"0.1.4"
"28603","646",2023-06-25 22:30:00,-1602,1913,3515,907,FALSE,NA,"0.1.4"
"28604","646",2023-06-25 22:45:00,-1602,1913,3515,907,FALSE,NA,"0.1.4"
"28605","646",2023-06-25 23:00:00,-1602,1913,3515,907,FALSE,NA,"0.1.4"
"28606","646",2023-06-25 23:15:00,-1602,1913,3515,907,FALSE,NA,"0.1.4"
"28607","646",2023-06-25 23:30:00,-1602,1913,3515,907,FALSE,NA,"0.1.4"
"28608","646",2023-06-25 23:45:00,-1602,1913,3515,907,FALSE,NA,"0.1.4"
"28609","646",2023-06-26,-1602,1913,3515,907,FALSE,NA,"0.1.4"
"28610","646",2023-06-26 00:15:00,-1766,1913,3679,907,FALSE,NA,"0.1.4"
"28611","646",2023-06-26 00:30:00,-1695,1913,3608,907,FALSE,NA,"0.1.4"
"28612","646",2023-06-26 00:45:00,-1605,1913,3518,907,FALSE,NA,"0.1.4"
"28613","646",2023-06-26 01:00:00,-1605,1913,3518,907,FALSE,"jump1","0.1.4"
"28614","646",2023-06-26 01:15:00,-1978,1913,3891,907,FALSE,NA,"0.1.4"
"28615","646",2023-06-26 01:30:00,-1496,1913,3409,907,FALSE,NA,"0.1.4"
"28616","646",2023-06-26 01:45:00,-1256,1913,3169,907,FALSE,NA,"0.1.4"
"28617","646",2023-06-26 02:00:00,-1059,1913,2972,907,FALSE,NA,"0.1.4"
"28618","646",2023-06-26 02:15:00,-981,1913,2894,907,FALSE,NA,"0.1.4"
"28619","646",2023-06-26 02:30:00,-983,1913,2896,907,FALSE,NA,"0.1.4"
"28620","646",2023-06-26 02:45:00,-981,1913,2894,907,FALSE,NA,"0.1.4"
"28621","646",2023-06-26 03:00:00,-981,1913,2894,907,FALSE,NA,"0.1.4"
"28622","646",2023-06-26 03:15:00,-985,1913,2898,907,FALSE,NA,"0.1.4"
"28623","646",2023-06-26 03:30:00,-1055,1913,2968,907,FALSE,NA,"0.1.4"
"28624","646",2023-06-26 03:45:00,-1061,1913,2974,907,FALSE,NA,"0.1.4"
"28625","646",2023-06-26 04:00:00,-1092,1913,3005,907,FALSE,NA,"0.1.4"
"28626","646",2023-06-26 04:15:00,-1446,1913,3359,907,FALSE,NA,"0.1.4"
"28627","646",2023-06-26 04:30:00,-1568,1913,3481,907,FALSE,NA,"0.1.4"
"28628","646",2023-06-26 04:45:00,-1568,1913,3481,907,FALSE,"jump1","0.1.4"
"28629","646",2023-06-26 05:00:00,-1998,1913,3911,907,FALSE,NA,"0.1.4"
"28630","646",2023-06-26 05:15:00,-1559,1913,3472,907,FALSE,NA,"0.1.4"
"28631","646",2023-06-26 05:30:00,-1559,1913,3472,907,FALSE,NA,"0.1.4"
"28632","646",2023-06-26 05:45:00,-1559,1913,3472,907,FALSE,NA,"0.1.4"
"28633","646",2023-06-26 06:00:00,-1559,1913,3472,907,FALSE,NA,"0.1.4"
"28634","646",2023-06-26 06:15:00,-1559,1913,3472,907,FALSE,NA,"0.1.4"
"28635","646",2023-06-26 06:30:00,-1562,1913,3475,907,FALSE,NA,"0.1.4"
"28636","646",2023-06-26 06:45:00,-1559,1913,3472,907,FALSE,NA,"0.1.4"
"28637","646",2023-06-26 07:00:00,-1559,1913,3472,907,FALSE,NA,"0.1.4"
"28638","646",2023-06-26 07:15:00,-1565,1913,3478,907,FALSE,NA,"0.1.4"
"28639","646",2023-06-26 07:30:00,-1560,1913,3473,907,FALSE,NA,"0.1.4"
"28640","646",2023-06-26 07:45:00,-1579,1913,3492,907,FALSE,NA,"0.1.4"
"28641","646",2023-06-26 08:00:00,-1562,1913,3475,907,FALSE,NA,"0.1.4"
"28642","646",2023-06-26 08:15:00,-1559,1913,3472,907,FALSE,NA,"0.1.4"
"28643","646",2023-06-26 08:30:00,-1559,1913,3472,907,FALSE,"jump1","0.1.4"
"28644","646",2023-06-26 08:45:00,-1559,1913,3472,907,FALSE,"jump1","0.1.4"
"28645","646",2023-06-26 09:00:00,-1470,1913,3383,907,FALSE,NA,"0.1.4"
"28646","646",2023-06-26 09:15:00,-1470,1913,3383,907,FALSE,NA,"0.1.4"
"28647","646",2023-06-26 09:30:00,-1472,1913,3385,907,FALSE,NA,"0.1.4"
"28648","646",2023-06-26 09:45:00,-1470,1913,3383,907,FALSE,NA,"0.1.4"
"28649","646",2023-06-26 10:00:00,-1470,1913,3383,907,FALSE,NA,"0.1.4"
"28650","646",2023-06-26 10:15:00,-1472,1913,3385,907,FALSE,NA,"0.1.4"
"28651","646",2023-06-26 10:30:00,-1537,1913,3450,907,FALSE,NA,"0.1.4"
"28652","646",2023-06-26 10:45:00,-1537,1913,3450,907,FALSE,"jump1","0.1.4"
"28653","646",2023-06-26 11:00:00,-1537,1913,3450,907,FALSE,"jump1","0.1.4"
"28654","646",2023-06-26 11:15:00,-1662,1913,3575,907,FALSE,NA,"0.1.4"
"28655","646",2023-06-26 11:30:00,-1667.4,1913,3580.4,907,FALSE,"out1, fill","0.1.4"
"28656","646",2023-06-26 11:45:00,-1672.8,1913,3585.8,907,FALSE,"out1, fill","0.1.4"
"28657","646",2023-06-26 12:00:00,-1678.2,1913,3591.2,907,FALSE,"out1, fill","0.1.4"
"28658","646",2023-06-26 12:15:00,-1683.6,1913,3596.6,907,FALSE,"out1, fill","0.1.4"
"28659","646",2023-06-26 12:30:00,-1689,1913,3602,907,FALSE,NA,"0.1.4"
"28660","646",2023-06-26 12:45:00,-1208,1913,3121,907,FALSE,NA,"0.1.4"
"28661","646",2023-06-26 13:00:00,-1607,1913,3520,907,FALSE,NA,"0.1.4"
"28662","646",2023-06-26 13:15:00,-1633,1913,3546,907,FALSE,NA,"0.1.4"
"28663","646",2023-06-26 13:30:00,-1347,1913,3260,907,FALSE,NA,"0.1.4"
"28664","646",2023-06-26 13:45:00,-1307,1913,3220,907,FALSE,NA,"0.1.4"
"28665","646",2023-06-26 14:00:00,-1129.5,1913,3042.5,907,FALSE,"out1, fill","0.1.4"
"28666","646",2023-06-26 14:15:00,-952,1913,2865,907,FALSE,NA,"0.1.4"
"28667","646",2023-06-26 14:30:00,-1037,1913,2950,907,FALSE,NA,"0.1.4"
"28668","646",2023-06-26 14:45:00,-1103,1913,3016,907,FALSE,NA,"0.1.4"
"28669","646",2023-06-26 15:00:00,-881,1913,2794,907,FALSE,NA,"0.1.4"
"28670","646",2023-06-26 15:15:00,-1002,1913,2915,907,FALSE,NA,"0.1.4"
"28671","646",2023-06-26 15:30:00,-825,1913,2738,907,FALSE,NA,"0.1.4"
"28672","646",2023-06-26 15:45:00,-1037,1913,2950,907,FALSE,NA,"0.1.4"
"28673","646",2023-06-26 16:00:00,-1089,1913,3002,907,FALSE,NA,"0.1.4"
"28674","646",2023-06-26 16:15:00,-1131,1913,3044,907,FALSE,NA,"0.1.4"
"28675","646",2023-06-26 16:30:00,-1403,1913,3316,907,FALSE,NA,"0.1.4"
"28676","646",2023-06-26 16:45:00,-1244,1913,3157,907,FALSE,NA,"0.1.4"
"28677","646",2023-06-26 17:00:00,-1344,1913,3257,907,FALSE,NA,"0.1.4"
"28678","646",2023-06-26 17:15:00,-1021,1913,2934,907,FALSE,NA,"0.1.4"
"28679","646",2023-06-26 17:30:00,-1094,1913,3007,907,FALSE,NA,"0.1.4"
"28680","646",2023-06-26 17:45:00,-1354,1913,3267,907,FALSE,NA,"0.1.4"
"28681","646",2023-06-26 18:00:00,-1189.5,1913,3102.5,907,FALSE,"out1, fill","0.1.4"
"28682","646",2023-06-26 18:15:00,-1025,1913,2938,907,FALSE,NA,"0.1.4"
"28683","646",2023-06-26 18:30:00,-580,1913,2493,907,FALSE,NA,"0.1.4"
"28684","646",2023-06-26 18:45:00,-579,1913,2492,907,FALSE,NA,"0.1.4"
"28685","646",2023-06-26 19:00:00,-220,1913,2133,907,FALSE,NA,"0.1.4"
"28686","646",2023-06-26 19:15:00,-220,1913,2133,907,FALSE,"jump1","0.1.4"
"28687","646",2023-06-26 19:30:00,-220,1913,2133,907,FALSE,"jump1","0.1.4"
"28688","646",2023-06-26 19:45:00,-638.5,1913,2551.5,907,FALSE,"out1, fill","0.1.4"
"28689","646",2023-06-26 20:00:00,-1057,1913,2970,907,FALSE,NA,"0.1.4"
"28690","646",2023-06-26 20:15:00,-705,1913,2618,907,FALSE,NA,"0.1.4"
"28691","646",2023-06-26 20:30:00,-884,1913,2797,907,FALSE,NA,"0.1.4"
"28692","646",2023-06-26 20:45:00,-1019,1913,2932,907,FALSE,NA,"0.1.4"
"28693","646",2023-06-26 21:00:00,-855.5,1913,2768.5,907,FALSE,"out1, fill","0.1.4"
"28694","646",2023-06-26 21:15:00,-692,1913,2605,907,FALSE,NA,"0.1.4"
"28695","646",2023-06-26 21:30:00,-234,1913,2147,907,FALSE,NA,"0.1.4"
"28696","646",2023-06-26 21:45:00,-734,1913,2647,907,FALSE,NA,"0.1.4"
"28697","646",2023-06-26 22:00:00,-396,1913,2309,907,FALSE,NA,"0.1.4"
"28698","646",2023-06-26 22:15:00,-678,1913,2591,907,FALSE,NA,"0.1.4"
"28699","646",2023-06-26 22:30:00,-589,1913,2502,907,FALSE,NA,"0.1.4"
"28700","646",2023-06-26 22:45:00,-635,1913,2548,907,FALSE,NA,"0.1.4"
"28701","646",2023-06-26 23:00:00,-377,1913,2290,907,FALSE,NA,"0.1.4"
"28702","646",2023-06-26 23:15:00,-778,1913,2691,907,FALSE,NA,"0.1.4"
"28703","646",2023-06-26 23:30:00,-844,1913,2757,907,FALSE,NA,"0.1.4"
"28704","646",2023-06-26 23:45:00,-1212,1913,3125,907,FALSE,NA,"0.1.4"
"28705","646",2023-06-27,-987,1913,2900,907,FALSE,NA,"0.1.4"
"28706","646",2023-06-27 00:15:00,-1311,1913,3224,907,FALSE,NA,"0.1.4"
"28707","646",2023-06-27 00:30:00,-933.5,1913,2846.5,907,FALSE,"out1, fill","0.1.4"
"28708","646",2023-06-27 00:45:00,-556,1913,2469,907,FALSE,NA,"0.1.4"
"28709","646",2023-06-27 01:00:00,-783,1913,2696,907,FALSE,NA,"0.1.4"
"28710","646",2023-06-27 01:15:00,-1034,1913,2947,907,FALSE,NA,"0.1.4"
"28711","646",2023-06-27 01:30:00,-1045,1913,2958,907,FALSE,NA,"0.1.4"
"28712","646",2023-06-27 01:45:00,-895,1913,2808,907,FALSE,NA,"0.1.4"
"28713","646",2023-06-27 02:00:00,-792,1913,2705,907,FALSE,NA,"0.1.4"
"28714","646",2023-06-27 02:15:00,-966,1913,2879,907,FALSE,NA,"0.1.4"
"28715","646",2023-06-27 02:30:00,-940,1913,2853,907,FALSE,NA,"0.1.4"
"28716","646",2023-06-27 02:45:00,-452,1913,2365,907,FALSE,NA,"0.1.4"
"28717","646",2023-06-27 03:00:00,-194,1913,2107,907,FALSE,NA,"0.1.4"
"28718","646",2023-06-27 03:15:00,-223,1913,2136,907,FALSE,NA,"0.1.4"
"28719","646",2023-06-27 03:30:00,-192,1913,2105,907,FALSE,NA,"0.1.4"
"28720","646",2023-06-27 03:45:00,-609,1913,2522,907,FALSE,NA,"0.1.4"
"28721","646",2023-06-27 04:00:00,-201,1913,2114,907,FALSE,NA,"0.1.4"
"28722","646",2023-06-27 04:15:00,-192,1913,2105,907,FALSE,NA,"0.1.4"
"28723","646",2023-06-27 04:30:00,-264,1913,2177,907,FALSE,NA,"0.1.4"
"28724","646",2023-06-27 04:45:00,-258.8,1913,2171.8,907,FALSE,"out1, fill","0.1.4"
"28725","646",2023-06-27 05:00:00,-253.6,1913,2166.6,907,FALSE,"out1, fill","0.1.4"
"28726","646",2023-06-27 05:15:00,-248.4,1913,2161.4,907,FALSE,"out1, fill","0.1.4"
"28727","646",2023-06-27 05:30:00,-243.2,1913,2156.2,907,FALSE,"out1, fill","0.1.4"
"28728","646",2023-06-27 05:45:00,-238,1913,2151,907,FALSE,NA,"0.1.4"
"28729","646",2023-06-27 06:00:00,-196,1913,2109,907,FALSE,NA,"0.1.4"
"28730","646",2023-06-27 06:15:00,-243,1913,2156,907,FALSE,NA,"0.1.4"
"28731","646",2023-06-27 06:30:00,-195,1913,2108,907,FALSE,NA,"0.1.4"
"28732","646",2023-06-27 06:45:00,-530,1913,2443,907,FALSE,"out1, fill","0.1.4"
"28733","646",2023-06-27 07:00:00,-865,1913,2778,907,FALSE,NA,"0.1.4"
"28734","646",2023-06-27 07:15:00,-865,1913,2778,907,FALSE,"jump1","0.1.4"
"28735","646",2023-06-27 07:30:00,-1276,1913,3189,907,FALSE,NA,"0.1.4"
"28736","646",2023-06-27 07:45:00,-1276,1913,3189,907,FALSE,"jump1","0.1.4"
"28737","646",2023-06-27 08:00:00,-1276,1913,3189,907,FALSE,"out1, fill","0.1.4"
"28738","646",2023-06-27 08:15:00,-1276,1913,3189,907,FALSE,"jump1","0.1.4"
"28739","646",2023-06-27 08:30:00,-1278,1913,3191,907,FALSE,NA,"0.1.4"
"28740","646",2023-06-27 08:45:00,-1405,1913,3318,907,FALSE,NA,"0.1.4"
"28741","646",2023-06-27 09:00:00,-1306,1913,3219,907,FALSE,NA,"0.1.4"
"28742","646",2023-06-27 09:15:00,-1280,1913,3193,907,FALSE,NA,"0.1.4"
"28743","646",2023-06-27 09:30:00,-1278,1913,3191,907,FALSE,NA,"0.1.4"
"28744","646",2023-06-27 09:45:00,-1337,1913,3250,907,FALSE,NA,"0.1.4"
"28745","646",2023-06-27 10:00:00,-1337,1913,3250,907,FALSE,"jump1","0.1.4"
"28746","646",2023-06-27 10:15:00,-1337,1913,3250,907,FALSE,"jump1","0.1.4"
"28747","646",2023-06-27 10:30:00,-1759,1913,3672,907,FALSE,NA,"0.1.4"
"28748","646",2023-06-27 10:45:00,-1800,1913,3713,907,FALSE,NA,"0.1.4"
"28749","646",2023-06-27 11:00:00,-1951,1913,3864,907,FALSE,NA,"0.1.4"
"28750","646",2023-06-27 11:15:00,-1889,1913,3802,907,FALSE,NA,"0.1.4"
"28751","646",2023-06-27 11:30:00,-1889,1913,3802,907,FALSE,"jump1","0.1.4"
"28752","646",2023-06-27 11:45:00,-1900,1913,3813,907,FALSE,NA,"0.1.4"
"28753","646",2023-06-27 12:00:00,-1888,1913,3801,907,FALSE,NA,"0.1.4"
"28754","646",2023-06-27 12:15:00,-1887,1913,3800,907,FALSE,NA,"0.1.4"
"28755","646",2023-06-27 12:30:00,-1881,1913,3794,907,FALSE,NA,"0.1.4"
"28756","646",2023-06-27 12:45:00,-1887,1913,3800,907,FALSE,NA,"0.1.4"
"28757","646",2023-06-27 13:00:00,-1880,1913,3793,907,FALSE,NA,"0.1.4"
"28758","646",2023-06-27 13:15:00,-1873,1913,3786,907,FALSE,NA,"0.1.4"
"28759","646",2023-06-27 13:30:00,-1897,1913,3810,907,FALSE,NA,"0.1.4"
"28760","646",2023-06-27 13:45:00,-2138,1913,4051,907,FALSE,NA,"0.1.4"
"28761","646",2023-06-27 14:00:00,-1874,1913,3787,907,FALSE,NA,"0.1.4"
"28762","646",2023-06-27 14:15:00,-1880,1913,3793,907,FALSE,NA,"0.1.4"
"28763","646",2023-06-27 14:30:00,-1884,1913,3797,907,FALSE,NA,"0.1.4"
"28764","646",2023-06-27 14:45:00,-1886,1913,3799,907,FALSE,NA,"0.1.4"
"28765","646",2023-06-27 15:00:00,-1882,1913,3795,907,FALSE,NA,"0.1.4"
"28766","646",2023-06-27 15:15:00,-1880,1913,3793,907,FALSE,NA,"0.1.4"
"28767","646",2023-06-27 15:30:00,-1883,1913,3796,907,FALSE,NA,"0.1.4"
"28768","646",2023-06-27 15:45:00,-1879,1913,3792,907,FALSE,NA,"0.1.4"
"28769","646",2023-06-27 16:00:00,-1872,1913,3785,907,FALSE,NA,"0.1.4"
"28770","646",2023-06-27 16:15:00,-1885,1913,3798,907,FALSE,NA,"0.1.4"
"28771","646",2023-06-27 16:30:00,-1881,1913,3794,907,FALSE,NA,"0.1.4"
"28772","646",2023-06-27 16:45:00,-1876,1913,3789,907,FALSE,NA,"0.1.4"
"28773","646",2023-06-27 17:00:00,-1882,1913,3795,907,FALSE,NA,"0.1.4"
"28774","646",2023-06-27 17:15:00,-1884,1913,3797,907,FALSE,NA,"0.1.4"
"28775","646",2023-06-27 17:30:00,-1885,1913,3798,907,FALSE,NA,"0.1.4"
"28776","646",2023-06-27 17:45:00,-1886,1913,3799,907,FALSE,NA,"0.1.4"
"28777","646",2023-06-27 18:00:00,-1884,1913,3797,907,FALSE,NA,"0.1.4"
"28778","646",2023-06-27 18:15:00,-1876,1913,3789,907,FALSE,NA,"0.1.4"
"28779","646",2023-06-27 18:30:00,-1886,1913,3799,907,FALSE,NA,"0.1.4"
"28780","646",2023-06-27 18:45:00,-1884,1913,3797,907,FALSE,NA,"0.1.4"
"28781","646",2023-06-27 19:00:00,-1880,1913,3793,907,FALSE,NA,"0.1.4"
"28782","646",2023-06-27 19:15:00,-1880,1913,3793,907,FALSE,NA,"0.1.4"
"28783","646",2023-06-27 19:30:00,-1887,1913,3800,907,FALSE,NA,"0.1.4"
"28784","646",2023-06-27 19:45:00,-1884,1913,3797,907,FALSE,NA,"0.1.4"
"28785","646",2023-06-27 20:00:00,-1885,1913,3798,907,FALSE,NA,"0.1.4"
"28786","646",2023-06-27 20:15:00,-1884,1913,3797,907,FALSE,NA,"0.1.4"
"28787","646",2023-06-27 20:30:00,-1883,1913,3796,907,FALSE,NA,"0.1.4"
"28788","646",2023-06-27 20:45:00,-1880,1913,3793,907,FALSE,NA,"0.1.4"
"28789","646",2023-06-27 21:00:00,-1885,1913,3798,907,FALSE,NA,"0.1.4"
"28790","646",2023-06-27 21:15:00,-1881,1913,3794,907,FALSE,NA,"0.1.4"
"28791","646",2023-06-27 21:30:00,-1883,1913,3796,907,FALSE,NA,"0.1.4"
"28792","646",2023-06-27 21:45:00,-1884,1913,3797,907,FALSE,NA,"0.1.4"
"28793","646",2023-06-27 22:00:00,-1884,1913,3797,907,FALSE,NA,"0.1.4"
"28794","646",2023-06-27 22:15:00,-1885,1913,3798,907,FALSE,NA,"0.1.4"
"28795","646",2023-06-27 22:30:00,-1884,1913,3797,907,FALSE,NA,"0.1.4"
"28796","646",2023-06-27 22:45:00,-1886,1913,3799,907,FALSE,NA,"0.1.4"
"28797","646",2023-06-27 23:00:00,-1886,1913,3799,907,FALSE,NA,"0.1.4"
"28798","646",2023-06-27 23:15:00,-1886,1913,3799,907,FALSE,NA,"0.1.4"
"28799","646",2023-06-27 23:30:00,-1879,1913,3792,907,FALSE,NA,"0.1.4"
"28800","646",2023-06-27 23:45:00,-1884,1913,3797,907,FALSE,NA,"0.1.4"
"28801","646",2023-06-28,-1881,1913,3794,907,FALSE,NA,"0.1.4"
"28802","646",2023-06-28 00:15:00,-1881,1913,3794,907,FALSE,NA,"0.1.4"
"28803","646",2023-06-28 00:30:00,-1882,1913,3795,907,FALSE,NA,"0.1.4"
"28804","646",2023-06-28 00:45:00,-1881,1913,3794,907,FALSE,NA,"0.1.4"
"28805","646",2023-06-28 01:00:00,-1875,1913,3788,907,FALSE,NA,"0.1.4"
"28806","646",2023-06-28 01:15:00,-1877,1913,3790,907,FALSE,NA,"0.1.4"
"28807","646",2023-06-28 01:30:00,-1904,1913,3817,907,FALSE,NA,"0.1.4"
"28808","646",2023-06-28 01:45:00,-1923,1913,3836,907,FALSE,NA,"0.1.4"
"28809","646",2023-06-28 02:00:00,-1881,1913,3794,907,FALSE,NA,"0.1.4"
"28810","646",2023-06-28 02:15:00,-1883,1913,3796,907,FALSE,NA,"0.1.4"
"28811","646",2023-06-28 02:30:00,-1863,1913,3776,907,FALSE,NA,"0.1.4"
"28812","646",2023-06-28 02:45:00,-1972,1913,3885,907,FALSE,NA,"0.1.4"
"28813","646",2023-06-28 03:00:00,-1881,1913,3794,907,FALSE,NA,"0.1.4"
"28814","646",2023-06-28 03:15:00,-1859,1913,3772,907,FALSE,NA,"0.1.4"
"28815","646",2023-06-28 03:30:00,-1872,1913,3785,907,FALSE,NA,"0.1.4"
"28816","646",2023-06-28 03:45:00,-1874,1913,3787,907,FALSE,NA,"0.1.4"
"28817","646",2023-06-28 04:00:00,-1879,1913,3792,907,FALSE,NA,"0.1.4"
"28818","646",2023-06-28 04:15:00,-1884,1913,3797,907,FALSE,NA,"0.1.4"
"28819","646",2023-06-28 04:30:00,-1858,1913,3771,907,FALSE,NA,"0.1.4"
"28820","646",2023-06-28 04:45:00,-1877,1913,3790,907,FALSE,NA,"0.1.4"
"28821","646",2023-06-28 05:00:00,-1881,1913,3794,907,FALSE,NA,"0.1.4"
"28822","646",2023-06-28 05:15:00,-1957,1913,3870,907,FALSE,NA,"0.1.4"
"28823","646",2023-06-28 05:30:00,-1914,1913,3827,907,FALSE,NA,"0.1.4"
"28824","646",2023-06-28 05:45:00,-1887,1913,3800,907,FALSE,NA,"0.1.4"
"28825","646",2023-06-28 06:00:00,-1865,1913,3778,907,FALSE,NA,"0.1.4"
"28826","646",2023-06-28 06:15:00,-1903,1913,3816,907,FALSE,NA,"0.1.4"
"28827","646",2023-06-28 06:30:00,-1895.33333333333,1913,3808.33333333333,907,FALSE,"out1, fill","0.1.4"
"28828","646",2023-06-28 06:45:00,-1887.66666666667,1913,3800.66666666667,907,FALSE,"out1, fill","0.1.4"
"28829","646",2023-06-28 07:00:00,-1880,1913,3793,907,FALSE,NA,"0.1.4"
"28830","646",2023-06-28 07:15:00,-2352,1913,4265,907,FALSE,NA,"0.1.4"
"28831","646",2023-06-28 07:30:00,-2352,1913,4265,907,FALSE,"jump1","0.1.4"
"28832","646",2023-06-28 07:45:00,-2499,1913,4412,907,FALSE,NA,"0.1.4"
"28833","646",2023-06-28 08:00:00,-2375,1913,4288,907,FALSE,NA,"0.1.4"
"28834","646",2023-06-28 08:15:00,-2375,1913,4288,907,FALSE,NA,"0.1.4"
"28835","646",2023-06-28 08:30:00,-2389,1913,4302,907,FALSE,NA,"0.1.4"
"28836","646",2023-06-28 08:45:00,-2368,1913,4281,907,FALSE,NA,"0.1.4"
"28837","646",2023-06-28 09:00:00,-2500,1913,4413,907,FALSE,NA,"0.1.4"
"28838","646",2023-06-28 09:15:00,-2500,1913,4413,907,FALSE,"jump1","0.1.4"
"28839","646",2023-06-28 09:30:00,-2663,1913,4576,907,FALSE,NA,"0.1.4"
"28840","646",2023-06-28 09:45:00,-2241,1913,4154,907,FALSE,"out1, fill","0.1.4"
"28841","646",2023-06-28 10:00:00,-1819,1913,3732,907,FALSE,NA,"0.1.4"
"28842","646",2023-06-28 10:15:00,-1822,1913,3735,907,FALSE,NA,"0.1.4"
"28843","646",2023-06-28 10:30:00,-1803,1913,3716,907,FALSE,NA,"0.1.4"
"28844","646",2023-06-28 10:45:00,-1832,1913,3745,907,FALSE,NA,"0.1.4"
"28845","646",2023-06-28 11:00:00,-2009,1913,3922,907,FALSE,NA,"0.1.4"
"28846","646",2023-06-28 11:15:00,-1960,1913,3873,907,FALSE,NA,"0.1.4"
"28847","646",2023-06-28 11:30:00,-1960,1913,3873,907,FALSE,"jump1","0.1.4"
"28848","646",2023-06-28 11:45:00,-2362,1913,4275,907,FALSE,NA,"0.1.4"
"28849","646",2023-06-28 12:00:00,-2004,1913,3917,907,FALSE,NA,"0.1.4"
"28850","646",2023-06-28 12:15:00,-2007,1913,3920,907,FALSE,NA,"0.1.4"
"28851","646",2023-06-28 12:30:00,-1878,1913,3791,907,FALSE,NA,"0.1.4"
"28852","646",2023-06-28 12:45:00,-2187,1913,4100,907,FALSE,NA,"0.1.4"
"28853","646",2023-06-28 13:00:00,-2187,1913,4100,907,FALSE,"jump1","0.1.4"
"28854","646",2023-06-28 13:15:00,-2003,1913,3916,907,FALSE,NA,"0.1.4"
"28855","646",2023-06-28 13:30:00,-2010,1913,3923,907,FALSE,NA,"0.1.4"
"28856","646",2023-06-28 13:45:00,-2002,1913,3915,907,FALSE,NA,"0.1.4"
"28857","646",2023-06-28 14:00:00,-1999,1913,3912,907,FALSE,NA,"0.1.4"
"28858","646",2023-06-28 14:15:00,-2000,1913,3913,907,FALSE,NA,"0.1.4"
"28859","646",2023-06-28 14:30:00,-1998,1913,3911,907,FALSE,NA,"0.1.4"
"28860","646",2023-06-28 14:45:00,-1997,1913,3910,907,FALSE,NA,"0.1.4"
"28861","646",2023-06-28 15:00:00,-1979,1913,3892,907,FALSE,NA,"0.1.4"
"28862","646",2023-06-28 15:15:00,-1997,1913,3910,907,FALSE,NA,"0.1.4"
"28863","646",2023-06-28 15:30:00,-1970,1913,3883,907,FALSE,NA,"0.1.4"
"28864","646",2023-06-28 15:45:00,-1955,1913,3868,907,FALSE,NA,"0.1.4"
"28865","646",2023-06-28 16:00:00,-1960,1913,3873,907,FALSE,NA,"0.1.4"
"28866","646",2023-06-28 16:15:00,-1967,1913,3880,907,FALSE,NA,"0.1.4"
"28867","646",2023-06-28 16:30:00,-1916,1913,3829,907,FALSE,NA,"0.1.4"
"28868","646",2023-06-28 16:45:00,-1934,1913,3847,907,FALSE,NA,"0.1.4"
"28869","646",2023-06-28 17:00:00,-1913,1913,3826,907,FALSE,NA,"0.1.4"
"28870","646",2023-06-28 17:15:00,-1951,1913,3864,907,FALSE,NA,"0.1.4"
"28871","646",2023-06-28 17:30:00,-1968,1913,3881,907,FALSE,NA,"0.1.4"
"28872","646",2023-06-28 17:45:00,-1944,1913,3857,907,FALSE,NA,"0.1.4"
"28873","646",2023-06-28 18:00:00,-1942,1913,3855,907,FALSE,NA,"0.1.4"
"28874","646",2023-06-28 18:15:00,-1948,1913,3861,907,FALSE,NA,"0.1.4"
"28875","646",2023-06-28 18:30:00,-1952,1913,3865,907,FALSE,NA,"0.1.4"
"28876","646",2023-06-28 18:45:00,-1984,1913,3897,907,FALSE,NA,"0.1.4"
"28877","646",2023-06-28 19:00:00,-1981,1913,3894,907,FALSE,NA,"0.1.4"
"28878","646",2023-06-28 19:15:00,-1974,1913,3887,907,FALSE,NA,"0.1.4"
"28879","646",2023-06-28 19:30:00,-1965,1913,3878,907,FALSE,NA,"0.1.4"
"28880","646",2023-06-28 19:45:00,-1948,1913,3861,907,FALSE,NA,"0.1.4"
"28881","646",2023-06-28 20:00:00,-1960,1913,3873,907,FALSE,NA,"0.1.4"
"28882","646",2023-06-28 20:15:00,-1983,1913,3896,907,FALSE,NA,"0.1.4"
"28883","646",2023-06-28 20:30:00,-1983,1913,3896,907,FALSE,NA,"0.1.4"
"28884","646",2023-06-28 20:45:00,-1966,1913,3879,907,FALSE,NA,"0.1.4"
"28885","646",2023-06-28 21:00:00,-1932,1913,3845,907,FALSE,NA,"0.1.4"
"28886","646",2023-06-28 21:15:00,-1936,1913,3849,907,FALSE,NA,"0.1.4"
"28887","646",2023-06-28 21:30:00,-1934,1913,3847,907,FALSE,NA,"0.1.4"
"28888","646",2023-06-28 21:45:00,-1934,1913,3847,907,FALSE,NA,"0.1.4"
"28889","646",2023-06-28 22:00:00,-1932,1913,3845,907,FALSE,NA,"0.1.4"
"28890","646",2023-06-28 22:15:00,-1930,1913,3843,907,FALSE,NA,"0.1.4"
"28891","646",2023-06-28 22:30:00,-1949,1913,3862,907,FALSE,NA,"0.1.4"
"28892","646",2023-06-28 22:45:00,-1928,1913,3841,907,FALSE,NA,"0.1.4"
"28893","646",2023-06-28 23:00:00,-1944,1913,3857,907,FALSE,NA,"0.1.4"
"28894","646",2023-06-28 23:15:00,-1945,1913,3858,907,FALSE,NA,"0.1.4"
"28895","646",2023-06-28 23:30:00,-1937,1913,3850,907,FALSE,NA,"0.1.4"
"28896","646",2023-06-28 23:45:00,-1959,1913,3872,907,FALSE,NA,"0.1.4"
"28897","646",2023-06-29,-1978,1913,3891,907,FALSE,NA,"0.1.4"
"28898","646",2023-06-29 00:15:00,-1948,1913,3861,907,FALSE,NA,"0.1.4"
"28899","646",2023-06-29 00:30:00,-1988,1913,3901,907,FALSE,NA,"0.1.4"
"28900","646",2023-06-29 00:45:00,-1991,1913,3904,907,FALSE,NA,"0.1.4"
"28901","646",2023-06-29 01:00:00,-1996,1913,3909,907,FALSE,NA,"0.1.4"
"28902","646",2023-06-29 01:15:00,-1996,1913,3909,907,FALSE,NA,"0.1.4"
"28903","646",2023-06-29 01:30:00,-1993,1913,3906,907,FALSE,NA,"0.1.4"
"28904","646",2023-06-29 01:45:00,-1882,1913,3795,907,FALSE,NA,"0.1.4"
"28905","646",2023-06-29 02:00:00,-2025,1913,3938,907,FALSE,NA,"0.1.4"
"28906","646",2023-06-29 02:15:00,-1937,1913,3850,907,FALSE,NA,"0.1.4"
"28907","646",2023-06-29 02:30:00,-1960,1913,3873,907,FALSE,NA,"0.1.4"
"28908","646",2023-06-29 02:45:00,-1947,1913,3860,907,FALSE,NA,"0.1.4"
"28909","646",2023-06-29 03:00:00,-2002,1913,3915,907,FALSE,NA,"0.1.4"
"28910","646",2023-06-29 03:15:00,-1991,1913,3904,907,FALSE,NA,"0.1.4"
"28911","646",2023-06-29 03:30:00,-2000,1913,3913,907,FALSE,NA,"0.1.4"
"28912","646",2023-06-29 03:45:00,-2000,1913,3913,907,FALSE,NA,"0.1.4"
"28913","646",2023-06-29 04:00:00,-2000,1913,3913,907,FALSE,NA,"0.1.4"
"28914","646",2023-06-29 04:15:00,-2000,1913,3913,907,FALSE,NA,"0.1.4"
"28915","646",2023-06-29 04:30:00,-1994,1913,3907,907,FALSE,NA,"0.1.4"
"28916","646",2023-06-29 04:45:00,-1999,1913,3912,907,FALSE,NA,"0.1.4"
"28917","646",2023-06-29 05:00:00,-1945,1913,3858,907,FALSE,NA,"0.1.4"
"28918","646",2023-06-29 05:15:00,-1999,1913,3912,907,FALSE,NA,"0.1.4"
"28919","646",2023-06-29 05:30:00,-2165,1913,4078,907,FALSE,NA,"0.1.4"
"28920","646",2023-06-29 05:45:00,-1998,1913,3911,907,FALSE,NA,"0.1.4"
"28921","646",2023-06-29 06:00:00,-1989,1913,3902,907,FALSE,NA,"0.1.4"
"28922","646",2023-06-29 06:15:00,-2105,1913,4018,907,FALSE,NA,"0.1.4"
"28923","646",2023-06-29 06:30:00,-2000,1913,3913,907,FALSE,NA,"0.1.4"
"28924","646",2023-06-29 06:45:00,-2008,1913,3921,907,FALSE,NA,"0.1.4"
"28925","646",2023-06-29 07:00:00,-2175,1913,4088,907,FALSE,NA,"0.1.4"
"28926","646",2023-06-29 07:15:00,-1998,1913,3911,907,FALSE,NA,"0.1.4"
"28927","646",2023-06-29 07:30:00,-1920,1913,3833,907,FALSE,NA,"0.1.4"
"28928","646",2023-06-29 07:45:00,-1935,1913,3848,907,FALSE,NA,"0.1.4"
"28929","646",2023-06-29 08:00:00,-2024,1913,3937,907,FALSE,NA,"0.1.4"
"28930","646",2023-06-29 08:15:00,-2013,1913,3926,907,FALSE,NA,"0.1.4"
"28931","646",2023-06-29 08:30:00,-1955,1913,3868,907,FALSE,NA,"0.1.4"
"28932","646",2023-06-29 08:45:00,-1950,1913,3863,907,FALSE,NA,"0.1.4"
"28933","646",2023-06-29 09:00:00,-1936,1913,3849,907,FALSE,NA,"0.1.4"
"28934","646",2023-06-29 09:15:00,-2002,1913,3915,907,FALSE,NA,"0.1.4"
"28935","646",2023-06-29 09:30:00,-1954,1913,3867,907,FALSE,NA,"0.1.4"
"28936","646",2023-06-29 09:45:00,-1946,1913,3859,907,FALSE,NA,"0.1.4"
"28937","646",2023-06-29 10:00:00,-1936,1913,3849,907,FALSE,NA,"0.1.4"
"28938","646",2023-06-29 10:15:00,-1951,1913,3864,907,FALSE,NA,"0.1.4"
"28939","646",2023-06-29 10:30:00,-1944,1913,3857,907,FALSE,NA,"0.1.4"
"28940","646",2023-06-29 10:45:00,-2255,1913,4168,907,FALSE,NA,"0.1.4"
"28941","646",2023-06-29 11:00:00,-1951,1913,3864,907,FALSE,NA,"0.1.4"
"28942","646",2023-06-29 11:15:00,-1946,1913,3859,907,FALSE,NA,"0.1.4"
"28943","646",2023-06-29 11:30:00,-1950,1913,3863,907,FALSE,NA,"0.1.4"
"28944","646",2023-06-29 11:45:00,-1950,1913,3863,907,FALSE,NA,"0.1.4"
"28945","646",2023-06-29 12:00:00,-1987,1913,3900,907,FALSE,NA,"0.1.4"
"28946","646",2023-06-29 12:15:00,-1934,1913,3847,907,FALSE,NA,"0.1.4"
"28947","646",2023-06-29 12:30:00,-1944,1913,3857,907,FALSE,NA,"0.1.4"
"28948","646",2023-06-29 12:45:00,-1949,1913,3862,907,FALSE,NA,"0.1.4"
"28949","646",2023-06-29 13:00:00,-1975.5,1913,3888.5,907,FALSE,"out1, fill","0.1.4"
"28950","646",2023-06-29 13:15:00,-2002,1913,3915,907,FALSE,"out1, fill","0.1.4"
"28951","646",2023-06-29 13:30:00,-2028.5,1913,3941.5,907,FALSE,"out1, fill","0.1.4"
"28952","646",2023-06-29 13:45:00,-2055,1913,3968,907,FALSE,"out1, fill","0.1.4"
"28953","646",2023-06-29 14:00:00,-2081.5,1913,3994.5,907,FALSE,"out1, fill","0.1.4"
"28954","646",2023-06-29 14:15:00,-2108,1913,4021,907,FALSE,NA,"0.1.4"
"28955","646",2023-06-29 14:30:00,-2221,1913,4134,907,FALSE,NA,"0.1.4"
"28956","646",2023-06-29 14:45:00,-2143,1913,4056,907,FALSE,NA,"0.1.4"
"28957","646",2023-06-29 15:00:00,-2181,1913,4094,907,FALSE,NA,"0.1.4"
"28958","646",2023-06-29 15:15:00,-2184,1913,4097,907,FALSE,NA,"0.1.4"
"28959","646",2023-06-29 15:30:00,-2103,1913,4016,907,FALSE,NA,"0.1.4"
"28960","646",2023-06-29 15:45:00,-2097,1913,4010,907,FALSE,NA,"0.1.4"
"28961","646",2023-06-29 16:00:00,-2131,1913,4044,907,FALSE,NA,"0.1.4"
"28962","646",2023-06-29 16:15:00,-2148,1913,4061,907,FALSE,NA,"0.1.4"
"28963","646",2023-06-29 16:30:00,-2144,1913,4057,907,FALSE,NA,"0.1.4"
"28964","646",2023-06-29 16:45:00,-2096,1913,4009,907,FALSE,NA,"0.1.4"
"28965","646",2023-06-29 17:00:00,-1953,1913,3866,907,FALSE,NA,"0.1.4"
"28966","646",2023-06-29 17:15:00,-1953,1913,3866,907,FALSE,NA,"0.1.4"
"28967","646",2023-06-29 17:30:00,-1970,1913,3883,907,FALSE,NA,"0.1.4"
"28968","646",2023-06-29 17:45:00,-2366,1913,4279,907,FALSE,NA,"0.1.4"
"28969","646",2023-06-29 18:00:00,-1951,1913,3864,907,FALSE,NA,"0.1.4"
"28970","646",2023-06-29 18:15:00,-1950,1913,3863,907,FALSE,NA,"0.1.4"
"28971","646",2023-06-29 18:30:00,-1956,1913,3869,907,FALSE,NA,"0.1.4"
"28972","646",2023-06-29 18:45:00,-1953,1913,3866,907,FALSE,NA,"0.1.4"
"28973","646",2023-06-29 19:00:00,-1954,1913,3867,907,FALSE,NA,"0.1.4"
"28974","646",2023-06-29 19:15:00,-1952,1913,3865,907,FALSE,NA,"0.1.4"
"28975","646",2023-06-29 19:30:00,-1953,1913,3866,907,FALSE,NA,"0.1.4"
"28976","646",2023-06-29 19:45:00,-1951,1913,3864,907,FALSE,NA,"0.1.4"
"28977","646",2023-06-29 20:00:00,-1950,1913,3863,907,FALSE,NA,"0.1.4"
"28978","646",2023-06-29 20:15:00,-2006,1913,3919,907,FALSE,NA,"0.1.4"
"28979","646",2023-06-29 20:30:00,-2079,1913,3992,907,FALSE,NA,"0.1.4"
"28980","646",2023-06-29 20:45:00,-2148,1913,4061,907,FALSE,NA,"0.1.4"
"28981","646",2023-06-29 21:00:00,-2146,1913,4059,907,FALSE,NA,"0.1.4"
"28982","646",2023-06-29 21:15:00,-2043,1913,3956,907,FALSE,NA,"0.1.4"
"28983","646",2023-06-29 21:30:00,-2051,1913,3964,907,FALSE,NA,"0.1.4"
"28984","646",2023-06-29 21:45:00,-2007,1913,3920,907,FALSE,NA,"0.1.4"
"28985","646",2023-06-29 22:00:00,-1990,1913,3903,907,FALSE,NA,"0.1.4"
"28986","646",2023-06-29 22:15:00,-2011,1913,3924,907,FALSE,NA,"0.1.4"
"28987","646",2023-06-29 22:30:00,-1975,1913,3888,907,FALSE,NA,"0.1.4"
"28988","646",2023-06-29 22:45:00,-1983,1913,3896,907,FALSE,NA,"0.1.4"
"28989","646",2023-06-29 23:00:00,-1986,1913,3899,907,FALSE,NA,"0.1.4"
"28990","646",2023-06-29 23:15:00,-1994,1913,3907,907,FALSE,NA,"0.1.4"
"28991","646",2023-06-29 23:30:00,-1963,1913,3876,907,FALSE,NA,"0.1.4"
"28992","646",2023-06-29 23:45:00,-1948,1913,3861,907,FALSE,NA,"0.1.4"
"28993","646",2023-06-30,-2195,1913,4108,907,FALSE,NA,"0.1.4"
"28994","646",2023-06-30 00:15:00,-2539,1913,4452,907,FALSE,NA,"0.1.4"
"28995","646",2023-06-30 00:30:00,-2500,1913,4413,907,FALSE,NA,"0.1.4"
"28996","646",2023-06-30 00:45:00,-2500,1913,4413,907,FALSE,"jump1","0.1.4"
"28997","646",2023-06-30 01:00:00,-2947,1913,4860,907,FALSE,"out1, fill","0.1.4"
"28998","646",2023-06-30 01:15:00,-3394,1913,5307,907,FALSE,NA,"0.1.4"
"28999","646",2023-06-30 01:30:00,-3530,1913,5443,907,FALSE,NA,"0.1.4"
"29000","646",2023-06-30 01:45:00,-3709,1913,5622,907,FALSE,NA,"0.1.4"
"29001","646",2023-06-30 02:00:00,-3432,1913,5345,907,FALSE,NA,"0.1.4"
"29002","646",2023-06-30 02:15:00,-3673,1913,5586,907,FALSE,NA,"0.1.4"
"29003","646",2023-06-30 02:30:00,-3795,1913,5708,907,FALSE,NA,"0.1.4"
"29004","646",2023-06-30 02:45:00,-3478.75,1913,5391.75,907,FALSE,"out1, fill","0.1.4"
"29005","646",2023-06-30 03:00:00,-3162.5,1913,5075.5,907,FALSE,"out1, fill","0.1.4"
"29006","646",2023-06-30 03:15:00,-2846.25,1913,4759.25,907,FALSE,"out1, fill","0.1.4"
"29007","646",2023-06-30 03:30:00,-2530,1913,4443,907,FALSE,NA,"0.1.4"
"29008","646",2023-06-30 03:45:00,-2578,1913,4491,907,FALSE,NA,"0.1.4"
"29009","646",2023-06-30 04:00:00,-2510,1913,4423,907,FALSE,NA,"0.1.4"
"29010","646",2023-06-30 04:15:00,-2511,1913,4424,907,FALSE,NA,"0.1.4"
"29011","646",2023-06-30 04:30:00,-2849,1913,4762,907,FALSE,NA,"0.1.4"
"29012","646",2023-06-30 04:45:00,-2518,1913,4431,907,FALSE,NA,"0.1.4"
"29013","646",2023-06-30 05:00:00,-2509,1913,4422,907,FALSE,NA,"0.1.4"
"29014","646",2023-06-30 05:15:00,-2505,1913,4418,907,FALSE,NA,"0.1.4"
"29015","646",2023-06-30 05:30:00,-2594,1913,4507,907,FALSE,"out1, fill","0.1.4"
"29016","646",2023-06-30 05:45:00,-2683,1913,4596,907,FALSE,"out1, fill","0.1.4"
"29017","646",2023-06-30 06:00:00,-2772,1913,4685,907,FALSE,NA,"0.1.4"
"29018","646",2023-06-30 06:15:00,-2517,1913,4430,907,FALSE,NA,"0.1.4"
"29019","646",2023-06-30 06:30:00,-2625,1913,4538,907,FALSE,NA,"0.1.4"
"29020","646",2023-06-30 06:45:00,-2509,1913,4422,907,FALSE,NA,"0.1.4"
"29021","646",2023-06-30 07:00:00,-2560,1913,4473,907,FALSE,NA,"0.1.4"
"29022","646",2023-06-30 07:15:00,-2546.5,1913,4459.5,907,FALSE,"out1, fill","0.1.4"
"29023","646",2023-06-30 07:30:00,-2533,1913,4446,907,FALSE,"out1, fill","0.1.4"
"29024","646",2023-06-30 07:45:00,-2519.5,1913,4432.5,907,FALSE,"out1, fill","0.1.4"
"29025","646",2023-06-30 08:00:00,-2506,1913,4419,907,FALSE,NA,"0.1.4"
"29026","646",2023-06-30 08:15:00,-2506,1913,4419,907,FALSE,"jump1","0.1.4"
"29027","646",2023-06-30 08:30:00,-2506,1913,4419,907,FALSE,"jump1","0.1.4"
"29028","646",2023-06-30 08:45:00,-2538,1913,4451,907,FALSE,NA,"0.1.4"
"29029","646",2023-06-30 09:00:00,-2973,1913,4886,907,FALSE,NA,"0.1.4"
"29030","646",2023-06-30 09:15:00,-2624,1913,4537,907,FALSE,NA,"0.1.4"
"29031","646",2023-06-30 09:30:00,-2615.23076923077,1913,4528.23076923077,907,FALSE,"out1, fill","0.1.4"
"29032","646",2023-06-30 09:45:00,-2606.46153846154,1913,4519.46153846154,907,FALSE,"out1, fill","0.1.4"
"29033","646",2023-06-30 10:00:00,-2597.69230769231,1913,4510.69230769231,907,FALSE,"out1, fill","0.1.4"
"29034","646",2023-06-30 10:15:00,-2588.92307692308,1913,4501.92307692308,907,FALSE,"out1, fill","0.1.4"
"29035","646",2023-06-30 10:30:00,-2580.15384615385,1913,4493.15384615385,907,FALSE,"out1, fill","0.1.4"
"29036","646",2023-06-30 10:45:00,-2571.38461538462,1913,4484.38461538462,907,FALSE,"out1, fill","0.1.4"
"29037","646",2023-06-30 11:00:00,-2562.61538461538,1913,4475.61538461538,907,FALSE,"out1, fill","0.1.4"
"29038","646",2023-06-30 11:15:00,-2553.84615384615,1913,4466.84615384615,907,FALSE,"out1, fill","0.1.4"
"29039","646",2023-06-30 11:30:00,-2545.07692307692,1913,4458.07692307692,907,FALSE,"out1, fill","0.1.4"
"29040","646",2023-06-30 11:45:00,-2536.30769230769,1913,4449.30769230769,907,FALSE,"out1, fill","0.1.4"
"29041","646",2023-06-30 12:00:00,-2527.53846153846,1913,4440.53846153846,907,FALSE,"out1, fill","0.1.4"
"29042","646",2023-06-30 12:15:00,-2518.76923076923,1913,4431.76923076923,907,FALSE,"out1, fill","0.1.4"
"29043","646",2023-06-30 12:30:00,-2510,1913,4423,907,FALSE,NA,"0.1.4"
"29044","646",2023-06-30 12:45:00,-2513,1913,4426,907,FALSE,NA,"0.1.4"
"29045","646",2023-06-30 13:00:00,-2513,1913,4426,907,FALSE,"jump1","0.1.4"
"29046","646",2023-06-30 13:15:00,-2513,1913,4426,907,FALSE,"jump1","0.1.4"
"29047","646",2023-06-30 13:30:00,-2537,1913,4450,907,FALSE,NA,"0.1.4"
"29048","646",2023-06-30 13:45:00,-2513,1913,4426,907,FALSE,NA,"0.1.4"
"29049","646",2023-06-30 14:00:00,-2513,1913,4426,907,FALSE,NA,"0.1.4"
"29050","646",2023-06-30 14:15:00,-2513,1913,4426,907,FALSE,NA,"0.1.4"
"29051","646",2023-06-30 14:30:00,-2513,1913,4426,907,FALSE,NA,"0.1.4"
"29052","646",2023-06-30 14:45:00,-2513,1913,4426,907,FALSE,NA,"0.1.4"
"29053","646",2023-06-30 15:00:00,-2512,1913,4425,907,FALSE,NA,"0.1.4"
"29054","646",2023-06-30 15:15:00,-2511,1913,4424,907,FALSE,NA,"0.1.4"
"29055","646",2023-06-30 15:30:00,-2513,1913,4426,907,FALSE,NA,"0.1.4"
"29056","646",2023-06-30 15:45:00,-2509,1913,4422,907,FALSE,NA,"0.1.4"
"29057","646",2023-06-30 16:00:00,-2512,1913,4425,907,FALSE,NA,"0.1.4"
"29058","646",2023-06-30 16:15:00,-2502,1913,4415,907,FALSE,NA,"0.1.4"
"29059","646",2023-06-30 16:30:00,-2508,1913,4421,907,FALSE,NA,"0.1.4"
"29060","646",2023-06-30 16:45:00,-2511,1913,4424,907,FALSE,NA,"0.1.4"
"29061","646",2023-06-30 17:00:00,-2511,1913,4424,907,FALSE,NA,"0.1.4"
"29062","646",2023-06-30 17:15:00,-2516,1913,4429,907,FALSE,NA,"0.1.4"
"29063","646",2023-06-30 17:30:00,-2515,1913,4428,907,FALSE,NA,"0.1.4"
"29064","646",2023-06-30 17:45:00,-2516,1913,4429,907,FALSE,NA,"0.1.4"
"29065","646",2023-06-30 18:00:00,-2529,1913,4442,907,FALSE,NA,"0.1.4"
"29066","646",2023-06-30 18:15:00,-2508,1913,4421,907,FALSE,NA,"0.1.4"
"29067","646",2023-06-30 18:30:00,-2508,1913,4421,907,FALSE,NA,"0.1.4"
"29068","646",2023-06-30 18:45:00,-2509,1913,4422,907,FALSE,NA,"0.1.4"
"29069","646",2023-06-30 19:00:00,-2508,1913,4421,907,FALSE,NA,"0.1.4"
"29070","646",2023-06-30 19:15:00,-2507,1913,4420,907,FALSE,NA,"0.1.4"
"29071","646",2023-06-30 19:30:00,-2507,1913,4420,907,FALSE,NA,"0.1.4"
"29072","646",2023-06-30 19:45:00,-2507,1913,4420,907,FALSE,NA,"0.1.4"
"29073","646",2023-06-30 20:00:00,-2507,1913,4420,907,FALSE,NA,"0.1.4"
"29074","646",2023-06-30 20:15:00,-2506,1913,4419,907,FALSE,NA,"0.1.4"
"29075","646",2023-06-30 20:30:00,-2506,1913,4419,907,FALSE,NA,"0.1.4"
"29076","646",2023-06-30 20:45:00,-2506,1913,4419,907,FALSE,NA,"0.1.4"
"29077","646",2023-06-30 21:00:00,-2505,1913,4418,907,FALSE,NA,"0.1.4"
"29078","646",2023-06-30 21:15:00,-2505,1913,4418,907,FALSE,NA,"0.1.4"
"29079","646",2023-06-30 21:30:00,-2506,1913,4419,907,FALSE,NA,"0.1.4"
"29080","646",2023-06-30 21:45:00,-2506,1913,4419,907,FALSE,NA,"0.1.4"
"29081","646",2023-06-30 22:00:00,-2508,1913,4421,907,FALSE,NA,"0.1.4"
"29082","646",2023-06-30 22:15:00,-2506,1913,4419,907,FALSE,NA,"0.1.4"
"29083","646",2023-06-30 22:30:00,-2506,1913,4419,907,FALSE,NA,"0.1.4"
"29084","646",2023-06-30 22:45:00,-2505,1913,4418,907,FALSE,NA,"0.1.4"
"29085","646",2023-06-30 23:00:00,-2505,1913,4418,907,FALSE,NA,"0.1.4"
"29086","646",2023-06-30 23:15:00,-2506,1913,4419,907,FALSE,NA,"0.1.4"
"29087","646",2023-06-30 23:30:00,-2503,1913,4416,907,FALSE,NA,"0.1.4"
"29088","646",2023-06-30 23:45:00,-2508,1913,4421,907,FALSE,NA,"0.1.4"
"29089","646",2023-07-01,-2507,1913,4420,907,FALSE,NA,"0.1.4"
"29090","646",2023-07-01 00:15:00,-2503,1913,4416,907,FALSE,NA,"0.1.4"
"29091","646",2023-07-01 00:30:00,-2498,1913,4411,907,FALSE,NA,"0.1.4"
"29092","646",2023-07-01 00:45:00,-2494,1913,4407,907,FALSE,NA,"0.1.4"
"29093","646",2023-07-01 01:00:00,-2516,1913,4429,907,FALSE,NA,"0.1.4"
"29094","646",2023-07-01 01:15:00,-2496,1913,4409,907,FALSE,NA,"0.1.4"
"29095","646",2023-07-01 01:30:00,-2513,1913,4426,907,FALSE,NA,"0.1.4"
"29096","646",2023-07-01 01:45:00,-2506,1913,4419,907,FALSE,NA,"0.1.4"
"29097","646",2023-07-01 02:00:00,-2515,1913,4428,907,FALSE,NA,"0.1.4"
"29098","646",2023-07-01 02:15:00,-2516,1913,4429,907,FALSE,NA,"0.1.4"
"29099","646",2023-07-01 02:30:00,-2515,1913,4428,907,FALSE,NA,"0.1.4"
"29100","646",2023-07-01 02:45:00,-2515,1913,4428,907,FALSE,NA,"0.1.4"
"29101","646",2023-07-01 03:00:00,-2517,1913,4430,907,FALSE,NA,"0.1.4"
"29102","646",2023-07-01 03:15:00,-2524,1913,4437,907,FALSE,NA,"0.1.4"
"29103","646",2023-07-01 03:30:00,-2560.33333333333,1913,4473.33333333333,907,FALSE,"out1, fill","0.1.4"
"29104","646",2023-07-01 03:45:00,-2596.66666666667,1913,4509.66666666667,907,FALSE,"out1, fill","0.1.4"
"29105","646",2023-07-01 04:00:00,-2633,1913,4546,907,FALSE,NA,"0.1.4"
"29106","646",2023-07-01 04:15:00,-2721,1913,4634,907,FALSE,NA,"0.1.4"
"29107","646",2023-07-01 04:30:00,-2481,1913,4394,907,FALSE,NA,"0.1.4"
"29108","646",2023-07-01 04:45:00,-2479,1913,4392,907,FALSE,"out1, fill","0.1.4"
"29109","646",2023-07-01 05:00:00,-2477,1913,4390,907,FALSE,"out1, fill","0.1.4"
"29110","646",2023-07-01 05:15:00,-2475,1913,4388,907,FALSE,NA,"0.1.4"
"29111","646",2023-07-01 05:30:00,-2474,1913,4387,907,FALSE,NA,"0.1.4"
"29112","646",2023-07-01 05:45:00,-2474,1913,4387,907,FALSE,"jump1","0.1.4"
"29113","646",2023-07-01 06:00:00,-2474,1913,4387,907,FALSE,"jump1","0.1.4"
"29114","646",2023-07-01 06:15:00,-2637.8,1913,4550.8,907,FALSE,"out1, fill","0.1.4"
"29115","646",2023-07-01 06:30:00,-2801.6,1913,4714.6,907,FALSE,"out1, fill","0.1.4"
"29116","646",2023-07-01 06:45:00,-2965.4,1913,4878.4,907,FALSE,"out1, fill","0.1.4"
"29117","646",2023-07-01 07:00:00,-3129.2,1913,5042.2,907,FALSE,"out1, fill","0.1.4"
"29118","646",2023-07-01 07:15:00,-3293,1913,5206,907,FALSE,NA,"0.1.4"
"29119","646",2023-07-01 07:30:00,-2880,1913,4793,907,FALSE,NA,"0.1.4"
"29120","646",2023-07-01 07:45:00,-2487,1913,4400,907,FALSE,NA,"0.1.4"
"29121","646",2023-07-01 08:00:00,-2501,1913,4414,907,FALSE,NA,"0.1.4"
"29122","646",2023-07-01 08:15:00,-2504,1913,4417,907,FALSE,NA,"0.1.4"
"29123","646",2023-07-01 08:30:00,-2447,1913,4360,907,FALSE,NA,"0.1.4"
"29124","646",2023-07-01 08:45:00,-2467,1913,4380,907,FALSE,"out1, fill","0.1.4"
"29125","646",2023-07-01 09:00:00,-2487,1913,4400,907,FALSE,"out1, fill","0.1.4"
"29126","646",2023-07-01 09:15:00,-2507,1913,4420,907,FALSE,NA,"0.1.4"
"29127","646",2023-07-01 09:30:00,-2507,1913,4420,907,FALSE,"jump1","0.1.4"
"29128","646",2023-07-01 09:45:00,-2507,1913,4420,907,FALSE,"jump1","0.1.4"
"29129","646",2023-07-01 10:00:00,-2499,1913,4412,907,FALSE,NA,"0.1.4"
"29130","646",2023-07-01 10:15:00,-2491,1913,4404,907,FALSE,NA,"0.1.4"
"29131","646",2023-07-01 10:30:00,-2602,1913,4515,907,FALSE,NA,"0.1.4"
"29132","646",2023-07-01 10:45:00,-2490,1913,4403,907,FALSE,NA,"0.1.4"
"29133","646",2023-07-01 11:00:00,-2490,1913,4403,907,FALSE,"jump1","0.1.4"
"29134","646",2023-07-01 11:15:00,-2490,1913,4403,907,FALSE,"jump1","0.1.4"
"29135","646",2023-07-01 11:30:00,-2490,1913,4403,907,FALSE,NA,"0.1.4"
"29136","646",2023-07-01 11:45:00,-2490,1913,4403,907,FALSE,NA,"0.1.4"
"29137","646",2023-07-01 12:00:00,-2490,1913,4403,907,FALSE,NA,"0.1.4"
"29138","646",2023-07-01 12:15:00,-2490,1913,4403,907,FALSE,NA,"0.1.4"
"29139","646",2023-07-01 12:30:00,-2490,1913,4403,907,FALSE,NA,"0.1.4"
"29140","646",2023-07-01 12:45:00,-2490,1913,4403,907,FALSE,NA,"0.1.4"
"29141","646",2023-07-01 13:00:00,-2774,1913,4687,907,FALSE,NA,"0.1.4"
"29142","646",2023-07-01 13:15:00,-2482,1913,4395,907,FALSE,NA,"0.1.4"
"29143","646",2023-07-01 13:30:00,-2490,1913,4403,907,FALSE,NA,"0.1.4"
"29144","646",2023-07-01 13:45:00,-2490,1913,4403,907,FALSE,NA,"0.1.4"
"29145","646",2023-07-01 14:00:00,-2483,1913,4396,907,FALSE,NA,"0.1.4"
"29146","646",2023-07-01 14:15:00,-2483,1913,4396,907,FALSE,NA,"0.1.4"
"29147","646",2023-07-01 14:30:00,-2483,1913,4396,907,FALSE,NA,"0.1.4"
"29148","646",2023-07-01 14:45:00,-2482,1913,4395,907,FALSE,NA,"0.1.4"
"29149","646",2023-07-01 15:00:00,-2485,1913,4398,907,FALSE,NA,"0.1.4"
"29150","646",2023-07-01 15:15:00,-2486,1913,4399,907,FALSE,NA,"0.1.4"
"29151","646",2023-07-01 15:30:00,-2485,1913,4398,907,FALSE,NA,"0.1.4"
"29152","646",2023-07-01 15:45:00,-2486,1913,4399,907,FALSE,NA,"0.1.4"
"29153","646",2023-07-01 16:00:00,-2487,1913,4400,907,FALSE,NA,"0.1.4"
"29154","646",2023-07-01 16:15:00,-2483,1913,4396,907,FALSE,NA,"0.1.4"
"29155","646",2023-07-01 16:30:00,-2483,1913,4396,907,FALSE,NA,"0.1.4"
"29156","646",2023-07-01 16:45:00,-2470,1913,4383,907,FALSE,NA,"0.1.4"
"29157","646",2023-07-01 17:00:00,-2481,1913,4394,907,FALSE,NA,"0.1.4"
"29158","646",2023-07-01 17:15:00,-2479,1913,4392,907,FALSE,NA,"0.1.4"
"29159","646",2023-07-01 17:30:00,-2485,1913,4398,907,FALSE,NA,"0.1.4"
"29160","646",2023-07-01 17:45:00,-2488,1913,4401,907,FALSE,NA,"0.1.4"
"29161","646",2023-07-01 18:00:00,-2488,1913,4401,907,FALSE,NA,"0.1.4"
"29162","646",2023-07-01 18:15:00,-2489,1913,4402,907,FALSE,NA,"0.1.4"
"29163","646",2023-07-01 18:30:00,-2488,1913,4401,907,FALSE,NA,"0.1.4"
"29164","646",2023-07-01 18:45:00,-2489,1913,4402,907,FALSE,NA,"0.1.4"
"29165","646",2023-07-01 19:00:00,-2485,1913,4398,907,FALSE,NA,"0.1.4"
"29166","646",2023-07-01 19:15:00,-2489,1913,4402,907,FALSE,NA,"0.1.4"
"29167","646",2023-07-01 19:30:00,-2489,1913,4402,907,FALSE,NA,"0.1.4"
"29168","646",2023-07-01 19:45:00,-2488,1913,4401,907,FALSE,NA,"0.1.4"
"29169","646",2023-07-01 20:00:00,-2489,1913,4402,907,FALSE,NA,"0.1.4"
"29170","646",2023-07-01 20:15:00,-2489,1913,4402,907,FALSE,NA,"0.1.4"
"29171","646",2023-07-01 20:30:00,-2489,1913,4402,907,FALSE,NA,"0.1.4"
"29172","646",2023-07-01 20:45:00,-2489,1913,4402,907,FALSE,NA,"0.1.4"
"29173","646",2023-07-01 21:00:00,-2489,1913,4402,907,FALSE,NA,"0.1.4"
"29174","646",2023-07-01 21:15:00,-2490,1913,4403,907,FALSE,NA,"0.1.4"
"29175","646",2023-07-01 21:30:00,-2490,1913,4403,907,FALSE,NA,"0.1.4"
"29176","646",2023-07-01 21:45:00,-2489,1913,4402,907,FALSE,NA,"0.1.4"
"29177","646",2023-07-01 22:00:00,-2489,1913,4402,907,FALSE,NA,"0.1.4"
"29178","646",2023-07-01 22:15:00,-2489,1913,4402,907,FALSE,NA,"0.1.4"
"29179","646",2023-07-01 22:30:00,-2489,1913,4402,907,FALSE,NA,"0.1.4"
"29180","646",2023-07-01 22:45:00,-2489,1913,4402,907,FALSE,NA,"0.1.4"
"29181","646",2023-07-01 23:00:00,-2489,1913,4402,907,FALSE,NA,"0.1.4"
"29182","646",2023-07-01 23:15:00,-2489,1913,4402,907,FALSE,NA,"0.1.4"
"29183","646",2023-07-01 23:30:00,-2490,1913,4403,907,FALSE,NA,"0.1.4"
"29184","646",2023-07-01 23:45:00,-2490,1913,4403,907,FALSE,NA,"0.1.4"
"29185","646",2023-07-02,-2490,1913,4403,907,FALSE,NA,"0.1.4"
"29186","646",2023-07-02 00:15:00,-2490,1913,4403,907,FALSE,NA,"0.1.4"
"29187","646",2023-07-02 00:30:00,-2490,1913,4403,907,FALSE,NA,"0.1.4"
"29188","646",2023-07-02 00:45:00,-2490,1913,4403,907,FALSE,NA,"0.1.4"
"29189","646",2023-07-02 01:00:00,-2490,1913,4403,907,FALSE,NA,"0.1.4"
"29190","646",2023-07-02 01:15:00,-2490,1913,4403,907,FALSE,NA,"0.1.4"
"29191","646",2023-07-02 01:30:00,-2655,1913,4568,907,FALSE,NA,"0.1.4"
"29192","646",2023-07-02 01:45:00,-2509,1913,4422,907,FALSE,NA,"0.1.4"
"29193","646",2023-07-02 02:00:00,-2490,1913,4403,907,FALSE,NA,"0.1.4"
"29194","646",2023-07-02 02:15:00,-2490,1913,4403,907,FALSE,NA,"0.1.4"
"29195","646",2023-07-02 02:30:00,-2490,1913,4403,907,FALSE,NA,"0.1.4"
"29196","646",2023-07-02 02:45:00,-2491,1913,4404,907,FALSE,NA,"0.1.4"
"29197","646",2023-07-02 03:00:00,-2490,1913,4403,907,FALSE,NA,"0.1.4"
"29198","646",2023-07-02 03:15:00,-2490,1913,4403,907,FALSE,NA,"0.1.4"
"29199","646",2023-07-02 03:30:00,-2532,1913,4445,907,FALSE,NA,"0.1.4"
"29200","646",2023-07-02 03:45:00,-2535,1913,4448,907,FALSE,NA,"0.1.4"
"29201","646",2023-07-02 04:00:00,-2489,1913,4402,907,FALSE,NA,"0.1.4"
"29202","646",2023-07-02 04:15:00,-2489,1913,4402,907,FALSE,"jump1","0.1.4"
"29203","646",2023-07-02 04:30:00,-2489,1913,4402,907,FALSE,"jump1","0.1.4"
"29204","646",2023-07-02 04:45:00,-2489,1913,4402,907,FALSE,NA,"0.1.4"
"29205","646",2023-07-02 05:00:00,-2489,1913,4402,907,FALSE,NA,"0.1.4"
"29206","646",2023-07-02 05:15:00,-2490,1913,4403,907,FALSE,NA,"0.1.4"
"29207","646",2023-07-02 05:30:00,-2491,1913,4404,907,FALSE,NA,"0.1.4"
"29208","646",2023-07-02 05:45:00,-2490,1913,4403,907,FALSE,NA,"0.1.4"
"29209","646",2023-07-02 06:00:00,-2490,1913,4403,907,FALSE,NA,"0.1.4"
"29210","646",2023-07-02 06:15:00,-2488,1913,4401,907,FALSE,NA,"0.1.4"
"29211","646",2023-07-02 06:30:00,-2634,1913,4547,907,FALSE,NA,"0.1.4"
"29212","646",2023-07-02 06:45:00,-2491,1913,4404,907,FALSE,NA,"0.1.4"
"29213","646",2023-07-02 07:00:00,-2490,1913,4403,907,FALSE,NA,"0.1.4"
"29214","646",2023-07-02 07:15:00,-2489,1913,4402,907,FALSE,NA,"0.1.4"
"29215","646",2023-07-02 07:30:00,-2491,1913,4404,907,FALSE,NA,"0.1.4"
"29216","646",2023-07-02 07:45:00,-2491,1913,4404,907,FALSE,NA,"0.1.4"
"29217","646",2023-07-02 08:00:00,-2489,1913,4402,907,FALSE,NA,"0.1.4"
"29218","646",2023-07-02 08:15:00,-2488,1913,4401,907,FALSE,NA,"0.1.4"
"29219","646",2023-07-02 08:30:00,-2485,1913,4398,907,FALSE,NA,"0.1.4"
"29220","646",2023-07-02 08:45:00,-2491,1913,4404,907,FALSE,NA,"0.1.4"
"29221","646",2023-07-02 09:00:00,-2490,1913,4403,907,FALSE,NA,"0.1.4"
"29222","646",2023-07-02 09:15:00,-2631,1913,4544,907,FALSE,NA,"0.1.4"
"29223","646",2023-07-02 09:30:00,-2474,1913,4387,907,FALSE,NA,"0.1.4"
"29224","646",2023-07-02 09:45:00,-2487,1913,4400,907,FALSE,NA,"0.1.4"
"29225","646",2023-07-02 10:00:00,-2479,1913,4392,907,FALSE,NA,"0.1.4"
"29226","646",2023-07-02 10:15:00,-2466,1913,4379,907,FALSE,NA,"0.1.4"
"29227","646",2023-07-02 10:30:00,-2466,1913,4379,907,FALSE,NA,"0.1.4"
"29228","646",2023-07-02 10:45:00,-2465,1913,4378,907,FALSE,NA,"0.1.4"
"29229","646",2023-07-02 11:00:00,-2463,1913,4376,907,FALSE,NA,"0.1.4"
"29230","646",2023-07-02 11:15:00,-2460,1913,4373,907,FALSE,NA,"0.1.4"
"29231","646",2023-07-02 11:30:00,-2466,1913,4379,907,FALSE,NA,"0.1.4"
"29232","646",2023-07-02 11:45:00,-2454,1913,4367,907,FALSE,NA,"0.1.4"
"29233","646",2023-07-02 12:00:00,-2457,1913,4370,907,FALSE,NA,"0.1.4"
"29234","646",2023-07-02 12:15:00,-2454,1913,4367,907,FALSE,NA,"0.1.4"
"29235","646",2023-07-02 12:30:00,-2452,1913,4365,907,FALSE,NA,"0.1.4"
"29236","646",2023-07-02 12:45:00,-2461,1913,4374,907,FALSE,NA,"0.1.4"
"29237","646",2023-07-02 13:00:00,-2664,1913,4577,907,FALSE,NA,"0.1.4"
"29238","646",2023-07-02 13:15:00,-2485,1913,4398,907,FALSE,NA,"0.1.4"
"29239","646",2023-07-02 13:30:00,-2453,1913,4366,907,FALSE,NA,"0.1.4"
"29240","646",2023-07-02 13:45:00,-2528,1913,4441,907,FALSE,NA,"0.1.4"
"29241","646",2023-07-02 14:00:00,-2506,1913,4419,907,FALSE,NA,"0.1.4"
"29242","646",2023-07-02 14:15:00,-2533,1913,4446,907,FALSE,NA,"0.1.4"
"29243","646",2023-07-02 14:30:00,-2549,1913,4462,907,FALSE,NA,"0.1.4"
"29244","646",2023-07-02 14:45:00,-2473,1913,4386,907,FALSE,NA,"0.1.4"
"29245","646",2023-07-02 15:00:00,-2458,1913,4371,907,FALSE,NA,"0.1.4"
"29246","646",2023-07-02 15:15:00,-2537,1913,4450,907,FALSE,NA,"0.1.4"
"29247","646",2023-07-02 15:30:00,-2547,1913,4460,907,FALSE,NA,"0.1.4"
"29248","646",2023-07-02 15:45:00,-2525,1913,4438,907,FALSE,NA,"0.1.4"
"29249","646",2023-07-02 16:00:00,-2457,1913,4370,907,FALSE,NA,"0.1.4"
"29250","646",2023-07-02 16:15:00,-2461,1913,4374,907,FALSE,NA,"0.1.4"
"29251","646",2023-07-02 16:30:00,-2458,1913,4371,907,FALSE,NA,"0.1.4"
"29252","646",2023-07-02 16:45:00,-2459,1913,4372,907,FALSE,NA,"0.1.4"
"29253","646",2023-07-02 17:00:00,-2459,1913,4372,907,FALSE,NA,"0.1.4"
"29254","646",2023-07-02 17:15:00,-2459,1913,4372,907,FALSE,NA,"0.1.4"
"29255","646",2023-07-02 17:30:00,-2458,1913,4371,907,FALSE,NA,"0.1.4"
"29256","646",2023-07-02 17:45:00,-2459,1913,4372,907,FALSE,NA,"0.1.4"
"29257","646",2023-07-02 18:00:00,-2458,1913,4371,907,FALSE,NA,"0.1.4"
"29258","646",2023-07-02 18:15:00,-2458,1913,4371,907,FALSE,NA,"0.1.4"
"29259","646",2023-07-02 18:30:00,-2458,1913,4371,907,FALSE,NA,"0.1.4"
"29260","646",2023-07-02 18:45:00,-2458,1913,4371,907,FALSE,NA,"0.1.4"
"29261","646",2023-07-02 19:00:00,-2457,1913,4370,907,FALSE,NA,"0.1.4"
"29262","646",2023-07-02 19:15:00,-2457,1913,4370,907,FALSE,NA,"0.1.4"
"29263","646",2023-07-02 19:30:00,-2460,1913,4373,907,FALSE,NA,"0.1.4"
"29264","646",2023-07-02 19:45:00,-2459,1913,4372,907,FALSE,NA,"0.1.4"
"29265","646",2023-07-02 20:00:00,-2459,1913,4372,907,FALSE,NA,"0.1.4"
"29266","646",2023-07-02 20:15:00,-2459,1913,4372,907,FALSE,NA,"0.1.4"
"29267","646",2023-07-02 20:30:00,-2459,1913,4372,907,FALSE,NA,"0.1.4"
"29268","646",2023-07-02 20:45:00,-2459,1913,4372,907,FALSE,NA,"0.1.4"
"29269","646",2023-07-02 21:00:00,-2458,1913,4371,907,FALSE,NA,"0.1.4"
"29270","646",2023-07-02 21:15:00,-2458,1913,4371,907,FALSE,NA,"0.1.4"
"29271","646",2023-07-02 21:30:00,-2458,1913,4371,907,FALSE,NA,"0.1.4"
"29272","646",2023-07-02 21:45:00,-2457,1913,4370,907,FALSE,NA,"0.1.4"
"29273","646",2023-07-02 22:00:00,-2458,1913,4371,907,FALSE,NA,"0.1.4"
"29274","646",2023-07-02 22:15:00,-2458,1913,4371,907,FALSE,NA,"0.1.4"
"29275","646",2023-07-02 22:30:00,-2458,1913,4371,907,FALSE,NA,"0.1.4"
"29276","646",2023-07-02 22:45:00,-2460,1913,4373,907,FALSE,NA,"0.1.4"
"29277","646",2023-07-02 23:00:00,-2462,1913,4375,907,FALSE,NA,"0.1.4"
"29278","646",2023-07-02 23:15:00,-2460,1913,4373,907,FALSE,NA,"0.1.4"
"29279","646",2023-07-02 23:30:00,-2458,1913,4371,907,FALSE,NA,"0.1.4"
"29280","646",2023-07-02 23:45:00,-2459,1913,4372,907,FALSE,NA,"0.1.4"
"29281","646",2023-07-03,-2463,1913,4376,907,FALSE,NA,"0.1.4"
"29282","646",2023-07-03 00:15:00,-2463,1913,4376,907,FALSE,NA,"0.1.4"
"29283","646",2023-07-03 00:30:00,-2460,1913,4373,907,FALSE,NA,"0.1.4"
"29284","646",2023-07-03 00:45:00,-2460,1913,4373,907,FALSE,NA,"0.1.4"
"29285","646",2023-07-03 01:00:00,-2464,1913,4377,907,FALSE,NA,"0.1.4"
"29286","646",2023-07-03 01:15:00,-2462,1913,4375,907,FALSE,NA,"0.1.4"
"29287","646",2023-07-03 01:30:00,-2463,1913,4376,907,FALSE,NA,"0.1.4"
"29288","646",2023-07-03 01:45:00,-2700,1913,4613,907,FALSE,NA,"0.1.4"
"29289","646",2023-07-03 02:00:00,-2504,1913,4417,907,FALSE,NA,"0.1.4"
"29290","646",2023-07-03 02:15:00,-2482,1913,4395,907,FALSE,NA,"0.1.4"
"29291","646",2023-07-03 02:30:00,-2470,1913,4383,907,FALSE,NA,"0.1.4"
"29292","646",2023-07-03 02:45:00,-2484,1913,4397,907,FALSE,NA,"0.1.4"
"29293","646",2023-07-03 03:00:00,-2783,1913,4696,907,FALSE,NA,"0.1.4"
"29294","646",2023-07-03 03:15:00,-2482,1913,4395,907,FALSE,NA,"0.1.4"
"29295","646",2023-07-03 03:30:00,-2463,1913,4376,907,FALSE,NA,"0.1.4"
"29296","646",2023-07-03 03:45:00,-2459,1913,4372,907,FALSE,NA,"0.1.4"
"29297","646",2023-07-03 04:00:00,-2463,1913,4376,907,FALSE,NA,"0.1.4"
"29298","646",2023-07-03 04:15:00,-2472,1913,4385,907,FALSE,NA,"0.1.4"
"29299","646",2023-07-03 04:30:00,-2465,1913,4378,907,FALSE,NA,"0.1.4"
"29300","646",2023-07-03 04:45:00,-2465,1913,4378,907,FALSE,NA,"0.1.4"
"29301","646",2023-07-03 05:00:00,-2453,1913,4366,907,FALSE,NA,"0.1.4"
"29302","646",2023-07-03 05:15:00,-2459,1913,4372,907,FALSE,NA,"0.1.4"
"29303","646",2023-07-03 05:30:00,-2468,1913,4381,907,FALSE,NA,"0.1.4"
"29304","646",2023-07-03 05:45:00,-2578,1913,4491,907,FALSE,NA,"0.1.4"
"29305","646",2023-07-03 06:00:00,-2463,1913,4376,907,FALSE,NA,"0.1.4"
"29306","646",2023-07-03 06:15:00,-2460,1913,4373,907,FALSE,NA,"0.1.4"
"29307","646",2023-07-03 06:30:00,-2445,1913,4358,907,FALSE,NA,"0.1.4"
"29308","646",2023-07-03 06:45:00,-2453,1913,4366,907,FALSE,NA,"0.1.4"
"29309","646",2023-07-03 07:00:00,-2466,1913,4379,907,FALSE,NA,"0.1.4"
"29310","646",2023-07-03 07:15:00,-2663,1913,4576,907,FALSE,NA,"0.1.4"
"29311","646",2023-07-03 07:30:00,-2446,1913,4359,907,FALSE,NA,"0.1.4"
"29312","646",2023-07-03 07:45:00,-2465,1913,4378,907,FALSE,NA,"0.1.4"
"29313","646",2023-07-03 08:00:00,-2454,1913,4367,907,FALSE,NA,"0.1.4"
"29314","646",2023-07-03 08:15:00,-2441,1913,4354,907,FALSE,NA,"0.1.4"
"29315","646",2023-07-03 08:30:00,-2729,1913,4642,907,FALSE,NA,"0.1.4"
"29316","646",2023-07-03 08:45:00,-2529,1913,4442,907,FALSE,NA,"0.1.4"
"29317","646",2023-07-03 09:00:00,-2443,1913,4356,907,FALSE,NA,"0.1.4"
"29318","646",2023-07-03 09:15:00,-2443,1913,4356,907,FALSE,"jump1","0.1.4"
"29319","646",2023-07-03 09:30:00,-2443,1913,4356,907,FALSE,"jump1","0.1.4"
"29320","646",2023-07-03 09:45:00,-2455,1913,4368,907,FALSE,NA,"0.1.4"
"29321","646",2023-07-03 10:00:00,-2453,1913,4366,907,FALSE,NA,"0.1.4"
"29322","646",2023-07-03 10:15:00,-2444,1913,4357,907,FALSE,NA,"0.1.4"
"29323","646",2023-07-03 10:30:00,-2447,1913,4360,907,FALSE,NA,"0.1.4"
"29324","646",2023-07-03 10:45:00,-2668,1913,4581,907,FALSE,NA,"0.1.4"
"29325","646",2023-07-03 11:00:00,-2467,1913,4380,907,FALSE,NA,"0.1.4"
"29326","646",2023-07-03 11:15:00,-2450,1913,4363,907,FALSE,NA,"0.1.4"
"29327","646",2023-07-03 11:30:00,-2440,1913,4353,907,FALSE,NA,"0.1.4"
"29328","646",2023-07-03 11:45:00,-2439,1913,4352,907,FALSE,NA,"0.1.4"
"29329","646",2023-07-03 12:00:00,-2462,1913,4375,907,FALSE,NA,"0.1.4"
"29330","646",2023-07-03 12:15:00,-2636.66666666667,1913,4549.66666666667,907,FALSE,"out1, fill","0.1.4"
"29331","646",2023-07-03 12:30:00,-2811.33333333333,1913,4724.33333333333,907,FALSE,"out1, fill","0.1.4"
"29332","646",2023-07-03 12:45:00,-2986,1913,4899,907,FALSE,NA,"0.1.4"
"29333","646",2023-07-03 13:00:00,-2986,1913,4899,907,FALSE,"jump1","0.1.4"
"29334","646",2023-07-03 13:15:00,-2983,1913,4896,907,FALSE,NA,"0.1.4"
"29335","646",2023-07-03 13:30:00,-2963,1913,4876,907,FALSE,NA,"0.1.4"
"29336","646",2023-07-03 13:45:00,-2963,1913,4876,907,FALSE,NA,"0.1.4"
"29337","646",2023-07-03 14:00:00,-2963,1913,4876,907,FALSE,NA,"0.1.4"
"29338","646",2023-07-03 14:15:00,-2963,1913,4876,907,FALSE,NA,"0.1.4"
"29339","646",2023-07-03 14:30:00,-2963,1913,4876,907,FALSE,NA,"0.1.4"
"29340","646",2023-07-03 14:45:00,-2963,1913,4876,907,FALSE,NA,"0.1.4"
"29341","646",2023-07-03 15:00:00,-2967,1913,4880,907,FALSE,NA,"0.1.4"
"29342","646",2023-07-03 15:15:00,-2969,1913,4882,907,FALSE,NA,"0.1.4"
"29343","646",2023-07-03 15:30:00,-2968,1913,4881,907,FALSE,NA,"0.1.4"
"29344","646",2023-07-03 15:45:00,-2968,1913,4881,907,FALSE,NA,"0.1.4"
"29345","646",2023-07-03 16:00:00,-2968,1913,4881,907,FALSE,NA,"0.1.4"
"29346","646",2023-07-03 16:15:00,-2964,1913,4877,907,FALSE,NA,"0.1.4"
"29347","646",2023-07-03 16:30:00,-2964,1913,4877,907,FALSE,NA,"0.1.4"
"29348","646",2023-07-03 16:45:00,-2963,1913,4876,907,FALSE,NA,"0.1.4"
"29349","646",2023-07-03 17:00:00,-2964,1913,4877,907,FALSE,NA,"0.1.4"
"29350","646",2023-07-03 17:15:00,-2966,1913,4879,907,FALSE,NA,"0.1.4"
"29351","646",2023-07-03 17:30:00,-2966,1913,4879,907,FALSE,NA,"0.1.4"
"29352","646",2023-07-03 17:45:00,-2968,1913,4881,907,FALSE,NA,"0.1.4"
"29353","646",2023-07-03 18:00:00,-2967,1913,4880,907,FALSE,NA,"0.1.4"
"29354","646",2023-07-03 18:15:00,-2964,1913,4877,907,FALSE,NA,"0.1.4"
"29355","646",2023-07-03 18:30:00,-2964,1913,4877,907,FALSE,NA,"0.1.4"
"29356","646",2023-07-03 18:45:00,-2964,1913,4877,907,FALSE,NA,"0.1.4"
"29357","646",2023-07-03 19:00:00,-2965,1913,4878,907,FALSE,NA,"0.1.4"
"29358","646",2023-07-03 19:15:00,-2966,1913,4879,907,FALSE,NA,"0.1.4"
"29359","646",2023-07-03 19:30:00,-2963,1913,4876,907,FALSE,NA,"0.1.4"
"29360","646",2023-07-03 19:45:00,-2969,1913,4882,907,FALSE,NA,"0.1.4"
"29361","646",2023-07-03 20:00:00,-2969,1913,4882,907,FALSE,NA,"0.1.4"
"29362","646",2023-07-03 20:15:00,-2971,1913,4884,907,FALSE,NA,"0.1.4"
"29363","646",2023-07-03 20:30:00,-2968,1913,4881,907,FALSE,NA,"0.1.4"
"29364","646",2023-07-03 20:45:00,-2965,1913,4878,907,FALSE,NA,"0.1.4"
"29365","646",2023-07-03 21:00:00,-2967,1913,4880,907,FALSE,NA,"0.1.4"
"29366","646",2023-07-03 21:15:00,-2972,1913,4885,907,FALSE,NA,"0.1.4"
"29367","646",2023-07-03 21:30:00,-2966,1913,4879,907,FALSE,NA,"0.1.4"
"29368","646",2023-07-03 21:45:00,-2965,1913,4878,907,FALSE,NA,"0.1.4"
"29369","646",2023-07-03 22:00:00,-2966,1913,4879,907,FALSE,NA,"0.1.4"
"29370","646",2023-07-03 22:15:00,-2965,1913,4878,907,FALSE,NA,"0.1.4"
"29371","646",2023-07-03 22:30:00,-2970,1913,4883,907,FALSE,NA,"0.1.4"
"29372","646",2023-07-03 22:45:00,-2966,1913,4879,907,FALSE,NA,"0.1.4"
"29373","646",2023-07-03 23:00:00,-2972,1913,4885,907,FALSE,NA,"0.1.4"
"29374","646",2023-07-03 23:15:00,-2974,1913,4887,907,FALSE,NA,"0.1.4"
"29375","646",2023-07-03 23:30:00,-2966,1913,4879,907,FALSE,NA,"0.1.4"
"29376","646",2023-07-03 23:45:00,-2969,1913,4882,907,FALSE,NA,"0.1.4"
"29377","646",2023-07-04,-2967,1913,4880,907,FALSE,NA,"0.1.4"
"29378","646",2023-07-04 00:15:00,-2964,1913,4877,907,FALSE,NA,"0.1.4"
"29379","646",2023-07-04 00:30:00,-2965,1913,4878,907,FALSE,NA,"0.1.4"
"29380","646",2023-07-04 00:45:00,-2973,1913,4886,907,FALSE,NA,"0.1.4"
"29381","646",2023-07-04 01:00:00,-2975,1913,4888,907,FALSE,NA,"0.1.4"
"29382","646",2023-07-04 01:15:00,-2965,1913,4878,907,FALSE,NA,"0.1.4"
"29383","646",2023-07-04 01:30:00,-2965,1913,4878,907,FALSE,NA,"0.1.4"
"29384","646",2023-07-04 01:45:00,-2964,1913,4877,907,FALSE,NA,"0.1.4"
"29385","646",2023-07-04 02:00:00,-3300,1913,5213,907,FALSE,NA,"0.1.4"
"29386","646",2023-07-04 02:15:00,-2966,1913,4879,907,FALSE,NA,"0.1.4"
"29387","646",2023-07-04 02:30:00,-2969,1913,4882,907,FALSE,NA,"0.1.4"
"29388","646",2023-07-04 02:45:00,-2978,1913,4891,907,FALSE,NA,"0.1.4"
"29389","646",2023-07-04 03:00:00,-2966,1913,4879,907,FALSE,NA,"0.1.4"
"29390","646",2023-07-04 03:15:00,-2974,1913,4887,907,FALSE,NA,"0.1.4"
"29391","646",2023-07-04 03:30:00,-3011,1913,4924,907,FALSE,NA,"0.1.4"
"29392","646",2023-07-04 03:45:00,-3020,1913,4933,907,FALSE,NA,"0.1.4"
"29393","646",2023-07-04 04:00:00,-3100,1913,5013,907,FALSE,NA,"0.1.4"
"29394","646",2023-07-04 04:15:00,-2990,1913,4903,907,FALSE,NA,"0.1.4"
"29395","646",2023-07-04 04:30:00,-3032,1913,4945,907,FALSE,NA,"0.1.4"
"29396","646",2023-07-04 04:45:00,-2973,1913,4886,907,FALSE,NA,"0.1.4"
"29397","646",2023-07-04 05:00:00,-2961,1913,4874,907,FALSE,NA,"0.1.4"
"29398","646",2023-07-04 05:15:00,-2980,1913,4893,907,FALSE,NA,"0.1.4"
"29399","646",2023-07-04 05:30:00,-2989,1913,4902,907,FALSE,NA,"0.1.4"
"29400","646",2023-07-04 05:45:00,-2966,1913,4879,907,FALSE,NA,"0.1.4"
"29401","646",2023-07-04 06:00:00,-3249,1913,5162,907,FALSE,NA,"0.1.4"
"29402","646",2023-07-04 06:15:00,-2957,1913,4870,907,FALSE,NA,"0.1.4"
"29403","646",2023-07-04 06:30:00,-3336,1913,5249,907,FALSE,NA,"0.1.4"
"29404","646",2023-07-04 06:45:00,-2957,1913,4870,907,FALSE,NA,"0.1.4"
"29405","646",2023-07-04 07:00:00,-2967,1913,4880,907,FALSE,NA,"0.1.4"
"29406","646",2023-07-04 07:15:00,-3316,1913,5229,907,FALSE,"out1, fill","0.1.4"
"29407","646",2023-07-04 07:30:00,-3665,1913,5578,907,FALSE,NA,"0.1.4"
"29408","646",2023-07-04 07:45:00,-3839,1913,5752,907,FALSE,NA,"0.1.4"
"29409","646",2023-07-04 08:00:00,-3370,1913,5283,907,FALSE,NA,"0.1.4"
"29410","646",2023-07-04 08:15:00,-2985,1913,4898,907,FALSE,NA,"0.1.4"
"29411","646",2023-07-04 08:30:00,-3032,1913,4945,907,FALSE,NA,"0.1.4"
"29412","646",2023-07-04 08:45:00,-3268,1913,5181,907,FALSE,NA,"0.1.4"
"29413","646",2023-07-04 09:00:00,-3448,1913,5361,907,FALSE,NA,"0.1.4"
"29414","646",2023-07-04 09:15:00,-3582,1913,5495,907,FALSE,NA,"0.1.4"
"29415","646",2023-07-04 09:30:00,-3582,1913,5495,907,FALSE,"jump1","0.1.4"
"29416","646",2023-07-04 09:45:00,-3483,1913,5396,907,FALSE,NA,"0.1.4"
"29417","646",2023-07-04 10:00:00,-3484,1913,5397,907,FALSE,NA,"0.1.4"
"29418","646",2023-07-04 10:15:00,-3484,1913,5397,907,FALSE,NA,"0.1.4"
"29419","646",2023-07-04 10:30:00,-3484,1913,5397,907,FALSE,NA,"0.1.4"
"29420","646",2023-07-04 10:45:00,-3483,1913,5396,907,FALSE,NA,"0.1.4"
"29421","646",2023-07-04 11:00:00,-3481,1913,5394,907,FALSE,NA,"0.1.4"
"29422","646",2023-07-04 11:15:00,-3483,1913,5396,907,FALSE,NA,"0.1.4"
"29423","646",2023-07-04 11:30:00,-3483,1913,5396,907,FALSE,NA,"0.1.4"
"29424","646",2023-07-04 11:45:00,-3484,1913,5397,907,FALSE,NA,"0.1.4"
"29425","646",2023-07-04 12:00:00,-3483,1913,5396,907,FALSE,NA,"0.1.4"
"29426","646",2023-07-04 12:15:00,-3483,1913,5396,907,FALSE,NA,"0.1.4"
"29427","646",2023-07-04 12:30:00,-3527,1913,5440,907,FALSE,NA,"0.1.4"
"29428","646",2023-07-04 12:45:00,-3744,1913,5657,907,FALSE,NA,"0.1.4"
"29429","646",2023-07-04 13:00:00,-3503,1913,5416,907,FALSE,NA,"0.1.4"
"29430","646",2023-07-04 13:15:00,-3494,1913,5407,907,FALSE,NA,"0.1.4"
"29431","646",2023-07-04 13:30:00,-3572,1913,5485,907,FALSE,NA,"0.1.4"
"29432","646",2023-07-04 13:45:00,-3572,1913,5485,907,FALSE,"jump1","0.1.4"
"29433","646",2023-07-04 14:00:00,-3376,1913,5289,907,FALSE,NA,"0.1.4"
"29434","646",2023-07-04 14:15:00,-2967,1913,4880,907,FALSE,NA,"0.1.4"
"29435","646",2023-07-04 14:30:00,-2934,1913,4847,907,FALSE,NA,"0.1.4"
"29436","646",2023-07-04 14:45:00,-2984,1913,4897,907,FALSE,NA,"0.1.4"
"29437","646",2023-07-04 15:00:00,-2954,1913,4867,907,FALSE,NA,"0.1.4"
"29438","646",2023-07-04 15:15:00,-2939,1913,4852,907,FALSE,NA,"0.1.4"
"29439","646",2023-07-04 15:30:00,-2946,1913,4859,907,FALSE,NA,"0.1.4"
"29440","646",2023-07-04 15:45:00,-2930,1913,4843,907,FALSE,NA,"0.1.4"
"29441","646",2023-07-04 16:00:00,-2941,1913,4854,907,FALSE,NA,"0.1.4"
"29442","646",2023-07-04 16:15:00,-2925,1913,4838,907,FALSE,NA,"0.1.4"
"29443","646",2023-07-04 16:30:00,-2923,1913,4836,907,FALSE,NA,"0.1.4"
"29444","646",2023-07-04 16:45:00,-2926,1913,4839,907,FALSE,NA,"0.1.4"
"29445","646",2023-07-04 17:00:00,-2926,1913,4839,907,FALSE,NA,"0.1.4"
"29446","646",2023-07-04 17:15:00,-2926,1913,4839,907,FALSE,NA,"0.1.4"
"29447","646",2023-07-04 17:30:00,-2926,1913,4839,907,FALSE,NA,"0.1.4"
"29448","646",2023-07-04 17:45:00,-2926,1913,4839,907,FALSE,NA,"0.1.4"
"29449","646",2023-07-04 18:00:00,-2926,1913,4839,907,FALSE,NA,"0.1.4"
"29450","646",2023-07-04 18:15:00,-2927,1913,4840,907,FALSE,NA,"0.1.4"
"29451","646",2023-07-04 18:30:00,-2927,1913,4840,907,FALSE,NA,"0.1.4"
"29452","646",2023-07-04 18:45:00,-2927,1913,4840,907,FALSE,NA,"0.1.4"
"29453","646",2023-07-04 19:00:00,-2927,1913,4840,907,FALSE,NA,"0.1.4"
"29454","646",2023-07-04 19:15:00,-2928,1913,4841,907,FALSE,NA,"0.1.4"
"29455","646",2023-07-04 19:30:00,-2927,1913,4840,907,FALSE,NA,"0.1.4"
"29456","646",2023-07-04 19:45:00,-2927,1913,4840,907,FALSE,NA,"0.1.4"
"29457","646",2023-07-04 20:00:00,-2927,1913,4840,907,FALSE,NA,"0.1.4"
"29458","646",2023-07-04 20:15:00,-2926,1913,4839,907,FALSE,NA,"0.1.4"
"29459","646",2023-07-04 20:30:00,-2927,1913,4840,907,FALSE,NA,"0.1.4"
"29460","646",2023-07-04 20:45:00,-2927,1913,4840,907,FALSE,NA,"0.1.4"
"29461","646",2023-07-04 21:00:00,-2927,1913,4840,907,FALSE,NA,"0.1.4"
"29462","646",2023-07-04 21:15:00,-2927,1913,4840,907,FALSE,NA,"0.1.4"
"29463","646",2023-07-04 21:30:00,-2927,1913,4840,907,FALSE,NA,"0.1.4"
"29464","646",2023-07-04 21:45:00,-2927,1913,4840,907,FALSE,NA,"0.1.4"
"29465","646",2023-07-04 22:00:00,-2927,1913,4840,907,FALSE,NA,"0.1.4"
"29466","646",2023-07-04 22:15:00,-2927,1913,4840,907,FALSE,NA,"0.1.4"
"29467","646",2023-07-04 22:30:00,-2927,1913,4840,907,FALSE,NA,"0.1.4"
"29468","646",2023-07-04 22:45:00,-2926,1913,4839,907,FALSE,NA,"0.1.4"
"29469","646",2023-07-04 23:00:00,-2927,1913,4840,907,FALSE,NA,"0.1.4"
"29470","646",2023-07-04 23:15:00,-2927,1913,4840,907,FALSE,NA,"0.1.4"
"29471","646",2023-07-04 23:30:00,-2927,1913,4840,907,FALSE,NA,"0.1.4"
"29472","646",2023-07-04 23:45:00,-2926,1913,4839,907,FALSE,NA,"0.1.4"
"29473","646",2023-07-05,-2927,1913,4840,907,FALSE,NA,"0.1.4"
"29474","646",2023-07-05 00:15:00,-2927,1913,4840,907,FALSE,NA,"0.1.4"
"29475","646",2023-07-05 00:30:00,-2927,1913,4840,907,FALSE,NA,"0.1.4"
"29476","646",2023-07-05 00:45:00,-2926,1913,4839,907,FALSE,NA,"0.1.4"
"29477","646",2023-07-05 01:00:00,-2924,1913,4837,907,FALSE,NA,"0.1.4"
"29478","646",2023-07-05 01:15:00,-2926,1913,4839,907,FALSE,NA,"0.1.4"
"29479","646",2023-07-05 01:30:00,-2924,1913,4837,907,FALSE,NA,"0.1.4"
"29480","646",2023-07-05 01:45:00,-2926,1913,4839,907,FALSE,NA,"0.1.4"
"29481","646",2023-07-05 02:00:00,-2924,1913,4837,907,FALSE,NA,"0.1.4"
"29482","646",2023-07-05 02:15:00,-2921,1913,4834,907,FALSE,NA,"0.1.4"
"29483","646",2023-07-05 02:30:00,-2925,1913,4838,907,FALSE,NA,"0.1.4"
"29484","646",2023-07-05 02:45:00,-2924,1913,4837,907,FALSE,NA,"0.1.4"
"29485","646",2023-07-05 03:00:00,-2922,1913,4835,907,FALSE,NA,"0.1.4"
"29486","646",2023-07-05 03:15:00,-2925,1913,4838,907,FALSE,NA,"0.1.4"
"29487","646",2023-07-05 03:30:00,-2924,1913,4837,907,FALSE,NA,"0.1.4"
"29488","646",2023-07-05 03:45:00,-2925,1913,4838,907,FALSE,NA,"0.1.4"
"29489","646",2023-07-05 04:00:00,-2927,1913,4840,907,FALSE,NA,"0.1.4"
"29490","646",2023-07-05 04:15:00,-2926,1913,4839,907,FALSE,NA,"0.1.4"
"29491","646",2023-07-05 04:30:00,-2925,1913,4838,907,FALSE,NA,"0.1.4"
"29492","646",2023-07-05 04:45:00,-2926,1913,4839,907,FALSE,NA,"0.1.4"
"29493","646",2023-07-05 05:00:00,-2923,1913,4836,907,FALSE,NA,"0.1.4"
"29494","646",2023-07-05 05:15:00,-2925,1913,4838,907,FALSE,NA,"0.1.4"
"29495","646",2023-07-05 05:30:00,-2925,1913,4838,907,FALSE,NA,"0.1.4"
"29496","646",2023-07-05 05:45:00,-2923,1913,4836,907,FALSE,NA,"0.1.4"
"29497","646",2023-07-05 06:00:00,-2927,1913,4840,907,FALSE,NA,"0.1.4"
"29498","646",2023-07-05 06:15:00,-2924,1913,4837,907,FALSE,NA,"0.1.4"
"29499","646",2023-07-05 06:30:00,-2998,1913,4911,907,FALSE,NA,"0.1.4"
"29500","646",2023-07-05 06:45:00,-2999,1913,4912,907,FALSE,NA,"0.1.4"
"29501","646",2023-07-05 07:00:00,-3215,1913,5128,907,FALSE,NA,"0.1.4"
"29502","646",2023-07-05 07:15:00,-3215,1913,5128,907,FALSE,"jump1","0.1.4"
"29503","646",2023-07-05 07:30:00,-3363.75,1913,5276.75,907,FALSE,"out1, fill","0.1.4"
"29504","646",2023-07-05 07:45:00,-3512.5,1913,5425.5,907,FALSE,"out1, fill","0.1.4"
"29505","646",2023-07-05 08:00:00,-3661.25,1913,5574.25,907,FALSE,"out1, fill","0.1.4"
"29506","646",2023-07-05 08:15:00,-3810,1913,5723,907,FALSE,NA,"0.1.4"
"29507","646",2023-07-05 08:30:00,-3653,1913,5566,907,FALSE,NA,"0.1.4"
"29508","646",2023-07-05 08:45:00,-3635,1913,5548,907,FALSE,NA,"0.1.4"
"29509","646",2023-07-05 09:00:00,-3895,1913,5808,907,FALSE,NA,"0.1.4"
"29510","646",2023-07-05 09:15:00,-3822,1913,5735,907,FALSE,NA,"0.1.4"
"29511","646",2023-07-05 09:30:00,-3699,1913,5612,907,FALSE,NA,"0.1.4"
"29512","646",2023-07-05 09:45:00,-3699,1913,5612,907,FALSE,"out1, fill","0.1.4"
"29513","646",2023-07-05 10:00:00,-3699,1913,5612,907,FALSE,"jump1","0.1.4"
"29514","646",2023-07-05 10:15:00,-3699,1913,5612,907,FALSE,"jump1","0.1.4"
"29515","646",2023-07-05 10:30:00,-3699,1913,5612,907,FALSE,"jump1","0.1.4"
"29516","646",2023-07-05 10:45:00,-3699,1913,5612,907,FALSE,"out1, fill","0.1.4"
"29517","646",2023-07-05 11:00:00,-3699,1913,5612,907,FALSE,"jump1","0.1.4"
"29518","646",2023-07-05 11:15:00,-3668,1913,5581,907,FALSE,NA,"0.1.4"
"29519","646",2023-07-05 11:30:00,-3818,1913,5731,907,FALSE,NA,"0.1.4"
"29520","646",2023-07-05 11:45:00,-3780.16666666667,1913,5693.16666666667,907,FALSE,"out1, fill","0.1.4"
"29521","646",2023-07-05 12:00:00,-3742.33333333333,1913,5655.33333333333,907,FALSE,"out1, fill","0.1.4"
"29522","646",2023-07-05 12:15:00,-3704.5,1913,5617.5,907,FALSE,"out1, fill","0.1.4"
"29523","646",2023-07-05 12:30:00,-3666.66666666667,1913,5579.66666666667,907,FALSE,"out1, fill","0.1.4"
"29524","646",2023-07-05 12:45:00,-3628.83333333333,1913,5541.83333333333,907,FALSE,"out1, fill","0.1.4"
"29525","646",2023-07-05 13:00:00,-3591,1913,5504,907,FALSE,NA,"0.1.4"
"29526","646",2023-07-05 13:15:00,-3605,1913,5518,907,FALSE,NA,"0.1.4"
"29527","646",2023-07-05 13:30:00,-3587,1913,5500,907,FALSE,NA,"0.1.4"
"29528","646",2023-07-05 13:45:00,-3588,1913,5501,907,FALSE,NA,"0.1.4"
"29529","646",2023-07-05 14:00:00,-3583,1913,5496,907,FALSE,NA,"0.1.4"
"29530","646",2023-07-05 14:15:00,-3583,1913,5496,907,FALSE,NA,"0.1.4"
"29531","646",2023-07-05 14:30:00,-3577,1913,5490,907,FALSE,NA,"0.1.4"
"29532","646",2023-07-05 14:45:00,-3573,1913,5486,907,FALSE,NA,"0.1.4"
"29533","646",2023-07-05 15:00:00,-3585,1913,5498,907,FALSE,NA,"0.1.4"
"29534","646",2023-07-05 15:15:00,-3571,1913,5484,907,FALSE,NA,"0.1.4"
"29535","646",2023-07-05 15:30:00,-3572,1913,5485,907,FALSE,NA,"0.1.4"
"29536","646",2023-07-05 15:45:00,-3572,1913,5485,907,FALSE,NA,"0.1.4"
"29537","646",2023-07-05 16:00:00,-3598,1913,5511,907,FALSE,NA,"0.1.4"
"29538","646",2023-07-05 16:15:00,-3573,1913,5486,907,FALSE,NA,"0.1.4"
"29539","646",2023-07-05 16:30:00,-3616,1913,5529,907,FALSE,NA,"0.1.4"
"29540","646",2023-07-05 16:45:00,-3602,1913,5515,907,FALSE,NA,"0.1.4"
"29541","646",2023-07-05 17:00:00,-3584,1913,5497,907,FALSE,NA,"0.1.4"
"29542","646",2023-07-05 17:15:00,-3609,1913,5522,907,FALSE,NA,"0.1.4"
"29543","646",2023-07-05 17:30:00,-3601,1913,5514,907,FALSE,NA,"0.1.4"
"29544","646",2023-07-05 17:45:00,-3580,1913,5493,907,FALSE,NA,"0.1.4"
"29545","646",2023-07-05 18:00:00,-3597,1913,5510,907,FALSE,NA,"0.1.4"
"29546","646",2023-07-05 18:15:00,-3606,1913,5519,907,FALSE,NA,"0.1.4"
"29547","646",2023-07-05 18:30:00,-3602,1913,5515,907,FALSE,NA,"0.1.4"
"29548","646",2023-07-05 18:45:00,-3596,1913,5509,907,FALSE,NA,"0.1.4"
"29549","646",2023-07-05 19:00:00,-3602,1913,5515,907,FALSE,NA,"0.1.4"
"29550","646",2023-07-05 19:15:00,-3583,1913,5496,907,FALSE,NA,"0.1.4"
"29551","646",2023-07-05 19:30:00,-3587,1913,5500,907,FALSE,NA,"0.1.4"
"29552","646",2023-07-05 19:45:00,-3599,1913,5512,907,FALSE,NA,"0.1.4"
"29553","646",2023-07-05 20:00:00,-3581,1913,5494,907,FALSE,NA,"0.1.4"
"29554","646",2023-07-05 20:15:00,-3584,1913,5497,907,FALSE,NA,"0.1.4"
"29555","646",2023-07-05 20:30:00,-3605,1913,5518,907,FALSE,NA,"0.1.4"
"29556","646",2023-07-05 20:45:00,-3598,1913,5511,907,FALSE,NA,"0.1.4"
"29557","646",2023-07-05 21:00:00,-3608,1913,5521,907,FALSE,NA,"0.1.4"
"29558","646",2023-07-05 21:15:00,-3606,1913,5519,907,FALSE,NA,"0.1.4"
"29559","646",2023-07-05 21:30:00,-3598,1913,5511,907,FALSE,NA,"0.1.4"
"29560","646",2023-07-05 21:45:00,-3584,1913,5497,907,FALSE,NA,"0.1.4"
"29561","646",2023-07-05 22:00:00,-3594,1913,5507,907,FALSE,NA,"0.1.4"
"29562","646",2023-07-05 22:15:00,-3593,1913,5506,907,FALSE,NA,"0.1.4"
"29563","646",2023-07-05 22:30:00,-3609,1913,5522,907,FALSE,NA,"0.1.4"
"29564","646",2023-07-05 22:45:00,-3609,1913,5522,907,FALSE,NA,"0.1.4"
"29565","646",2023-07-05 23:00:00,-3607,1913,5520,907,FALSE,NA,"0.1.4"
"29566","646",2023-07-05 23:15:00,-3608,1913,5521,907,FALSE,NA,"0.1.4"
"29567","646",2023-07-05 23:30:00,-3660,1913,5573,907,FALSE,NA,"0.1.4"
"29568","646",2023-07-05 23:45:00,-3614,1913,5527,907,FALSE,NA,"0.1.4"
"29569","646",2023-07-06,-3611,1913,5524,907,FALSE,NA,"0.1.4"
"29570","646",2023-07-06 00:15:00,-3583,1913,5496,907,FALSE,NA,"0.1.4"
"29571","646",2023-07-06 00:30:00,-3618,1913,5531,907,FALSE,NA,"0.1.4"
"29572","646",2023-07-06 00:45:00,-3619,1913,5532,907,FALSE,NA,"0.1.4"
"29573","646",2023-07-06 01:00:00,-3604,1913,5517,907,FALSE,NA,"0.1.4"
"29574","646",2023-07-06 01:15:00,-3603,1913,5516,907,FALSE,NA,"0.1.4"
"29575","646",2023-07-06 01:30:00,-3599,1913,5512,907,FALSE,NA,"0.1.4"
"29576","646",2023-07-06 01:45:00,-3619,1913,5532,907,FALSE,NA,"0.1.4"
"29577","646",2023-07-06 02:00:00,-3612,1913,5525,907,FALSE,NA,"0.1.4"
"29578","646",2023-07-06 02:15:00,-3611,1913,5524,907,FALSE,NA,"0.1.4"
"29579","646",2023-07-06 02:30:00,-3620,1913,5533,907,FALSE,NA,"0.1.4"
"29580","646",2023-07-06 02:45:00,-3624,1913,5537,907,FALSE,NA,"0.1.4"
"29581","646",2023-07-06 03:00:00,-3629,1913,5542,907,FALSE,NA,"0.1.4"
"29582","646",2023-07-06 03:15:00,-3629,1913,5542,907,FALSE,"jump1","0.1.4"
"29583","646",2023-07-06 03:30:00,-3629,1913,5542,907,FALSE,"jump1","0.1.4"
"29584","646",2023-07-06 03:45:00,-3620.83333333333,1913,5533.83333333333,907,FALSE,"out1, fill","0.1.4"
"29585","646",2023-07-06 04:00:00,-3612.66666666667,1913,5525.66666666667,907,FALSE,"out1, fill","0.1.4"
"29586","646",2023-07-06 04:15:00,-3604.5,1913,5517.5,907,FALSE,"out1, fill","0.1.4"
"29587","646",2023-07-06 04:30:00,-3596.33333333333,1913,5509.33333333333,907,FALSE,"out1, fill","0.1.4"
"29588","646",2023-07-06 04:45:00,-3588.16666666667,1913,5501.16666666667,907,FALSE,"out1, fill","0.1.4"
"29589","646",2023-07-06 05:00:00,-3580,1913,5493,907,FALSE,NA,"0.1.4"
"29590","646",2023-07-06 05:15:00,-3652,1913,5565,907,FALSE,NA,"0.1.4"
"29591","646",2023-07-06 05:30:00,-3598,1913,5511,907,FALSE,NA,"0.1.4"
"29592","646",2023-07-06 05:45:00,-3597,1913,5510,907,FALSE,NA,"0.1.4"
"29593","646",2023-07-06 06:00:00,-3558,1913,5471,907,FALSE,NA,"0.1.4"
"29594","646",2023-07-06 06:15:00,-3566,1913,5479,907,FALSE,NA,"0.1.4"
"29595","646",2023-07-06 06:30:00,-3566,1913,5479,907,FALSE,"jump1","0.1.4"
"29596","646",2023-07-06 06:45:00,-3566,1913,5479,907,FALSE,"jump1","0.1.4"
"29597","646",2023-07-06 07:00:00,-3740,1913,5653,907,FALSE,NA,"0.1.4"
"29598","646",2023-07-06 07:15:00,-3882,1913,5795,907,FALSE,NA,"0.1.4"
"29599","646",2023-07-06 07:30:00,-3847.33333333333,1913,5760.33333333333,907,FALSE,"out1, fill","0.1.4"
"29600","646",2023-07-06 07:45:00,-3812.66666666667,1913,5725.66666666667,907,FALSE,"out1, fill","0.1.4"
"29601","646",2023-07-06 08:00:00,-3778,1913,5691,907,FALSE,NA,"0.1.4"
"29602","646",2023-07-06 08:15:00,-4234,1913,6147,907,FALSE,NA,"0.1.4"
"29603","646",2023-07-06 08:30:00,-4259,1913,6172,907,FALSE,NA,"0.1.4"
"29604","646",2023-07-06 08:45:00,-4541,1913,6454,907,FALSE,NA,"0.1.4"
"29605","646",2023-07-06 09:00:00,-4912,1913,6825,907,FALSE,NA,"0.1.4"
"29606","646",2023-07-06 09:15:00,-4912,1913,6825,907,FALSE,"out1, fill","0.1.4"
"29607","646",2023-07-06 09:30:00,-4912,1913,6825,907,FALSE,"jump1","0.1.4"
"29608","646",2023-07-06 09:45:00,-5087,1913,7000,907,FALSE,NA,"0.1.4"
"29609","646",2023-07-06 10:00:00,-5087,1913,7000,907,FALSE,"jump1","0.1.4"
"29610","646",2023-07-06 10:15:00,-5276,1913,7189,907,FALSE,NA,"0.1.4"
"29611","646",2023-07-06 10:30:00,-5276,1913,7189,907,FALSE,"jump1","0.1.4"
"29612","646",2023-07-06 10:45:00,-5758,1913,7671,907,FALSE,NA,"0.1.4"
"29613","646",2023-07-06 11:00:00,-5862,1913,7775,907,FALSE,NA,"0.1.4"
"29614","646",2023-07-06 11:15:00,-5773,1913,7686,907,FALSE,NA,"0.1.4"
"29615","646",2023-07-06 11:30:00,-5402,1913,7315,907,FALSE,NA,"0.1.4"
"29616","646",2023-07-06 11:45:00,-5255.5,1913,7168.5,907,FALSE,"out1, fill","0.1.4"
"29617","646",2023-07-06 12:00:00,-5109,1913,7022,907,FALSE,"out1, fill","0.1.4"
"29618","646",2023-07-06 12:15:00,-4962.5,1913,6875.5,907,FALSE,"out1, fill","0.1.4"
"29619","646",2023-07-06 12:30:00,-4816,1913,6729,907,FALSE,NA,"0.1.4"
"29620","646",2023-07-06 12:45:00,-5295,1913,7208,907,FALSE,NA,"0.1.4"
"29621","646",2023-07-06 13:00:00,-5091,1913,7004,907,FALSE,NA,"0.1.4"
"29622","646",2023-07-06 13:15:00,-4814,1913,6727,907,FALSE,NA,"0.1.4"
"29623","646",2023-07-06 13:30:00,-4753,1913,6666,907,FALSE,NA,"0.1.4"
"29624","646",2023-07-06 13:45:00,-4758,1913,6671,907,FALSE,NA,"0.1.4"
"29625","646",2023-07-06 14:00:00,-4885,1913,6798,907,FALSE,NA,"0.1.4"
"29626","646",2023-07-06 14:15:00,-5267,1913,7180,907,FALSE,"out1, fill","0.1.4"
"29627","646",2023-07-06 14:30:00,-5649,1913,7562,907,FALSE,NA,"0.1.4"
"29628","646",2023-07-06 14:45:00,-5616,1913,7529,907,FALSE,NA,"0.1.4"
"29629","646",2023-07-06 15:00:00,-5495,1913,7408,907,FALSE,NA,"0.1.4"
"29630","646",2023-07-06 15:15:00,-5533,1913,7446,907,FALSE,NA,"0.1.4"
"29631","646",2023-07-06 15:30:00,-5617,1913,7530,907,FALSE,NA,"0.1.4"
"29632","646",2023-07-06 15:45:00,-5557,1913,7470,907,FALSE,NA,"0.1.4"
"29633","646",2023-07-06 16:00:00,-5311,1913,7224,907,FALSE,NA,"0.1.4"
"29634","646",2023-07-06 16:15:00,-5426,1913,7339,907,FALSE,NA,"0.1.4"
"29635","646",2023-07-06 16:30:00,-5368,1913,7281,907,FALSE,NA,"0.1.4"
"29636","646",2023-07-06 16:45:00,-5368,1913,7281,907,FALSE,"jump1","0.1.4"
"29637","646",2023-07-06 17:00:00,-5360,1913,7273,907,FALSE,NA,"0.1.4"
"29638","646",2023-07-06 17:15:00,-5516,1913,7429,907,FALSE,NA,"0.1.4"
"29639","646",2023-07-06 17:30:00,-5516,1913,7429,907,FALSE,"jump1","0.1.4"
"29640","646",2023-07-06 17:45:00,-5516,1913,7429,907,FALSE,"jump1","0.1.4"
"29641","646",2023-07-06 18:00:00,-5516,1913,7429,907,FALSE,"jump1","0.1.4"
"29642","646",2023-07-06 18:15:00,-5516,1913,7429,907,FALSE,"jump1","0.1.4"
"29643","646",2023-07-06 18:30:00,-5491,1913,7404,907,FALSE,NA,"0.1.4"
"29644","646",2023-07-06 18:45:00,-5491,1913,7404,907,FALSE,"jump1","0.1.4"
"29645","646",2023-07-06 19:00:00,-5069,1913,6982,907,FALSE,NA,"0.1.4"
"29646","646",2023-07-06 19:15:00,-5081,1913,6994,907,FALSE,NA,"0.1.4"
"29647","646",2023-07-06 19:30:00,-4859,1913,6772,907,FALSE,NA,"0.1.4"
"29648","646",2023-07-06 19:45:00,-4892,1913,6805,907,FALSE,NA,"0.1.4"
"29649","646",2023-07-06 20:00:00,-4891,1913,6804,907,FALSE,"out1, fill","0.1.4"
"29650","646",2023-07-06 20:15:00,-4890,1913,6803,907,FALSE,"out1, fill","0.1.4"
"29651","646",2023-07-06 20:30:00,-4889,1913,6802,907,FALSE,"out1, fill","0.1.4"
"29652","646",2023-07-06 20:45:00,-4888,1913,6801,907,FALSE,NA,"0.1.4"
"29653","646",2023-07-06 21:00:00,-4889,1913,6802,907,FALSE,NA,"0.1.4"
"29654","646",2023-07-06 21:15:00,-4890,1913,6803,907,FALSE,NA,"0.1.4"
"29655","646",2023-07-06 21:30:00,-4891,1913,6804,907,FALSE,NA,"0.1.4"
"29656","646",2023-07-06 21:45:00,-4873,1913,6786,907,FALSE,NA,"0.1.4"
"29657","646",2023-07-06 22:00:00,-4872,1913,6785,907,FALSE,NA,"0.1.4"
"29658","646",2023-07-06 22:15:00,-4880,1913,6793,907,FALSE,NA,"0.1.4"
"29659","646",2023-07-06 22:30:00,-4878,1913,6791,907,FALSE,NA,"0.1.4"
"29660","646",2023-07-06 22:45:00,-4909,1913,6822,907,FALSE,NA,"0.1.4"
"29661","646",2023-07-06 23:00:00,-4896,1913,6809,907,FALSE,NA,"0.1.4"
"29662","646",2023-07-06 23:15:00,-4997,1913,6910,907,FALSE,NA,"0.1.4"
"29663","646",2023-07-06 23:30:00,-4889,1913,6802,907,FALSE,NA,"0.1.4"
"29664","646",2023-07-06 23:45:00,-4892,1913,6805,907,FALSE,NA,"0.1.4"
"29665","646",2023-07-07,-4892,1913,6805,907,FALSE,NA,"0.1.4"
"29666","646",2023-07-07 00:15:00,-4891,1913,6804,907,FALSE,NA,"0.1.4"
"29667","646",2023-07-07 00:30:00,-5262,1913,7175,907,FALSE,"out1, fill","0.1.4"
"29668","646",2023-07-07 00:45:00,-5633,1913,7546,907,FALSE,NA,"0.1.4"
"29669","646",2023-07-07 01:00:00,-5633,1913,7546,907,FALSE,"jump1","0.1.4"
"29670","646",2023-07-07 01:15:00,-5583,1913,7496,907,FALSE,NA,"0.1.4"
"29671","646",2023-07-07 01:30:00,-5582,1913,7495,907,FALSE,NA,"0.1.4"
"29672","646",2023-07-07 01:45:00,-5577,1913,7490,907,FALSE,NA,"0.1.4"
"29673","646",2023-07-07 02:00:00,-5578,1913,7491,907,FALSE,NA,"0.1.4"
"29674","646",2023-07-07 02:15:00,-5614,1913,7527,907,FALSE,"out1, fill","0.1.4"
"29675","646",2023-07-07 02:30:00,-5650,1913,7563,907,FALSE,"out1, fill","0.1.4"
"29676","646",2023-07-07 02:45:00,-5686,1913,7599,907,FALSE,"out1, fill","0.1.4"
"29677","646",2023-07-07 03:00:00,-5722,1913,7635,907,FALSE,"out1, fill","0.1.4"
"29678","646",2023-07-07 03:15:00,-5758,1913,7671,907,FALSE,NA,"0.1.4"
"29679","646",2023-07-07 03:30:00,-5605,1913,7518,907,FALSE,NA,"0.1.4"
"29680","646",2023-07-07 03:45:00,-5600,1913,7513,907,FALSE,NA,"0.1.4"
"29681","646",2023-07-07 04:00:00,-5607,1913,7520,907,FALSE,NA,"0.1.4"
"29682","646",2023-07-07 04:15:00,-5598.33333333333,1913,7511.33333333333,907,FALSE,"out1, fill","0.1.4"
"29683","646",2023-07-07 04:30:00,-5589.66666666667,1913,7502.66666666667,907,FALSE,"out1, fill","0.1.4"
"29684","646",2023-07-07 04:45:00,-5581,1913,7494,907,FALSE,NA,"0.1.4"
"29685","646",2023-07-07 05:00:00,-5595,1913,7508,907,FALSE,NA,"0.1.4"
"29686","646",2023-07-07 05:15:00,-5741,1913,7654,907,FALSE,NA,"0.1.4"
"29687","646",2023-07-07 05:30:00,-5890,1913,7803,907,FALSE,NA,"0.1.4"
"29688","646",2023-07-07 05:45:00,-5607,1913,7520,907,FALSE,NA,"0.1.4"
"29689","646",2023-07-07 06:00:00,-5581,1913,7494,907,FALSE,NA,"0.1.4"
"29690","646",2023-07-07 06:15:00,-5582,1913,7495,907,FALSE,NA,"0.1.4"
"29691","646",2023-07-07 06:30:00,-5595,1913,7508,907,FALSE,NA,"0.1.4"
"29692","646",2023-07-07 06:45:00,-5616,1913,7529,907,FALSE,NA,"0.1.4"
"29693","646",2023-07-07 07:00:00,-5608,1913,7521,907,FALSE,NA,"0.1.4"
"29694","646",2023-07-07 07:15:00,-5879,1913,7792,907,FALSE,NA,"0.1.4"
"29695","646",2023-07-07 07:30:00,-6054,1913,7967,907,FALSE,NA,"0.1.4"
"29696","646",2023-07-07 07:45:00,-5585,1913,7498,907,FALSE,NA,"0.1.4"
"29697","646",2023-07-07 08:00:00,-5600,1913,7513,907,FALSE,NA,"0.1.4"
"29698","646",2023-07-07 08:15:00,-6054,1913,7967,907,FALSE,NA,"0.1.4"
"29699","646",2023-07-07 08:30:00,-6044.66666666667,1913,7957.66666666667,907,FALSE,"out1, fill","0.1.4"
"29700","646",2023-07-07 08:45:00,-6035.33333333333,1913,7948.33333333333,907,FALSE,"out1, fill","0.1.4"
"29701","646",2023-07-07 09:00:00,-6026,1913,7939,907,FALSE,NA,"0.1.4"
"29702","646",2023-07-07 09:15:00,-5578,1913,7491,907,FALSE,NA,"0.1.4"
"29703","646",2023-07-07 09:30:00,-5688,1913,7601,907,FALSE,NA,"0.1.4"
"29704","646",2023-07-07 09:45:00,NA,NA,NA,NA,NA,"out1","0.1.4"
"29705","646",2023-07-07 10:00:00,NA,NA,NA,NA,NA,"out1","0.1.4"
"29706","646",2023-07-07 10:15:00,NA,NA,NA,NA,NA,"out1","0.1.4"
"29707","646",2023-07-07 10:30:00,NA,NA,NA,NA,NA,"out1","0.1.4"
"29708","646",2023-07-07 10:45:00,NA,NA,NA,NA,NA,"out1","0.1.4"
"29709","646",2023-07-07 11:00:00,NA,NA,NA,NA,NA,"out1","0.1.4"
"29710","646",2023-07-07 11:15:00,NA,NA,NA,NA,NA,"out1","0.1.4"
"29711","646",2023-07-07 11:30:00,NA,NA,NA,NA,NA,"out1","0.1.4"
"29712","646",2023-07-07 11:45:00,NA,NA,NA,NA,NA,"out1","0.1.4"
"29713","646",2023-07-07 12:00:00,NA,NA,NA,NA,NA,"out1","0.1.4"
"29714","646",2023-07-07 12:15:00,NA,NA,NA,NA,NA,"out1","0.1.4"
"29715","646",2023-07-07 12:30:00,NA,NA,NA,NA,NA,"out1","0.1.4"
"29716","646",2023-07-07 12:45:00,NA,NA,NA,NA,NA,"out1","0.1.4"
"29717","646",2023-07-07 13:00:00,NA,NA,NA,NA,NA,"out1","0.1.4"
"29718","646",2023-07-07 13:15:00,NA,NA,NA,NA,NA,"out1","0.1.4"
"29719","646",2023-07-07 13:30:00,NA,NA,NA,NA,NA,"out1","0.1.4"
"29720","646",2023-07-07 13:45:00,NA,NA,NA,NA,NA,"out1","0.1.4"
"29721","646",2023-07-07 14:00:00,-6528,1913,8441,907,FALSE,NA,"0.1.4"
"29722","646",2023-07-07 14:15:00,-6349,1913,8262,907,FALSE,NA,"0.1.4"
"29723","646",2023-07-07 14:30:00,-6337,1913,8250,907,FALSE,NA,"0.1.4"
"29724","646",2023-07-07 14:45:00,-6336,1913,8249,907,FALSE,NA,"0.1.4"
"29725","646",2023-07-07 15:00:00,-6364,1913,8277,907,FALSE,NA,"0.1.4"
"29726","646",2023-07-07 15:15:00,-6354,1913,8267,907,FALSE,NA,"0.1.4"
"29727","646",2023-07-07 15:30:00,-6350,1913,8263,907,FALSE,NA,"0.1.4"
"29728","646",2023-07-07 15:45:00,-6321,1913,8234,907,FALSE,NA,"0.1.4"
"29729","646",2023-07-07 16:00:00,-6688,1913,8601,907,FALSE,NA,"0.1.4"
"29730","646",2023-07-07 16:15:00,-6621.4,1913,8534.4,907,FALSE,"out1, fill","0.1.4"
"29731","646",2023-07-07 16:30:00,-6554.8,1913,8467.8,907,FALSE,"out1, fill","0.1.4"
"29732","646",2023-07-07 16:45:00,-6488.2,1913,8401.2,907,FALSE,"out1, fill","0.1.4"
"29733","646",2023-07-07 17:00:00,-6421.6,1913,8334.6,907,FALSE,"out1, fill","0.1.4"
"29734","646",2023-07-07 17:15:00,-6355,1913,8268,907,FALSE,NA,"0.1.4"
"29735","646",2023-07-07 17:30:00,-6098,1913,8011,907,FALSE,NA,"0.1.4"
"29736","646",2023-07-07 17:45:00,-5726,1913,7639,907,FALSE,NA,"0.1.4"
"29737","646",2023-07-07 18:00:00,-5610,1913,7523,907,FALSE,NA,"0.1.4"
"29738","646",2023-07-07 18:15:00,-5662,1913,7575,907,FALSE,NA,"0.1.4"
"29739","646",2023-07-07 18:30:00,-5582,1913,7495,907,FALSE,NA,"0.1.4"
"29740","646",2023-07-07 18:45:00,-5709,1913,7622,907,FALSE,NA,"0.1.4"
"29741","646",2023-07-07 19:00:00,-5596,1913,7509,907,FALSE,NA,"0.1.4"
"29742","646",2023-07-07 19:15:00,-5754,1913,7667,907,FALSE,NA,"0.1.4"
"29743","646",2023-07-07 19:30:00,-5580,1913,7493,907,FALSE,NA,"0.1.4"
"29744","646",2023-07-07 19:45:00,-5603,1913,7516,907,FALSE,NA,"0.1.4"
"29745","646",2023-07-07 20:00:00,-5593,1913,7506,907,FALSE,NA,"0.1.4"
"29746","646",2023-07-07 20:15:00,-5597,1913,7510,907,FALSE,NA,"0.1.4"
"29747","646",2023-07-07 20:30:00,-5579,1913,7492,907,FALSE,NA,"0.1.4"
"29748","646",2023-07-07 20:45:00,-5570,1913,7483,907,FALSE,NA,"0.1.4"
"29749","646",2023-07-07 21:00:00,-5584,1913,7497,907,FALSE,NA,"0.1.4"
"29750","646",2023-07-07 21:15:00,-5604,1913,7517,907,FALSE,NA,"0.1.4"
"29751","646",2023-07-07 21:30:00,-5552,1913,7465,907,FALSE,NA,"0.1.4"
"29752","646",2023-07-07 21:45:00,-5589,1913,7502,907,FALSE,NA,"0.1.4"
"29753","646",2023-07-07 22:00:00,-5582,1913,7495,907,FALSE,NA,"0.1.4"
"29754","646",2023-07-07 22:15:00,-5908,1913,7821,907,FALSE,NA,"0.1.4"
"29755","646",2023-07-07 22:30:00,-5857,1913,7770,907,FALSE,NA,"0.1.4"
"29756","646",2023-07-07 22:45:00,-5820,1913,7733,907,FALSE,NA,"0.1.4"
"29757","646",2023-07-07 23:00:00,-5683,1913,7596,907,FALSE,NA,"0.1.4"
"29758","646",2023-07-07 23:15:00,-5651,1913,7564,907,FALSE,NA,"0.1.4"
"29759","646",2023-07-07 23:30:00,-5558,1913,7471,907,FALSE,NA,"0.1.4"
"29760","646",2023-07-07 23:45:00,-5614,1913,7527,907,FALSE,NA,"0.1.4"
"29761","646",2023-07-08,-5547,1913,7460,907,FALSE,NA,"0.1.4"
"29762","646",2023-07-08 00:15:00,-5575,1913,7488,907,FALSE,NA,"0.1.4"
"29763","646",2023-07-08 00:30:00,-5622,1913,7535,907,FALSE,NA,"0.1.4"
"29764","646",2023-07-08 00:45:00,-5716,1913,7629,907,FALSE,NA,"0.1.4"
"29765","646",2023-07-08 01:00:00,-5588,1913,7501,907,FALSE,NA,"0.1.4"
"29766","646",2023-07-08 01:15:00,-5750,1913,7663,907,FALSE,NA,"0.1.4"
"29767","646",2023-07-08 01:30:00,-5566,1913,7479,907,FALSE,NA,"0.1.4"
"29768","646",2023-07-08 01:45:00,-6050,1913,7963,907,FALSE,"out1, fill","0.1.4"
"29769","646",2023-07-08 02:00:00,-6534,1913,8447,907,FALSE,NA,"0.1.4"
"29770","646",2023-07-08 02:15:00,-6358,1913,8271,907,FALSE,NA,"0.1.4"
"29771","646",2023-07-08 02:30:00,-6569,1913,8482,907,FALSE,NA,"0.1.4"
"29772","646",2023-07-08 02:45:00,-6636,1913,8549,907,FALSE,NA,"0.1.4"
"29773","646",2023-07-08 03:00:00,-6450,1913,8363,907,FALSE,NA,"0.1.4"
"29774","646",2023-07-08 03:15:00,-6638,1913,8551,907,FALSE,NA,"0.1.4"
"29775","646",2023-07-08 03:30:00,-6773,1913,8686,907,FALSE,NA,"0.1.4"
"29776","646",2023-07-08 03:45:00,-6773,1913,8686,907,FALSE,"jump1","0.1.4"
"29777","646",2023-07-08 04:00:00,-7135,1913,9048,907,FALSE,NA,"0.1.4"
"29778","646",2023-07-08 04:15:00,-7164.6,1913,9077.6,907,FALSE,"out1, fill","0.1.4"
"29779","646",2023-07-08 04:30:00,-7194.2,1913,9107.2,907,FALSE,"out1, fill","0.1.4"
"29780","646",2023-07-08 04:45:00,-7223.8,1913,9136.8,907,FALSE,"out1, fill","0.1.4"
"29781","646",2023-07-08 05:00:00,-7253.4,1913,9166.4,907,FALSE,"out1, fill","0.1.4"
"29782","646",2023-07-08 05:15:00,-7283,1913,9196,907,FALSE,NA,"0.1.4"
"29783","646",2023-07-08 05:30:00,-7671,1913,9584,907,FALSE,NA,"0.1.4"
"29784","646",2023-07-08 05:45:00,-7671,1913,9584,907,FALSE,"jump1","0.1.4"
"29785","646",2023-07-08 06:00:00,-7219,1913,9132,907,FALSE,NA,"0.1.4"
"29786","646",2023-07-08 06:15:00,-7205.66666666667,1913,9118.66666666667,907,FALSE,"out1, fill","0.1.4"
"29787","646",2023-07-08 06:30:00,-7192.33333333333,1913,9105.33333333333,907,FALSE,"out1, fill","0.1.4"
"29788","646",2023-07-08 06:45:00,-7179,1913,9092,907,FALSE,NA,"0.1.4"
"29789","646",2023-07-08 07:00:00,-7179,1913,9092,907,FALSE,"jump1","0.1.4"
"29790","646",2023-07-08 07:15:00,-7262,1913,9175,907,FALSE,NA,"0.1.4"
"29791","646",2023-07-08 07:30:00,-7262,1913,9175,907,FALSE,"jump1","0.1.4"
"29792","646",2023-07-08 07:45:00,-7229.875,1913,9142.875,907,FALSE,"out1, fill","0.1.4"
"29793","646",2023-07-08 08:00:00,-7197.75,1913,9110.75,907,FALSE,"out1, fill","0.1.4"
"29794","646",2023-07-08 08:15:00,-7165.625,1913,9078.625,907,FALSE,"out1, fill","0.1.4"
"29795","646",2023-07-08 08:30:00,-7133.5,1913,9046.5,907,FALSE,"out1, fill","0.1.4"
"29796","646",2023-07-08 08:45:00,-7101.375,1913,9014.375,907,FALSE,"out1, fill","0.1.4"
"29797","646",2023-07-08 09:00:00,-7069.25,1913,8982.25,907,FALSE,"out1, fill","0.1.4"
"29798","646",2023-07-08 09:15:00,-7037.125,1913,8950.125,907,FALSE,"out1, fill","0.1.4"
"29799","646",2023-07-08 09:30:00,-7005,1913,8918,907,FALSE,NA,"0.1.4"
"29800","646",2023-07-08 09:45:00,-6842,1913,8755,907,FALSE,NA,"0.1.4"
"29801","646",2023-07-08 10:00:00,-6842,1913,8755,907,FALSE,NA,"0.1.4"
"29802","646",2023-07-08 10:15:00,-7042,1913,8955,907,FALSE,NA,"0.1.4"
"29803","646",2023-07-08 10:30:00,-6856,1913,8769,907,FALSE,NA,"0.1.4"
"29804","646",2023-07-08 10:45:00,-6851.33333333333,1913,8764.33333333333,907,FALSE,"out1, fill","0.1.4"
"29805","646",2023-07-08 11:00:00,-6846.66666666667,1913,8759.66666666667,907,FALSE,"out1, fill","0.1.4"
"29806","646",2023-07-08 11:15:00,-6842,1913,8755,907,FALSE,NA,"0.1.4"
"29807","646",2023-07-08 11:30:00,-7342,1913,9255,907,FALSE,NA,"0.1.4"
"29808","646",2023-07-08 11:45:00,-6864,1913,8777,907,FALSE,NA,"0.1.4"
"29809","646",2023-07-08 12:00:00,-6887,1913,8800,907,FALSE,NA,"0.1.4"
"29810","646",2023-07-08 12:15:00,-6850,1913,8763,907,FALSE,NA,"0.1.4"
"29811","646",2023-07-08 12:30:00,-6859,1913,8772,907,FALSE,NA,"0.1.4"
"29812","646",2023-07-08 12:45:00,-7025.5,1913,8938.5,907,FALSE,"out1, fill","0.1.4"
"29813","646",2023-07-08 13:00:00,-7192,1913,9105,907,FALSE,"out1, fill","0.1.4"
"29814","646",2023-07-08 13:15:00,-7358.5,1913,9271.5,907,FALSE,"out1, fill","0.1.4"
"29815","646",2023-07-08 13:30:00,-7525,1913,9438,907,FALSE,NA,"0.1.4"
"29816","646",2023-07-08 13:45:00,-7223,1913,9136,907,FALSE,NA,"0.1.4"
"29817","646",2023-07-08 14:00:00,-6906,1913,8819,907,FALSE,NA,"0.1.4"
"29818","646",2023-07-08 14:15:00,-6969,1913,8882,907,FALSE,NA,"0.1.4"
"29819","646",2023-07-08 14:30:00,-6874,1913,8787,907,FALSE,NA,"0.1.4"
"29820","646",2023-07-08 14:45:00,-6856,1913,8769,907,FALSE,NA,"0.1.4"
"29821","646",2023-07-08 15:00:00,-6862,1913,8775,907,FALSE,NA,"0.1.4"
"29822","646",2023-07-08 15:15:00,-6853,1913,8766,907,FALSE,NA,"0.1.4"
"29823","646",2023-07-08 15:30:00,-6868,1913,8781,907,FALSE,NA,"0.1.4"
"29824","646",2023-07-08 15:45:00,-6905,1913,8818,907,FALSE,NA,"0.1.4"
"29825","646",2023-07-08 16:00:00,-6962,1913,8875,907,FALSE,NA,"0.1.4"
"29826","646",2023-07-08 16:15:00,-6842,1913,8755,907,FALSE,NA,"0.1.4"
"29827","646",2023-07-08 16:30:00,-6843,1913,8756,907,FALSE,NA,"0.1.4"
"29828","646",2023-07-08 16:45:00,-6880,1913,8793,907,FALSE,NA,"0.1.4"
"29829","646",2023-07-08 17:00:00,-6851,1913,8764,907,FALSE,NA,"0.1.4"
"29830","646",2023-07-08 17:15:00,-6934,1913,8847,907,FALSE,NA,"0.1.4"
"29831","646",2023-07-08 17:30:00,-6843,1913,8756,907,FALSE,NA,"0.1.4"
"29832","646",2023-07-08 17:45:00,-6843,1913,8756,907,FALSE,"jump1","0.1.4"
"29833","646",2023-07-08 18:00:00,-6380,1913,8293,907,FALSE,NA,"0.1.4"
"29834","646",2023-07-08 18:15:00,-6397,1913,8310,907,FALSE,NA,"0.1.4"
"29835","646",2023-07-08 18:30:00,-6874,1913,8787,907,FALSE,NA,"0.1.4"
"29836","646",2023-07-08 18:45:00,-6648,1913,8561,907,FALSE,NA,"0.1.4"
"29837","646",2023-07-08 19:00:00,-7096,1913,9009,907,FALSE,NA,"0.1.4"
"29838","646",2023-07-08 19:15:00,-7027.5,1913,8940.5,907,FALSE,"out1, fill","0.1.4"
"29839","646",2023-07-08 19:30:00,-6959,1913,8872,907,FALSE,NA,"0.1.4"
"29840","646",2023-07-08 19:45:00,-7043,1913,8956,907,FALSE,NA,"0.1.4"
"29841","646",2023-07-08 20:00:00,-6862,1913,8775,907,FALSE,NA,"0.1.4"
"29842","646",2023-07-08 20:15:00,-6862,1913,8775,907,FALSE,"jump1","0.1.4"
"29843","646",2023-07-08 20:30:00,-6863,1913,8776,907,FALSE,NA,"0.1.4"
"29844","646",2023-07-08 20:45:00,-6870,1913,8783,907,FALSE,NA,"0.1.4"
"29845","646",2023-07-08 21:00:00,-6868,1913,8781,907,FALSE,NA,"0.1.4"
"29846","646",2023-07-08 21:15:00,-7056,1913,8969,907,FALSE,NA,"0.1.4"
"29847","646",2023-07-08 21:30:00,-6859,1913,8772,907,FALSE,NA,"0.1.4"
"29848","646",2023-07-08 21:45:00,-6858,1913,8771,907,FALSE,NA,"0.1.4"
"29849","646",2023-07-08 22:00:00,-6858,1913,8771,907,FALSE,NA,"0.1.4"
"29850","646",2023-07-08 22:15:00,-6859,1913,8772,907,FALSE,NA,"0.1.4"
"29851","646",2023-07-08 22:30:00,-6858,1913,8771,907,FALSE,NA,"0.1.4"
"29852","646",2023-07-08 22:45:00,-6864,1913,8777,907,FALSE,NA,"0.1.4"
"29853","646",2023-07-08 23:00:00,-6866,1913,8779,907,FALSE,NA,"0.1.4"
"29854","646",2023-07-08 23:15:00,-6860,1913,8773,907,FALSE,NA,"0.1.4"
"29855","646",2023-07-08 23:30:00,-6885,1913,8798,907,FALSE,NA,"0.1.4"
"29856","646",2023-07-08 23:45:00,-6859,1913,8772,907,FALSE,NA,"0.1.4"
"29857","646",2023-07-09,-6858,1913,8771,907,FALSE,NA,"0.1.4"
"29858","646",2023-07-09 00:15:00,-6859,1913,8772,907,FALSE,NA,"0.1.4"
"29859","646",2023-07-09 00:30:00,-6859,1913,8772,907,FALSE,NA,"0.1.4"
"29860","646",2023-07-09 00:45:00,-6859,1913,8772,907,FALSE,NA,"0.1.4"
"29861","646",2023-07-09 01:00:00,-6859,1913,8772,907,FALSE,NA,"0.1.4"
"29862","646",2023-07-09 01:15:00,-6859,1913,8772,907,FALSE,"jump1","0.1.4"
"29863","646",2023-07-09 01:30:00,-6847,1913,8760,907,FALSE,NA,"0.1.4"
"29864","646",2023-07-09 01:45:00,-6847,1913,8760,907,FALSE,"jump1","0.1.4"
"29865","646",2023-07-09 02:00:00,-6962,1913,8875,907,FALSE,NA,"0.1.4"
"29866","646",2023-07-09 02:15:00,-6946,1913,8859,907,FALSE,NA,"0.1.4"
"29867","646",2023-07-09 02:30:00,-6970,1913,8883,907,FALSE,NA,"0.1.4"
"29868","646",2023-07-09 02:45:00,-6863,1913,8776,907,FALSE,NA,"0.1.4"
"29869","646",2023-07-09 03:00:00,-7188,1913,9101,907,FALSE,NA,"0.1.4"
"29870","646",2023-07-09 03:15:00,-6939,1913,8852,907,FALSE,NA,"0.1.4"
"29871","646",2023-07-09 03:30:00,-6908,1913,8821,907,FALSE,NA,"0.1.4"
"29872","646",2023-07-09 03:45:00,-6831,1913,8744,907,FALSE,NA,"0.1.4"
"29873","646",2023-07-09 04:00:00,-6897,1913,8810,907,FALSE,NA,"0.1.4"
"29874","646",2023-07-09 04:15:00,-6841,1913,8754,907,FALSE,NA,"0.1.4"
"29875","646",2023-07-09 04:30:00,-6831,1913,8744,907,FALSE,NA,"0.1.4"
"29876","646",2023-07-09 04:45:00,-6876,1913,8789,907,FALSE,NA,"0.1.4"
"29877","646",2023-07-09 05:00:00,-6817,1913,8730,907,FALSE,NA,"0.1.4"
"29878","646",2023-07-09 05:15:00,-6857,1913,8770,907,FALSE,NA,"0.1.4"
"29879","646",2023-07-09 05:30:00,-6836,1913,8749,907,FALSE,NA,"0.1.4"
"29880","646",2023-07-09 05:45:00,-6967,1913,8880,907,FALSE,NA,"0.1.4"
"29881","646",2023-07-09 06:00:00,-6989,1913,8902,907,FALSE,NA,"0.1.4"
"29882","646",2023-07-09 06:15:00,-7185.75,1913,9098.75,907,FALSE,"out1, fill","0.1.4"
"29883","646",2023-07-09 06:30:00,-7382.5,1913,9295.5,907,FALSE,"out1, fill","0.1.4"
"29884","646",2023-07-09 06:45:00,-7579.25,1913,9492.25,907,FALSE,"out1, fill","0.1.4"
"29885","646",2023-07-09 07:00:00,-7776,1913,9689,907,FALSE,NA,"0.1.4"
"29886","646",2023-07-09 07:15:00,-7703,1913,9616,907,FALSE,NA,"0.1.4"
"29887","646",2023-07-09 07:30:00,-7613,1913,9526,907,FALSE,NA,"0.1.4"
"29888","646",2023-07-09 07:45:00,-7613,1913,9526,907,FALSE,"jump1","0.1.4"
"29889","646",2023-07-09 08:00:00,-7533,1913,9446,907,FALSE,NA,"0.1.4"
"29890","646",2023-07-09 08:15:00,-7466,1913,9379,907,FALSE,NA,"0.1.4"
"29891","646",2023-07-09 08:30:00,-7513,1913,9426,907,FALSE,NA,"0.1.4"
"29892","646",2023-07-09 08:45:00,-7513,1913,9426,907,FALSE,"jump1","0.1.4"
"29893","646",2023-07-09 09:00:00,-7800,1913,9713,907,FALSE,NA,"0.1.4"
"29894","646",2023-07-09 09:15:00,-7800,1913,9713,907,FALSE,"jump1","0.1.4"
"29895","646",2023-07-09 09:30:00,-7564,1913,9477,907,FALSE,NA,"0.1.4"
"29896","646",2023-07-09 09:45:00,-7623,1913,9536,907,FALSE,NA,"0.1.4"
"29897","646",2023-07-09 10:00:00,-7708,1913,9621,907,FALSE,NA,"0.1.4"
"29898","646",2023-07-09 10:15:00,-7594,1913,9507,907,FALSE,NA,"0.1.4"
"29899","646",2023-07-09 10:30:00,-7800,1913,9713,907,FALSE,NA,"0.1.4"
"29900","646",2023-07-09 10:45:00,-7800,1913,9713,907,FALSE,"jump1","0.1.4"
"29901","646",2023-07-09 11:00:00,-7800,1913,9713,907,FALSE,"jump1","0.1.4"
"29902","646",2023-07-09 11:15:00,-7927.88888888889,1913,9840.88888888889,907,FALSE,"out1, fill","0.1.4"
"29903","646",2023-07-09 11:30:00,-8055.77777777778,1913,9968.77777777778,907,FALSE,"out1, fill","0.1.4"
"29904","646",2023-07-09 11:45:00,-8183.66666666667,1913,10096.6666666667,907,FALSE,"out1, fill","0.1.4"
"29905","646",2023-07-09 12:00:00,-8311.55555555555,1913,10224.5555555556,907,FALSE,"out1, fill","0.1.4"
"29906","646",2023-07-09 12:15:00,-8439.44444444445,1913,10352.4444444444,907,FALSE,"out1, fill","0.1.4"
"29907","646",2023-07-09 12:30:00,-8567.33333333333,1913,10480.3333333333,907,FALSE,"out1, fill","0.1.4"
"29908","646",2023-07-09 12:45:00,-8695.22222222222,1913,10608.2222222222,907,FALSE,"out1, fill","0.1.4"
"29909","646",2023-07-09 13:00:00,-8823.11111111111,1913,10736.1111111111,907,FALSE,"out1, fill","0.1.4"
"29910","646",2023-07-09 13:15:00,-8951,1913,10864,907,FALSE,NA,"0.1.4"
"29911","646",2023-07-09 13:30:00,-8951,1913,10864,907,FALSE,"jump1","0.1.4"
"29912","646",2023-07-09 13:45:00,-8906,1913,10819,907,FALSE,NA,"0.1.4"
"29913","646",2023-07-09 14:00:00,-8675,1913,10588,907,FALSE,NA,"0.1.4"
"29914","646",2023-07-09 14:15:00,-8675,1913,10588,907,FALSE,"jump1","0.1.4"
"29915","646",2023-07-09 14:30:00,-8307,1913,10220,907,FALSE,NA,"0.1.4"
"29916","646",2023-07-09 14:45:00,-8378,1913,10291,907,FALSE,NA,"0.1.4"
"29917","646",2023-07-09 15:00:00,-8378,1913,10291,907,FALSE,"jump1","0.1.4"
"29918","646",2023-07-09 15:15:00,-8161,1913,10074,907,FALSE,NA,"0.1.4"
"29919","646",2023-07-09 15:30:00,-8094,1913,10007,907,FALSE,NA,"0.1.4"
"29920","646",2023-07-09 15:45:00,-8078,1913,9991,907,FALSE,NA,"0.1.4"
"29921","646",2023-07-09 16:00:00,-8070,1913,9983,907,FALSE,NA,"0.1.4"
"29922","646",2023-07-09 16:15:00,-8043,1913,9956,907,FALSE,NA,"0.1.4"
"29923","646",2023-07-09 16:30:00,-8033,1913,9946,907,FALSE,NA,"0.1.4"
"29924","646",2023-07-09 16:45:00,-8056,1913,9969,907,FALSE,NA,"0.1.4"
"29925","646",2023-07-09 17:00:00,-8137,1913,10050,907,FALSE,NA,"0.1.4"
"29926","646",2023-07-09 17:15:00,-8067,1913,9980,907,FALSE,NA,"0.1.4"
"29927","646",2023-07-09 17:30:00,-8065,1913,9978,907,FALSE,NA,"0.1.4"
"29928","646",2023-07-09 17:45:00,-8445,1913,10358,907,FALSE,NA,"0.1.4"
"29929","646",2023-07-09 18:00:00,-8741,1913,10654,907,FALSE,NA,"0.1.4"
"29930","646",2023-07-09 18:15:00,-8741,1913,10654,907,FALSE,"jump1","0.1.4"
"29931","646",2023-07-09 18:30:00,-8756,1913,10669,907,FALSE,NA,"0.1.4"
"29932","646",2023-07-09 18:45:00,-8741,1913,10654,907,FALSE,NA,"0.1.4"
"29933","646",2023-07-09 19:00:00,-8742,1913,10655,907,FALSE,NA,"0.1.4"
"29934","646",2023-07-09 19:15:00,-8737,1913,10650,907,FALSE,NA,"0.1.4"
"29935","646",2023-07-09 19:30:00,-8778,1913,10691,907,FALSE,NA,"0.1.4"
"29936","646",2023-07-09 19:45:00,-8743,1913,10656,907,FALSE,NA,"0.1.4"
"29937","646",2023-07-09 20:00:00,-8792,1913,10705,907,FALSE,NA,"0.1.4"
"29938","646",2023-07-09 20:15:00,-9052,1913,10965,907,FALSE,NA,"0.1.4"
"29939","646",2023-07-09 20:30:00,-8743,1913,10656,907,FALSE,NA,"0.1.4"
"29940","646",2023-07-09 20:45:00,-8744,1913,10657,907,FALSE,"out1, fill","0.1.4"
"29941","646",2023-07-09 21:00:00,-8745,1913,10658,907,FALSE,"out1, fill","0.1.4"
"29942","646",2023-07-09 21:15:00,-8746,1913,10659,907,FALSE,"out1, fill","0.1.4"
"29943","646",2023-07-09 21:30:00,-8747,1913,10660,907,FALSE,NA,"0.1.4"
"29944","646",2023-07-09 21:45:00,-8747,1913,10660,907,FALSE,NA,"0.1.4"
"29945","646",2023-07-09 22:00:00,-8778,1913,10691,907,FALSE,NA,"0.1.4"
"29946","646",2023-07-09 22:15:00,-8741,1913,10654,907,FALSE,NA,"0.1.4"
"29947","646",2023-07-09 22:30:00,-8740,1913,10653,907,FALSE,NA,"0.1.4"
"29948","646",2023-07-09 22:45:00,-8735,1913,10648,907,FALSE,NA,"0.1.4"
"29949","646",2023-07-09 23:00:00,-8742,1913,10655,907,FALSE,NA,"0.1.4"
"29950","646",2023-07-09 23:15:00,-8735,1913,10648,907,FALSE,NA,"0.1.4"
"29951","646",2023-07-09 23:30:00,-8742,1913,10655,907,FALSE,NA,"0.1.4"
"29952","646",2023-07-09 23:45:00,-8745.66666666667,1913,10658.6666666667,907,FALSE,"out1, fill","0.1.4"
"29953","646",2023-07-10,-8749.33333333333,1913,10662.3333333333,907,FALSE,"out1, fill","0.1.4"
"29954","646",2023-07-10 00:15:00,-8753,1913,10666,907,FALSE,"out1, fill","0.1.4"
"29955","646",2023-07-10 00:30:00,-8756.66666666667,1913,10669.6666666667,907,FALSE,"out1, fill","0.1.4"
"29956","646",2023-07-10 00:45:00,-8760.33333333333,1913,10673.3333333333,907,FALSE,"out1, fill","0.1.4"
"29957","646",2023-07-10 01:00:00,-8764,1913,10677,907,FALSE,NA,"0.1.4"
"29958","646",2023-07-10 01:15:00,-8745,1913,10658,907,FALSE,NA,"0.1.4"
"29959","646",2023-07-10 01:30:00,-8744,1913,10657,907,FALSE,NA,"0.1.4"
"29960","646",2023-07-10 01:45:00,-9176.5,1913,11089.5,907,FALSE,"out1, fill","0.1.4"
"29961","646",2023-07-10 02:00:00,-9609,1913,11522,907,FALSE,NA,"0.1.4"
"29962","646",2023-07-10 02:15:00,-9199,1913,11112,907,FALSE,NA,"0.1.4"
"29963","646",2023-07-10 02:30:00,-8784,1913,10697,907,FALSE,NA,"0.1.4"
"29964","646",2023-07-10 02:45:00,-9099.5,1913,11012.5,907,FALSE,"out1, fill","0.1.4"
"29965","646",2023-07-10 03:00:00,-9415,1913,11328,907,FALSE,NA,"0.1.4"
"29966","646",2023-07-10 03:15:00,-8923,1913,10836,907,FALSE,NA,"0.1.4"
"29967","646",2023-07-10 03:30:00,-8754,1913,10667,907,FALSE,NA,"0.1.4"
"29968","646",2023-07-10 03:45:00,-8745,1913,10658,907,FALSE,NA,"0.1.4"
"29969","646",2023-07-10 04:00:00,-9245,1913,11158,907,FALSE,NA,"0.1.4"
"29970","646",2023-07-10 04:15:00,-9394,1913,11307,907,FALSE,NA,"0.1.4"
"29971","646",2023-07-10 04:30:00,-9040,1913,10953,907,FALSE,NA,"0.1.4"
"29972","646",2023-07-10 04:45:00,-8836,1913,10749,907,FALSE,NA,"0.1.4"
"29973","646",2023-07-10 05:00:00,-8801,1913,10714,907,FALSE,NA,"0.1.4"
"29974","646",2023-07-10 05:15:00,-8810.8,1913,10723.8,907,FALSE,"out1, fill","0.1.4"
"29975","646",2023-07-10 05:30:00,-8820.6,1913,10733.6,907,FALSE,"out1, fill","0.1.4"
"29976","646",2023-07-10 05:45:00,-8830.4,1913,10743.4,907,FALSE,"out1, fill","0.1.4"
"29977","646",2023-07-10 06:00:00,-8840.2,1913,10753.2,907,FALSE,"out1, fill","0.1.4"
"29978","646",2023-07-10 06:15:00,-8850,1913,10763,907,FALSE,NA,"0.1.4"
"29979","646",2023-07-10 06:30:00,-8761,1913,10674,907,FALSE,NA,"0.1.4"
"29980","646",2023-07-10 06:45:00,-9050,1913,10963,907,FALSE,NA,"0.1.4"
"29981","646",2023-07-10 07:00:00,-8716,1913,10629,907,FALSE,NA,"0.1.4"
"29982","646",2023-07-10 07:15:00,-8714,1913,10627,907,FALSE,NA,"0.1.4"
"29983","646",2023-07-10 07:30:00,-8715,1913,10628,907,FALSE,NA,"0.1.4"
"29984","646",2023-07-10 07:45:00,-8710,1913,10623,907,FALSE,NA,"0.1.4"
"29985","646",2023-07-10 08:00:00,-8717,1913,10630,907,FALSE,NA,"0.1.4"
"29986","646",2023-07-10 08:15:00,-8711,1913,10624,907,FALSE,NA,"0.1.4"
"29987","646",2023-07-10 08:30:00,-8745,1913,10658,907,FALSE,NA,"0.1.4"
"29988","646",2023-07-10 08:45:00,-8746,1913,10659,907,FALSE,NA,"0.1.4"
"29989","646",2023-07-10 09:00:00,-8742,1913,10655,907,FALSE,NA,"0.1.4"
"29990","646",2023-07-10 09:15:00,-8821,1913,10734,907,FALSE,NA,"0.1.4"
"29991","646",2023-07-10 09:30:00,-8732,1913,10645,907,FALSE,NA,"0.1.4"
"29992","646",2023-07-10 09:45:00,-8710,1913,10623,907,FALSE,NA,"0.1.4"
"29993","646",2023-07-10 10:00:00,-8726.33333333333,1913,10639.3333333333,907,FALSE,"out1, fill","0.1.4"
"29994","646",2023-07-10 10:15:00,-8742.66666666667,1913,10655.6666666667,907,FALSE,"out1, fill","0.1.4"
"29995","646",2023-07-10 10:30:00,-8759,1913,10672,907,FALSE,NA,"0.1.4"
"29996","646",2023-07-10 10:45:00,-8766,1913,10679,907,FALSE,NA,"0.1.4"
"29997","646",2023-07-10 11:00:00,-8801,1913,10714,907,FALSE,NA,"0.1.4"
"29998","646",2023-07-10 11:15:00,-8769,1913,10682,907,FALSE,NA,"0.1.4"
"29999","646",2023-07-10 11:30:00,-8769,1913,10682,907,FALSE,"jump1","0.1.4"
"30000","646",2023-07-10 11:45:00,-8769,1913,10682,907,FALSE,"jump1","0.1.4"
"30001","646",2023-07-10 12:00:00,-8860,1913,10773,907,FALSE,NA,"0.1.4"
"30002","646",2023-07-10 12:15:00,-8830,1913,10743,907,FALSE,NA,"0.1.4"
"30003","646",2023-07-10 12:30:00,-8764,1913,10677,907,FALSE,NA,"0.1.4"
"30004","646",2023-07-10 12:45:00,-8726,1913,10639,907,FALSE,NA,"0.1.4"
"30005","646",2023-07-10 13:00:00,-9004,1913,10917,907,FALSE,NA,"0.1.4"
"30006","646",2023-07-10 13:15:00,-8993,1913,10906,907,FALSE,NA,"0.1.4"
"30007","646",2023-07-10 13:30:00,-8993,1913,10906,907,FALSE,"jump1","0.1.4"
"30008","646",2023-07-10 13:45:00,-8985,1913,10898,907,FALSE,NA,"0.1.4"
"30009","646",2023-07-10 14:00:00,-8608,1913,10521,907,FALSE,NA,"0.1.4"
"30010","646",2023-07-10 14:15:00,-8646.33333333333,1913,10559.3333333333,907,FALSE,"out1, fill","0.1.4"
"30011","646",2023-07-10 14:30:00,-8684.66666666667,1913,10597.6666666667,907,FALSE,"out1, fill","0.1.4"
"30012","646",2023-07-10 14:45:00,-8723,1913,10636,907,FALSE,NA,"0.1.4"
"30013","646",2023-07-10 15:00:00,-8723,1913,10636,907,FALSE,"jump1","0.1.4"
"30014","646",2023-07-10 15:15:00,-8734,1913,10647,907,FALSE,NA,"0.1.4"
"30015","646",2023-07-10 15:30:00,-8863,1913,10776,907,FALSE,NA,"0.1.4"
"30016","646",2023-07-10 15:45:00,-8902,1913,10815,907,FALSE,NA,"0.1.4"
"30017","646",2023-07-10 16:00:00,-8883,1913,10796,907,FALSE,NA,"0.1.4"
"30018","646",2023-07-10 16:15:00,-9121,1913,11034,907,FALSE,NA,"0.1.4"
"30019","646",2023-07-10 16:30:00,-8723,1913,10636,907,FALSE,NA,"0.1.4"
"30020","646",2023-07-10 16:45:00,-8723,1913,10636,907,FALSE,"jump1","0.1.4"
"30021","646",2023-07-10 17:00:00,-8267,1913,10180,907,FALSE,NA,"0.1.4"
"30022","646",2023-07-10 17:15:00,-8666,1913,10579,907,FALSE,NA,"0.1.4"
"30023","646",2023-07-10 17:30:00,-8666,1913,10579,907,FALSE,"jump1","0.1.4"
"30024","646",2023-07-10 17:45:00,-8668,1913,10581,907,FALSE,NA,"0.1.4"
"30025","646",2023-07-10 18:00:00,-8592,1913,10505,907,FALSE,NA,"0.1.4"
"30026","646",2023-07-10 18:15:00,-8607,1913,10520,907,FALSE,NA,"0.1.4"
"30027","646",2023-07-10 18:30:00,-8600,1913,10513,907,FALSE,NA,"0.1.4"
"30028","646",2023-07-10 18:45:00,-8637,1913,10550,907,FALSE,NA,"0.1.4"
"30029","646",2023-07-10 19:00:00,-8592,1913,10505,907,FALSE,NA,"0.1.4"
"30030","646",2023-07-10 19:15:00,-8588.33333333333,1913,10501.3333333333,907,FALSE,"out1, fill","0.1.4"
"30031","646",2023-07-10 19:30:00,-8584.66666666667,1913,10497.6666666667,907,FALSE,"out1, fill","0.1.4"
"30032","646",2023-07-10 19:45:00,-8581,1913,10494,907,FALSE,NA,"0.1.4"
"30033","646",2023-07-10 20:00:00,-8587,1913,10500,907,FALSE,NA,"0.1.4"
"30034","646",2023-07-10 20:15:00,-8613,1913,10526,907,FALSE,NA,"0.1.4"
"30035","646",2023-07-10 20:30:00,-8597,1913,10510,907,FALSE,NA,"0.1.4"
"30036","646",2023-07-10 20:45:00,-8569,1913,10482,907,FALSE,NA,"0.1.4"
"30037","646",2023-07-10 21:00:00,-8592,1913,10505,907,FALSE,NA,"0.1.4"
"30038","646",2023-07-10 21:15:00,-8585,1913,10498,907,FALSE,NA,"0.1.4"
"30039","646",2023-07-10 21:30:00,-8580,1913,10493,907,FALSE,NA,"0.1.4"
"30040","646",2023-07-10 21:45:00,-8590,1913,10503,907,FALSE,NA,"0.1.4"
"30041","646",2023-07-10 22:00:00,-8583,1913,10496,907,FALSE,NA,"0.1.4"
"30042","646",2023-07-10 22:15:00,-8592,1913,10505,907,FALSE,NA,"0.1.4"
"30043","646",2023-07-10 22:30:00,-8582,1913,10495,907,FALSE,NA,"0.1.4"
"30044","646",2023-07-10 22:45:00,-8592,1913,10505,907,FALSE,NA,"0.1.4"
"30045","646",2023-07-10 23:00:00,-8591,1913,10504,907,FALSE,NA,"0.1.4"
"30046","646",2023-07-10 23:15:00,-8584,1913,10497,907,FALSE,NA,"0.1.4"
"30047","646",2023-07-10 23:30:00,-8591,1913,10504,907,FALSE,NA,"0.1.4"
"30048","646",2023-07-10 23:45:00,-8590,1913,10503,907,FALSE,NA,"0.1.4"
"30049","646",2023-07-11,-8588,1913,10501,907,FALSE,NA,"0.1.4"
"30050","646",2023-07-11 00:15:00,-8579,1913,10492,907,FALSE,NA,"0.1.4"
"30051","646",2023-07-11 00:30:00,-8575,1913,10488,907,FALSE,NA,"0.1.4"
"30052","646",2023-07-11 00:45:00,-8566,1913,10479,907,FALSE,NA,"0.1.4"
"30053","646",2023-07-11 01:00:00,-8659,1913,10572,907,FALSE,NA,"0.1.4"
"30054","646",2023-07-11 01:15:00,-8579,1913,10492,907,FALSE,NA,"0.1.4"
"30055","646",2023-07-11 01:30:00,-8602,1913,10515,907,FALSE,NA,"0.1.4"
"30056","646",2023-07-11 01:45:00,-8867,1913,10780,907,FALSE,NA,"0.1.4"
"30057","646",2023-07-11 02:00:00,-8593,1913,10506,907,FALSE,NA,"0.1.4"
"30058","646",2023-07-11 02:15:00,NA,NA,NA,NA,NA,"out1","0.1.4"
"30059","646",2023-07-11 02:30:00,NA,NA,NA,NA,NA,"out1","0.1.4"
"30060","646",2023-07-11 02:45:00,NA,NA,NA,NA,NA,"out1","0.1.4"
"30061","646",2023-07-11 03:00:00,NA,NA,NA,NA,NA,"out1","0.1.4"
"30062","646",2023-07-11 03:15:00,NA,NA,NA,NA,NA,"out1","0.1.4"
"30063","646",2023-07-11 03:30:00,NA,NA,NA,NA,NA,"out1","0.1.4"
"30064","646",2023-07-11 03:45:00,NA,NA,NA,NA,NA,"out1","0.1.4"
"30065","646",2023-07-11 04:00:00,NA,NA,NA,NA,NA,"out1","0.1.4"
"30066","646",2023-07-11 04:15:00,NA,NA,NA,NA,NA,"out1","0.1.4"
"30067","646",2023-07-11 04:30:00,NA,NA,NA,NA,NA,"out1","0.1.4"
"30068","646",2023-07-11 04:45:00,NA,NA,NA,NA,NA,"out1","0.1.4"
"30069","646",2023-07-11 05:00:00,NA,NA,NA,NA,NA,"out1","0.1.4"
"30070","646",2023-07-11 05:15:00,NA,NA,NA,NA,NA,"out1","0.1.4"
"30071","646",2023-07-11 05:30:00,NA,NA,NA,NA,NA,"out1","0.1.4"
"30072","646",2023-07-11 05:45:00,NA,NA,NA,NA,NA,"out1","0.1.4"
"30073","646",2023-07-11 06:00:00,NA,NA,NA,NA,NA,"out1","0.1.4"
"30074","646",2023-07-11 06:15:00,-9291,1913,11204,907,FALSE,NA,"0.1.4"
"30075","646",2023-07-11 06:30:00,-9291,1913,11204,907,FALSE,"jump1","0.1.4"
"30076","646",2023-07-11 06:45:00,-9334,1913,11247,907,FALSE,NA,"0.1.4"
"30077","646",2023-07-11 07:00:00,-9264,1913,11177,907,FALSE,NA,"0.1.4"
"30078","646",2023-07-11 07:15:00,-9241,1913,11154,907,FALSE,NA,"0.1.4"
"30079","646",2023-07-11 07:30:00,-9282,1913,11195,907,FALSE,NA,"0.1.4"
"30080","646",2023-07-11 07:45:00,-9284.66666666667,1913,11197.6666666667,907,FALSE,"out1, fill","0.1.4"
"30081","646",2023-07-11 08:00:00,-9287.33333333333,1913,11200.3333333333,907,FALSE,"out1, fill","0.1.4"
"30082","646",2023-07-11 08:15:00,-9290,1913,11203,907,FALSE,NA,"0.1.4"
"30083","646",2023-07-11 08:30:00,-9593,1913,11506,907,FALSE,NA,"0.1.4"
"30084","646",2023-07-11 08:45:00,-9484,1913,11397,907,FALSE,NA,"0.1.4"
"30085","646",2023-07-11 09:00:00,-9274,1913,11187,907,FALSE,NA,"0.1.4"
"30086","646",2023-07-11 09:15:00,-9513,1913,11426,907,FALSE,"out1, fill","0.1.4"
"30087","646",2023-07-11 09:30:00,-9752,1913,11665,907,FALSE,NA,"0.1.4"
"30088","646",2023-07-11 09:45:00,-9293,1913,11206,907,FALSE,NA,"0.1.4"
"30089","646",2023-07-11 10:00:00,-9259,1913,11172,907,FALSE,NA,"0.1.4"
"30090","646",2023-07-11 10:15:00,-9259,1913,11172,907,FALSE,NA,"0.1.4"
"30091","646",2023-07-11 10:30:00,-9256,1913,11169,907,FALSE,NA,"0.1.4"
"30092","646",2023-07-11 10:45:00,-9252,1913,11165,907,FALSE,NA,"0.1.4"
"30093","646",2023-07-11 11:00:00,-9260,1913,11173,907,FALSE,NA,"0.1.4"
"30094","646",2023-07-11 11:15:00,-9296,1913,11209,907,FALSE,NA,"0.1.4"
"30095","646",2023-07-11 11:30:00,-9679,1913,11592,907,FALSE,NA,"0.1.4"
"30096","646",2023-07-11 11:45:00,-9286,1913,11199,907,FALSE,NA,"0.1.4"
"30097","646",2023-07-11 12:00:00,-9395,1913,11308,907,FALSE,NA,"0.1.4"
"30098","646",2023-07-11 12:15:00,-9395,1913,11308,907,FALSE,"jump1","0.1.4"
"30099","646",2023-07-11 12:30:00,-9785,1913,11698,907,FALSE,NA,"0.1.4"
"30100","646",2023-07-11 12:45:00,-9367,1913,11280,907,FALSE,NA,"0.1.4"
"30101","646",2023-07-11 13:00:00,-9367,1913,11280,907,FALSE,"jump1","0.1.4"
"30102","646",2023-07-11 13:15:00,-9738,1913,11651,907,FALSE,NA,"0.1.4"
"30103","646",2023-07-11 13:30:00,-10096,1913,12009,907,FALSE,NA,"0.1.4"
"30104","646",2023-07-11 13:45:00,-9857,1913,11770,907,FALSE,NA,"0.1.4"
"30105","646",2023-07-11 14:00:00,-9834,1913,11747,907,FALSE,NA,"0.1.4"
"30106","646",2023-07-11 14:15:00,-9834,1913,11747,907,FALSE,"jump1","0.1.4"
"30107","646",2023-07-11 14:30:00,-9863,1913,11776,907,FALSE,NA,"0.1.4"
"30108","646",2023-07-11 14:45:00,-9861,1913,11774,907,FALSE,NA,"0.1.4"
"30109","646",2023-07-11 15:00:00,-9861,1913,11774,907,FALSE,NA,"0.1.4"
"30110","646",2023-07-11 15:15:00,-9859,1913,11772,907,FALSE,NA,"0.1.4"
"30111","646",2023-07-11 15:30:00,-9838,1913,11751,907,FALSE,NA,"0.1.4"
"30112","646",2023-07-11 15:45:00,-9867,1913,11780,907,FALSE,NA,"0.1.4"
"30113","646",2023-07-11 16:00:00,-9838,1913,11751,907,FALSE,NA,"0.1.4"
"30114","646",2023-07-11 16:15:00,-9853,1913,11766,907,FALSE,NA,"0.1.4"
"30115","646",2023-07-11 16:30:00,-9847,1913,11760,907,FALSE,NA,"0.1.4"
"30116","646",2023-07-11 16:45:00,-9849,1913,11762,907,FALSE,NA,"0.1.4"
"30117","646",2023-07-11 17:00:00,-9840,1913,11753,907,FALSE,NA,"0.1.4"
"30118","646",2023-07-11 17:15:00,-9842,1913,11755,907,FALSE,NA,"0.1.4"
"30119","646",2023-07-11 17:30:00,-9873,1913,11786,907,FALSE,NA,"0.1.4"
"30120","646",2023-07-11 17:45:00,-9869,1913,11782,907,FALSE,NA,"0.1.4"
"30121","646",2023-07-11 18:00:00,-9885,1913,11798,907,FALSE,NA,"0.1.4"
"30122","646",2023-07-11 18:15:00,-9884,1913,11797,907,FALSE,NA,"0.1.4"
"30123","646",2023-07-11 18:30:00,-9885,1913,11798,907,FALSE,NA,"0.1.4"
"30124","646",2023-07-11 18:45:00,-9898,1913,11811,907,FALSE,NA,"0.1.4"
"30125","646",2023-07-11 19:00:00,-9880,1913,11793,907,FALSE,NA,"0.1.4"
"30126","646",2023-07-11 19:15:00,-9880,1913,11793,907,FALSE,NA,"0.1.4"
"30127","646",2023-07-11 19:30:00,-9880,1913,11793,907,FALSE,NA,"0.1.4"
"30128","646",2023-07-11 19:45:00,-9876,1913,11789,907,FALSE,NA,"0.1.4"
"30129","646",2023-07-11 20:00:00,-9864,1913,11777,907,FALSE,NA,"0.1.4"
"30130","646",2023-07-11 20:15:00,-9855,1913,11768,907,FALSE,NA,"0.1.4"
"30131","646",2023-07-11 20:30:00,-9876,1913,11789,907,FALSE,NA,"0.1.4"
"30132","646",2023-07-11 20:45:00,-9845,1913,11758,907,FALSE,NA,"0.1.4"
"30133","646",2023-07-11 21:00:00,-9884,1913,11797,907,FALSE,NA,"0.1.4"
"30134","646",2023-07-11 21:15:00,-9877,1913,11790,907,FALSE,NA,"0.1.4"
"30135","646",2023-07-11 21:30:00,-9844,1913,11757,907,FALSE,NA,"0.1.4"
"30136","646",2023-07-11 21:45:00,-9871,1913,11784,907,FALSE,NA,"0.1.4"
"30137","646",2023-07-11 22:00:00,-9878,1913,11791,907,FALSE,NA,"0.1.4"
"30138","646",2023-07-11 22:15:00,-9876,1913,11789,907,FALSE,NA,"0.1.4"
"30139","646",2023-07-11 22:30:00,-9887,1913,11800,907,FALSE,NA,"0.1.4"
"30140","646",2023-07-11 22:45:00,-9873,1913,11786,907,FALSE,NA,"0.1.4"
"30141","646",2023-07-11 23:00:00,-9871,1913,11784,907,FALSE,NA,"0.1.4"
"30142","646",2023-07-11 23:15:00,-9876,1913,11789,907,FALSE,NA,"0.1.4"
"30143","646",2023-07-11 23:30:00,-9841,1913,11754,907,FALSE,NA,"0.1.4"
"30144","646",2023-07-11 23:45:00,-9880,1913,11793,907,FALSE,NA,"0.1.4"
"30145","646",2023-07-12,-9873,1913,11786,907,FALSE,NA,"0.1.4"
"30146","646",2023-07-12 00:15:00,-9899,1913,11812,907,FALSE,NA,"0.1.4"
"30147","646",2023-07-12 00:30:00,-9898,1913,11811,907,FALSE,NA,"0.1.4"
"30148","646",2023-07-12 00:45:00,-9900,1913,11813,907,FALSE,NA,"0.1.4"
"30149","646",2023-07-12 01:00:00,-9838,1913,11751,907,FALSE,NA,"0.1.4"
"30150","646",2023-07-12 01:15:00,-10123,1913,12036,907,FALSE,NA,"0.1.4"
"30151","646",2023-07-12 01:30:00,-9921,1913,11834,907,FALSE,NA,"0.1.4"
"30152","646",2023-07-12 01:45:00,-9897,1913,11810,907,FALSE,NA,"0.1.4"
"30153","646",2023-07-12 02:00:00,-9867,1913,11780,907,FALSE,NA,"0.1.4"
"30154","646",2023-07-12 02:15:00,-9841,1913,11754,907,FALSE,NA,"0.1.4"
"30155","646",2023-07-12 02:30:00,-9841,1913,11754,907,FALSE,"jump1","0.1.4"
"30156","646",2023-07-12 02:45:00,-9519,1913,11432,907,FALSE,NA,"0.1.4"
"30157","646",2023-07-12 03:00:00,-9178,1913,11091,907,FALSE,NA,"0.1.4"
"30158","646",2023-07-12 03:15:00,-9198,1913,11111,907,FALSE,NA,"0.1.4"
"30159","646",2023-07-12 03:30:00,-9207,1913,11120,907,FALSE,NA,"0.1.4"
"30160","646",2023-07-12 03:45:00,-9683,1913,11596,907,FALSE,NA,"0.1.4"
"30161","646",2023-07-12 04:00:00,-9474,1913,11387,907,FALSE,NA,"0.1.4"
"30162","646",2023-07-12 04:15:00,-9220,1913,11133,907,FALSE,NA,"0.1.4"
"30163","646",2023-07-12 04:30:00,-9394,1913,11307,907,FALSE,NA,"0.1.4"
"30164","646",2023-07-12 04:45:00,-9397,1913,11310,907,FALSE,NA,"0.1.4"
"30165","646",2023-07-12 05:00:00,-9397,1913,11310,907,FALSE,"jump1","0.1.4"
"30166","646",2023-07-12 05:15:00,-9397,1913,11310,907,FALSE,"jump1","0.1.4"
"30167","646",2023-07-12 05:30:00,-9149,1913,11062,907,FALSE,NA,"0.1.4"
"30168","646",2023-07-12 05:45:00,-9350.66666666667,1913,11263.6666666667,907,FALSE,"out1, fill","0.1.4"
"30169","646",2023-07-12 06:00:00,-9552.33333333333,1913,11465.3333333333,907,FALSE,"out1, fill","0.1.4"
"30170","646",2023-07-12 06:15:00,-9754,1913,11667,907,FALSE,NA,"0.1.4"
"30171","646",2023-07-12 06:30:00,-9580,1913,11493,907,FALSE,NA,"0.1.4"
"30172","646",2023-07-12 06:45:00,-9580,1913,11493,907,FALSE,"jump1","0.1.4"
"30173","646",2023-07-12 07:00:00,-9486,1913,11399,907,FALSE,NA,"0.1.4"
"30174","646",2023-07-12 07:15:00,-9507,1913,11420,907,FALSE,NA,"0.1.4"
"30175","646",2023-07-12 07:30:00,-9307,1913,11220,907,FALSE,NA,"0.1.4"
"30176","646",2023-07-12 07:45:00,-9753,1913,11666,907,FALSE,NA,"0.1.4"
"30177","646",2023-07-12 08:00:00,-9600,1913,11513,907,FALSE,NA,"0.1.4"
"30178","646",2023-07-12 08:15:00,-9203,1913,11116,907,FALSE,NA,"0.1.4"
"30179","646",2023-07-12 08:30:00,-9203,1913,11116,907,FALSE,"jump1","0.1.4"
"30180","646",2023-07-12 08:45:00,-9350,1913,11263,907,FALSE,"out1, fill","0.1.4"
"30181","646",2023-07-12 09:00:00,-9497,1913,11410,907,FALSE,"out1, fill","0.1.4"
"30182","646",2023-07-12 09:15:00,-9644,1913,11557,907,FALSE,NA,"0.1.4"
"30183","646",2023-07-12 09:30:00,-9233,1913,11146,907,FALSE,NA,"0.1.4"
"30184","646",2023-07-12 09:45:00,-9221,1913,11134,907,FALSE,NA,"0.1.4"
"30185","646",2023-07-12 10:00:00,-9358,1913,11271,907,FALSE,NA,"0.1.4"
"30186","646",2023-07-12 10:15:00,-9196,1913,11109,907,FALSE,NA,"0.1.4"
"30187","646",2023-07-12 10:30:00,-9177,1913,11090,907,FALSE,NA,"0.1.4"
"30188","646",2023-07-12 10:45:00,-9239,1913,11152,907,FALSE,NA,"0.1.4"
"30189","646",2023-07-12 11:00:00,-9246,1913,11159,907,FALSE,NA,"0.1.4"
"30190","646",2023-07-12 11:15:00,-9191,1913,11104,907,FALSE,NA,"0.1.4"
"30191","646",2023-07-12 11:30:00,-9196,1913,11109,907,FALSE,NA,"0.1.4"
"30192","646",2023-07-12 11:45:00,-9189.25,1913,11102.25,907,FALSE,"out1, fill","0.1.4"
"30193","646",2023-07-12 12:00:00,-9182.5,1913,11095.5,907,FALSE,"out1, fill","0.1.4"
"30194","646",2023-07-12 12:15:00,-9175.75,1913,11088.75,907,FALSE,"out1, fill","0.1.4"
"30195","646",2023-07-12 12:30:00,-9169,1913,11082,907,FALSE,NA,"0.1.4"
"30196","646",2023-07-12 12:45:00,-9195,1913,11108,907,FALSE,NA,"0.1.4"
"30197","646",2023-07-12 13:00:00,-9196,1913,11109,907,FALSE,NA,"0.1.4"
"30198","646",2023-07-12 13:15:00,-9179,1913,11092,907,FALSE,NA,"0.1.4"
"30199","646",2023-07-12 13:30:00,-9225,1913,11138,907,FALSE,NA,"0.1.4"
"30200","646",2023-07-12 13:45:00,-9179,1913,11092,907,FALSE,NA,"0.1.4"
"30201","646",2023-07-12 14:00:00,-9181,1913,11094,907,FALSE,NA,"0.1.4"
"30202","646",2023-07-12 14:15:00,-9173,1913,11086,907,FALSE,NA,"0.1.4"
"30203","646",2023-07-12 14:30:00,-9172,1913,11085,907,FALSE,NA,"0.1.4"
"30204","646",2023-07-12 14:45:00,-9184,1913,11097,907,FALSE,NA,"0.1.4"
"30205","646",2023-07-12 15:00:00,-9181,1913,11094,907,FALSE,NA,"0.1.4"
"30206","646",2023-07-12 15:15:00,-9175,1913,11088,907,FALSE,NA,"0.1.4"
"30207","646",2023-07-12 15:30:00,-9174,1913,11087,907,FALSE,NA,"0.1.4"
"30208","646",2023-07-12 15:45:00,-9161,1913,11074,907,FALSE,NA,"0.1.4"
"30209","646",2023-07-12 16:00:00,-9150,1913,11063,907,FALSE,NA,"0.1.4"
"30210","646",2023-07-12 16:15:00,-9162,1913,11075,907,FALSE,NA,"0.1.4"
"30211","646",2023-07-12 16:30:00,-9175,1913,11088,907,FALSE,NA,"0.1.4"
"30212","646",2023-07-12 16:45:00,-9167,1913,11080,907,FALSE,NA,"0.1.4"
"30213","646",2023-07-12 17:00:00,-9181,1913,11094,907,FALSE,NA,"0.1.4"
"30214","646",2023-07-12 17:15:00,-9195,1913,11108,907,FALSE,NA,"0.1.4"
"30215","646",2023-07-12 17:30:00,-9171,1913,11084,907,FALSE,NA,"0.1.4"
"30216","646",2023-07-12 17:45:00,-9187,1913,11100,907,FALSE,NA,"0.1.4"
"30217","646",2023-07-12 18:00:00,-9185,1913,11098,907,FALSE,NA,"0.1.4"
"30218","646",2023-07-12 18:15:00,-9191,1913,11104,907,FALSE,NA,"0.1.4"
"30219","646",2023-07-12 18:30:00,-9175,1913,11088,907,FALSE,NA,"0.1.4"
"30220","646",2023-07-12 18:45:00,-9189,1913,11102,907,FALSE,NA,"0.1.4"
"30221","646",2023-07-12 19:00:00,-9187,1913,11100,907,FALSE,NA,"0.1.4"
"30222","646",2023-07-12 19:15:00,-9183,1913,11096,907,FALSE,NA,"0.1.4"
"30223","646",2023-07-12 19:30:00,-9188,1913,11101,907,FALSE,NA,"0.1.4"
"30224","646",2023-07-12 19:45:00,-9184,1913,11097,907,FALSE,NA,"0.1.4"
"30225","646",2023-07-12 20:00:00,-9178,1913,11091,907,FALSE,NA,"0.1.4"
"30226","646",2023-07-12 20:15:00,-9169,1913,11082,907,FALSE,NA,"0.1.4"
"30227","646",2023-07-12 20:30:00,-9176,1913,11089,907,FALSE,NA,"0.1.4"
"30228","646",2023-07-12 20:45:00,-9184,1913,11097,907,FALSE,NA,"0.1.4"
"30229","646",2023-07-12 21:00:00,-9186,1913,11099,907,FALSE,NA,"0.1.4"
"30230","646",2023-07-12 21:15:00,-9184,1913,11097,907,FALSE,NA,"0.1.4"
"30231","646",2023-07-12 21:30:00,-9196,1913,11109,907,FALSE,NA,"0.1.4"
"30232","646",2023-07-12 21:45:00,-9196,1913,11109,907,FALSE,NA,"0.1.4"
"30233","646",2023-07-12 22:00:00,-9163,1913,11076,907,FALSE,NA,"0.1.4"
"30234","646",2023-07-12 22:15:00,-9183,1913,11096,907,FALSE,NA,"0.1.4"
"30235","646",2023-07-12 22:30:00,-9191,1913,11104,907,FALSE,NA,"0.1.4"
"30236","646",2023-07-12 22:45:00,-9188,1913,11101,907,FALSE,NA,"0.1.4"
"30237","646",2023-07-12 23:00:00,-9185,1913,11098,907,FALSE,NA,"0.1.4"
"30238","646",2023-07-12 23:15:00,-9176,1913,11089,907,FALSE,NA,"0.1.4"
"30239","646",2023-07-12 23:30:00,-9175,1913,11088,907,FALSE,NA,"0.1.4"
"30240","646",2023-07-12 23:45:00,-9183,1913,11096,907,FALSE,NA,"0.1.4"
"30241","646",2023-07-13,-9163,1913,11076,907,FALSE,NA,"0.1.4"
"30242","646",2023-07-13 00:15:00,-9185,1913,11098,907,FALSE,NA,"0.1.4"
"30243","646",2023-07-13 00:30:00,-9153,1913,11066,907,FALSE,NA,"0.1.4"
"30244","646",2023-07-13 00:45:00,-9172,1913,11085,907,FALSE,NA,"0.1.4"
"30245","646",2023-07-13 01:00:00,-9182,1913,11095,907,FALSE,NA,"0.1.4"
"30246","646",2023-07-13 01:15:00,-9170,1913,11083,907,FALSE,NA,"0.1.4"
"30247","646",2023-07-13 01:30:00,-9170,1913,11083,907,FALSE,NA,"0.1.4"
"30248","646",2023-07-13 01:45:00,-9172,1913,11085,907,FALSE,NA,"0.1.4"
"30249","646",2023-07-13 02:00:00,-9157,1913,11070,907,FALSE,NA,"0.1.4"
"30250","646",2023-07-13 02:15:00,-9169,1913,11082,907,FALSE,NA,"0.1.4"
"30251","646",2023-07-13 02:30:00,-9167,1913,11080,907,FALSE,NA,"0.1.4"
"30252","646",2023-07-13 02:45:00,-9181,1913,11094,907,FALSE,NA,"0.1.4"
"30253","646",2023-07-13 03:00:00,-9170,1913,11083,907,FALSE,NA,"0.1.4"
"30254","646",2023-07-13 03:15:00,-9189,1913,11102,907,FALSE,NA,"0.1.4"
"30255","646",2023-07-13 03:30:00,-9196,1913,11109,907,FALSE,NA,"0.1.4"
"30256","646",2023-07-13 03:45:00,-9176,1913,11089,907,FALSE,NA,"0.1.4"
"30257","646",2023-07-13 04:00:00,-9188,1913,11101,907,FALSE,NA,"0.1.4"
"30258","646",2023-07-13 04:15:00,-9167,1913,11080,907,FALSE,NA,"0.1.4"
"30259","646",2023-07-13 04:30:00,-9177,1913,11090,907,FALSE,NA,"0.1.4"
"30260","646",2023-07-13 04:45:00,-9210,1913,11123,907,FALSE,NA,"0.1.4"
"30261","646",2023-07-13 05:00:00,-9177,1913,11090,907,FALSE,NA,"0.1.4"
"30262","646",2023-07-13 05:15:00,-9175,1913,11088,907,FALSE,NA,"0.1.4"
"30263","646",2023-07-13 05:30:00,-9178,1913,11091,907,FALSE,NA,"0.1.4"
"30264","646",2023-07-13 05:45:00,-9192,1913,11105,907,FALSE,NA,"0.1.4"
"30265","646",2023-07-13 06:00:00,-9188,1913,11101,907,FALSE,NA,"0.1.4"
"30266","646",2023-07-13 06:15:00,-9190,1913,11103,907,FALSE,NA,"0.1.4"
"30267","646",2023-07-13 06:30:00,-9175,1913,11088,907,FALSE,NA,"0.1.4"
"30268","646",2023-07-13 06:45:00,-9159,1913,11072,907,FALSE,NA,"0.1.4"
"30269","646",2023-07-13 07:00:00,-9172,1913,11085,907,FALSE,NA,"0.1.4"
"30270","646",2023-07-13 07:15:00,-9192,1913,11105,907,FALSE,NA,"0.1.4"
"30271","646",2023-07-13 07:30:00,-9188,1913,11101,907,FALSE,NA,"0.1.4"
"30272","646",2023-07-13 07:45:00,-9206,1913,11119,907,FALSE,NA,"0.1.4"
"30273","646",2023-07-13 08:00:00,-9164,1913,11077,907,FALSE,NA,"0.1.4"
"30274","646",2023-07-13 08:15:00,-9174,1913,11087,907,FALSE,NA,"0.1.4"
"30275","646",2023-07-13 08:30:00,-9178,1913,11091,907,FALSE,NA,"0.1.4"
"30276","646",2023-07-13 08:45:00,-9206,1913,11119,907,FALSE,NA,"0.1.4"
"30277","646",2023-07-13 09:00:00,-9245,1913,11158,907,FALSE,NA,"0.1.4"
"30278","646",2023-07-13 09:15:00,-9195,1913,11108,907,FALSE,NA,"0.1.4"
"30279","646",2023-07-13 09:30:00,-9317,1913,11230,907,FALSE,NA,"0.1.4"
"30280","646",2023-07-13 09:45:00,-9361,1913,11274,907,FALSE,NA,"0.1.4"
"30281","646",2023-07-13 10:00:00,-9168,1913,11081,907,FALSE,NA,"0.1.4"
"30282","646",2023-07-13 10:15:00,-9164,1913,11077,907,FALSE,NA,"0.1.4"
"30283","646",2023-07-13 10:30:00,-9164,1913,11077,907,FALSE,NA,"0.1.4"
"30284","646",2023-07-13 10:45:00,-9178,1913,11091,907,FALSE,NA,"0.1.4"
"30285","646",2023-07-13 11:00:00,-9171,1913,11084,907,FALSE,NA,"0.1.4"
"30286","646",2023-07-13 11:15:00,-9164,1913,11077,907,FALSE,NA,"0.1.4"
"30287","646",2023-07-13 11:30:00,-9164,1913,11077,907,FALSE,NA,"0.1.4"
"30288","646",2023-07-13 11:45:00,-9171,1913,11084,907,FALSE,NA,"0.1.4"
"30289","646",2023-07-13 12:00:00,-9239,1913,11152,907,FALSE,NA,"0.1.4"
"30290","646",2023-07-13 12:15:00,-9725,1913,11638,907,FALSE,NA,"0.1.4"
"30291","646",2023-07-13 12:30:00,-9725,1913,11638,907,FALSE,"jump1","0.1.4"
"30292","646",2023-07-13 12:45:00,-9748,1913,11661,907,FALSE,NA,"0.1.4"
"30293","646",2023-07-13 13:00:00,-10231,1913,12144,907,FALSE,NA,"0.1.4"
"30294","646",2023-07-13 13:15:00,-10231,1913,12144,907,FALSE,"jump1","0.1.4"
"30295","646",2023-07-13 13:30:00,-10311,1913,12224,907,FALSE,NA,"0.1.4"
"30296","646",2023-07-13 13:45:00,-10027,1913,11940,907,FALSE,NA,"0.1.4"
"30297","646",2023-07-13 14:00:00,-10027,1913,11940,907,FALSE,"jump1","0.1.4"
"30298","646",2023-07-13 14:15:00,-9758,1913,11671,907,FALSE,NA,"0.1.4"
"30299","646",2023-07-13 14:30:00,-9800,1913,11713,907,FALSE,NA,"0.1.4"
"30300","646",2023-07-13 14:45:00,-9701,1913,11614,907,FALSE,NA,"0.1.4"
"30301","646",2023-07-13 15:00:00,-9571,1913,11484,907,FALSE,NA,"0.1.4"
"30302","646",2023-07-13 15:15:00,-9131,1913,11044,907,FALSE,NA,"0.1.4"
"30303","646",2023-07-13 15:30:00,-8942,1913,10855,907,FALSE,NA,"0.1.4"
"30304","646",2023-07-13 15:45:00,-8673,1913,10586,907,FALSE,NA,"0.1.4"
"30305","646",2023-07-13 16:00:00,-9050,1913,10963,907,FALSE,"out1, fill","0.1.4"
"30306","646",2023-07-13 16:15:00,-9427,1913,11340,907,FALSE,NA,"0.1.4"
"30307","646",2023-07-13 16:30:00,-9427,1913,11340,907,FALSE,"jump1","0.1.4"
"30308","646",2023-07-13 16:45:00,-9127,1913,11040,907,FALSE,NA,"0.1.4"
"30309","646",2023-07-13 17:00:00,-9128,1913,11041,907,FALSE,NA,"0.1.4"
"30310","646",2023-07-13 17:15:00,-9125,1913,11038,907,FALSE,NA,"0.1.4"
"30311","646",2023-07-13 17:30:00,-9125,1913,11038,907,FALSE,NA,"0.1.4"
"30312","646",2023-07-13 17:45:00,-9125,1913,11038,907,FALSE,NA,"0.1.4"
"30313","646",2023-07-13 18:00:00,-9122,1913,11035,907,FALSE,NA,"0.1.4"
"30314","646",2023-07-13 18:15:00,-9127,1913,11040,907,FALSE,NA,"0.1.4"
"30315","646",2023-07-13 18:30:00,-9128,1913,11041,907,FALSE,NA,"0.1.4"
"30316","646",2023-07-13 18:45:00,-9133,1913,11046,907,FALSE,NA,"0.1.4"
"30317","646",2023-07-13 19:00:00,-9129,1913,11042,907,FALSE,NA,"0.1.4"
"30318","646",2023-07-13 19:15:00,-9128,1913,11041,907,FALSE,NA,"0.1.4"
"30319","646",2023-07-13 19:30:00,-9116,1913,11029,907,FALSE,NA,"0.1.4"
"30320","646",2023-07-13 19:45:00,-9132,1913,11045,907,FALSE,NA,"0.1.4"
"30321","646",2023-07-13 20:00:00,-9123,1913,11036,907,FALSE,NA,"0.1.4"
"30322","646",2023-07-13 20:15:00,-9125,1913,11038,907,FALSE,NA,"0.1.4"
"30323","646",2023-07-13 20:30:00,-9136,1913,11049,907,FALSE,NA,"0.1.4"
"30324","646",2023-07-13 20:45:00,-9118,1913,11031,907,FALSE,NA,"0.1.4"
"30325","646",2023-07-13 21:00:00,-9119,1913,11032,907,FALSE,NA,"0.1.4"
"30326","646",2023-07-13 21:15:00,-9118,1913,11031,907,FALSE,NA,"0.1.4"
"30327","646",2023-07-13 21:30:00,-9139,1913,11052,907,FALSE,NA,"0.1.4"
"30328","646",2023-07-13 21:45:00,-9119,1913,11032,907,FALSE,NA,"0.1.4"
"30329","646",2023-07-13 22:00:00,-9123,1913,11036,907,FALSE,NA,"0.1.4"
"30330","646",2023-07-13 22:15:00,-9115,1913,11028,907,FALSE,NA,"0.1.4"
"30331","646",2023-07-13 22:30:00,-9393,1913,11306,907,FALSE,NA,"0.1.4"
"30332","646",2023-07-13 22:45:00,-9125,1913,11038,907,FALSE,NA,"0.1.4"
"30333","646",2023-07-13 23:00:00,-9116,1913,11029,907,FALSE,NA,"0.1.4"
"30334","646",2023-07-13 23:15:00,-9127,1913,11040,907,FALSE,NA,"0.1.4"
"30335","646",2023-07-13 23:30:00,-9125,1913,11038,907,FALSE,NA,"0.1.4"
"30336","646",2023-07-13 23:45:00,-9120,1913,11033,907,FALSE,NA,"0.1.4"
"30337","646",2023-07-14,-9121,1913,11034,907,FALSE,NA,"0.1.4"
"30338","646",2023-07-14 00:15:00,-9133,1913,11046,907,FALSE,NA,"0.1.4"
"30339","646",2023-07-14 00:30:00,-9137,1913,11050,907,FALSE,NA,"0.1.4"
"30340","646",2023-07-14 00:45:00,-9116,1913,11029,907,FALSE,NA,"0.1.4"
"30341","646",2023-07-14 01:00:00,-9122,1913,11035,907,FALSE,NA,"0.1.4"
"30342","646",2023-07-14 01:15:00,-9126,1913,11039,907,FALSE,NA,"0.1.4"
"30343","646",2023-07-14 01:30:00,-9128,1913,11041,907,FALSE,NA,"0.1.4"
"30344","646",2023-07-14 01:45:00,-9161,1913,11074,907,FALSE,NA,"0.1.4"
"30345","646",2023-07-14 02:00:00,-9150,1913,11063,907,FALSE,NA,"0.1.4"
"30346","646",2023-07-14 02:15:00,-9451,1913,11364,907,FALSE,NA,"0.1.4"
"30347","646",2023-07-14 02:30:00,-9119,1913,11032,907,FALSE,NA,"0.1.4"
"30348","646",2023-07-14 02:45:00,-9113,1913,11026,907,FALSE,NA,"0.1.4"
"30349","646",2023-07-14 03:00:00,-9173,1913,11086,907,FALSE,NA,"0.1.4"
"30350","646",2023-07-14 03:15:00,-9648,1913,11561,907,FALSE,NA,"0.1.4"
"30351","646",2023-07-14 03:30:00,-10067,1913,11980,907,FALSE,NA,"0.1.4"
"30352","646",2023-07-14 03:45:00,-9613,1913,11526,907,FALSE,"out1, fill","0.1.4"
"30353","646",2023-07-14 04:00:00,-9159,1913,11072,907,FALSE,NA,"0.1.4"
"30354","646",2023-07-14 04:15:00,-9135,1913,11048,907,FALSE,NA,"0.1.4"
"30355","646",2023-07-14 04:30:00,-9128,1913,11041,907,FALSE,NA,"0.1.4"
"30356","646",2023-07-14 04:45:00,-9277,1913,11190,907,FALSE,"out1, fill","0.1.4"
"30357","646",2023-07-14 05:00:00,-9426,1913,11339,907,FALSE,"out1, fill","0.1.4"
"30358","646",2023-07-14 05:15:00,-9575,1913,11488,907,FALSE,"out1, fill","0.1.4"
"30359","646",2023-07-14 05:30:00,-9724,1913,11637,907,FALSE,"out1, fill","0.1.4"
"30360","646",2023-07-14 05:45:00,-9873,1913,11786,907,FALSE,"out1, fill","0.1.4"
"30361","646",2023-07-14 06:00:00,-10022,1913,11935,907,FALSE,"out1, fill","0.1.4"
"30362","646",2023-07-14 06:15:00,-10171,1913,12084,907,FALSE,NA,"0.1.4"
"30363","646",2023-07-14 06:30:00,-9929,1913,11842,907,FALSE,NA,"0.1.4"
"30364","646",2023-07-14 06:45:00,-10057,1913,11970,907,FALSE,NA,"0.1.4"
"30365","646",2023-07-14 07:00:00,-10269,1913,12182,907,FALSE,NA,"0.1.4"
"30366","646",2023-07-14 07:15:00,-10296,1913,12209,907,FALSE,NA,"0.1.4"
"30367","646",2023-07-14 07:30:00,-10240,1913,12153,907,FALSE,NA,"0.1.4"
"30368","646",2023-07-14 07:45:00,-10179,1913,12092,907,FALSE,NA,"0.1.4"
"30369","646",2023-07-14 08:00:00,-10179,1913,12092,907,FALSE,"out1, fill","0.1.4"
"30370","646",2023-07-14 08:15:00,-10179,1913,12092,907,FALSE,"jump1","0.1.4"
"30371","646",2023-07-14 08:30:00,-10210,1913,12123,907,FALSE,NA,"0.1.4"
"30372","646",2023-07-14 08:45:00,-10203,1913,12116,907,FALSE,NA,"0.1.4"
"30373","646",2023-07-14 09:00:00,-10526.5,1913,12439.5,907,FALSE,"out1, fill","0.1.4"
"30374","646",2023-07-14 09:15:00,-10850,1913,12763,907,FALSE,NA,"0.1.4"
"30375","646",2023-07-14 09:30:00,-10850,1913,12763,907,FALSE,"jump1","0.1.4"
"30376","646",2023-07-14 09:45:00,-11292,1913,13205,907,FALSE,NA,"0.1.4"
"30377","646",2023-07-14 10:00:00,-11201,1913,13114,907,FALSE,"out1, fill","0.1.4"
"30378","646",2023-07-14 10:15:00,-11110,1913,13023,907,FALSE,"out1, fill","0.1.4"
"30379","646",2023-07-14 10:30:00,-11019,1913,12932,907,FALSE,"out1, fill","0.1.4"
"30380","646",2023-07-14 10:45:00,-10928,1913,12841,907,FALSE,"out1, fill","0.1.4"
"30381","646",2023-07-14 11:00:00,-10837,1913,12750,907,FALSE,NA,"0.1.4"
"30382","646",2023-07-14 11:15:00,-10911,1913,12824,907,FALSE,NA,"0.1.4"
"30383","646",2023-07-14 11:30:00,-10919,1913,12832,907,FALSE,NA,"0.1.4"
"30384","646",2023-07-14 11:45:00,-10869,1913,12782,907,FALSE,NA,"0.1.4"
"30385","646",2023-07-14 12:00:00,-11318.75,1913,13231.75,907,FALSE,"out1, fill","0.1.4"
"30386","646",2023-07-14 12:15:00,-11768.5,1913,13681.5,907,FALSE,"out1, fill","0.1.4"
"30387","646",2023-07-14 12:30:00,-12218.25,1913,14131.25,907,FALSE,"out1, fill","0.1.4"
"30388","646",2023-07-14 12:45:00,-12668,1913,14581,907,FALSE,NA,"0.1.4"
"30389","646",2023-07-14 13:00:00,-12722,1913,14635,907,FALSE,NA,"0.1.4"
"30390","646",2023-07-14 13:15:00,-12649,1913,14562,907,FALSE,NA,"0.1.4"
"30391","646",2023-07-14 13:30:00,-12326,1913,14239,907,FALSE,NA,"0.1.4"
"30392","646",2023-07-14 13:45:00,-12643,1913,14556,907,FALSE,NA,"0.1.4"
"30393","646",2023-07-14 14:00:00,-12349,1913,14262,907,FALSE,NA,"0.1.4"
"30394","646",2023-07-14 14:15:00,-12363,1913,14276,907,FALSE,NA,"0.1.4"
"30395","646",2023-07-14 14:30:00,-12590,1913,14503,907,FALSE,NA,"0.1.4"
"30396","646",2023-07-14 14:45:00,-12590,1913,14503,907,FALSE,"jump1","0.1.4"
"30397","646",2023-07-14 15:00:00,-12178.5,1913,14091.5,907,FALSE,"out1, fill","0.1.4"
"30398","646",2023-07-14 15:15:00,-11767,1913,13680,907,FALSE,NA,"0.1.4"
"30399","646",2023-07-14 15:30:00,-11807,1913,13720,907,FALSE,NA,"0.1.4"
"30400","646",2023-07-14 15:45:00,-11816,1913,13729,907,FALSE,NA,"0.1.4"
"30401","646",2023-07-14 16:00:00,-11816,1913,13729,907,FALSE,"jump1","0.1.4"
"30402","646",2023-07-14 16:15:00,-11582,1913,13495,907,FALSE,"out1, fill","0.1.4"
"30403","646",2023-07-14 16:30:00,-11348,1913,13261,907,FALSE,"out1, fill","0.1.4"
"30404","646",2023-07-14 16:45:00,-11114,1913,13027,907,FALSE,"out1, fill","0.1.4"
"30405","646",2023-07-14 17:00:00,-10880,1913,12793,907,FALSE,NA,"0.1.4"
"30406","646",2023-07-14 17:15:00,-10889,1913,12802,907,FALSE,NA,"0.1.4"
"30407","646",2023-07-14 17:30:00,-10889,1913,12802,907,FALSE,NA,"0.1.4"
"30408","646",2023-07-14 17:45:00,-10790,1913,12703,907,FALSE,NA,"0.1.4"
"30409","646",2023-07-14 18:00:00,-10790,1913,12703,907,FALSE,NA,"0.1.4"
"30410","646",2023-07-14 18:15:00,-10808,1913,12721,907,FALSE,NA,"0.1.4"
"30411","646",2023-07-14 18:30:00,-10858,1913,12771,907,FALSE,NA,"0.1.4"
"30412","646",2023-07-14 18:45:00,-10891,1913,12804,907,FALSE,NA,"0.1.4"
"30413","646",2023-07-14 19:00:00,-10896,1913,12809,907,FALSE,NA,"0.1.4"
"30414","646",2023-07-14 19:15:00,-10890,1913,12803,907,FALSE,NA,"0.1.4"
"30415","646",2023-07-14 19:30:00,-11027,1913,12940,907,FALSE,NA,"0.1.4"
"30416","646",2023-07-14 19:45:00,-10905,1913,12818,907,FALSE,NA,"0.1.4"
"30417","646",2023-07-14 20:00:00,-10904,1913,12817,907,FALSE,NA,"0.1.4"
"30418","646",2023-07-14 20:15:00,-10898,1913,12811,907,FALSE,NA,"0.1.4"
"30419","646",2023-07-14 20:30:00,-10904,1913,12817,907,FALSE,NA,"0.1.4"
"30420","646",2023-07-14 20:45:00,-10902,1913,12815,907,FALSE,NA,"0.1.4"
"30421","646",2023-07-14 21:00:00,-10908,1913,12821,907,FALSE,NA,"0.1.4"
"30422","646",2023-07-14 21:15:00,-10903,1913,12816,907,FALSE,NA,"0.1.4"
"30423","646",2023-07-14 21:30:00,-10908,1913,12821,907,FALSE,NA,"0.1.4"
"30424","646",2023-07-14 21:45:00,-10902,1913,12815,907,FALSE,NA,"0.1.4"
"30425","646",2023-07-14 22:00:00,-10912,1913,12825,907,FALSE,NA,"0.1.4"
"30426","646",2023-07-14 22:15:00,-10913,1913,12826,907,FALSE,NA,"0.1.4"
"30427","646",2023-07-14 22:30:00,-10904,1913,12817,907,FALSE,NA,"0.1.4"
"30428","646",2023-07-14 22:45:00,-10907,1913,12820,907,FALSE,NA,"0.1.4"
"30429","646",2023-07-14 23:00:00,-10902,1913,12815,907,FALSE,NA,"0.1.4"
"30430","646",2023-07-14 23:15:00,-10921,1913,12834,907,FALSE,NA,"0.1.4"
"30431","646",2023-07-14 23:30:00,-11150,1913,13063,907,FALSE,NA,"0.1.4"
"30432","646",2023-07-14 23:45:00,-10937,1913,12850,907,FALSE,NA,"0.1.4"
"30433","646",2023-07-15,-10970.5,1913,12883.5,907,FALSE,"out1, fill","0.1.4"
"30434","646",2023-07-15 00:15:00,-11004,1913,12917,907,FALSE,NA,"0.1.4"
"30435","646",2023-07-15 00:30:00,-11034,1913,12947,907,FALSE,NA,"0.1.4"
"30436","646",2023-07-15 00:45:00,-11251,1913,13164,907,FALSE,NA,"0.1.4"
"30437","646",2023-07-15 01:00:00,-11015,1913,12928,907,FALSE,NA,"0.1.4"
"30438","646",2023-07-15 01:15:00,-11157,1913,13070,907,FALSE,NA,"0.1.4"
"30439","646",2023-07-15 01:30:00,-11172,1913,13085,907,FALSE,NA,"0.1.4"
"30440","646",2023-07-15 01:45:00,-11381.8571428571,1913,13294.8571428571,907,FALSE,"out1, fill","0.1.4"
"30441","646",2023-07-15 02:00:00,-11591.7142857143,1913,13504.7142857143,907,FALSE,"out1, fill","0.1.4"
"30442","646",2023-07-15 02:15:00,-11801.5714285714,1913,13714.5714285714,907,FALSE,"out1, fill","0.1.4"
"30443","646",2023-07-15 02:30:00,-12011.4285714286,1913,13924.4285714286,907,FALSE,"out1, fill","0.1.4"
"30444","646",2023-07-15 02:45:00,-12221.2857142857,1913,14134.2857142857,907,FALSE,"out1, fill","0.1.4"
"30445","646",2023-07-15 03:00:00,-12431.1428571429,1913,14344.1428571429,907,FALSE,"out1, fill","0.1.4"
"30446","646",2023-07-15 03:15:00,-12641,1913,14554,907,FALSE,NA,"0.1.4"
"30447","646",2023-07-15 03:30:00,-12264,1913,14177,907,FALSE,NA,"0.1.4"
"30448","646",2023-07-15 03:45:00,-12498,1913,14411,907,FALSE,NA,"0.1.4"
"30449","646",2023-07-15 04:00:00,-12589,1913,14502,907,FALSE,NA,"0.1.4"
"30450","646",2023-07-15 04:15:00,-12589,1913,14502,907,FALSE,"jump1","0.1.4"
"30451","646",2023-07-15 04:30:00,-12834,1913,14747,907,FALSE,NA,"0.1.4"
"30452","646",2023-07-15 04:45:00,-12617,1913,14530,907,FALSE,NA,"0.1.4"
"30453","646",2023-07-15 05:00:00,-12396,1913,14309,907,FALSE,NA,"0.1.4"
"30454","646",2023-07-15 05:15:00,-11975.5,1913,13888.5,907,FALSE,"out1, fill","0.1.4"
"30455","646",2023-07-15 05:30:00,-11555,1913,13468,907,FALSE,NA,"0.1.4"
"30456","646",2023-07-15 05:45:00,-11555,1913,13468,907,FALSE,"jump1","0.1.4"
"30457","646",2023-07-15 06:00:00,-11555,1913,13468,907,FALSE,"jump1","0.1.4"
"30458","646",2023-07-15 06:15:00,-11555,1913,13468,907,FALSE,"jump1","0.1.4"
"30459","646",2023-07-15 06:30:00,-11953,1913,13866,907,FALSE,"out1, fill","0.1.4"
"30460","646",2023-07-15 06:45:00,-12351,1913,14264,907,FALSE,NA,"0.1.4"
"30461","646",2023-07-15 07:00:00,-12397,1913,14310,907,FALSE,NA,"0.1.4"
"30462","646",2023-07-15 07:15:00,-12153,1913,14066,907,FALSE,NA,"0.1.4"
"30463","646",2023-07-15 07:30:00,-12613,1913,14526,907,FALSE,NA,"0.1.4"
"30464","646",2023-07-15 07:45:00,-12263,1913,14176,907,FALSE,NA,"0.1.4"
"30465","646",2023-07-15 08:00:00,-12493,1913,14406,907,FALSE,NA,"0.1.4"
"30466","646",2023-07-15 08:15:00,-12679,1913,14592,907,FALSE,NA,"0.1.4"
"30467","646",2023-07-15 08:30:00,-12296,1913,14209,907,FALSE,NA,"0.1.4"
"30468","646",2023-07-15 08:45:00,-12593,1913,14506,907,FALSE,NA,"0.1.4"
"30469","646",2023-07-15 09:00:00,-12322,1913,14235,907,FALSE,NA,"0.1.4"
"30470","646",2023-07-15 09:15:00,-12464,1913,14377,907,FALSE,NA,"0.1.4"
"30471","646",2023-07-15 09:30:00,-12446.8571428571,1913,14359.8571428571,907,FALSE,"out1, fill","0.1.4"
"30472","646",2023-07-15 09:45:00,-12429.7142857143,1913,14342.7142857143,907,FALSE,"out1, fill","0.1.4"
"30473","646",2023-07-15 10:00:00,-12412.5714285714,1913,14325.5714285714,907,FALSE,"out1, fill","0.1.4"
"30474","646",2023-07-15 10:15:00,-12395.4285714286,1913,14308.4285714286,907,FALSE,"out1, fill","0.1.4"
"30475","646",2023-07-15 10:30:00,-12378.2857142857,1913,14291.2857142857,907,FALSE,"out1, fill","0.1.4"
"30476","646",2023-07-15 10:45:00,-12361.1428571429,1913,14274.1428571429,907,FALSE,"out1, fill","0.1.4"
"30477","646",2023-07-15 11:00:00,-12344,1913,14257,907,FALSE,NA,"0.1.4"
"30478","646",2023-07-15 11:15:00,-12449,1913,14362,907,FALSE,NA,"0.1.4"
"30479","646",2023-07-15 11:30:00,-12353,1913,14266,907,FALSE,NA,"0.1.4"
"30480","646",2023-07-15 11:45:00,-11986.5,1913,13899.5,907,FALSE,"out1, fill","0.1.4"
"30481","646",2023-07-15 12:00:00,-11620,1913,13533,907,FALSE,NA,"0.1.4"
"30482","646",2023-07-15 12:15:00,-11920,1913,13833,907,FALSE,NA,"0.1.4"
"30483","646",2023-07-15 12:30:00,-11920,1913,13833,907,FALSE,"jump1","0.1.4"
"30484","646",2023-07-15 12:45:00,-11758.4,1913,13671.4,907,FALSE,"out1, fill","0.1.4"
"30485","646",2023-07-15 13:00:00,-11596.8,1913,13509.8,907,FALSE,"out1, fill","0.1.4"
"30486","646",2023-07-15 13:15:00,-11435.2,1913,13348.2,907,FALSE,"out1, fill","0.1.4"
"30487","646",2023-07-15 13:30:00,-11273.6,1913,13186.6,907,FALSE,"out1, fill","0.1.4"
"30488","646",2023-07-15 13:45:00,-11112,1913,13025,907,FALSE,NA,"0.1.4"
"30489","646",2023-07-15 14:00:00,-11313,1913,13226,907,FALSE,NA,"0.1.4"
"30490","646",2023-07-15 14:15:00,-11403,1913,13316,907,FALSE,NA,"0.1.4"
"30491","646",2023-07-15 14:30:00,-11364,1913,13277,907,FALSE,NA,"0.1.4"
"30492","646",2023-07-15 14:45:00,-11171,1913,13084,907,FALSE,NA,"0.1.4"
"30493","646",2023-07-15 15:00:00,-11072,1913,12985,907,FALSE,NA,"0.1.4"
"30494","646",2023-07-15 15:15:00,-10816,1913,12729,907,FALSE,NA,"0.1.4"
"30495","646",2023-07-15 15:30:00,-10547,1913,12460,907,FALSE,NA,"0.1.4"
"30496","646",2023-07-15 15:45:00,-10352,1913,12265,907,FALSE,NA,"0.1.4"
"30497","646",2023-07-15 16:00:00,-10354,1913,12267,907,FALSE,NA,"0.1.4"
"30498","646",2023-07-15 16:15:00,-10408,1913,12321,907,FALSE,NA,"0.1.4"
"30499","646",2023-07-15 16:30:00,-10788,1913,12701,907,FALSE,NA,"0.1.4"
"30500","646",2023-07-15 16:45:00,-10355,1913,12268,907,FALSE,NA,"0.1.4"
"30501","646",2023-07-15 17:00:00,-10593,1913,12506,907,FALSE,NA,"0.1.4"
"30502","646",2023-07-15 17:15:00,-10421,1913,12334,907,FALSE,NA,"0.1.4"
"30503","646",2023-07-15 17:30:00,-10842,1913,12755,907,FALSE,NA,"0.1.4"
"30504","646",2023-07-15 17:45:00,-10417,1913,12330,907,FALSE,NA,"0.1.4"
"30505","646",2023-07-15 18:00:00,-10346,1913,12259,907,FALSE,NA,"0.1.4"
"30506","646",2023-07-15 18:15:00,-10394,1913,12307,907,FALSE,NA,"0.1.4"
"30507","646",2023-07-15 18:30:00,-10332,1913,12245,907,FALSE,NA,"0.1.4"
"30508","646",2023-07-15 18:45:00,-10332,1913,12245,907,FALSE,NA,"0.1.4"
"30509","646",2023-07-15 19:00:00,-10355,1913,12268,907,FALSE,NA,"0.1.4"
"30510","646",2023-07-15 19:15:00,-10564,1913,12477,907,FALSE,NA,"0.1.4"
"30511","646",2023-07-15 19:30:00,-10562,1913,12475,907,FALSE,NA,"0.1.4"
"30512","646",2023-07-15 19:45:00,-10337,1913,12250,907,FALSE,NA,"0.1.4"
"30513","646",2023-07-15 20:00:00,-10359,1913,12272,907,FALSE,NA,"0.1.4"
"30514","646",2023-07-15 20:15:00,-10335,1913,12248,907,FALSE,NA,"0.1.4"
"30515","646",2023-07-15 20:30:00,-10334,1913,12247,907,FALSE,NA,"0.1.4"
"30516","646",2023-07-15 20:45:00,-10333,1913,12246,907,FALSE,NA,"0.1.4"
"30517","646",2023-07-15 21:00:00,-10339,1913,12252,907,FALSE,NA,"0.1.4"
"30518","646",2023-07-15 21:15:00,-10331,1913,12244,907,FALSE,NA,"0.1.4"
"30519","646",2023-07-15 21:30:00,-10333,1913,12246,907,FALSE,NA,"0.1.4"
"30520","646",2023-07-15 21:45:00,-10334,1913,12247,907,FALSE,NA,"0.1.4"
"30521","646",2023-07-15 22:00:00,-10333,1913,12246,907,FALSE,NA,"0.1.4"
"30522","646",2023-07-15 22:15:00,-10335,1913,12248,907,FALSE,NA,"0.1.4"
"30523","646",2023-07-15 22:30:00,-10342,1913,12255,907,FALSE,NA,"0.1.4"
"30524","646",2023-07-15 22:45:00,-10330,1913,12243,907,FALSE,NA,"0.1.4"
"30525","646",2023-07-15 23:00:00,-10333,1913,12246,907,FALSE,NA,"0.1.4"
"30526","646",2023-07-15 23:15:00,-10330,1913,12243,907,FALSE,NA,"0.1.4"
"30527","646",2023-07-15 23:30:00,-10620,1913,12533,907,FALSE,NA,"0.1.4"
"30528","646",2023-07-15 23:45:00,-10825.6,1913,12738.6,907,FALSE,"out1, fill","0.1.4"
"30529","646",2023-07-16,-11031.2,1913,12944.2,907,FALSE,"out1, fill","0.1.4"
"30530","646",2023-07-16 00:15:00,-11236.8,1913,13149.8,907,FALSE,"out1, fill","0.1.4"
"30531","646",2023-07-16 00:30:00,-11442.4,1913,13355.4,907,FALSE,"out1, fill","0.1.4"
"30532","646",2023-07-16 00:45:00,-11648,1913,13561,907,FALSE,NA,"0.1.4"
"30533","646",2023-07-16 01:00:00,-11829,1913,13742,907,FALSE,NA,"0.1.4"
"30534","646",2023-07-16 01:15:00,-11601,1913,13514,907,FALSE,NA,"0.1.4"
"30535","646",2023-07-16 01:30:00,-11676,1913,13589,907,FALSE,NA,"0.1.4"
"30536","646",2023-07-16 01:45:00,-11927,1913,13840,907,FALSE,NA,"0.1.4"
"30537","646",2023-07-16 02:00:00,-11729,1913,13642,907,FALSE,NA,"0.1.4"
"30538","646",2023-07-16 02:15:00,-11713,1913,13626,907,FALSE,NA,"0.1.4"
"30539","646",2023-07-16 02:30:00,-11342,1913,13255,907,FALSE,NA,"0.1.4"
"30540","646",2023-07-16 02:45:00,-11429,1913,13342,907,FALSE,NA,"0.1.4"
"30541","646",2023-07-16 03:00:00,-11282.8571428571,1913,13195.8571428571,907,FALSE,"out1, fill","0.1.4"
"30542","646",2023-07-16 03:15:00,-11136.7142857143,1913,13049.7142857143,907,FALSE,"out1, fill","0.1.4"
"30543","646",2023-07-16 03:30:00,-10990.5714285714,1913,12903.5714285714,907,FALSE,"out1, fill","0.1.4"
"30544","646",2023-07-16 03:45:00,-10844.4285714286,1913,12757.4285714286,907,FALSE,"out1, fill","0.1.4"
"30545","646",2023-07-16 04:00:00,-10698.2857142857,1913,12611.2857142857,907,FALSE,"out1, fill","0.1.4"
"30546","646",2023-07-16 04:15:00,-10552.1428571429,1913,12465.1428571429,907,FALSE,"out1, fill","0.1.4"
"30547","646",2023-07-16 04:30:00,-10406,1913,12319,907,FALSE,NA,"0.1.4"
"30548","646",2023-07-16 04:45:00,-10406,1913,12319,907,FALSE,"jump1","0.1.4"
"30549","646",2023-07-16 05:00:00,-10137,1913,12050,907,FALSE,NA,"0.1.4"
"30550","646",2023-07-16 05:15:00,-10026,1913,11939,907,FALSE,NA,"0.1.4"
"30551","646",2023-07-16 05:30:00,-10115.6666666667,1913,12028.6666666667,907,FALSE,"out1, fill","0.1.4"
"30552","646",2023-07-16 05:45:00,-10205.3333333333,1913,12118.3333333333,907,FALSE,"out1, fill","0.1.4"
"30553","646",2023-07-16 06:00:00,-10295,1913,12208,907,FALSE,"out1, fill","0.1.4"
"30554","646",2023-07-16 06:15:00,-10384.6666666667,1913,12297.6666666667,907,FALSE,"out1, fill","0.1.4"
"30555","646",2023-07-16 06:30:00,-10474.3333333333,1913,12387.3333333333,907,FALSE,"out1, fill","0.1.4"
"30556","646",2023-07-16 06:45:00,-10564,1913,12477,907,FALSE,NA,"0.1.4"
"30557","646",2023-07-16 07:00:00,-10564,1913,12477,907,FALSE,"jump1","0.1.4"
"30558","646",2023-07-16 07:15:00,-10303,1913,12216,907,FALSE,NA,"0.1.4"
"30559","646",2023-07-16 07:30:00,-10211,1913,12124,907,FALSE,NA,"0.1.4"
"30560","646",2023-07-16 07:45:00,-10216.6666666667,1913,12129.6666666667,907,FALSE,"out1, fill","0.1.4"
"30561","646",2023-07-16 08:00:00,-10222.3333333333,1913,12135.3333333333,907,FALSE,"out1, fill","0.1.4"
"30562","646",2023-07-16 08:15:00,-10228,1913,12141,907,FALSE,NA,"0.1.4"
"30563","646",2023-07-16 08:30:00,-10247,1913,12160,907,FALSE,NA,"0.1.4"
"30564","646",2023-07-16 08:45:00,-9784,1913,11697,907,FALSE,NA,"0.1.4"
"30565","646",2023-07-16 09:00:00,-10109,1913,12022,907,FALSE,NA,"0.1.4"
"30566","646",2023-07-16 09:15:00,-10050,1913,11963,907,FALSE,NA,"0.1.4"
"30567","646",2023-07-16 09:30:00,-10126,1913,12039,907,FALSE,NA,"0.1.4"
"30568","646",2023-07-16 09:45:00,-10099,1913,12012,907,FALSE,NA,"0.1.4"
"30569","646",2023-07-16 10:00:00,-9734,1913,11647,907,FALSE,NA,"0.1.4"
"30570","646",2023-07-16 10:15:00,-9553,1913,11466,907,FALSE,NA,"0.1.4"
"30571","646",2023-07-16 10:30:00,-9553,1913,11466,907,FALSE,"jump1","0.1.4"
"30572","646",2023-07-16 10:45:00,-9631,1913,11544,907,FALSE,NA,"0.1.4"
"30573","646",2023-07-16 11:00:00,-9588,1913,11501,907,FALSE,NA,"0.1.4"
"30574","646",2023-07-16 11:15:00,-9618,1913,11531,907,FALSE,NA,"0.1.4"
"30575","646",2023-07-16 11:30:00,-9609.66666666667,1913,11522.6666666667,907,FALSE,"out1, fill","0.1.4"
"30576","646",2023-07-16 11:45:00,-9601.33333333333,1913,11514.3333333333,907,FALSE,"out1, fill","0.1.4"
"30577","646",2023-07-16 12:00:00,-9593,1913,11506,907,FALSE,NA,"0.1.4"
"30578","646",2023-07-16 12:15:00,-9255,1913,11168,907,FALSE,NA,"0.1.4"
"30579","646",2023-07-16 12:30:00,-9255,1913,11168,907,FALSE,"jump1","0.1.4"
"30580","646",2023-07-16 12:45:00,-9515,1913,11428,907,FALSE,NA,"0.1.4"
"30581","646",2023-07-16 13:00:00,-9310,1913,11223,907,FALSE,NA,"0.1.4"
"30582","646",2023-07-16 13:15:00,-9199,1913,11112,907,FALSE,NA,"0.1.4"
"30583","646",2023-07-16 13:30:00,-9191,1913,11104,907,FALSE,NA,"0.1.4"
"30584","646",2023-07-16 13:45:00,-9191,1913,11104,907,FALSE,NA,"0.1.4"
"30585","646",2023-07-16 14:00:00,-9191,1913,11104,907,FALSE,NA,"0.1.4"
"30586","646",2023-07-16 14:15:00,-9191,1913,11104,907,FALSE,NA,"0.1.4"
"30587","646",2023-07-16 14:30:00,-9191,1913,11104,907,FALSE,NA,"0.1.4"
"30588","646",2023-07-16 14:45:00,-9191,1913,11104,907,FALSE,NA,"0.1.4"
"30589","646",2023-07-16 15:00:00,-9191,1913,11104,907,FALSE,NA,"0.1.4"
"30590","646",2023-07-16 15:15:00,-9191,1913,11104,907,FALSE,NA,"0.1.4"
"30591","646",2023-07-16 15:30:00,-9191,1913,11104,907,FALSE,NA,"0.1.4"
"30592","646",2023-07-16 15:45:00,-9191,1913,11104,907,FALSE,NA,"0.1.4"
"30593","646",2023-07-16 16:00:00,-9191,1913,11104,907,FALSE,NA,"0.1.4"
"30594","646",2023-07-16 16:15:00,-9191,1913,11104,907,FALSE,NA,"0.1.4"
"30595","646",2023-07-16 16:30:00,-9191,1913,11104,907,FALSE,NA,"0.1.4"
"30596","646",2023-07-16 16:45:00,-9191,1913,11104,907,FALSE,NA,"0.1.4"
"30597","646",2023-07-16 17:00:00,-9191,1913,11104,907,FALSE,NA,"0.1.4"
"30598","646",2023-07-16 17:15:00,-9191,1913,11104,907,FALSE,NA,"0.1.4"
"30599","646",2023-07-16 17:30:00,-9193,1913,11106,907,FALSE,NA,"0.1.4"
"30600","646",2023-07-16 17:45:00,-9228,1913,11141,907,FALSE,NA,"0.1.4"
"30601","646",2023-07-16 18:00:00,-9245,1913,11158,907,FALSE,NA,"0.1.4"
"30602","646",2023-07-16 18:15:00,-9197,1913,11110,907,FALSE,NA,"0.1.4"
"30603","646",2023-07-16 18:30:00,-9201,1913,11114,907,FALSE,NA,"0.1.4"
"30604","646",2023-07-16 18:45:00,-9222,1913,11135,907,FALSE,NA,"0.1.4"
"30605","646",2023-07-16 19:00:00,-9305,1913,11218,907,FALSE,NA,"0.1.4"
"30606","646",2023-07-16 19:15:00,-9194,1913,11107,907,FALSE,NA,"0.1.4"
"30607","646",2023-07-16 19:30:00,-9213,1913,11126,907,FALSE,NA,"0.1.4"
"30608","646",2023-07-16 19:45:00,-9434,1913,11347,907,FALSE,NA,"0.1.4"
"30609","646",2023-07-16 20:00:00,-9266,1913,11179,907,FALSE,NA,"0.1.4"
"30610","646",2023-07-16 20:15:00,-9186,1913,11099,907,FALSE,NA,"0.1.4"
"30611","646",2023-07-16 20:30:00,-9179,1913,11092,907,FALSE,NA,"0.1.4"
"30612","646",2023-07-16 20:45:00,-9191,1913,11104,907,FALSE,NA,"0.1.4"
"30613","646",2023-07-16 21:00:00,-9178,1913,11091,907,FALSE,NA,"0.1.4"
"30614","646",2023-07-16 21:15:00,-9180,1913,11093,907,FALSE,NA,"0.1.4"
"30615","646",2023-07-16 21:30:00,-9185,1913,11098,907,FALSE,NA,"0.1.4"
"30616","646",2023-07-16 21:45:00,-9182,1913,11095,907,FALSE,NA,"0.1.4"
"30617","646",2023-07-16 22:00:00,-9180,1913,11093,907,FALSE,NA,"0.1.4"
"30618","646",2023-07-16 22:15:00,-9204,1913,11117,907,FALSE,NA,"0.1.4"
"30619","646",2023-07-16 22:30:00,-9179,1913,11092,907,FALSE,NA,"0.1.4"
"30620","646",2023-07-16 22:45:00,-9179.25,1913,11092.25,907,FALSE,"out1, fill","0.1.4"
"30621","646",2023-07-16 23:00:00,-9179.5,1913,11092.5,907,FALSE,"out1, fill","0.1.4"
"30622","646",2023-07-16 23:15:00,-9179.75,1913,11092.75,907,FALSE,"out1, fill","0.1.4"
"30623","646",2023-07-16 23:30:00,-9180,1913,11093,907,FALSE,NA,"0.1.4"
"30624","646",2023-07-16 23:45:00,-9180,1913,11093,907,FALSE,NA,"0.1.4"
"30625","646",2023-07-17,-9179,1913,11092,907,FALSE,NA,"0.1.4"
"30626","646",2023-07-17 00:15:00,-9184,1913,11097,907,FALSE,NA,"0.1.4"
"30627","646",2023-07-17 00:30:00,-9182,1913,11095,907,FALSE,NA,"0.1.4"
"30628","646",2023-07-17 00:45:00,-9195,1913,11108,907,FALSE,NA,"0.1.4"
"30629","646",2023-07-17 01:00:00,-9620,1913,11533,907,FALSE,"out1, fill","0.1.4"
"30630","646",2023-07-17 01:15:00,-10045,1913,11958,907,FALSE,NA,"0.1.4"
"30631","646",2023-07-17 01:30:00,-10248,1913,12161,907,FALSE,NA,"0.1.4"
"30632","646",2023-07-17 01:45:00,-10254,1913,12167,907,FALSE,NA,"0.1.4"
"30633","646",2023-07-17 02:00:00,-10078.5,1913,11991.5,907,FALSE,"out1, fill","0.1.4"
"30634","646",2023-07-17 02:15:00,-9903,1913,11816,907,FALSE,NA,"0.1.4"
"30635","646",2023-07-17 02:30:00,-9903,1913,11816,907,FALSE,"jump1","0.1.4"
"30636","646",2023-07-17 02:45:00,-9974,1913,11887,907,FALSE,NA,"0.1.4"
"30637","646",2023-07-17 03:00:00,-9951,1913,11864,907,FALSE,NA,"0.1.4"
"30638","646",2023-07-17 03:15:00,-9949.33333333333,1913,11862.3333333333,907,FALSE,"out1, fill","0.1.4"
"30639","646",2023-07-17 03:30:00,-9947.66666666667,1913,11860.6666666667,907,FALSE,"out1, fill","0.1.4"
"30640","646",2023-07-17 03:45:00,-9946,1913,11859,907,FALSE,NA,"0.1.4"
"30641","646",2023-07-17 04:00:00,-9903,1913,11816,907,FALSE,NA,"0.1.4"
"30642","646",2023-07-17 04:15:00,-9901,1913,11814,907,FALSE,NA,"0.1.4"
"30643","646",2023-07-17 04:30:00,-10059,1913,11972,907,FALSE,NA,"0.1.4"
"30644","646",2023-07-17 04:45:00,-10138,1913,12051,907,FALSE,NA,"0.1.4"
"30645","646",2023-07-17 05:00:00,-9888,1913,11801,907,FALSE,NA,"0.1.4"
"30646","646",2023-07-17 05:15:00,-9893,1913,11806,907,FALSE,NA,"0.1.4"
"30647","646",2023-07-17 05:30:00,-9897,1913,11810,907,FALSE,NA,"0.1.4"
"30648","646",2023-07-17 05:45:00,-9894,1913,11807,907,FALSE,NA,"0.1.4"
"30649","646",2023-07-17 06:00:00,-9906,1913,11819,907,FALSE,NA,"0.1.4"
"30650","646",2023-07-17 06:15:00,-9895,1913,11808,907,FALSE,NA,"0.1.4"
"30651","646",2023-07-17 06:30:00,-9982,1913,11895,907,FALSE,NA,"0.1.4"
"30652","646",2023-07-17 06:45:00,-10330,1913,12243,907,FALSE,NA,"0.1.4"
"30653","646",2023-07-17 07:00:00,-9918,1913,11831,907,FALSE,NA,"0.1.4"
"30654","646",2023-07-17 07:15:00,-9898,1913,11811,907,FALSE,NA,"0.1.4"
"30655","646",2023-07-17 07:30:00,-9896,1913,11809,907,FALSE,NA,"0.1.4"
"30656","646",2023-07-17 07:45:00,-9897,1913,11810,907,FALSE,NA,"0.1.4"
"30657","646",2023-07-17 08:00:00,-9896,1913,11809,907,FALSE,NA,"0.1.4"
"30658","646",2023-07-17 08:15:00,-10263,1913,12176,907,FALSE,NA,"0.1.4"
"30659","646",2023-07-17 08:30:00,-10163,1913,12076,907,FALSE,NA,"0.1.4"
"30660","646",2023-07-17 08:45:00,-9897,1913,11810,907,FALSE,NA,"0.1.4"
"30661","646",2023-07-17 09:00:00,-10048,1913,11961,907,FALSE,NA,"0.1.4"
"30662","646",2023-07-17 09:15:00,-10048,1913,11961,907,FALSE,"jump1","0.1.4"
"30663","646",2023-07-17 09:30:00,-9840,1913,11753,907,FALSE,NA,"0.1.4"
"30664","646",2023-07-17 09:45:00,-9879,1913,11792,907,FALSE,NA,"0.1.4"
"30665","646",2023-07-17 10:00:00,-9613,1913,11526,907,FALSE,NA,"0.1.4"
"30666","646",2023-07-17 10:15:00,-9613,1913,11526,907,FALSE,"jump1","0.1.4"
"30667","646",2023-07-17 10:30:00,-9352.5,1913,11265.5,907,FALSE,"out1, fill","0.1.4"
"30668","646",2023-07-17 10:45:00,-9092,1913,11005,907,FALSE,NA,"0.1.4"
"30669","646",2023-07-17 11:00:00,-9092,1913,11005,907,FALSE,"jump1","0.1.4"
"30670","646",2023-07-17 11:15:00,-9270,1913,11183,907,FALSE,NA,"0.1.4"
"30671","646",2023-07-17 11:30:00,-9143,1913,11056,907,FALSE,NA,"0.1.4"
"30672","646",2023-07-17 11:45:00,-9198,1913,11111,907,FALSE,NA,"0.1.4"
"30673","646",2023-07-17 12:00:00,-9288.5,1913,11201.5,907,FALSE,"out1, fill","0.1.4"
"30674","646",2023-07-17 12:15:00,-9379,1913,11292,907,FALSE,"out1, fill","0.1.4"
"30675","646",2023-07-17 12:30:00,-9469.5,1913,11382.5,907,FALSE,"out1, fill","0.1.4"
"30676","646",2023-07-17 12:45:00,-9560,1913,11473,907,FALSE,NA,"0.1.4"
"30677","646",2023-07-17 13:00:00,-9586,1913,11499,907,FALSE,NA,"0.1.4"
"30678","646",2023-07-17 13:15:00,-9835,1913,11748,907,FALSE,NA,"0.1.4"
"30679","646",2023-07-17 13:30:00,-9570,1913,11483,907,FALSE,NA,"0.1.4"
"30680","646",2023-07-17 13:45:00,-9648,1913,11561,907,FALSE,NA,"0.1.4"
"30681","646",2023-07-17 14:00:00,-9613,1913,11526,907,FALSE,NA,"0.1.4"
"30682","646",2023-07-17 14:15:00,-9592,1913,11505,907,FALSE,NA,"0.1.4"
"30683","646",2023-07-17 14:30:00,-9431,1913,11344,907,FALSE,NA,"0.1.4"
"30684","646",2023-07-17 14:45:00,-9485,1913,11398,907,FALSE,NA,"0.1.4"
"30685","646",2023-07-17 15:00:00,-9270,1913,11183,907,FALSE,NA,"0.1.4"
"30686","646",2023-07-17 15:15:00,-9410,1913,11323,907,FALSE,NA,"0.1.4"
"30687","646",2023-07-17 15:30:00,-9498,1913,11411,907,FALSE,NA,"0.1.4"
"30688","646",2023-07-17 15:45:00,-9501,1913,11414,907,FALSE,NA,"0.1.4"
"30689","646",2023-07-17 16:00:00,-9292,1913,11205,907,FALSE,NA,"0.1.4"
"30690","646",2023-07-17 16:15:00,-9210,1913,11123,907,FALSE,NA,"0.1.4"
"30691","646",2023-07-17 16:30:00,-9277,1913,11190,907,FALSE,NA,"0.1.4"
"30692","646",2023-07-17 16:45:00,-9277,1913,11190,907,FALSE,"out1, fill","0.1.4"
"30693","646",2023-07-17 17:00:00,-9277,1913,11190,907,FALSE,"jump1","0.1.4"
"30694","646",2023-07-17 17:15:00,-9277,1913,11190,907,FALSE,NA,"0.1.4"
"30695","646",2023-07-17 17:30:00,-9306,1913,11219,907,FALSE,NA,"0.1.4"
"30696","646",2023-07-17 17:45:00,-9277,1913,11190,907,FALSE,NA,"0.1.4"
"30697","646",2023-07-17 18:00:00,-9277,1913,11190,907,FALSE,NA,"0.1.4"
"30698","646",2023-07-17 18:15:00,-9277,1913,11190,907,FALSE,NA,"0.1.4"
"30699","646",2023-07-17 18:30:00,-9277,1913,11190,907,FALSE,NA,"0.1.4"
"30700","646",2023-07-17 18:45:00,-9278,1913,11191,907,FALSE,NA,"0.1.4"
"30701","646",2023-07-17 19:00:00,-9289,1913,11202,907,FALSE,NA,"0.1.4"
"30702","646",2023-07-17 19:15:00,-9277,1913,11190,907,FALSE,NA,"0.1.4"
"30703","646",2023-07-17 19:30:00,-9277,1913,11190,907,FALSE,NA,"0.1.4"
"30704","646",2023-07-17 19:45:00,-9279,1913,11192,907,FALSE,NA,"0.1.4"
"30705","646",2023-07-17 20:00:00,-9285,1913,11198,907,FALSE,NA,"0.1.4"
"30706","646",2023-07-17 20:15:00,-9278,1913,11191,907,FALSE,NA,"0.1.4"
"30707","646",2023-07-17 20:30:00,-9278,1913,11191,907,FALSE,NA,"0.1.4"
"30708","646",2023-07-17 20:45:00,-9278,1913,11191,907,FALSE,NA,"0.1.4"
"30709","646",2023-07-17 21:00:00,-9280,1913,11193,907,FALSE,NA,"0.1.4"
"30710","646",2023-07-17 21:15:00,-9278,1913,11191,907,FALSE,NA,"0.1.4"
"30711","646",2023-07-17 21:30:00,-9277,1913,11190,907,FALSE,NA,"0.1.4"
"30712","646",2023-07-17 21:45:00,-9277,1913,11190,907,FALSE,NA,"0.1.4"
"30713","646",2023-07-17 22:00:00,-9278,1913,11191,907,FALSE,NA,"0.1.4"
"30714","646",2023-07-17 22:15:00,-9278,1913,11191,907,FALSE,NA,"0.1.4"
"30715","646",2023-07-17 22:30:00,-9278,1913,11191,907,FALSE,NA,"0.1.4"
"30716","646",2023-07-17 22:45:00,-9278,1913,11191,907,FALSE,NA,"0.1.4"
"30717","646",2023-07-17 23:00:00,-9278,1913,11191,907,FALSE,NA,"0.1.4"
"30718","646",2023-07-17 23:15:00,-9435,1913,11348,907,FALSE,NA,"0.1.4"
"30719","646",2023-07-17 23:30:00,-9615,1913,11528,907,FALSE,NA,"0.1.4"
"30720","646",2023-07-17 23:45:00,-9615,1913,11528,907,FALSE,"jump1","0.1.4"
"30721","646",2023-07-18,-9160.5,1913,11073.5,907,FALSE,"out1, fill","0.1.4"
"30722","646",2023-07-18 00:15:00,-8706,1913,10619,907,FALSE,NA,"0.1.4"
"30723","646",2023-07-18 00:30:00,-8752,1913,10665,907,FALSE,NA,"0.1.4"
"30724","646",2023-07-18 00:45:00,-8752,1913,10665,907,FALSE,"jump1","0.1.4"
"30725","646",2023-07-18 01:00:00,-8258,1913,10171,907,FALSE,NA,"0.1.4"
"30726","646",2023-07-18 01:15:00,-8346,1913,10259,907,FALSE,NA,"0.1.4"
"30727","646",2023-07-18 01:30:00,-8297,1913,10210,907,FALSE,NA,"0.1.4"
"30728","646",2023-07-18 01:45:00,-8461.5,1913,10374.5,907,FALSE,"out1, fill","0.1.4"
"30729","646",2023-07-18 02:00:00,-8626,1913,10539,907,FALSE,NA,"0.1.4"
"30730","646",2023-07-18 02:15:00,-8816,1913,10729,907,FALSE,NA,"0.1.4"
"30731","646",2023-07-18 02:30:00,-8384,1913,10297,907,FALSE,NA,"0.1.4"
"30732","646",2023-07-18 02:45:00,-8384,1913,10297,907,FALSE,"jump1","0.1.4"
"30733","646",2023-07-18 03:00:00,-8629,1913,10542,907,FALSE,NA,"0.1.4"
"30734","646",2023-07-18 03:15:00,-8550,1913,10463,907,FALSE,NA,"0.1.4"
"30735","646",2023-07-18 03:30:00,-8652,1913,10565,907,FALSE,NA,"0.1.4"
"30736","646",2023-07-18 03:45:00,-8547,1913,10460,907,FALSE,NA,"0.1.4"
"30737","646",2023-07-18 04:00:00,-8656,1913,10569,907,FALSE,NA,"0.1.4"
"30738","646",2023-07-18 04:15:00,-8450,1913,10363,907,FALSE,NA,"0.1.4"
"30739","646",2023-07-18 04:30:00,-8705,1913,10618,907,FALSE,NA,"0.1.4"
"30740","646",2023-07-18 04:45:00,-8679,1913,10592,907,FALSE,NA,"0.1.4"
"30741","646",2023-07-18 05:00:00,-8523,1913,10436,907,FALSE,NA,"0.1.4"
"30742","646",2023-07-18 05:15:00,-8612,1913,10525,907,FALSE,NA,"0.1.4"
"30743","646",2023-07-18 05:30:00,-8793,1913,10706,907,FALSE,NA,"0.1.4"
"30744","646",2023-07-18 05:45:00,-8705,1913,10618,907,FALSE,NA,"0.1.4"
"30745","646",2023-07-18 06:00:00,-8866,1913,10779,907,FALSE,NA,"0.1.4"
"30746","646",2023-07-18 06:15:00,-8852,1913,10765,907,FALSE,NA,"0.1.4"
"30747","646",2023-07-18 06:30:00,-8713,1913,10626,907,FALSE,NA,"0.1.4"
"30748","646",2023-07-18 06:45:00,-8773,1913,10686,907,FALSE,NA,"0.1.4"
"30749","646",2023-07-18 07:00:00,-8524,1913,10437,907,FALSE,NA,"0.1.4"
"30750","646",2023-07-18 07:15:00,-8608,1913,10521,907,FALSE,NA,"0.1.4"
"30751","646",2023-07-18 07:30:00,-8795,1913,10708,907,FALSE,NA,"0.1.4"
"30752","646",2023-07-18 07:45:00,-8712,1913,10625,907,FALSE,NA,"0.1.4"
"30753","646",2023-07-18 08:00:00,-8525,1913,10438,907,FALSE,NA,"0.1.4"
"30754","646",2023-07-18 08:15:00,-8735,1913,10648,907,FALSE,NA,"0.1.4"
"30755","646",2023-07-18 08:30:00,-8368,1913,10281,907,FALSE,NA,"0.1.4"
"30756","646",2023-07-18 08:45:00,-8608,1913,10521,907,FALSE,NA,"0.1.4"
"30757","646",2023-07-18 09:00:00,-8576,1913,10489,907,FALSE,NA,"0.1.4"
"30758","646",2023-07-18 09:15:00,-8299,1913,10212,907,FALSE,NA,"0.1.4"
"30759","646",2023-07-18 09:30:00,-8555,1913,10468,907,FALSE,NA,"0.1.4"
"30760","646",2023-07-18 09:45:00,-8678,1913,10591,907,FALSE,NA,"0.1.4"
"30761","646",2023-07-18 10:00:00,-8474,1913,10387,907,FALSE,NA,"0.1.4"
"30762","646",2023-07-18 10:15:00,-8577,1913,10490,907,FALSE,NA,"0.1.4"
"30763","646",2023-07-18 10:30:00,-8568,1913,10481,907,FALSE,NA,"0.1.4"
"30764","646",2023-07-18 10:45:00,-8655.57142857143,1913,10568.5714285714,907,FALSE,"out1, fill","0.1.4"
"30765","646",2023-07-18 11:00:00,-8743.14285714286,1913,10656.1428571429,907,FALSE,"out1, fill","0.1.4"
"30766","646",2023-07-18 11:15:00,-8830.71428571429,1913,10743.7142857143,907,FALSE,"out1, fill","0.1.4"
"30767","646",2023-07-18 11:30:00,-8918.28571428571,1913,10831.2857142857,907,FALSE,"out1, fill","0.1.4"
"30768","646",2023-07-18 11:45:00,-9005.85714285714,1913,10918.8571428571,907,FALSE,"out1, fill","0.1.4"
"30769","646",2023-07-18 12:00:00,-9093.42857142857,1913,11006.4285714286,907,FALSE,"out1, fill","0.1.4"
"30770","646",2023-07-18 12:15:00,-9181,1913,11094,907,FALSE,NA,"0.1.4"
"30771","646",2023-07-18 12:30:00,-8990,1913,10903,907,FALSE,NA,"0.1.4"
"30772","646",2023-07-18 12:45:00,-9272,1913,11185,907,FALSE,NA,"0.1.4"
"30773","646",2023-07-18 13:00:00,-9151,1913,11064,907,FALSE,NA,"0.1.4"
"30774","646",2023-07-18 13:15:00,-9299,1913,11212,907,FALSE,NA,"0.1.4"
"30775","646",2023-07-18 13:30:00,-8988,1913,10901,907,FALSE,NA,"0.1.4"
"30776","646",2023-07-18 13:45:00,-8917,1913,10830,907,FALSE,NA,"0.1.4"
"30777","646",2023-07-18 14:00:00,-8646,1913,10559,907,FALSE,NA,"0.1.4"
"30778","646",2023-07-18 14:15:00,-8345,1913,10258,907,FALSE,NA,"0.1.4"
"30779","646",2023-07-18 14:30:00,-8533,1913,10446,907,FALSE,NA,"0.1.4"
"30780","646",2023-07-18 14:45:00,-8511,1913,10424,907,FALSE,NA,"0.1.4"
"30781","646",2023-07-18 15:00:00,-8723,1913,10636,907,FALSE,NA,"0.1.4"
"30782","646",2023-07-18 15:15:00,-8652,1913,10565,907,FALSE,NA,"0.1.4"
"30783","646",2023-07-18 15:30:00,-8749,1913,10662,907,FALSE,NA,"0.1.4"
"30784","646",2023-07-18 15:45:00,-8493,1913,10406,907,FALSE,NA,"0.1.4"
"30785","646",2023-07-18 16:00:00,-8665,1913,10578,907,FALSE,NA,"0.1.4"
"30786","646",2023-07-18 16:15:00,-8538,1913,10451,907,FALSE,NA,"0.1.4"
"30787","646",2023-07-18 16:30:00,-8631,1913,10544,907,FALSE,NA,"0.1.4"
"30788","646",2023-07-18 16:45:00,-8544,1913,10457,907,FALSE,NA,"0.1.4"
"30789","646",2023-07-18 17:00:00,-8523,1913,10436,907,FALSE,NA,"0.1.4"
"30790","646",2023-07-18 17:15:00,-8622,1913,10535,907,FALSE,NA,"0.1.4"
"30791","646",2023-07-18 17:30:00,-8535,1913,10448,907,FALSE,NA,"0.1.4"
"30792","646",2023-07-18 17:45:00,-8507,1913,10420,907,FALSE,NA,"0.1.4"
"30793","646",2023-07-18 18:00:00,-8223,1913,10136,907,FALSE,NA,"0.1.4"
"30794","646",2023-07-18 18:15:00,-7815,1913,9728,907,FALSE,NA,"0.1.4"
"30795","646",2023-07-18 18:30:00,-7426,1913,9339,907,FALSE,NA,"0.1.4"
"30796","646",2023-07-18 18:45:00,-7424,1913,9337,907,FALSE,NA,"0.1.4"
"30797","646",2023-07-18 19:00:00,-7446,1913,9359,907,FALSE,NA,"0.1.4"
"30798","646",2023-07-18 19:15:00,-7446,1913,9359,907,FALSE,"jump1","0.1.4"
"30799","646",2023-07-18 19:30:00,-7446,1913,9359,907,FALSE,"jump1","0.1.4"
"30800","646",2023-07-18 19:45:00,-7458,1913,9371,907,FALSE,NA,"0.1.4"
"30801","646",2023-07-18 20:00:00,-7446,1913,9359,907,FALSE,NA,"0.1.4"
"30802","646",2023-07-18 20:15:00,-7446,1913,9359,907,FALSE,NA,"0.1.4"
"30803","646",2023-07-18 20:30:00,-7448,1913,9361,907,FALSE,NA,"0.1.4"
"30804","646",2023-07-18 20:45:00,-7445,1913,9358,907,FALSE,NA,"0.1.4"
"30805","646",2023-07-18 21:00:00,-7446,1913,9359,907,FALSE,NA,"0.1.4"
"30806","646",2023-07-18 21:15:00,-7446,1913,9359,907,FALSE,NA,"0.1.4"
"30807","646",2023-07-18 21:30:00,-7443,1913,9356,907,FALSE,NA,"0.1.4"
"30808","646",2023-07-18 21:45:00,-7443,1913,9356,907,FALSE,NA,"0.1.4"
"30809","646",2023-07-18 22:00:00,-7444,1913,9357,907,FALSE,NA,"0.1.4"
"30810","646",2023-07-18 22:15:00,-7450,1913,9363,907,FALSE,NA,"0.1.4"
"30811","646",2023-07-18 22:30:00,-7449,1913,9362,907,FALSE,NA,"0.1.4"
"30812","646",2023-07-18 22:45:00,-7443,1913,9356,907,FALSE,NA,"0.1.4"
"30813","646",2023-07-18 23:00:00,-7488,1913,9401,907,FALSE,NA,"0.1.4"
"30814","646",2023-07-18 23:15:00,-7811.5,1913,9724.5,907,FALSE,"out1, fill","0.1.4"
"30815","646",2023-07-18 23:30:00,-8135,1913,10048,907,FALSE,NA,"0.1.4"
"30816","646",2023-07-18 23:45:00,-7841,1913,9754,907,FALSE,NA,"0.1.4"
"30817","646",2023-07-19,-7852,1913,9765,907,FALSE,NA,"0.1.4"
"30818","646",2023-07-19 00:15:00,-7806,1913,9719,907,FALSE,NA,"0.1.4"
"30819","646",2023-07-19 00:30:00,-7459,1913,9372,907,FALSE,NA,"0.1.4"
"30820","646",2023-07-19 00:45:00,-7865,1913,9778,907,FALSE,NA,"0.1.4"
"30821","646",2023-07-19 01:00:00,-7448,1913,9361,907,FALSE,NA,"0.1.4"
"30822","646",2023-07-19 01:15:00,-7448,1913,9361,907,FALSE,"jump1","0.1.4"
"30823","646",2023-07-19 01:30:00,-7225,1913,9138,907,FALSE,NA,"0.1.4"
"30824","646",2023-07-19 01:45:00,-6924,1913,8837,907,FALSE,NA,"0.1.4"
"30825","646",2023-07-19 02:00:00,-7286,1913,9199,907,FALSE,NA,"0.1.4"
"30826","646",2023-07-19 02:15:00,-7663,1913,9576,907,FALSE,NA,"0.1.4"
"30827","646",2023-07-19 02:30:00,-7311,1913,9224,907,FALSE,NA,"0.1.4"
"30828","646",2023-07-19 02:45:00,-7448,1913,9361,907,FALSE,NA,"0.1.4"
"30829","646",2023-07-19 03:00:00,-7448,1913,9361,907,FALSE,"jump1","0.1.4"
"30830","646",2023-07-19 03:15:00,-7439,1913,9352,907,FALSE,NA,"0.1.4"
"30831","646",2023-07-19 03:30:00,-7439,1913,9352,907,FALSE,"jump1","0.1.4"
"30832","646",2023-07-19 03:45:00,-7751,1913,9664,907,FALSE,NA,"0.1.4"
"30833","646",2023-07-19 04:00:00,-7846,1913,9759,907,FALSE,NA,"0.1.4"
"30834","646",2023-07-19 04:15:00,-7731,1913,9644,907,FALSE,NA,"0.1.4"
"30835","646",2023-07-19 04:30:00,-8059,1913,9972,907,FALSE,NA,"0.1.4"
"30836","646",2023-07-19 04:45:00,-7703,1913,9616,907,FALSE,NA,"0.1.4"
"30837","646",2023-07-19 05:00:00,-7817,1913,9730,907,FALSE,NA,"0.1.4"
"30838","646",2023-07-19 05:15:00,-7692,1913,9605,907,FALSE,NA,"0.1.4"
"30839","646",2023-07-19 05:30:00,-7692,1913,9605,907,FALSE,"jump1","0.1.4"
"30840","646",2023-07-19 05:45:00,-7785,1913,9698,907,FALSE,NA,"0.1.4"
"30841","646",2023-07-19 06:00:00,-7701,1913,9614,907,FALSE,NA,"0.1.4"
"30842","646",2023-07-19 06:15:00,-7505,1913,9418,907,FALSE,"out1, fill","0.1.4"
"30843","646",2023-07-19 06:30:00,-7309,1913,9222,907,FALSE,"out1, fill","0.1.4"
"30844","646",2023-07-19 06:45:00,-7113,1913,9026,907,FALSE,NA,"0.1.4"
"30845","646",2023-07-19 07:00:00,-7113,1913,9026,907,FALSE,"jump1","0.1.4"
"30846","646",2023-07-19 07:15:00,-6881,1913,8794,907,FALSE,NA,"0.1.4"
"30847","646",2023-07-19 07:30:00,-7049,1913,8962,907,FALSE,NA,"0.1.4"
"30848","646",2023-07-19 07:45:00,-7058,1913,8971,907,FALSE,NA,"0.1.4"
"30849","646",2023-07-19 08:00:00,-6680,1913,8593,907,FALSE,NA,"0.1.4"
"30850","646",2023-07-19 08:15:00,-6898,1913,8811,907,FALSE,NA,"0.1.4"
"30851","646",2023-07-19 08:30:00,-7143,1913,9056,907,FALSE,NA,"0.1.4"
"30852","646",2023-07-19 08:45:00,-7043,1913,8956,907,FALSE,NA,"0.1.4"
"30853","646",2023-07-19 09:00:00,-7029,1913,8942,907,FALSE,NA,"0.1.4"
"30854","646",2023-07-19 09:15:00,-7029,1913,8942,907,FALSE,"jump1","0.1.4"
"30855","646",2023-07-19 09:30:00,-7151,1913,9064,907,FALSE,NA,"0.1.4"
"30856","646",2023-07-19 09:45:00,-7507,1913,9420,907,FALSE,NA,"0.1.4"
"30857","646",2023-07-19 10:00:00,-7468,1913,9381,907,FALSE,NA,"0.1.4"
"30858","646",2023-07-19 10:15:00,-7538,1913,9451,907,FALSE,NA,"0.1.4"
"30859","646",2023-07-19 10:30:00,-7344,1913,9257,907,FALSE,NA,"0.1.4"
"30860","646",2023-07-19 10:45:00,-7537,1913,9450,907,FALSE,NA,"0.1.4"
"30861","646",2023-07-19 11:00:00,-7281,1913,9194,907,FALSE,NA,"0.1.4"
"30862","646",2023-07-19 11:15:00,-7767,1913,9680,907,FALSE,NA,"0.1.4"
"30863","646",2023-07-19 11:30:00,-7730,1913,9643,907,FALSE,NA,"0.1.4"
"30864","646",2023-07-19 11:45:00,-7719,1913,9632,907,FALSE,NA,"0.1.4"
"30865","646",2023-07-19 12:00:00,-7735,1913,9648,907,FALSE,NA,"0.1.4"
"30866","646",2023-07-19 12:15:00,-7912,1913,9825,907,FALSE,NA,"0.1.4"
"30867","646",2023-07-19 12:30:00,-7700,1913,9613,907,FALSE,NA,"0.1.4"
"30868","646",2023-07-19 12:45:00,-7659,1913,9572,907,FALSE,NA,"0.1.4"
"30869","646",2023-07-19 13:00:00,-7768,1913,9681,907,FALSE,NA,"0.1.4"
"30870","646",2023-07-19 13:15:00,-7745,1913,9658,907,FALSE,NA,"0.1.4"
"30871","646",2023-07-19 13:30:00,-7795,1913,9708,907,FALSE,NA,"0.1.4"
"30872","646",2023-07-19 13:45:00,-7852,1913,9765,907,FALSE,NA,"0.1.4"
"30873","646",2023-07-19 14:00:00,-7794,1913,9707,907,FALSE,NA,"0.1.4"
"30874","646",2023-07-19 14:15:00,-7485,1913,9398,907,FALSE,NA,"0.1.4"
"30875","646",2023-07-19 14:30:00,-7756,1913,9669,907,FALSE,NA,"0.1.4"
"30876","646",2023-07-19 14:45:00,-7371,1913,9284,907,FALSE,NA,"0.1.4"
"30877","646",2023-07-19 15:00:00,-7232,1913,9145,907,FALSE,NA,"0.1.4"
"30878","646",2023-07-19 15:15:00,-7282,1913,9195,907,FALSE,NA,"0.1.4"
"30879","646",2023-07-19 15:30:00,-7303,1913,9216,907,FALSE,NA,"0.1.4"
"30880","646",2023-07-19 15:45:00,-7080,1913,8993,907,FALSE,NA,"0.1.4"
"30881","646",2023-07-19 16:00:00,-7156,1913,9069,907,FALSE,NA,"0.1.4"
"30882","646",2023-07-19 16:15:00,-7093.33333333333,1913,9006.33333333333,907,FALSE,"out1, fill","0.1.4"
"30883","646",2023-07-19 16:30:00,-7030.66666666667,1913,8943.66666666667,907,FALSE,"out1, fill","0.1.4"
"30884","646",2023-07-19 16:45:00,-6968,1913,8881,907,FALSE,NA,"0.1.4"
"30885","646",2023-07-19 17:00:00,-6565,1913,8478,907,FALSE,NA,"0.1.4"
"30886","646",2023-07-19 17:15:00,-6596,1913,8509,907,FALSE,NA,"0.1.4"
"30887","646",2023-07-19 17:30:00,-7006,1913,8919,907,FALSE,NA,"0.1.4"
"30888","646",2023-07-19 17:45:00,-7129,1913,9042,907,FALSE,NA,"0.1.4"
"30889","646",2023-07-19 18:00:00,-6863,1913,8776,907,FALSE,NA,"0.1.4"
"30890","646",2023-07-19 18:15:00,-6463,1913,8376,907,FALSE,NA,"0.1.4"
"30891","646",2023-07-19 18:30:00,-6555,1913,8468,907,FALSE,"out1, fill","0.1.4"
"30892","646",2023-07-19 18:45:00,-6647,1913,8560,907,FALSE,"out1, fill","0.1.4"
"30893","646",2023-07-19 19:00:00,-6739,1913,8652,907,FALSE,"out1, fill","0.1.4"
"30894","646",2023-07-19 19:15:00,-6831,1913,8744,907,FALSE,"out1, fill","0.1.4"
"30895","646",2023-07-19 19:30:00,-6923,1913,8836,907,FALSE,NA,"0.1.4"
"30896","646",2023-07-19 19:45:00,-6923,1913,8836,907,FALSE,"jump1","0.1.4"
"30897","646",2023-07-19 20:00:00,-6917,1913,8830,907,FALSE,NA,"0.1.4"
"30898","646",2023-07-19 20:15:00,-6917,1913,8830,907,FALSE,NA,"0.1.4"
"30899","646",2023-07-19 20:30:00,-6917,1913,8830,907,FALSE,NA,"0.1.4"
"30900","646",2023-07-19 20:45:00,-6917,1913,8830,907,FALSE,NA,"0.1.4"
"30901","646",2023-07-19 21:00:00,-7164,1913,9077,907,FALSE,NA,"0.1.4"
"30902","646",2023-07-19 21:15:00,-6919,1913,8832,907,FALSE,NA,"0.1.4"
"30903","646",2023-07-19 21:30:00,-6929,1913,8842,907,FALSE,NA,"0.1.4"
"30904","646",2023-07-19 21:45:00,-6924,1913,8837,907,FALSE,NA,"0.1.4"
"30905","646",2023-07-19 22:00:00,-6918,1913,8831,907,FALSE,NA,"0.1.4"
"30906","646",2023-07-19 22:15:00,-6967,1913,8880,907,FALSE,NA,"0.1.4"
"30907","646",2023-07-19 22:30:00,-6939,1913,8852,907,FALSE,NA,"0.1.4"
"30908","646",2023-07-19 22:45:00,-6918,1913,8831,907,FALSE,NA,"0.1.4"
"30909","646",2023-07-19 23:00:00,-6917,1913,8830,907,FALSE,NA,"0.1.4"
"30910","646",2023-07-19 23:15:00,-7237,1913,9150,907,FALSE,NA,"0.1.4"
"30911","646",2023-07-19 23:30:00,-7034,1913,8947,907,FALSE,NA,"0.1.4"
"30912","646",2023-07-19 23:45:00,-7034,1913,8947,907,FALSE,"jump1","0.1.4"
"30913","646",2023-07-20,-7034,1913,8947,907,FALSE,"jump1","0.1.4"
"30914","646",2023-07-20 00:15:00,-7034,1913,8947,907,FALSE,"jump1","0.1.4"
"30915","646",2023-07-20 00:30:00,-7273,1913,9186,907,FALSE,NA,"0.1.4"
"30916","646",2023-07-20 00:45:00,-7713,1913,9626,907,FALSE,NA,"0.1.4"
"30917","646",2023-07-20 01:00:00,-7445,1913,9358,907,FALSE,NA,"0.1.4"
"30918","646",2023-07-20 01:15:00,-7122,1913,9035,907,FALSE,NA,"0.1.4"
"30919","646",2023-07-20 01:30:00,-7306,1913,9219,907,FALSE,NA,"0.1.4"
"30920","646",2023-07-20 01:45:00,-7219,1913,9132,907,FALSE,NA,"0.1.4"
"30921","646",2023-07-20 02:00:00,-7280,1913,9193,907,FALSE,NA,"0.1.4"
"30922","646",2023-07-20 02:15:00,-7576,1913,9489,907,FALSE,NA,"0.1.4"
"30923","646",2023-07-20 02:30:00,-7653,1913,9566,907,FALSE,NA,"0.1.4"
"30924","646",2023-07-20 02:45:00,-7164,1913,9077,907,FALSE,NA,"0.1.4"
"30925","646",2023-07-20 03:00:00,-7164,1913,9077,907,FALSE,"jump1","0.1.4"
"30926","646",2023-07-20 03:15:00,-7099,1913,9012,907,FALSE,NA,"0.1.4"
"30927","646",2023-07-20 03:30:00,-7168,1913,9081,907,FALSE,NA,"0.1.4"
"30928","646",2023-07-20 03:45:00,-7032,1913,8945,907,FALSE,NA,"0.1.4"
"30929","646",2023-07-20 04:00:00,-7226,1913,9139,907,FALSE,NA,"0.1.4"
"30930","646",2023-07-20 04:15:00,-7304,1913,9217,907,FALSE,NA,"0.1.4"
"30931","646",2023-07-20 04:30:00,-7315,1913,9228,907,FALSE,NA,"0.1.4"
"30932","646",2023-07-20 04:45:00,-7450,1913,9363,907,FALSE,NA,"0.1.4"
"30933","646",2023-07-20 05:00:00,-7548,1913,9461,907,FALSE,NA,"0.1.4"
"30934","646",2023-07-20 05:15:00,-7100,1913,9013,907,FALSE,NA,"0.1.4"
"30935","646",2023-07-20 05:30:00,-7100,1913,9013,907,FALSE,"out1, fill","0.1.4"
"30936","646",2023-07-20 05:45:00,-7100,1913,9013,907,FALSE,"jump1","0.1.4"
"30937","646",2023-07-20 06:00:00,-7099,1913,9012,907,FALSE,NA,"0.1.4"
"30938","646",2023-07-20 06:15:00,-7318,1913,9231,907,FALSE,NA,"0.1.4"
"30939","646",2023-07-20 06:30:00,-7318,1913,9231,907,FALSE,"out1, fill","0.1.4"
"30940","646",2023-07-20 06:45:00,-7318,1913,9231,907,FALSE,"jump1","0.1.4"
"30941","646",2023-07-20 07:00:00,-7281,1913,9194,907,FALSE,NA,"0.1.4"
"30942","646",2023-07-20 07:15:00,-7261,1913,9174,907,FALSE,NA,"0.1.4"
"30943","646",2023-07-20 07:30:00,-6990.6,1913,8903.6,907,FALSE,"out1, fill","0.1.4"
"30944","646",2023-07-20 07:45:00,-6720.2,1913,8633.2,907,FALSE,"out1, fill","0.1.4"
"30945","646",2023-07-20 08:00:00,-6449.8,1913,8362.8,907,FALSE,"out1, fill","0.1.4"
"30946","646",2023-07-20 08:15:00,-6179.4,1913,8092.4,907,FALSE,"out1, fill","0.1.4"
"30947","646",2023-07-20 08:30:00,-5909,1913,7822,907,FALSE,NA,"0.1.4"
"30948","646",2023-07-20 08:45:00,-6060,1913,7973,907,FALSE,NA,"0.1.4"
"30949","646",2023-07-20 09:00:00,-6060,1913,7973,907,FALSE,"jump1","0.1.4"
"30950","646",2023-07-20 09:15:00,-6032,1913,7945,907,FALSE,NA,"0.1.4"
"30951","646",2023-07-20 09:30:00,-6215,1913,8128,907,FALSE,NA,"0.1.4"
"30952","646",2023-07-20 09:45:00,-5772,1913,7685,907,FALSE,NA,"0.1.4"
"30953","646",2023-07-20 10:00:00,-6037.5,1913,7950.5,907,FALSE,"out1, fill","0.1.4"
"30954","646",2023-07-20 10:15:00,-6303,1913,8216,907,FALSE,NA,"0.1.4"
"30955","646",2023-07-20 10:30:00,-6312,1913,8225,907,FALSE,NA,"0.1.4"
"30956","646",2023-07-20 10:45:00,-6455,1913,8368,907,FALSE,NA,"0.1.4"
"30957","646",2023-07-20 11:00:00,-6674,1913,8587,907,FALSE,NA,"0.1.4"
"30958","646",2023-07-20 11:15:00,-6415,1913,8328,907,FALSE,NA,"0.1.4"
"30959","646",2023-07-20 11:30:00,-5980,1913,7893,907,FALSE,NA,"0.1.4"
"30960","646",2023-07-20 11:45:00,-5980,1913,7893,907,FALSE,"jump1","0.1.4"
"30961","646",2023-07-20 12:00:00,-6110,1913,8023,907,FALSE,NA,"0.1.4"
"30962","646",2023-07-20 12:15:00,-6028,1913,7941,907,FALSE,NA,"0.1.4"
"30963","646",2023-07-20 12:30:00,-5626,1913,7539,907,FALSE,NA,"0.1.4"
"30964","646",2023-07-20 12:45:00,-5559,1913,7472,907,FALSE,NA,"0.1.4"
"30965","646",2023-07-20 13:00:00,-5973,1913,7886,907,FALSE,NA,"0.1.4"
"30966","646",2023-07-20 13:15:00,-5985,1913,7898,907,FALSE,NA,"0.1.4"
"30967","646",2023-07-20 13:30:00,-5985,1913,7898,907,FALSE,"jump1","0.1.4"
"30968","646",2023-07-20 13:45:00,-6230,1913,8143,907,FALSE,"out1, fill","0.1.4"
"30969","646",2023-07-20 14:00:00,-6475,1913,8388,907,FALSE,NA,"0.1.4"
"30970","646",2023-07-20 14:15:00,-6415,1913,8328,907,FALSE,NA,"0.1.4"
"30971","646",2023-07-20 14:30:00,-6351,1913,8264,907,FALSE,NA,"0.1.4"
"30972","646",2023-07-20 14:45:00,-6270,1913,8183,907,FALSE,NA,"0.1.4"
"30973","646",2023-07-20 15:00:00,-6346,1913,8259,907,FALSE,NA,"0.1.4"
"30974","646",2023-07-20 15:15:00,-6014,1913,7927,907,FALSE,NA,"0.1.4"
"30975","646",2023-07-20 15:30:00,-6356,1913,8269,907,FALSE,NA,"0.1.4"
"30976","646",2023-07-20 15:45:00,-6289,1913,8202,907,FALSE,NA,"0.1.4"
"30977","646",2023-07-20 16:00:00,-6285,1913,8198,907,FALSE,NA,"0.1.4"
"30978","646",2023-07-20 16:15:00,-6376,1913,8289,907,FALSE,NA,"0.1.4"
"30979","646",2023-07-20 16:30:00,-6081,1913,7994,907,FALSE,NA,"0.1.4"
"30980","646",2023-07-20 16:45:00,-6460,1913,8373,907,FALSE,NA,"0.1.4"
"30981","646",2023-07-20 17:00:00,-6460,1913,8373,907,FALSE,"jump1","0.1.4"
"30982","646",2023-07-20 17:15:00,-6722,1913,8635,907,FALSE,NA,"0.1.4"
"30983","646",2023-07-20 17:30:00,-6457,1913,8370,907,FALSE,"out1, fill","0.1.4"
"30984","646",2023-07-20 17:45:00,-6192,1913,8105,907,FALSE,NA,"0.1.4"
"30985","646",2023-07-20 18:00:00,-5734,1913,7647,907,FALSE,NA,"0.1.4"
"30986","646",2023-07-20 18:15:00,-5869,1913,7782,907,FALSE,NA,"0.1.4"
"30987","646",2023-07-20 18:30:00,-5745,1913,7658,907,FALSE,NA,"0.1.4"
"30988","646",2023-07-20 18:45:00,-5745,1913,7658,907,FALSE,NA,"0.1.4"
"30989","646",2023-07-20 19:00:00,-5744,1913,7657,907,FALSE,NA,"0.1.4"
"30990","646",2023-07-20 19:15:00,-5797,1913,7710,907,FALSE,NA,"0.1.4"
"30991","646",2023-07-20 19:30:00,-5809,1913,7722,907,FALSE,NA,"0.1.4"
"30992","646",2023-07-20 19:45:00,-5829,1913,7742,907,FALSE,NA,"0.1.4"
"30993","646",2023-07-20 20:00:00,-5780,1913,7693,907,FALSE,NA,"0.1.4"
"30994","646",2023-07-20 20:15:00,-5776,1913,7689,907,FALSE,NA,"0.1.4"
"30995","646",2023-07-20 20:30:00,-5763,1913,7676,907,FALSE,NA,"0.1.4"
"30996","646",2023-07-20 20:45:00,-5760,1913,7673,907,FALSE,NA,"0.1.4"
"30997","646",2023-07-20 21:00:00,-5762,1913,7675,907,FALSE,NA,"0.1.4"
"30998","646",2023-07-20 21:15:00,-5760,1913,7673,907,FALSE,NA,"0.1.4"
"30999","646",2023-07-20 21:30:00,-5766,1913,7679,907,FALSE,NA,"0.1.4"
"31000","646",2023-07-20 21:45:00,-5749,1913,7662,907,FALSE,NA,"0.1.4"
"31001","646",2023-07-20 22:00:00,-5745,1913,7658,907,FALSE,NA,"0.1.4"
"31002","646",2023-07-20 22:15:00,-5749,1913,7662,907,FALSE,NA,"0.1.4"
"31003","646",2023-07-20 22:30:00,-5747,1913,7660,907,FALSE,NA,"0.1.4"
"31004","646",2023-07-20 22:45:00,-5769,1913,7682,907,FALSE,NA,"0.1.4"
"31005","646",2023-07-20 23:00:00,-5863,1913,7776,907,FALSE,NA,"0.1.4"
"31006","646",2023-07-20 23:15:00,-5747,1913,7660,907,FALSE,NA,"0.1.4"
"31007","646",2023-07-20 23:30:00,-5747,1913,7660,907,FALSE,"jump1","0.1.4"
"31008","646",2023-07-20 23:45:00,-6014,1913,7927,907,FALSE,NA,"0.1.4"
"31009","646",2023-07-21,-6044,1913,7957,907,FALSE,NA,"0.1.4"
"31010","646",2023-07-21 00:15:00,-5610,1913,7523,907,FALSE,NA,"0.1.4"
"31011","646",2023-07-21 00:30:00,-5383,1913,7296,907,FALSE,NA,"0.1.4"
"31012","646",2023-07-21 00:45:00,-5383,1913,7296,907,FALSE,"jump1","0.1.4"
"31013","646",2023-07-21 01:00:00,-5357,1913,7270,907,FALSE,NA,"0.1.4"
"31014","646",2023-07-21 01:15:00,-5380,1913,7293,907,FALSE,NA,"0.1.4"
"31015","646",2023-07-21 01:30:00,-5380,1913,7293,907,FALSE,"jump1","0.1.4"
"31016","646",2023-07-21 01:45:00,-5410,1913,7323,907,FALSE,"out1, fill","0.1.4"
"31017","646",2023-07-21 02:00:00,-5440,1913,7353,907,FALSE,"out1, fill","0.1.4"
"31018","646",2023-07-21 02:15:00,-5470,1913,7383,907,FALSE,"out1, fill","0.1.4"
"31019","646",2023-07-21 02:30:00,-5500,1913,7413,907,FALSE,"out1, fill","0.1.4"
"31020","646",2023-07-21 02:45:00,-5530,1913,7443,907,FALSE,"out1, fill","0.1.4"
"31021","646",2023-07-21 03:00:00,-5560,1913,7473,907,FALSE,"out1, fill","0.1.4"
"31022","646",2023-07-21 03:15:00,-5590,1913,7503,907,FALSE,"out1, fill","0.1.4"
"31023","646",2023-07-21 03:30:00,-5620,1913,7533,907,FALSE,"out1, fill","0.1.4"
"31024","646",2023-07-21 03:45:00,-5650,1913,7563,907,FALSE,"out1, fill","0.1.4"
"31025","646",2023-07-21 04:00:00,-5680,1913,7593,907,FALSE,NA,"0.1.4"
"31026","646",2023-07-21 04:15:00,-5423,1913,7336,907,FALSE,NA,"0.1.4"
"31027","646",2023-07-21 04:30:00,-5520,1913,7433,907,FALSE,NA,"0.1.4"
"31028","646",2023-07-21 04:45:00,-5520,1913,7433,907,FALSE,"jump1","0.1.4"
"31029","646",2023-07-21 05:00:00,-5484,1913,7397,907,FALSE,NA,"0.1.4"
"31030","646",2023-07-21 05:15:00,-5534,1913,7447,907,FALSE,NA,"0.1.4"
"31031","646",2023-07-21 05:30:00,-5411,1913,7324,907,FALSE,NA,"0.1.4"
"31032","646",2023-07-21 05:45:00,-5019,1913,6932,907,FALSE,NA,"0.1.4"
"31033","646",2023-07-21 06:00:00,-4529,1913,6442,907,FALSE,NA,"0.1.4"
"31034","646",2023-07-21 06:15:00,-4816,1913,6729,907,FALSE,NA,"0.1.4"
"31035","646",2023-07-21 06:30:00,-4542,1913,6455,907,FALSE,NA,"0.1.4"
"31036","646",2023-07-21 06:45:00,-4536,1913,6449,907,FALSE,NA,"0.1.4"
"31037","646",2023-07-21 07:00:00,-5005,1913,6918,907,FALSE,NA,"0.1.4"
"31038","646",2023-07-21 07:15:00,-5005,1913,6918,907,FALSE,"out1, fill","0.1.4"
"31039","646",2023-07-21 07:30:00,-5005,1913,6918,907,FALSE,"jump1","0.1.4"
"31040","646",2023-07-21 07:45:00,-4558,1913,6471,907,FALSE,NA,"0.1.4"
"31041","646",2023-07-21 08:00:00,-4848,1913,6761,907,FALSE,NA,"0.1.4"
"31042","646",2023-07-21 08:15:00,-4681,1913,6594,907,FALSE,NA,"0.1.4"
"31043","646",2023-07-21 08:30:00,-4681,1913,6594,907,FALSE,"jump1","0.1.4"
"31044","646",2023-07-21 08:45:00,-4681,1913,6594,907,FALSE,"jump1","0.1.4"
"31045","646",2023-07-21 09:00:00,-5038,1913,6951,907,FALSE,NA,"0.1.4"
"31046","646",2023-07-21 09:15:00,-5038,1913,6951,907,FALSE,"jump1","0.1.4"
"31047","646",2023-07-21 09:30:00,-4875,1913,6788,907,FALSE,NA,"0.1.4"
"31048","646",2023-07-21 09:45:00,-5348,1913,7261,907,FALSE,NA,"0.1.4"
"31049","646",2023-07-21 10:00:00,-5527,1913,7440,907,FALSE,NA,"0.1.4"
"31050","646",2023-07-21 10:15:00,-5411,1913,7324,907,FALSE,NA,"0.1.4"
"31051","646",2023-07-21 10:30:00,-5061,1913,6974,907,FALSE,NA,"0.1.4"
"31052","646",2023-07-21 10:45:00,-5338,1913,7251,907,FALSE,NA,"0.1.4"
"31053","646",2023-07-21 11:00:00,-5338,1913,7251,907,FALSE,"jump1","0.1.4"
"31054","646",2023-07-21 11:15:00,-5660,1913,7573,907,FALSE,NA,"0.1.4"
"31055","646",2023-07-21 11:30:00,-6033,1913,7946,907,FALSE,NA,"0.1.4"
"31056","646",2023-07-21 11:45:00,-5560,1913,7473,907,FALSE,"out1, fill","0.1.4"
"31057","646",2023-07-21 12:00:00,-5087,1913,7000,907,FALSE,"out1, fill","0.1.4"
"31058","646",2023-07-21 12:15:00,-4614,1913,6527,907,FALSE,NA,"0.1.4"
"31059","646",2023-07-21 12:30:00,-4609,1913,6522,907,FALSE,NA,"0.1.4"
"31060","646",2023-07-21 12:45:00,-4321,1913,6234,907,FALSE,NA,"0.1.4"
"31061","646",2023-07-21 13:00:00,-4329,1913,6242,907,FALSE,NA,"0.1.4"
"31062","646",2023-07-21 13:15:00,-4344,1913,6257,907,FALSE,NA,"0.1.4"
"31063","646",2023-07-21 13:30:00,-4323,1913,6236,907,FALSE,NA,"0.1.4"
"31064","646",2023-07-21 13:45:00,-4319,1913,6232,907,FALSE,NA,"0.1.4"
"31065","646",2023-07-21 14:00:00,-4312,1913,6225,907,FALSE,NA,"0.1.4"
"31066","646",2023-07-21 14:15:00,-4312,1913,6225,907,FALSE,NA,"0.1.4"
"31067","646",2023-07-21 14:30:00,-4312,1913,6225,907,FALSE,NA,"0.1.4"
"31068","646",2023-07-21 14:45:00,-4312,1913,6225,907,FALSE,NA,"0.1.4"
"31069","646",2023-07-21 15:00:00,-4312,1913,6225,907,FALSE,NA,"0.1.4"
"31070","646",2023-07-21 15:15:00,-4312,1913,6225,907,FALSE,NA,"0.1.4"
"31071","646",2023-07-21 15:30:00,-4313,1913,6226,907,FALSE,NA,"0.1.4"
"31072","646",2023-07-21 15:45:00,-4346,1913,6259,907,FALSE,NA,"0.1.4"
"31073","646",2023-07-21 16:00:00,-4348,1913,6261,907,FALSE,NA,"0.1.4"
"31074","646",2023-07-21 16:15:00,-4350,1913,6263,907,FALSE,NA,"0.1.4"
"31075","646",2023-07-21 16:30:00,-4353,1913,6266,907,FALSE,NA,"0.1.4"
"31076","646",2023-07-21 16:45:00,-4338,1913,6251,907,FALSE,NA,"0.1.4"
"31077","646",2023-07-21 17:00:00,-4343,1913,6256,907,FALSE,NA,"0.1.4"
"31078","646",2023-07-21 17:15:00,-4359,1913,6272,907,FALSE,NA,"0.1.4"
"31079","646",2023-07-21 17:30:00,-4348,1913,6261,907,FALSE,NA,"0.1.4"
"31080","646",2023-07-21 17:45:00,-4359,1913,6272,907,FALSE,NA,"0.1.4"
"31081","646",2023-07-21 18:00:00,-4360,1913,6273,907,FALSE,NA,"0.1.4"
"31082","646",2023-07-21 18:15:00,-4359,1913,6272,907,FALSE,NA,"0.1.4"
"31083","646",2023-07-21 18:30:00,-4359,1913,6272,907,FALSE,NA,"0.1.4"
"31084","646",2023-07-21 18:45:00,-4359,1913,6272,907,FALSE,NA,"0.1.4"
"31085","646",2023-07-21 19:00:00,-4352,1913,6265,907,FALSE,NA,"0.1.4"
"31086","646",2023-07-21 19:15:00,-4355,1913,6268,907,FALSE,NA,"0.1.4"
"31087","646",2023-07-21 19:30:00,-4356,1913,6269,907,FALSE,NA,"0.1.4"
"31088","646",2023-07-21 19:45:00,-4352,1913,6265,907,FALSE,NA,"0.1.4"
"31089","646",2023-07-21 20:00:00,-4358,1913,6271,907,FALSE,NA,"0.1.4"
"31090","646",2023-07-21 20:15:00,-4363,1913,6276,907,FALSE,NA,"0.1.4"
"31091","646",2023-07-21 20:30:00,-4351,1913,6264,907,FALSE,NA,"0.1.4"
"31092","646",2023-07-21 20:45:00,-4363,1913,6276,907,FALSE,NA,"0.1.4"
"31093","646",2023-07-21 21:00:00,-4410,1913,6323,907,FALSE,NA,"0.1.4"
"31094","646",2023-07-21 21:15:00,-4358,1913,6271,907,FALSE,NA,"0.1.4"
"31095","646",2023-07-21 21:30:00,-4360,1913,6273,907,FALSE,NA,"0.1.4"
"31096","646",2023-07-21 21:45:00,-4347,1913,6260,907,FALSE,NA,"0.1.4"
"31097","646",2023-07-21 22:00:00,-4354,1913,6267,907,FALSE,NA,"0.1.4"
"31098","646",2023-07-21 22:15:00,-4315,1913,6228,907,FALSE,NA,"0.1.4"
"31099","646",2023-07-21 22:30:00,-4415,1913,6328,907,FALSE,NA,"0.1.4"
"31100","646",2023-07-21 22:45:00,-4348,1913,6261,907,FALSE,NA,"0.1.4"
"31101","646",2023-07-21 23:00:00,-4359,1913,6272,907,FALSE,NA,"0.1.4"
"31102","646",2023-07-21 23:15:00,-4360,1913,6273,907,FALSE,NA,"0.1.4"
"31103","646",2023-07-21 23:30:00,-4576,1913,6489,907,FALSE,NA,"0.1.4"
"31104","646",2023-07-21 23:45:00,-4379,1913,6292,907,FALSE,NA,"0.1.4"
"31105","646",2023-07-22,-4356,1913,6269,907,FALSE,NA,"0.1.4"
"31106","646",2023-07-22 00:15:00,-4417,1913,6330,907,FALSE,NA,"0.1.4"
"31107","646",2023-07-22 00:30:00,-4429,1913,6342,907,FALSE,NA,"0.1.4"
"31108","646",2023-07-22 00:45:00,-4377,1913,6290,907,FALSE,NA,"0.1.4"
"31109","646",2023-07-22 01:00:00,-4557,1913,6470,907,FALSE,NA,"0.1.4"
"31110","646",2023-07-22 01:15:00,-4886,1913,6799,907,FALSE,NA,"0.1.4"
"31111","646",2023-07-22 01:30:00,-5074,1913,6987,907,FALSE,NA,"0.1.4"
"31112","646",2023-07-22 01:45:00,-5360,1913,7273,907,FALSE,NA,"0.1.4"
"31113","646",2023-07-22 02:00:00,-5360,1913,7273,907,FALSE,"jump1","0.1.4"
"31114","646",2023-07-22 02:15:00,-5668,1913,7581,907,FALSE,NA,"0.1.4"
"31115","646",2023-07-22 02:30:00,-6016,1913,7929,907,FALSE,NA,"0.1.4"
"31116","646",2023-07-22 02:45:00,-5906.66666666667,1913,7819.66666666667,907,FALSE,"out1, fill","0.1.4"
"31117","646",2023-07-22 03:00:00,-5797.33333333333,1913,7710.33333333333,907,FALSE,"out1, fill","0.1.4"
"31118","646",2023-07-22 03:15:00,-5688,1913,7601,907,FALSE,"out1, fill","0.1.4"
"31119","646",2023-07-22 03:30:00,-5578.66666666667,1913,7491.66666666667,907,FALSE,"out1, fill","0.1.4"
"31120","646",2023-07-22 03:45:00,-5469.33333333333,1913,7382.33333333333,907,FALSE,"out1, fill","0.1.4"
"31121","646",2023-07-22 04:00:00,-5360,1913,7273,907,FALSE,"out1, fill","0.1.4"
"31122","646",2023-07-22 04:15:00,-5250.66666666667,1913,7163.66666666667,907,FALSE,"out1, fill","0.1.4"
"31123","646",2023-07-22 04:30:00,-5141.33333333333,1913,7054.33333333333,907,FALSE,"out1, fill","0.1.4"
"31124","646",2023-07-22 04:45:00,-5032,1913,6945,907,FALSE,NA,"0.1.4"
"31125","646",2023-07-22 05:00:00,-5414,1913,7327,907,FALSE,NA,"0.1.4"
"31126","646",2023-07-22 05:15:00,-5414,1913,7327,907,FALSE,"jump1","0.1.4"
"31127","646",2023-07-22 05:30:00,-5160.5,1913,7073.5,907,FALSE,"out1, fill","0.1.4"
"31128","646",2023-07-22 05:45:00,-4907,1913,6820,907,FALSE,NA,"0.1.4"
"31129","646",2023-07-22 06:00:00,-4968,1913,6881,907,FALSE,NA,"0.1.4"
"31130","646",2023-07-22 06:15:00,-4491,1913,6404,907,FALSE,NA,"0.1.4"
"31131","646",2023-07-22 06:30:00,-4494,1913,6407,907,FALSE,NA,"0.1.4"
"31132","646",2023-07-22 06:45:00,-4484,1913,6397,907,FALSE,NA,"0.1.4"
"31133","646",2023-07-22 07:00:00,-4613,1913,6526,907,FALSE,"out1, fill","0.1.4"
"31134","646",2023-07-22 07:15:00,-4742,1913,6655,907,FALSE,NA,"0.1.4"
"31135","646",2023-07-22 07:30:00,-4742,1913,6655,907,FALSE,"jump1","0.1.4"
"31136","646",2023-07-22 07:45:00,-4937,1913,6850,907,FALSE,NA,"0.1.4"
"31137","646",2023-07-22 08:00:00,-4631.5,1913,6544.5,907,FALSE,"out1, fill","0.1.4"
"31138","646",2023-07-22 08:15:00,-4326,1913,6239,907,FALSE,NA,"0.1.4"
"31139","646",2023-07-22 08:30:00,-3906,1913,5819,907,FALSE,NA,"0.1.4"
"31140","646",2023-07-22 08:45:00,-3850,1913,5763,907,FALSE,NA,"0.1.4"
"31141","646",2023-07-22 09:00:00,-3984,1913,5897,907,FALSE,NA,"0.1.4"
"31142","646",2023-07-22 09:15:00,-4437,1913,6350,907,FALSE,NA,"0.1.4"
"31143","646",2023-07-22 09:30:00,-4009,1913,5922,907,FALSE,NA,"0.1.4"
"31144","646",2023-07-22 09:45:00,-4225,1913,6138,907,FALSE,NA,"0.1.4"
"31145","646",2023-07-22 10:00:00,-4134,1913,6047,907,FALSE,NA,"0.1.4"
"31146","646",2023-07-22 10:15:00,-3888,1913,5801,907,FALSE,NA,"0.1.4"
"31147","646",2023-07-22 10:30:00,-3862,1913,5775,907,FALSE,NA,"0.1.4"
"31148","646",2023-07-22 10:45:00,-3859,1913,5772,907,FALSE,NA,"0.1.4"
"31149","646",2023-07-22 11:00:00,-3859,1913,5772,907,FALSE,NA,"0.1.4"
"31150","646",2023-07-22 11:15:00,-4152,1913,6065,907,FALSE,NA,"0.1.4"
"31151","646",2023-07-22 11:30:00,-4112,1913,6025,907,FALSE,NA,"0.1.4"
"31152","646",2023-07-22 11:45:00,-4076,1913,5989,907,FALSE,NA,"0.1.4"
"31153","646",2023-07-22 12:00:00,-4180,1913,6093,907,FALSE,NA,"0.1.4"
"31154","646",2023-07-22 12:15:00,-3905,1913,5818,907,FALSE,NA,"0.1.4"
"31155","646",2023-07-22 12:30:00,-4110,1913,6023,907,FALSE,NA,"0.1.4"
"31156","646",2023-07-22 12:45:00,-4385,1913,6298,907,FALSE,NA,"0.1.4"
"31157","646",2023-07-22 13:00:00,-4385,1913,6298,907,FALSE,"jump1","0.1.4"
"31158","646",2023-07-22 13:15:00,-4605,1913,6518,907,FALSE,NA,"0.1.4"
"31159","646",2023-07-22 13:30:00,-4605,1913,6518,907,FALSE,"jump1","0.1.4"
"31160","646",2023-07-22 13:45:00,-4116,1913,6029,907,FALSE,NA,"0.1.4"
"31161","646",2023-07-22 14:00:00,-4085,1913,5998,907,FALSE,NA,"0.1.4"
"31162","646",2023-07-22 14:15:00,-3711,1913,5624,907,FALSE,NA,"0.1.4"
"31163","646",2023-07-22 14:30:00,-3708,1913,5621,907,FALSE,NA,"0.1.4"
"31164","646",2023-07-22 14:45:00,-3705,1913,5618,907,FALSE,NA,"0.1.4"
"31165","646",2023-07-22 15:00:00,-3705,1913,5618,907,FALSE,NA,"0.1.4"
"31166","646",2023-07-22 15:15:00,-3705,1913,5618,907,FALSE,NA,"0.1.4"
"31167","646",2023-07-22 15:30:00,-3706,1913,5619,907,FALSE,NA,"0.1.4"
"31168","646",2023-07-22 15:45:00,-3706,1913,5619,907,FALSE,NA,"0.1.4"
"31169","646",2023-07-22 16:00:00,-3690,1913,5603,907,FALSE,NA,"0.1.4"
"31170","646",2023-07-22 16:15:00,-3662,1913,5575,907,FALSE,NA,"0.1.4"
"31171","646",2023-07-22 16:30:00,-3660,1913,5573,907,FALSE,NA,"0.1.4"
"31172","646",2023-07-22 16:45:00,-3661,1913,5574,907,FALSE,NA,"0.1.4"
"31173","646",2023-07-22 17:00:00,-3659,1913,5572,907,FALSE,NA,"0.1.4"
"31174","646",2023-07-22 17:15:00,-3674,1913,5587,907,FALSE,NA,"0.1.4"
"31175","646",2023-07-22 17:30:00,-3662,1913,5575,907,FALSE,NA,"0.1.4"
"31176","646",2023-07-22 17:45:00,-3704,1913,5617,907,FALSE,NA,"0.1.4"
"31177","646",2023-07-22 18:00:00,-3693,1913,5606,907,FALSE,NA,"0.1.4"
"31178","646",2023-07-22 18:15:00,-3702,1913,5615,907,FALSE,NA,"0.1.4"
"31179","646",2023-07-22 18:30:00,-3702,1913,5615,907,FALSE,NA,"0.1.4"
"31180","646",2023-07-22 18:45:00,-3705,1913,5618,907,FALSE,NA,"0.1.4"
"31181","646",2023-07-22 19:00:00,-3703,1913,5616,907,FALSE,NA,"0.1.4"
"31182","646",2023-07-22 19:15:00,-3699,1913,5612,907,FALSE,NA,"0.1.4"
"31183","646",2023-07-22 19:30:00,-3696,1913,5609,907,FALSE,NA,"0.1.4"
"31184","646",2023-07-22 19:45:00,-3697,1913,5610,907,FALSE,NA,"0.1.4"
"31185","646",2023-07-22 20:00:00,-3694,1913,5607,907,FALSE,NA,"0.1.4"
"31186","646",2023-07-22 20:15:00,-3690,1913,5603,907,FALSE,NA,"0.1.4"
"31187","646",2023-07-22 20:30:00,-3697,1913,5610,907,FALSE,NA,"0.1.4"
"31188","646",2023-07-22 20:45:00,-3699,1913,5612,907,FALSE,NA,"0.1.4"
"31189","646",2023-07-22 21:00:00,-3698,1913,5611,907,FALSE,NA,"0.1.4"
"31190","646",2023-07-22 21:15:00,-3701,1913,5614,907,FALSE,NA,"0.1.4"
"31191","646",2023-07-22 21:30:00,-3678,1913,5591,907,FALSE,NA,"0.1.4"
"31192","646",2023-07-22 21:45:00,-3693,1913,5606,907,FALSE,NA,"0.1.4"
"31193","646",2023-07-22 22:00:00,-3704,1913,5617,907,FALSE,NA,"0.1.4"
"31194","646",2023-07-22 22:15:00,-3702,1913,5615,907,FALSE,NA,"0.1.4"
"31195","646",2023-07-22 22:30:00,-3702,1913,5615,907,FALSE,"jump1","0.1.4"
"31196","646",2023-07-22 22:45:00,-3702,1913,5615,907,FALSE,"jump1","0.1.4"
"31197","646",2023-07-22 23:00:00,-3799,1913,5712,907,FALSE,NA,"0.1.4"
"31198","646",2023-07-22 23:15:00,-3718,1913,5631,907,FALSE,NA,"0.1.4"
"31199","646",2023-07-22 23:30:00,-3716,1913,5629,907,FALSE,NA,"0.1.4"
"31200","646",2023-07-22 23:45:00,-3723,1913,5636,907,FALSE,NA,"0.1.4"
"31201","646",2023-07-23,-3716,1913,5629,907,FALSE,NA,"0.1.4"
"31202","646",2023-07-23 00:15:00,-3738,1913,5651,907,FALSE,NA,"0.1.4"
"31203","646",2023-07-23 00:30:00,-3799,1913,5712,907,FALSE,NA,"0.1.4"
"31204","646",2023-07-23 00:45:00,-3717,1913,5630,907,FALSE,NA,"0.1.4"
"31205","646",2023-07-23 01:00:00,-3715,1913,5628,907,FALSE,NA,"0.1.4"
"31206","646",2023-07-23 01:15:00,-3707,1913,5620,907,FALSE,NA,"0.1.4"
"31207","646",2023-07-23 01:30:00,-3689,1913,5602,907,FALSE,NA,"0.1.4"
"31208","646",2023-07-23 01:45:00,-3717,1913,5630,907,FALSE,NA,"0.1.4"
"31209","646",2023-07-23 02:00:00,-3673,1913,5586,907,FALSE,NA,"0.1.4"
"31210","646",2023-07-23 02:15:00,-3708,1913,5621,907,FALSE,NA,"0.1.4"
"31211","646",2023-07-23 02:30:00,-3701,1913,5614,907,FALSE,NA,"0.1.4"
"31212","646",2023-07-23 02:45:00,-3719,1913,5632,907,FALSE,NA,"0.1.4"
"31213","646",2023-07-23 03:00:00,-3758,1913,5671,907,FALSE,NA,"0.1.4"
"31214","646",2023-07-23 03:15:00,-3680,1913,5593,907,FALSE,NA,"0.1.4"
"31215","646",2023-07-23 03:30:00,-3743,1913,5656,907,FALSE,NA,"0.1.4"
"31216","646",2023-07-23 03:45:00,-3721,1913,5634,907,FALSE,NA,"0.1.4"
"31217","646",2023-07-23 04:00:00,-3715,1913,5628,907,FALSE,NA,"0.1.4"
"31218","646",2023-07-23 04:15:00,-4168,1913,6081,907,FALSE,NA,"0.1.4"
"31219","646",2023-07-23 04:30:00,-4168,1913,6081,907,FALSE,"jump1","0.1.4"
"31220","646",2023-07-23 04:45:00,-3877,1913,5790,907,FALSE,NA,"0.1.4"
"31221","646",2023-07-23 05:00:00,-3930.45454545455,1913,5843.45454545455,907,FALSE,"out1, fill","0.1.4"
"31222","646",2023-07-23 05:15:00,-3983.90909090909,1913,5896.90909090909,907,FALSE,"out1, fill","0.1.4"
"31223","646",2023-07-23 05:30:00,-4037.36363636364,1913,5950.36363636364,907,FALSE,"out1, fill","0.1.4"
"31224","646",2023-07-23 05:45:00,-4090.81818181818,1913,6003.81818181818,907,FALSE,"out1, fill","0.1.4"
"31225","646",2023-07-23 06:00:00,-4144.27272727273,1913,6057.27272727273,907,FALSE,"out1, fill","0.1.4"
"31226","646",2023-07-23 06:15:00,-4197.72727272727,1913,6110.72727272727,907,FALSE,"out1, fill","0.1.4"
"31227","646",2023-07-23 06:30:00,-4251.18181818182,1913,6164.18181818182,907,FALSE,"out1, fill","0.1.4"
"31228","646",2023-07-23 06:45:00,-4304.63636363636,1913,6217.63636363636,907,FALSE,"out1, fill","0.1.4"
"31229","646",2023-07-23 07:00:00,-4358.09090909091,1913,6271.09090909091,907,FALSE,"out1, fill","0.1.4"
"31230","646",2023-07-23 07:15:00,-4411.54545454545,1913,6324.54545454545,907,FALSE,"out1, fill","0.1.4"
"31231","646",2023-07-23 07:30:00,-4465,1913,6378,907,FALSE,NA,"0.1.4"
"31232","646",2023-07-23 07:45:00,-4382,1913,6295,907,FALSE,NA,"0.1.4"
"31233","646",2023-07-23 08:00:00,-4448,1913,6361,907,FALSE,NA,"0.1.4"
"31234","646",2023-07-23 08:15:00,-4835,1913,6748,907,FALSE,NA,"0.1.4"
"31235","646",2023-07-23 08:30:00,-4835,1913,6748,907,FALSE,"out1, fill","0.1.4"
"31236","646",2023-07-23 08:45:00,-4835,1913,6748,907,FALSE,"jump1","0.1.4"
"31237","646",2023-07-23 09:00:00,-5016,1913,6929,907,FALSE,NA,"0.1.4"
"31238","646",2023-07-23 09:15:00,-4806,1913,6719,907,FALSE,NA,"0.1.4"
"31239","646",2023-07-23 09:30:00,-4645,1913,6558,907,FALSE,NA,"0.1.4"
"31240","646",2023-07-23 09:45:00,-4566,1913,6479,907,FALSE,NA,"0.1.4"
"31241","646",2023-07-23 10:00:00,-4566,1913,6479,907,FALSE,"out1, fill","0.1.4"
"31242","646",2023-07-23 10:15:00,-4566,1913,6479,907,FALSE,"jump1","0.1.4"
"31243","646",2023-07-23 10:30:00,-4835,1913,6748,907,FALSE,NA,"0.1.4"
"31244","646",2023-07-23 10:45:00,-4668,1913,6581,907,FALSE,NA,"0.1.4"
"31245","646",2023-07-23 11:00:00,-4836,1913,6749,907,FALSE,NA,"0.1.4"
"31246","646",2023-07-23 11:15:00,-4537,1913,6450,907,FALSE,NA,"0.1.4"
"31247","646",2023-07-23 11:30:00,-4047,1913,5960,907,FALSE,NA,"0.1.4"
"31248","646",2023-07-23 11:45:00,-4167.66666666667,1913,6080.66666666667,907,FALSE,"out1, fill","0.1.4"
"31249","646",2023-07-23 12:00:00,-4288.33333333333,1913,6201.33333333333,907,FALSE,"out1, fill","0.1.4"
"31250","646",2023-07-23 12:15:00,-4409,1913,6322,907,FALSE,"out1, fill","0.1.4"
"31251","646",2023-07-23 12:30:00,-4529.66666666667,1913,6442.66666666667,907,FALSE,"out1, fill","0.1.4"
"31252","646",2023-07-23 12:45:00,-4650.33333333333,1913,6563.33333333333,907,FALSE,"out1, fill","0.1.4"
"31253","646",2023-07-23 13:00:00,-4771,1913,6684,907,FALSE,NA,"0.1.4"
"31254","646",2023-07-23 13:15:00,-5077,1913,6990,907,FALSE,NA,"0.1.4"
"31255","646",2023-07-23 13:30:00,-5085,1913,6998,907,FALSE,NA,"0.1.4"
"31256","646",2023-07-23 13:45:00,-4922,1913,6835,907,FALSE,NA,"0.1.4"
"31257","646",2023-07-23 14:00:00,-4929,1913,6842,907,FALSE,NA,"0.1.4"
"31258","646",2023-07-23 14:15:00,-4637,1913,6550,907,FALSE,NA,"0.1.4"
"31259","646",2023-07-23 14:30:00,-4620,1913,6533,907,FALSE,NA,"0.1.4"
"31260","646",2023-07-23 14:45:00,-4634,1913,6547,907,FALSE,NA,"0.1.4"
"31261","646",2023-07-23 15:00:00,-4232,1913,6145,907,FALSE,NA,"0.1.4"
"31262","646",2023-07-23 15:15:00,-4425,1913,6338,907,FALSE,NA,"0.1.4"
"31263","646",2023-07-23 15:30:00,-4425,1913,6338,907,FALSE,"out1, fill","0.1.4"
"31264","646",2023-07-23 15:45:00,-4425,1913,6338,907,FALSE,"jump1","0.1.4"
"31265","646",2023-07-23 16:00:00,-4415,1913,6328,907,FALSE,NA,"0.1.4"
"31266","646",2023-07-23 16:15:00,-4402,1913,6315,907,FALSE,NA,"0.1.4"
"31267","646",2023-07-23 16:30:00,-4408,1913,6321,907,FALSE,NA,"0.1.4"
"31268","646",2023-07-23 16:45:00,-4402,1913,6315,907,FALSE,NA,"0.1.4"
"31269","646",2023-07-23 17:00:00,-4568,1913,6481,907,FALSE,"out1, fill","0.1.4"
"31270","646",2023-07-23 17:15:00,-4734,1913,6647,907,FALSE,NA,"0.1.4"
"31271","646",2023-07-23 17:30:00,-4435,1913,6348,907,FALSE,NA,"0.1.4"
"31272","646",2023-07-23 17:45:00,-4389,1913,6302,907,FALSE,NA,"0.1.4"
"31273","646",2023-07-23 18:00:00,-4383,1913,6296,907,FALSE,NA,"0.1.4"
"31274","646",2023-07-23 18:15:00,-4421,1913,6334,907,FALSE,NA,"0.1.4"
"31275","646",2023-07-23 18:30:00,-4419,1913,6332,907,FALSE,NA,"0.1.4"
"31276","646",2023-07-23 18:45:00,-4425,1913,6338,907,FALSE,NA,"0.1.4"
"31277","646",2023-07-23 19:00:00,-4404,1913,6317,907,FALSE,NA,"0.1.4"
"31278","646",2023-07-23 19:15:00,-4514,1913,6427,907,FALSE,NA,"0.1.4"
"31279","646",2023-07-23 19:30:00,-4420,1913,6333,907,FALSE,NA,"0.1.4"
"31280","646",2023-07-23 19:45:00,-4422,1913,6335,907,FALSE,NA,"0.1.4"
"31281","646",2023-07-23 20:00:00,-4421,1913,6334,907,FALSE,NA,"0.1.4"
"31282","646",2023-07-23 20:15:00,-4430,1913,6343,907,FALSE,NA,"0.1.4"
"31283","646",2023-07-23 20:30:00,-4430,1913,6343,907,FALSE,NA,"0.1.4"
"31284","646",2023-07-23 20:45:00,-4456,1913,6369,907,FALSE,"out1, fill","0.1.4"
"31285","646",2023-07-23 21:00:00,-4482,1913,6395,907,FALSE,NA,"0.1.4"
"31286","646",2023-07-23 21:15:00,-4505,1913,6418,907,FALSE,NA,"0.1.4"
"31287","646",2023-07-23 21:30:00,-4492,1913,6405,907,FALSE,NA,"0.1.4"
"31288","646",2023-07-23 21:45:00,-4432,1913,6345,907,FALSE,NA,"0.1.4"
"31289","646",2023-07-23 22:00:00,-4464,1913,6377,907,FALSE,NA,"0.1.4"
"31290","646",2023-07-23 22:15:00,-4429,1913,6342,907,FALSE,NA,"0.1.4"
"31291","646",2023-07-23 22:30:00,-4429,1913,6342,907,FALSE,NA,"0.1.4"
"31292","646",2023-07-23 22:45:00,-4427,1913,6340,907,FALSE,NA,"0.1.4"
"31293","646",2023-07-23 23:00:00,-4425,1913,6338,907,FALSE,NA,"0.1.4"
"31294","646",2023-07-23 23:15:00,-4428,1913,6341,907,FALSE,NA,"0.1.4"
"31295","646",2023-07-23 23:30:00,-4429,1913,6342,907,FALSE,NA,"0.1.4"
"31296","646",2023-07-23 23:45:00,-4500,1913,6413,907,FALSE,NA,"0.1.4"
"31297","646",2023-07-24,-4427,1913,6340,907,FALSE,NA,"0.1.4"
"31298","646",2023-07-24 00:15:00,-4431,1913,6344,907,FALSE,NA,"0.1.4"
"31299","646",2023-07-24 00:30:00,-4428,1913,6341,907,FALSE,NA,"0.1.4"
"31300","646",2023-07-24 00:45:00,-4431,1913,6344,907,FALSE,NA,"0.1.4"
"31301","646",2023-07-24 01:00:00,-4431,1913,6344,907,FALSE,NA,"0.1.4"
"31302","646",2023-07-24 01:15:00,-4492,1913,6405,907,FALSE,NA,"0.1.4"
"31303","646",2023-07-24 01:30:00,-4551,1913,6464,907,FALSE,NA,"0.1.4"
"31304","646",2023-07-24 01:45:00,-4427,1913,6340,907,FALSE,NA,"0.1.4"
"31305","646",2023-07-24 02:00:00,-4414,1913,6327,907,FALSE,NA,"0.1.4"
"31306","646",2023-07-24 02:15:00,-4529,1913,6442,907,FALSE,NA,"0.1.4"
"31307","646",2023-07-24 02:30:00,-4730,1913,6643,907,FALSE,NA,"0.1.4"
"31308","646",2023-07-24 02:45:00,-4468,1913,6381,907,FALSE,NA,"0.1.4"
"31309","646",2023-07-24 03:00:00,-4453,1913,6366,907,FALSE,NA,"0.1.4"
"31310","646",2023-07-24 03:15:00,-4417,1913,6330,907,FALSE,NA,"0.1.4"
"31311","646",2023-07-24 03:30:00,-4486,1913,6399,907,FALSE,NA,"0.1.4"
"31312","646",2023-07-24 03:45:00,-4442,1913,6355,907,FALSE,NA,"0.1.4"
"31313","646",2023-07-24 04:00:00,-4402,1913,6315,907,FALSE,NA,"0.1.4"
"31314","646",2023-07-24 04:15:00,-4484,1913,6397,907,FALSE,NA,"0.1.4"
"31315","646",2023-07-24 04:30:00,-4528,1913,6441,907,FALSE,NA,"0.1.4"
"31316","646",2023-07-24 04:45:00,-4528,1913,6441,907,FALSE,"jump1","0.1.4"
"31317","646",2023-07-24 05:00:00,-4041,1913,5954,907,FALSE,NA,"0.1.4"
"31318","646",2023-07-24 05:15:00,-3995,1913,5908,907,FALSE,NA,"0.1.4"
"31319","646",2023-07-24 05:30:00,-3877,1913,5790,907,FALSE,NA,"0.1.4"
"31320","646",2023-07-24 05:45:00,-3872,1913,5785,907,FALSE,NA,"0.1.4"
"31321","646",2023-07-24 06:00:00,-3888,1913,5801,907,FALSE,NA,"0.1.4"
"31322","646",2023-07-24 06:15:00,-3931,1913,5844,907,FALSE,NA,"0.1.4"
"31323","646",2023-07-24 06:30:00,-3931,1913,5844,907,FALSE,"jump1","0.1.4"
"31324","646",2023-07-24 06:45:00,-3931,1913,5844,907,FALSE,"jump1","0.1.4"
"31325","646",2023-07-24 07:00:00,-4107.28571428571,1913,6020.28571428571,907,FALSE,"out1, fill","0.1.4"
"31326","646",2023-07-24 07:15:00,-4283.57142857143,1913,6196.57142857143,907,FALSE,"out1, fill","0.1.4"
"31327","646",2023-07-24 07:30:00,-4459.85714285714,1913,6372.85714285714,907,FALSE,"out1, fill","0.1.4"
"31328","646",2023-07-24 07:45:00,-4636.14285714286,1913,6549.14285714286,907,FALSE,"out1, fill","0.1.4"
"31329","646",2023-07-24 08:00:00,-4812.42857142857,1913,6725.42857142857,907,FALSE,"out1, fill","0.1.4"
"31330","646",2023-07-24 08:15:00,-4988.71428571429,1913,6901.71428571429,907,FALSE,"out1, fill","0.1.4"
"31331","646",2023-07-24 08:30:00,-5165,1913,7078,907,FALSE,NA,"0.1.4"
"31332","646",2023-07-24 08:45:00,-5233,1913,7146,907,FALSE,NA,"0.1.4"
"31333","646",2023-07-24 09:00:00,-5233,1913,7146,907,FALSE,"jump1","0.1.4"
"31334","646",2023-07-24 09:15:00,-5233,1913,7146,907,FALSE,"jump1","0.1.4"
"31335","646",2023-07-24 09:30:00,-5508,1913,7421,907,FALSE,NA,"0.1.4"
"31336","646",2023-07-24 09:45:00,-5455,1913,7368,907,FALSE,NA,"0.1.4"
"31337","646",2023-07-24 10:00:00,-5455,1913,7368,907,FALSE,"jump1","0.1.4"
"31338","646",2023-07-24 10:15:00,-5882,1913,7795,907,FALSE,NA,"0.1.4"
"31339","646",2023-07-24 10:30:00,-6193,1913,8106,907,FALSE,NA,"0.1.4"
"31340","646",2023-07-24 10:45:00,-5794,1913,7707,907,FALSE,NA,"0.1.4"
"31341","646",2023-07-24 11:00:00,-5895.66666666667,1913,7808.66666666667,907,FALSE,"out1, fill","0.1.4"
"31342","646",2023-07-24 11:15:00,-5997.33333333333,1913,7910.33333333333,907,FALSE,"out1, fill","0.1.4"
"31343","646",2023-07-24 11:30:00,-6099,1913,8012,907,FALSE,NA,"0.1.4"
"31344","646",2023-07-24 11:45:00,-5995,1913,7908,907,FALSE,NA,"0.1.4"
"31345","646",2023-07-24 12:00:00,-6425,1913,8338,907,FALSE,NA,"0.1.4"
"31346","646",2023-07-24 12:15:00,-6272,1913,8185,907,FALSE,NA,"0.1.4"
"31347","646",2023-07-24 12:30:00,-6125.66666666667,1913,8038.66666666667,907,FALSE,"out1, fill","0.1.4"
"31348","646",2023-07-24 12:45:00,-5979.33333333333,1913,7892.33333333333,907,FALSE,"out1, fill","0.1.4"
"31349","646",2023-07-24 13:00:00,-5833,1913,7746,907,FALSE,NA,"0.1.4"
"31350","646",2023-07-24 13:15:00,-6166,1913,8079,907,FALSE,NA,"0.1.4"
"31351","646",2023-07-24 13:30:00,-5985,1913,7898,907,FALSE,NA,"0.1.4"
"31352","646",2023-07-24 13:45:00,-6137,1913,8050,907,FALSE,NA,"0.1.4"
"31353","646",2023-07-24 14:00:00,-6107,1913,8020,907,FALSE,NA,"0.1.4"
"31354","646",2023-07-24 14:15:00,-6107,1913,8020,907,FALSE,"jump1","0.1.4"
"31355","646",2023-07-24 14:30:00,-6551,1913,8464,907,FALSE,NA,"0.1.4"
"31356","646",2023-07-24 14:45:00,-6527,1913,8440,907,FALSE,NA,"0.1.4"
"31357","646",2023-07-24 15:00:00,-6527,1913,8440,907,FALSE,"jump1","0.1.4"
"31358","646",2023-07-24 15:15:00,-6085,1913,7998,907,FALSE,NA,"0.1.4"
"31359","646",2023-07-24 15:30:00,-5739,1913,7652,907,FALSE,NA,"0.1.4"
"31360","646",2023-07-24 15:45:00,-6096,1913,8009,907,FALSE,NA,"0.1.4"
"31361","646",2023-07-24 16:00:00,-6096,1913,8009,907,FALSE,"jump1","0.1.4"
"31362","646",2023-07-24 16:15:00,-5910.8,1913,7823.8,907,FALSE,"out1, fill","0.1.4"
"31363","646",2023-07-24 16:30:00,-5725.6,1913,7638.6,907,FALSE,"out1, fill","0.1.4"
"31364","646",2023-07-24 16:45:00,-5540.4,1913,7453.4,907,FALSE,"out1, fill","0.1.4"
"31365","646",2023-07-24 17:00:00,-5355.2,1913,7268.2,907,FALSE,"out1, fill","0.1.4"
"31366","646",2023-07-24 17:15:00,-5170,1913,7083,907,FALSE,NA,"0.1.4"
"31367","646",2023-07-24 17:30:00,-5171,1913,7084,907,FALSE,NA,"0.1.4"
"31368","646",2023-07-24 17:45:00,-5585,1913,7498,907,FALSE,NA,"0.1.4"
"31369","646",2023-07-24 18:00:00,-5843,1913,7756,907,FALSE,NA,"0.1.4"
"31370","646",2023-07-24 18:15:00,-5843,1913,7756,907,FALSE,"jump1","0.1.4"
"31371","646",2023-07-24 18:30:00,-5997,1913,7910,907,FALSE,"out1, fill","0.1.4"
"31372","646",2023-07-24 18:45:00,-6151,1913,8064,907,FALSE,"out1, fill","0.1.4"
"31373","646",2023-07-24 19:00:00,-6305,1913,8218,907,FALSE,"out1, fill","0.1.4"
"31374","646",2023-07-24 19:15:00,-6459,1913,8372,907,FALSE,NA,"0.1.4"
"31375","646",2023-07-24 19:30:00,-6491,1913,8404,907,FALSE,NA,"0.1.4"
"31376","646",2023-07-24 19:45:00,-6491,1913,8404,907,FALSE,"jump1","0.1.4"
"31377","646",2023-07-24 20:00:00,-6549,1913,8462,907,FALSE,NA,"0.1.4"
"31378","646",2023-07-24 20:15:00,-6640,1913,8553,907,FALSE,NA,"0.1.4"
"31379","646",2023-07-24 20:30:00,-6426,1913,8339,907,FALSE,NA,"0.1.4"
"31380","646",2023-07-24 20:45:00,-6426,1913,8339,907,FALSE,NA,"0.1.4"
"31381","646",2023-07-24 21:00:00,-6423,1913,8336,907,FALSE,NA,"0.1.4"
"31382","646",2023-07-24 21:15:00,-6422,1913,8335,907,FALSE,NA,"0.1.4"
"31383","646",2023-07-24 21:30:00,-6422,1913,8335,907,FALSE,NA,"0.1.4"
"31384","646",2023-07-24 21:45:00,-6422,1913,8335,907,FALSE,NA,"0.1.4"
"31385","646",2023-07-24 22:00:00,-6449.33333333333,1913,8362.33333333333,907,FALSE,"out1, fill","0.1.4"
"31386","646",2023-07-24 22:15:00,-6476.66666666667,1913,8389.66666666667,907,FALSE,"out1, fill","0.1.4"
"31387","646",2023-07-24 22:30:00,-6504,1913,8417,907,FALSE,NA,"0.1.4"
"31388","646",2023-07-24 22:45:00,-6434,1913,8347,907,FALSE,NA,"0.1.4"
"31389","646",2023-07-24 23:00:00,-6667,1913,8580,907,FALSE,NA,"0.1.4"
"31390","646",2023-07-24 23:15:00,-6617.8,1913,8530.8,907,FALSE,"out1, fill","0.1.4"
"31391","646",2023-07-24 23:30:00,-6568.6,1913,8481.6,907,FALSE,"out1, fill","0.1.4"
"31392","646",2023-07-24 23:45:00,-6519.4,1913,8432.4,907,FALSE,"out1, fill","0.1.4"
"31393","646",2023-07-25,-6470.2,1913,8383.2,907,FALSE,"out1, fill","0.1.4"
"31394","646",2023-07-25 00:15:00,-6421,1913,8334,907,FALSE,NA,"0.1.4"
"31395","646",2023-07-25 00:30:00,-6421,1913,8334,907,FALSE,NA,"0.1.4"
"31396","646",2023-07-25 00:45:00,-6421,1913,8334,907,FALSE,NA,"0.1.4"
"31397","646",2023-07-25 01:00:00,-6421,1913,8334,907,FALSE,NA,"0.1.4"
"31398","646",2023-07-25 01:15:00,-6421,1913,8334,907,FALSE,NA,"0.1.4"
"31399","646",2023-07-25 01:30:00,-6421,1913,8334,907,FALSE,NA,"0.1.4"
"31400","646",2023-07-25 01:45:00,-6422,1913,8335,907,FALSE,NA,"0.1.4"
"31401","646",2023-07-25 02:00:00,-6429,1913,8342,907,FALSE,NA,"0.1.4"
"31402","646",2023-07-25 02:15:00,-6428,1913,8341,907,FALSE,NA,"0.1.4"
"31403","646",2023-07-25 02:30:00,-6426.8,1913,8339.8,907,FALSE,"out1, fill","0.1.4"
"31404","646",2023-07-25 02:45:00,-6425.6,1913,8338.6,907,FALSE,"out1, fill","0.1.4"
"31405","646",2023-07-25 03:00:00,-6424.4,1913,8337.4,907,FALSE,"out1, fill","0.1.4"
"31406","646",2023-07-25 03:15:00,-6423.2,1913,8336.2,907,FALSE,"out1, fill","0.1.4"
"31407","646",2023-07-25 03:30:00,-6422,1913,8335,907,FALSE,NA,"0.1.4"
"31408","646",2023-07-25 03:45:00,-6421,1913,8334,907,FALSE,NA,"0.1.4"
"31409","646",2023-07-25 04:00:00,-6421,1913,8334,907,FALSE,NA,"0.1.4"
"31410","646",2023-07-25 04:15:00,-6610.33333333333,1913,8523.33333333333,907,FALSE,"out1, fill","0.1.4"
"31411","646",2023-07-25 04:30:00,-6799.66666666667,1913,8712.66666666667,907,FALSE,"out1, fill","0.1.4"
"31412","646",2023-07-25 04:45:00,-6989,1913,8902,907,FALSE,"out1, fill","0.1.4"
"31413","646",2023-07-25 05:00:00,-7178.33333333333,1913,9091.33333333333,907,FALSE,"out1, fill","0.1.4"
"31414","646",2023-07-25 05:15:00,-7367.66666666667,1913,9280.66666666667,907,FALSE,"out1, fill","0.1.4"
"31415","646",2023-07-25 05:30:00,-7557,1913,9470,907,FALSE,NA,"0.1.4"
"31416","646",2023-07-25 05:45:00,-7557,1913,9470,907,FALSE,"jump1","0.1.4"
"31417","646",2023-07-25 06:00:00,-7064,1913,8977,907,FALSE,NA,"0.1.4"
"31418","646",2023-07-25 06:15:00,-7068,1913,8981,907,FALSE,NA,"0.1.4"
"31419","646",2023-07-25 06:30:00,-7068,1913,8981,907,FALSE,"jump1","0.1.4"
"31420","646",2023-07-25 06:45:00,-7144,1913,9057,907,FALSE,NA,"0.1.4"
"31421","646",2023-07-25 07:00:00,-7144,1913,9057,907,FALSE,"jump1","0.1.4"
"31422","646",2023-07-25 07:15:00,-7144,1913,9057,907,FALSE,NA,"0.1.4"
"31423","646",2023-07-25 07:30:00,-7146,1913,9059,907,FALSE,NA,"0.1.4"
"31424","646",2023-07-25 07:45:00,-7477.25,1913,9390.25,907,FALSE,"out1, fill","0.1.4"
"31425","646",2023-07-25 08:00:00,-7808.5,1913,9721.5,907,FALSE,"out1, fill","0.1.4"
"31426","646",2023-07-25 08:15:00,-8139.75,1913,10052.75,907,FALSE,"out1, fill","0.1.4"
"31427","646",2023-07-25 08:30:00,-8471,1913,10384,907,FALSE,NA,"0.1.4"
"31428","646",2023-07-25 08:45:00,-8372,1913,10285,907,FALSE,NA,"0.1.4"
"31429","646",2023-07-25 09:00:00,-8381,1913,10294,907,FALSE,NA,"0.1.4"
"31430","646",2023-07-25 09:15:00,-8072,1913,9985,907,FALSE,NA,"0.1.4"
"31431","646",2023-07-25 09:30:00,-8256,1913,10169,907,FALSE,NA,"0.1.4"
"31432","646",2023-07-25 09:45:00,-8256,1913,10169,907,FALSE,"jump1","0.1.4"
"31433","646",2023-07-25 10:00:00,-8111,1913,10024,907,FALSE,NA,"0.1.4"
"31434","646",2023-07-25 10:15:00,-8310,1913,10223,907,FALSE,NA,"0.1.4"
"31435","646",2023-07-25 10:30:00,-8068,1913,9981,907,FALSE,NA,"0.1.4"
"31436","646",2023-07-25 10:45:00,-8237,1913,10150,907,FALSE,NA,"0.1.4"
"31437","646",2023-07-25 11:00:00,-7998,1913,9911,907,FALSE,NA,"0.1.4"
"31438","646",2023-07-25 11:15:00,-7975,1913,9888,907,FALSE,NA,"0.1.4"
"31439","646",2023-07-25 11:30:00,-7848,1913,9761,907,FALSE,NA,"0.1.4"
"31440","646",2023-07-25 11:45:00,-7841,1913,9754,907,FALSE,NA,"0.1.4"
"31441","646",2023-07-25 12:00:00,-7844,1913,9757,907,FALSE,NA,"0.1.4"
"31442","646",2023-07-25 12:15:00,-7758,1913,9671,907,FALSE,NA,"0.1.4"
"31443","646",2023-07-25 12:30:00,-7798,1913,9711,907,FALSE,NA,"0.1.4"
"31444","646",2023-07-25 12:45:00,-7906.66666666667,1913,9819.66666666667,907,FALSE,"out1, fill","0.1.4"
"31445","646",2023-07-25 13:00:00,-8015.33333333333,1913,9928.33333333333,907,FALSE,"out1, fill","0.1.4"
"31446","646",2023-07-25 13:15:00,-8124,1913,10037,907,FALSE,NA,"0.1.4"
"31447","646",2023-07-25 13:30:00,-8111,1913,10024,907,FALSE,NA,"0.1.4"
"31448","646",2023-07-25 13:45:00,-8161,1913,10074,907,FALSE,NA,"0.1.4"
"31449","646",2023-07-25 14:00:00,-7808,1913,9721,907,FALSE,NA,"0.1.4"
"31450","646",2023-07-25 14:15:00,-7798,1913,9711,907,FALSE,NA,"0.1.4"
"31451","646",2023-07-25 14:30:00,-8211,1913,10124,907,FALSE,NA,"0.1.4"
"31452","646",2023-07-25 14:45:00,-8089,1913,10002,907,FALSE,NA,"0.1.4"
"31453","646",2023-07-25 15:00:00,-8263,1913,10176,907,FALSE,NA,"0.1.4"
"31454","646",2023-07-25 15:15:00,-8269,1913,10182,907,FALSE,NA,"0.1.4"
"31455","646",2023-07-25 15:30:00,-8172,1913,10085,907,FALSE,NA,"0.1.4"
"31456","646",2023-07-25 15:45:00,-7986,1913,9899,907,FALSE,NA,"0.1.4"
"31457","646",2023-07-25 16:00:00,-7644,1913,9557,907,FALSE,NA,"0.1.4"
"31458","646",2023-07-25 16:15:00,-7590.4,1913,9503.4,907,FALSE,"out1, fill","0.1.4"
"31459","646",2023-07-25 16:30:00,-7536.8,1913,9449.8,907,FALSE,"out1, fill","0.1.4"
"31460","646",2023-07-25 16:45:00,-7483.2,1913,9396.2,907,FALSE,"out1, fill","0.1.4"
"31461","646",2023-07-25 17:00:00,-7429.6,1913,9342.6,907,FALSE,"out1, fill","0.1.4"
"31462","646",2023-07-25 17:15:00,-7376,1913,9289,907,FALSE,NA,"0.1.4"
"31463","646",2023-07-25 17:30:00,-6900,1913,8813,907,FALSE,NA,"0.1.4"
"31464","646",2023-07-25 17:45:00,-6639,1913,8552,907,FALSE,NA,"0.1.4"
"31465","646",2023-07-25 18:00:00,-6646,1913,8559,907,FALSE,NA,"0.1.4"
"31466","646",2023-07-25 18:15:00,-6645.14285714286,1913,8558.14285714286,907,FALSE,"out1, fill","0.1.4"
"31467","646",2023-07-25 18:30:00,-6644.28571428571,1913,8557.28571428571,907,FALSE,"out1, fill","0.1.4"
"31468","646",2023-07-25 18:45:00,-6643.42857142857,1913,8556.42857142857,907,FALSE,"out1, fill","0.1.4"
"31469","646",2023-07-25 19:00:00,-6642.57142857143,1913,8555.57142857143,907,FALSE,"out1, fill","0.1.4"
"31470","646",2023-07-25 19:15:00,-6641.71428571429,1913,8554.71428571429,907,FALSE,"out1, fill","0.1.4"
"31471","646",2023-07-25 19:30:00,-6640.85714285714,1913,8553.85714285714,907,FALSE,"out1, fill","0.1.4"
"31472","646",2023-07-25 19:45:00,-6640,1913,8553,907,FALSE,NA,"0.1.4"
"31473","646",2023-07-25 20:00:00,-6658,1913,8571,907,FALSE,NA,"0.1.4"
"31474","646",2023-07-25 20:15:00,-7010,1913,8923,907,FALSE,NA,"0.1.4"
"31475","646",2023-07-25 20:30:00,-7440,1913,9353,907,FALSE,NA,"0.1.4"
"31476","646",2023-07-25 20:45:00,-7253,1913,9166,907,FALSE,NA,"0.1.4"
"31477","646",2023-07-25 21:00:00,-7253,1913,9166,907,FALSE,"jump1","0.1.4"
"31478","646",2023-07-25 21:15:00,-7254,1913,9167,907,FALSE,NA,"0.1.4"
"31479","646",2023-07-25 21:30:00,-7253,1913,9166,907,FALSE,NA,"0.1.4"
"31480","646",2023-07-25 21:45:00,-7370,1913,9283,907,FALSE,"out1, fill","0.1.4"
"31481","646",2023-07-25 22:00:00,-7487,1913,9400,907,FALSE,"out1, fill","0.1.4"
"31482","646",2023-07-25 22:15:00,-7604,1913,9517,907,FALSE,NA,"0.1.4"
"31483","646",2023-07-25 22:30:00,-7253,1913,9166,907,FALSE,NA,"0.1.4"
"31484","646",2023-07-25 22:45:00,-7253,1913,9166,907,FALSE,NA,"0.1.4"
"31485","646",2023-07-25 23:00:00,-7255,1913,9168,907,FALSE,NA,"0.1.4"
"31486","646",2023-07-25 23:15:00,-7265,1913,9178,907,FALSE,NA,"0.1.4"
"31487","646",2023-07-25 23:30:00,-7372,1913,9285,907,FALSE,NA,"0.1.4"
"31488","646",2023-07-25 23:45:00,-7308,1913,9221,907,FALSE,NA,"0.1.4"
"31489","646",2023-07-26,-7259,1913,9172,907,FALSE,NA,"0.1.4"
"31490","646",2023-07-26 00:15:00,-7292,1913,9205,907,FALSE,NA,"0.1.4"
"31491","646",2023-07-26 00:30:00,-7286,1913,9199,907,FALSE,NA,"0.1.4"
"31492","646",2023-07-26 00:45:00,-7633,1913,9546,907,FALSE,NA,"0.1.4"
"31493","646",2023-07-26 01:00:00,-7288,1913,9201,907,FALSE,NA,"0.1.4"
"31494","646",2023-07-26 01:15:00,-7251,1913,9164,907,FALSE,NA,"0.1.4"
"31495","646",2023-07-26 01:30:00,-7585,1913,9498,907,FALSE,NA,"0.1.4"
"31496","646",2023-07-26 01:45:00,-7679,1913,9592,907,FALSE,NA,"0.1.4"
"31497","646",2023-07-26 02:00:00,-7679,1913,9592,907,FALSE,"jump1","0.1.4"
"31498","646",2023-07-26 02:15:00,-7661.33333333333,1913,9574.33333333333,907,FALSE,"out1, fill","0.1.4"
"31499","646",2023-07-26 02:30:00,-7643.66666666667,1913,9556.66666666667,907,FALSE,"out1, fill","0.1.4"
"31500","646",2023-07-26 02:45:00,-7626,1913,9539,907,FALSE,NA,"0.1.4"
"31501","646",2023-07-26 03:00:00,-7133,1913,9046,907,FALSE,NA,"0.1.4"
"31502","646",2023-07-26 03:15:00,-6708,1913,8621,907,FALSE,NA,"0.1.4"
"31503","646",2023-07-26 03:30:00,-7000.4,1913,8913.4,907,FALSE,"out1, fill","0.1.4"
"31504","646",2023-07-26 03:45:00,-7292.8,1913,9205.8,907,FALSE,"out1, fill","0.1.4"
"31505","646",2023-07-26 04:00:00,-7585.2,1913,9498.2,907,FALSE,"out1, fill","0.1.4"
"31506","646",2023-07-26 04:15:00,-7877.6,1913,9790.6,907,FALSE,"out1, fill","0.1.4"
"31507","646",2023-07-26 04:30:00,-8170,1913,10083,907,FALSE,NA,"0.1.4"
"31508","646",2023-07-26 04:45:00,-8189,1913,10102,907,FALSE,NA,"0.1.4"
"31509","646",2023-07-26 05:00:00,-7756,1913,9669,907,FALSE,NA,"0.1.4"
"31510","646",2023-07-26 05:15:00,-8066,1913,9979,907,FALSE,NA,"0.1.4"
"31511","646",2023-07-26 05:30:00,-7927,1913,9840,907,FALSE,NA,"0.1.4"
"31512","646",2023-07-26 05:45:00,-7696,1913,9609,907,FALSE,NA,"0.1.4"
"31513","646",2023-07-26 06:00:00,-7301,1913,9214,907,FALSE,NA,"0.1.4"
"31514","646",2023-07-26 06:15:00,-7797.5,1913,9710.5,907,FALSE,"out1, fill","0.1.4"
"31515","646",2023-07-26 06:30:00,-8294,1913,10207,907,FALSE,NA,"0.1.4"
"31516","646",2023-07-26 06:45:00,-7841,1913,9754,907,FALSE,NA,"0.1.4"
"31517","646",2023-07-26 07:00:00,-7697,1913,9610,907,FALSE,NA,"0.1.4"
"31518","646",2023-07-26 07:15:00,-7697,1913,9610,907,FALSE,"jump1","0.1.4"
"31519","646",2023-07-26 07:30:00,-7854,1913,9767,907,FALSE,NA,"0.1.4"
"31520","646",2023-07-26 07:45:00,-7842.33333333333,1913,9755.33333333333,907,FALSE,"out1, fill","0.1.4"
"31521","646",2023-07-26 08:00:00,-7830.66666666667,1913,9743.66666666667,907,FALSE,"out1, fill","0.1.4"
"31522","646",2023-07-26 08:15:00,-7819,1913,9732,907,FALSE,NA,"0.1.4"
"31523","646",2023-07-26 08:30:00,-7741,1913,9654,907,FALSE,NA,"0.1.4"
"31524","646",2023-07-26 08:45:00,-7729,1913,9642,907,FALSE,NA,"0.1.4"
"31525","646",2023-07-26 09:00:00,-7838,1913,9751,907,FALSE,NA,"0.1.4"
"31526","646",2023-07-26 09:15:00,-7935,1913,9848,907,FALSE,NA,"0.1.4"
"31527","646",2023-07-26 09:30:00,-7898,1913,9811,907,FALSE,NA,"0.1.4"
"31528","646",2023-07-26 09:45:00,-7636,1913,9549,907,FALSE,NA,"0.1.4"
"31529","646",2023-07-26 10:00:00,-7538,1913,9451,907,FALSE,NA,"0.1.4"
"31530","646",2023-07-26 10:15:00,-8009,1913,9922,907,FALSE,NA,"0.1.4"
"31531","646",2023-07-26 10:30:00,-8060,1913,9973,907,FALSE,NA,"0.1.4"
"31532","646",2023-07-26 10:45:00,-7615,1913,9528,907,FALSE,NA,"0.1.4"
"31533","646",2023-07-26 11:00:00,-7408,1913,9321,907,FALSE,NA,"0.1.4"
"31534","646",2023-07-26 11:15:00,-7442,1913,9355,907,FALSE,NA,"0.1.4"
"31535","646",2023-07-26 11:30:00,-7368,1913,9281,907,FALSE,NA,"0.1.4"
"31536","646",2023-07-26 11:45:00,-7368,1913,9281,907,FALSE,"jump1","0.1.4"
"31537","646",2023-07-26 12:00:00,-7099,1913,9012,907,FALSE,NA,"0.1.4"
"31538","646",2023-07-26 12:15:00,-7491,1913,9404,907,FALSE,NA,"0.1.4"
"31539","646",2023-07-26 12:30:00,-7631,1913,9544,907,FALSE,NA,"0.1.4"
"31540","646",2023-07-26 12:45:00,-7631,1913,9544,907,FALSE,"jump1","0.1.4"
"31541","646",2023-07-26 13:00:00,-7631,1913,9544,907,FALSE,"jump1","0.1.4"
"31542","646",2023-07-26 13:15:00,-7631,1913,9544,907,FALSE,"jump1","0.1.4"
"31543","646",2023-07-26 13:30:00,-8054,1913,9967,907,FALSE,NA,"0.1.4"
"31544","646",2023-07-26 13:45:00,-7778,1913,9691,907,FALSE,NA,"0.1.4"
"31545","646",2023-07-26 14:00:00,-7611,1913,9524,907,FALSE,NA,"0.1.4"
"31546","646",2023-07-26 14:15:00,-7451,1913,9364,907,FALSE,NA,"0.1.4"
"31547","646",2023-07-26 14:30:00,-7763,1913,9676,907,FALSE,NA,"0.1.4"
"31548","646",2023-07-26 14:45:00,-7629,1913,9542,907,FALSE,NA,"0.1.4"
"31549","646",2023-07-26 15:00:00,-7376,1913,9289,907,FALSE,NA,"0.1.4"
"31550","646",2023-07-26 15:15:00,-7287.6,1913,9200.6,907,FALSE,"out1, fill","0.1.4"
"31551","646",2023-07-26 15:30:00,-7199.2,1913,9112.2,907,FALSE,"out1, fill","0.1.4"
"31552","646",2023-07-26 15:45:00,-7110.8,1913,9023.8,907,FALSE,"out1, fill","0.1.4"
"31553","646",2023-07-26 16:00:00,-7022.4,1913,8935.4,907,FALSE,"out1, fill","0.1.4"
"31554","646",2023-07-26 16:15:00,-6934,1913,8847,907,FALSE,NA,"0.1.4"
"31555","646",2023-07-26 16:30:00,-6934,1913,8847,907,FALSE,"jump1","0.1.4"
"31556","646",2023-07-26 16:45:00,-6929,1913,8842,907,FALSE,NA,"0.1.4"
"31557","646",2023-07-26 17:00:00,-6939,1913,8852,907,FALSE,NA,"0.1.4"
"31558","646",2023-07-26 17:15:00,-6922,1913,8835,907,FALSE,NA,"0.1.4"
"31559","646",2023-07-26 17:30:00,-6881,1913,8794,907,FALSE,NA,"0.1.4"
"31560","646",2023-07-26 17:45:00,-6886,1913,8799,907,FALSE,NA,"0.1.4"
"31561","646",2023-07-26 18:00:00,-6885,1913,8798,907,FALSE,NA,"0.1.4"
"31562","646",2023-07-26 18:15:00,-6877,1913,8790,907,FALSE,NA,"0.1.4"
"31563","646",2023-07-26 18:30:00,-6931,1913,8844,907,FALSE,NA,"0.1.4"
"31564","646",2023-07-26 18:45:00,-6931,1913,8844,907,FALSE,"jump1","0.1.4"
"31565","646",2023-07-26 19:00:00,-6931,1913,8844,907,FALSE,"jump1","0.1.4"
"31566","646",2023-07-26 19:15:00,-6853,1913,8766,907,FALSE,NA,"0.1.4"
"31567","646",2023-07-26 19:30:00,-6853,1913,8766,907,FALSE,"jump1","0.1.4"
"31568","646",2023-07-26 19:45:00,-6853,1913,8766,907,FALSE,"jump1","0.1.4"
"31569","646",2023-07-26 20:00:00,-7232,1913,9145,907,FALSE,NA,"0.1.4"
"31570","646",2023-07-26 20:15:00,-6808,1913,8721,907,FALSE,NA,"0.1.4"
"31571","646",2023-07-26 20:30:00,-6858,1913,8771,907,FALSE,NA,"0.1.4"
"31572","646",2023-07-26 20:45:00,-6842,1913,8755,907,FALSE,NA,"0.1.4"
"31573","646",2023-07-26 21:00:00,-6816,1913,8729,907,FALSE,NA,"0.1.4"
"31574","646",2023-07-26 21:15:00,-6813,1913,8726,907,FALSE,NA,"0.1.4"
"31575","646",2023-07-26 21:30:00,-7096,1913,9009,907,FALSE,NA,"0.1.4"
"31576","646",2023-07-26 21:45:00,-7116,1913,9029,907,FALSE,NA,"0.1.4"
"31577","646",2023-07-26 22:00:00,-7584,1913,9497,907,FALSE,NA,"0.1.4"
"31578","646",2023-07-26 22:15:00,-7683,1913,9596,907,FALSE,NA,"0.1.4"
"31579","646",2023-07-26 22:30:00,-7924,1913,9837,907,FALSE,NA,"0.1.4"
"31580","646",2023-07-26 22:45:00,-7793.4,1913,9706.4,907,FALSE,"out1, fill","0.1.4"
"31581","646",2023-07-26 23:00:00,-7662.8,1913,9575.8,907,FALSE,"out1, fill","0.1.4"
"31582","646",2023-07-26 23:15:00,-7532.2,1913,9445.2,907,FALSE,"out1, fill","0.1.4"
"31583","646",2023-07-26 23:30:00,-7401.6,1913,9314.6,907,FALSE,"out1, fill","0.1.4"
"31584","646",2023-07-26 23:45:00,-7271,1913,9184,907,FALSE,NA,"0.1.4"
"31585","646",2023-07-27,-6993,1913,8906,907,FALSE,NA,"0.1.4"
"31586","646",2023-07-27 00:15:00,-6788,1913,8701,907,FALSE,NA,"0.1.4"
"31587","646",2023-07-27 00:30:00,-6809,1913,8722,907,FALSE,NA,"0.1.4"
"31588","646",2023-07-27 00:45:00,-6809,1913,8722,907,FALSE,NA,"0.1.4"
"31589","646",2023-07-27 01:00:00,-7157,1913,9070,907,FALSE,NA,"0.1.4"
"31590","646",2023-07-27 01:15:00,-7589,1913,9502,907,FALSE,NA,"0.1.4"
"31591","646",2023-07-27 01:30:00,-7597.46153846154,1913,9510.46153846154,907,FALSE,"out1, fill","0.1.4"
"31592","646",2023-07-27 01:45:00,-7605.92307692308,1913,9518.92307692308,907,FALSE,"out1, fill","0.1.4"
"31593","646",2023-07-27 02:00:00,-7614.38461538462,1913,9527.38461538462,907,FALSE,"out1, fill","0.1.4"
"31594","646",2023-07-27 02:15:00,-7622.84615384615,1913,9535.84615384615,907,FALSE,"out1, fill","0.1.4"
"31595","646",2023-07-27 02:30:00,-7631.30769230769,1913,9544.30769230769,907,FALSE,"out1, fill","0.1.4"
"31596","646",2023-07-27 02:45:00,-7639.76923076923,1913,9552.76923076923,907,FALSE,"out1, fill","0.1.4"
"31597","646",2023-07-27 03:00:00,-7648.23076923077,1913,9561.23076923077,907,FALSE,"out1, fill","0.1.4"
"31598","646",2023-07-27 03:15:00,-7656.69230769231,1913,9569.69230769231,907,FALSE,"out1, fill","0.1.4"
"31599","646",2023-07-27 03:30:00,-7665.15384615385,1913,9578.15384615385,907,FALSE,"out1, fill","0.1.4"
"31600","646",2023-07-27 03:45:00,-7673.61538461538,1913,9586.61538461538,907,FALSE,"out1, fill","0.1.4"
"31601","646",2023-07-27 04:00:00,-7682.07692307692,1913,9595.07692307692,907,FALSE,"out1, fill","0.1.4"
"31602","646",2023-07-27 04:15:00,-7690.53846153846,1913,9603.53846153846,907,FALSE,"out1, fill","0.1.4"
"31603","646",2023-07-27 04:30:00,-7699,1913,9612,907,FALSE,NA,"0.1.4"
"31604","646",2023-07-27 04:45:00,-7975,1913,9888,907,FALSE,NA,"0.1.4"
"31605","646",2023-07-27 05:00:00,-7975,1913,9888,907,FALSE,"jump1","0.1.4"
"31606","646",2023-07-27 05:15:00,-8005.5,1913,9918.5,907,FALSE,"out1, fill","0.1.4"
"31607","646",2023-07-27 05:30:00,-8036,1913,9949,907,FALSE,"out1, fill","0.1.4"
"31608","646",2023-07-27 05:45:00,-8066.5,1913,9979.5,907,FALSE,"out1, fill","0.1.4"
"31609","646",2023-07-27 06:00:00,-8097,1913,10010,907,FALSE,NA,"0.1.4"
"31610","646",2023-07-27 06:15:00,-8169,1913,10082,907,FALSE,NA,"0.1.4"
"31611","646",2023-07-27 06:30:00,-8010,1913,9923,907,FALSE,NA,"0.1.4"
"31612","646",2023-07-27 06:45:00,-7862,1913,9775,907,FALSE,NA,"0.1.4"
"31613","646",2023-07-27 07:00:00,-7603,1913,9516,907,FALSE,NA,"0.1.4"
"31614","646",2023-07-27 07:15:00,-7603,1913,9516,907,FALSE,"jump1","0.1.4"
"31615","646",2023-07-27 07:30:00,-7543,1913,9456,907,FALSE,NA,"0.1.4"
"31616","646",2023-07-27 07:45:00,-7530.33333333333,1913,9443.33333333333,907,FALSE,"out1, fill","0.1.4"
"31617","646",2023-07-27 08:00:00,-7517.66666666667,1913,9430.66666666667,907,FALSE,"out1, fill","0.1.4"
"31618","646",2023-07-27 08:15:00,-7505,1913,9418,907,FALSE,NA,"0.1.4"
"31619","646",2023-07-27 08:30:00,-7505,1913,9418,907,FALSE,"jump1","0.1.4"
"31620","646",2023-07-27 08:45:00,-7836,1913,9749,907,FALSE,NA,"0.1.4"
"31621","646",2023-07-27 09:00:00,-7521,1913,9434,907,FALSE,NA,"0.1.4"
"31622","646",2023-07-27 09:15:00,-7458.76923076923,1913,9371.76923076923,907,FALSE,"out1, fill","0.1.4"
"31623","646",2023-07-27 09:30:00,-7396.53846153846,1913,9309.53846153846,907,FALSE,"out1, fill","0.1.4"
"31624","646",2023-07-27 09:45:00,-7334.30769230769,1913,9247.30769230769,907,FALSE,"out1, fill","0.1.4"
"31625","646",2023-07-27 10:00:00,-7272.07692307692,1913,9185.07692307692,907,FALSE,"out1, fill","0.1.4"
"31626","646",2023-07-27 10:15:00,-7209.84615384615,1913,9122.84615384615,907,FALSE,"out1, fill","0.1.4"
"31627","646",2023-07-27 10:30:00,-7147.61538461538,1913,9060.61538461538,907,FALSE,"out1, fill","0.1.4"
"31628","646",2023-07-27 10:45:00,-7085.38461538462,1913,8998.38461538462,907,FALSE,"out1, fill","0.1.4"
"31629","646",2023-07-27 11:00:00,-7023.15384615385,1913,8936.15384615385,907,FALSE,"out1, fill","0.1.4"
"31630","646",2023-07-27 11:15:00,-6960.92307692308,1913,8873.92307692308,907,FALSE,"out1, fill","0.1.4"
"31631","646",2023-07-27 11:30:00,-6898.69230769231,1913,8811.69230769231,907,FALSE,"out1, fill","0.1.4"
"31632","646",2023-07-27 11:45:00,-6836.46153846154,1913,8749.46153846154,907,FALSE,"out1, fill","0.1.4"
"31633","646",2023-07-27 12:00:00,-6774.23076923077,1913,8687.23076923077,907,FALSE,"out1, fill","0.1.4"
"31634","646",2023-07-27 12:15:00,-6712,1913,8625,907,FALSE,NA,"0.1.4"
"31635","646",2023-07-27 12:30:00,-6326,1913,8239,907,FALSE,NA,"0.1.4"
"31636","646",2023-07-27 12:45:00,-6170,1913,8083,907,FALSE,NA,"0.1.4"
"31637","646",2023-07-27 13:00:00,-6144,1913,8057,907,FALSE,NA,"0.1.4"
"31638","646",2023-07-27 13:15:00,-6144,1913,8057,907,FALSE,"jump1","0.1.4"
"31639","646",2023-07-27 13:30:00,-5970,1913,7883,907,FALSE,"out1, fill","0.1.4"
"31640","646",2023-07-27 13:45:00,-5796,1913,7709,907,FALSE,"out1, fill","0.1.4"
"31641","646",2023-07-27 14:00:00,-5622,1913,7535,907,FALSE,NA,"0.1.4"
"31642","646",2023-07-27 14:15:00,-5620,1913,7533,907,FALSE,NA,"0.1.4"
"31643","646",2023-07-27 14:30:00,-5617,1913,7530,907,FALSE,NA,"0.1.4"
"31644","646",2023-07-27 14:45:00,-5648,1913,7561,907,FALSE,NA,"0.1.4"
"31645","646",2023-07-27 15:00:00,-5648,1913,7561,907,FALSE,"jump1","0.1.4"
"31646","646",2023-07-27 15:15:00,-5961,1913,7874,907,FALSE,NA,"0.1.4"
"31647","646",2023-07-27 15:30:00,-6189,1913,8102,907,FALSE,NA,"0.1.4"
"31648","646",2023-07-27 15:45:00,-6466,1913,8379,907,FALSE,NA,"0.1.4"
"31649","646",2023-07-27 16:00:00,-6660,1913,8573,907,FALSE,NA,"0.1.4"
"31650","646",2023-07-27 16:15:00,-6660,1913,8573,907,FALSE,"jump1","0.1.4"
"31651","646",2023-07-27 16:30:00,-6988,1913,8901,907,FALSE,NA,"0.1.4"
"31652","646",2023-07-27 16:45:00,-7004,1913,8917,907,FALSE,NA,"0.1.4"
"31653","646",2023-07-27 17:00:00,-6952.5,1913,8865.5,907,FALSE,"out1, fill","0.1.4"
"31654","646",2023-07-27 17:15:00,-6901,1913,8814,907,FALSE,NA,"0.1.4"
"31655","646",2023-07-27 17:30:00,-6798,1913,8711,907,FALSE,NA,"0.1.4"
"31656","646",2023-07-27 17:45:00,-6798,1913,8711,907,FALSE,"jump1","0.1.4"
"31657","646",2023-07-27 18:00:00,-6798,1913,8711,907,FALSE,"jump1","0.1.4"
"31658","646",2023-07-27 18:15:00,-6705.25,1913,8618.25,907,FALSE,"out1, fill","0.1.4"
"31659","646",2023-07-27 18:30:00,-6612.5,1913,8525.5,907,FALSE,"out1, fill","0.1.4"
"31660","646",2023-07-27 18:45:00,-6519.75,1913,8432.75,907,FALSE,"out1, fill","0.1.4"
"31661","646",2023-07-27 19:00:00,-6427,1913,8340,907,FALSE,NA,"0.1.4"
"31662","646",2023-07-27 19:15:00,-6429,1913,8342,907,FALSE,NA,"0.1.4"
"31663","646",2023-07-27 19:30:00,-6713,1913,8626,907,FALSE,NA,"0.1.4"
"31664","646",2023-07-27 19:45:00,-6828,1913,8741,907,FALSE,NA,"0.1.4"
"31665","646",2023-07-27 20:00:00,-6828,1913,8741,907,FALSE,"out1, fill","0.1.4"
"31666","646",2023-07-27 20:15:00,-6828,1913,8741,907,FALSE,"jump1","0.1.4"
"31667","646",2023-07-27 20:30:00,-6950,1913,8863,907,FALSE,NA,"0.1.4"
"31668","646",2023-07-27 20:45:00,-6822,1913,8735,907,FALSE,NA,"0.1.4"
"31669","646",2023-07-27 21:00:00,-7065,1913,8978,907,FALSE,NA,"0.1.4"
"31670","646",2023-07-27 21:15:00,-6867,1913,8780,907,FALSE,NA,"0.1.4"
"31671","646",2023-07-27 21:30:00,-6933.66666666667,1913,8846.66666666667,907,FALSE,"out1, fill","0.1.4"
"31672","646",2023-07-27 21:45:00,-7000.33333333333,1913,8913.33333333333,907,FALSE,"out1, fill","0.1.4"
"31673","646",2023-07-27 22:00:00,-7067,1913,8980,907,FALSE,NA,"0.1.4"
"31674","646",2023-07-27 22:15:00,-6872,1913,8785,907,FALSE,NA,"0.1.4"
"31675","646",2023-07-27 22:30:00,-6863,1913,8776,907,FALSE,NA,"0.1.4"
"31676","646",2023-07-27 22:45:00,-6903,1913,8816,907,FALSE,NA,"0.1.4"
"31677","646",2023-07-27 23:00:00,-7284,1913,9197,907,FALSE,NA,"0.1.4"
"31678","646",2023-07-27 23:15:00,-6827,1913,8740,907,FALSE,NA,"0.1.4"
"31679","646",2023-07-27 23:30:00,-7006,1913,8919,907,FALSE,"out1, fill","0.1.4"
"31680","646",2023-07-27 23:45:00,-7185,1913,9098,907,FALSE,"out1, fill","0.1.4"
"31681","646",2023-07-28,-7364,1913,9277,907,FALSE,"out1, fill","0.1.4"
"31682","646",2023-07-28 00:15:00,-7543,1913,9456,907,FALSE,"out1, fill","0.1.4"
"31683","646",2023-07-28 00:30:00,-7722,1913,9635,907,FALSE,NA,"0.1.4"
"31684","646",2023-07-28 00:45:00,-7653,1913,9566,907,FALSE,NA,"0.1.4"
"31685","646",2023-07-28 01:00:00,-7860,1913,9773,907,FALSE,NA,"0.1.4"
"31686","646",2023-07-28 01:15:00,-7994,1913,9907,907,FALSE,"out1, fill","0.1.4"
"31687","646",2023-07-28 01:30:00,-8128,1913,10041,907,FALSE,"out1, fill","0.1.4"
"31688","646",2023-07-28 01:45:00,-8262,1913,10175,907,FALSE,"out1, fill","0.1.4"
"31689","646",2023-07-28 02:00:00,-8396,1913,10309,907,FALSE,NA,"0.1.4"
"31690","646",2023-07-28 02:15:00,-8138,1913,10051,907,FALSE,NA,"0.1.4"
"31691","646",2023-07-28 02:30:00,-8058,1913,9971,907,FALSE,NA,"0.1.4"
"31692","646",2023-07-28 02:45:00,-8103.5,1913,10016.5,907,FALSE,"out1, fill","0.1.4"
"31693","646",2023-07-28 03:00:00,-8149,1913,10062,907,FALSE,"out1, fill","0.1.4"
"31694","646",2023-07-28 03:15:00,-8194.5,1913,10107.5,907,FALSE,"out1, fill","0.1.4"
"31695","646",2023-07-28 03:30:00,-8240,1913,10153,907,FALSE,"out1, fill","0.1.4"
"31696","646",2023-07-28 03:45:00,-8285.5,1913,10198.5,907,FALSE,"out1, fill","0.1.4"
"31697","646",2023-07-28 04:00:00,-8331,1913,10244,907,FALSE,NA,"0.1.4"
"31698","646",2023-07-28 04:15:00,-8415,1913,10328,907,FALSE,NA,"0.1.4"
"31699","646",2023-07-28 04:30:00,-8360,1913,10273,907,FALSE,NA,"0.1.4"
"31700","646",2023-07-28 04:45:00,-8589,1913,10502,907,FALSE,NA,"0.1.4"
"31701","646",2023-07-28 05:00:00,-8605.8,1913,10518.8,907,FALSE,"out1, fill","0.1.4"
"31702","646",2023-07-28 05:15:00,-8622.6,1913,10535.6,907,FALSE,"out1, fill","0.1.4"
"31703","646",2023-07-28 05:30:00,-8639.4,1913,10552.4,907,FALSE,"out1, fill","0.1.4"
"31704","646",2023-07-28 05:45:00,-8656.2,1913,10569.2,907,FALSE,"out1, fill","0.1.4"
"31705","646",2023-07-28 06:00:00,-8673,1913,10586,907,FALSE,NA,"0.1.4"
"31706","646",2023-07-28 06:15:00,-8443,1913,10356,907,FALSE,NA,"0.1.4"
"31707","646",2023-07-28 06:30:00,-8827,1913,10740,907,FALSE,NA,"0.1.4"
"31708","646",2023-07-28 06:45:00,-8343,1913,10256,907,FALSE,NA,"0.1.4"
"31709","646",2023-07-28 07:00:00,-8368,1913,10281,907,FALSE,NA,"0.1.4"
"31710","646",2023-07-28 07:15:00,-8602,1913,10515,907,FALSE,NA,"0.1.4"
"31711","646",2023-07-28 07:30:00,-8602,1913,10515,907,FALSE,"jump1","0.1.4"
"31712","646",2023-07-28 07:45:00,-8601,1913,10514,907,FALSE,NA,"0.1.4"
"31713","646",2023-07-28 08:00:00,-9058,1913,10971,907,FALSE,NA,"0.1.4"
"31714","646",2023-07-28 08:15:00,-8863,1913,10776,907,FALSE,NA,"0.1.4"
"31715","646",2023-07-28 08:30:00,-8863,1913,10776,907,FALSE,"jump1","0.1.4"
"31716","646",2023-07-28 08:45:00,-8863,1913,10776,907,FALSE,"jump1","0.1.4"
"31717","646",2023-07-28 09:00:00,-8885,1913,10798,907,FALSE,NA,"0.1.4"
"31718","646",2023-07-28 09:15:00,-8885,1913,10798,907,FALSE,"jump1","0.1.4"
"31719","646",2023-07-28 09:30:00,-8811.85714285714,1913,10724.8571428571,907,FALSE,"out1, fill","0.1.4"
"31720","646",2023-07-28 09:45:00,-8738.71428571429,1913,10651.7142857143,907,FALSE,"out1, fill","0.1.4"
"31721","646",2023-07-28 10:00:00,-8665.57142857143,1913,10578.5714285714,907,FALSE,"out1, fill","0.1.4"
"31722","646",2023-07-28 10:15:00,-8592.42857142857,1913,10505.4285714286,907,FALSE,"out1, fill","0.1.4"
"31723","646",2023-07-28 10:30:00,-8519.28571428571,1913,10432.2857142857,907,FALSE,"out1, fill","0.1.4"
"31724","646",2023-07-28 10:45:00,-8446.14285714286,1913,10359.1428571429,907,FALSE,"out1, fill","0.1.4"
"31725","646",2023-07-28 11:00:00,-8373,1913,10286,907,FALSE,NA,"0.1.4"
"31726","646",2023-07-28 11:15:00,-8480,1913,10393,907,FALSE,NA,"0.1.4"
"31727","646",2023-07-28 11:30:00,-8146,1913,10059,907,FALSE,NA,"0.1.4"
"31728","646",2023-07-28 11:45:00,-8534.25,1913,10447.25,907,FALSE,"out1, fill","0.1.4"
"31729","646",2023-07-28 12:00:00,-8922.5,1913,10835.5,907,FALSE,"out1, fill","0.1.4"
"31730","646",2023-07-28 12:15:00,-9310.75,1913,11223.75,907,FALSE,"out1, fill","0.1.4"
"31731","646",2023-07-28 12:30:00,-9699,1913,11612,907,FALSE,NA,"0.1.4"
"31732","646",2023-07-28 12:45:00,-9482,1913,11395,907,FALSE,NA,"0.1.4"
"31733","646",2023-07-28 13:00:00,-9687,1913,11600,907,FALSE,NA,"0.1.4"
"31734","646",2023-07-28 13:15:00,-9651,1913,11564,907,FALSE,NA,"0.1.4"
"31735","646",2023-07-28 13:30:00,-9709,1913,11622,907,FALSE,NA,"0.1.4"
"31736","646",2023-07-28 13:45:00,-9485,1913,11398,907,FALSE,NA,"0.1.4"
"31737","646",2023-07-28 14:00:00,-9840,1913,11753,907,FALSE,NA,"0.1.4"
"31738","646",2023-07-28 14:15:00,-9703,1913,11616,907,FALSE,NA,"0.1.4"
"31739","646",2023-07-28 14:30:00,-9483,1913,11396,907,FALSE,NA,"0.1.4"
"31740","646",2023-07-28 14:45:00,-9057,1913,10970,907,FALSE,NA,"0.1.4"
"31741","646",2023-07-28 15:00:00,-8964,1913,10877,907,FALSE,NA,"0.1.4"
"31742","646",2023-07-28 15:15:00,-9204,1913,11117,907,FALSE,NA,"0.1.4"
"31743","646",2023-07-28 15:30:00,-9148,1913,11061,907,FALSE,NA,"0.1.4"
"31744","646",2023-07-28 15:45:00,-9148,1913,11061,907,FALSE,"jump1","0.1.4"
"31745","646",2023-07-28 16:00:00,-9148,1913,11061,907,FALSE,"jump1","0.1.4"
"31746","646",2023-07-28 16:15:00,-9090,1913,11003,907,FALSE,NA,"0.1.4"
"31747","646",2023-07-28 16:30:00,-9090,1913,11003,907,FALSE,"jump1","0.1.4"
"31748","646",2023-07-28 16:45:00,-8793.75,1913,10706.75,907,FALSE,"out1, fill","0.1.4"
"31749","646",2023-07-28 17:00:00,-8497.5,1913,10410.5,907,FALSE,"out1, fill","0.1.4"
"31750","646",2023-07-28 17:15:00,-8201.25,1913,10114.25,907,FALSE,"out1, fill","0.1.4"
"31751","646",2023-07-28 17:30:00,-7905,1913,9818,907,FALSE,NA,"0.1.4"
"31752","646",2023-07-28 17:45:00,-8117,1913,10030,907,FALSE,NA,"0.1.4"
"31753","646",2023-07-28 18:00:00,-8100,1913,10013,907,FALSE,NA,"0.1.4"
"31754","646",2023-07-28 18:15:00,-7815,1913,9728,907,FALSE,NA,"0.1.4"
"31755","646",2023-07-28 18:30:00,-7569,1913,9482,907,FALSE,NA,"0.1.4"
"31756","646",2023-07-28 18:45:00,-7578,1913,9491,907,FALSE,NA,"0.1.4"
"31757","646",2023-07-28 19:00:00,-7556,1913,9469,907,FALSE,NA,"0.1.4"
"31758","646",2023-07-28 19:15:00,-7541,1913,9454,907,FALSE,"out1, fill","0.1.4"
"31759","646",2023-07-28 19:30:00,-7526,1913,9439,907,FALSE,"out1, fill","0.1.4"
"31760","646",2023-07-28 19:45:00,-7511,1913,9424,907,FALSE,NA,"0.1.4"
"31761","646",2023-07-28 20:00:00,-7656,1913,9569,907,FALSE,NA,"0.1.4"
"31762","646",2023-07-28 20:15:00,-7907,1913,9820,907,FALSE,NA,"0.1.4"
"31763","646",2023-07-28 20:30:00,-7574,1913,9487,907,FALSE,NA,"0.1.4"
"31764","646",2023-07-28 20:45:00,-7702,1913,9615,907,FALSE,NA,"0.1.4"
"31765","646",2023-07-28 21:00:00,-7702,1913,9615,907,FALSE,"jump1","0.1.4"
"31766","646",2023-07-28 21:15:00,-7308.5,1913,9221.5,907,FALSE,"out1, fill","0.1.4"
"31767","646",2023-07-28 21:30:00,-6915,1913,8828,907,FALSE,NA,"0.1.4"
"31768","646",2023-07-28 21:45:00,-6808,1913,8721,907,FALSE,NA,"0.1.4"
"31769","646",2023-07-28 22:00:00,-6960,1913,8873,907,FALSE,NA,"0.1.4"
"31770","646",2023-07-28 22:15:00,-6876,1913,8789,907,FALSE,NA,"0.1.4"
"31771","646",2023-07-28 22:30:00,-7286.5,1913,9199.5,907,FALSE,"out1, fill","0.1.4"
"31772","646",2023-07-28 22:45:00,-7697,1913,9610,907,FALSE,NA,"0.1.4"
"31773","646",2023-07-28 23:00:00,-7494,1913,9407,907,FALSE,NA,"0.1.4"
"31774","646",2023-07-28 23:15:00,-7494,1913,9407,907,FALSE,"jump1","0.1.4"
"31775","646",2023-07-28 23:30:00,-7921,1913,9834,907,FALSE,"out1, fill","0.1.4"
"31776","646",2023-07-28 23:45:00,-8348,1913,10261,907,FALSE,NA,"0.1.4"
"31777","646",2023-07-29,-8428,1913,10341,907,FALSE,NA,"0.1.4"
"31778","646",2023-07-29 00:15:00,-8428,1913,10341,907,FALSE,"jump1","0.1.4"
"31779","646",2023-07-29 00:30:00,-7975,1913,9888,907,FALSE,NA,"0.1.4"
"31780","646",2023-07-29 00:45:00,-7975,1913,9888,907,FALSE,"jump1","0.1.4"
"31781","646",2023-07-29 01:00:00,-7849,1913,9762,907,FALSE,NA,"0.1.4"
"31782","646",2023-07-29 01:15:00,-7807,1913,9720,907,FALSE,NA,"0.1.4"
"31783","646",2023-07-29 01:30:00,-8258.5,1913,10171.5,907,FALSE,"out1, fill","0.1.4"
"31784","646",2023-07-29 01:45:00,-8710,1913,10623,907,FALSE,NA,"0.1.4"
"31785","646",2023-07-29 02:00:00,-8464,1913,10377,907,FALSE,NA,"0.1.4"
"31786","646",2023-07-29 02:15:00,-8762,1913,10675,907,FALSE,NA,"0.1.4"
"31787","646",2023-07-29 02:30:00,-8744,1913,10657,907,FALSE,"out1, fill","0.1.4"
"31788","646",2023-07-29 02:45:00,-8726,1913,10639,907,FALSE,"out1, fill","0.1.4"
"31789","646",2023-07-29 03:00:00,-8708,1913,10621,907,FALSE,NA,"0.1.4"
"31790","646",2023-07-29 03:15:00,-8725,1913,10638,907,FALSE,NA,"0.1.4"
"31791","646",2023-07-29 03:30:00,-8944,1913,10857,907,FALSE,NA,"0.1.4"
"31792","646",2023-07-29 03:45:00,-8469.5,1913,10382.5,907,FALSE,"out1, fill","0.1.4"
"31793","646",2023-07-29 04:00:00,-7995,1913,9908,907,FALSE,NA,"0.1.4"
"31794","646",2023-07-29 04:15:00,-8009,1913,9922,907,FALSE,NA,"0.1.4"
"31795","646",2023-07-29 04:30:00,-8429,1913,10342,907,FALSE,NA,"0.1.4"
"31796","646",2023-07-29 04:45:00,-8429,1913,10342,907,FALSE,"jump1","0.1.4"
"31797","646",2023-07-29 05:00:00,-8383.14285714286,1913,10296.1428571429,907,FALSE,"out1, fill","0.1.4"
"31798","646",2023-07-29 05:15:00,-8337.28571428571,1913,10250.2857142857,907,FALSE,"out1, fill","0.1.4"
"31799","646",2023-07-29 05:30:00,-8291.42857142857,1913,10204.4285714286,907,FALSE,"out1, fill","0.1.4"
"31800","646",2023-07-29 05:45:00,-8245.57142857143,1913,10158.5714285714,907,FALSE,"out1, fill","0.1.4"
"31801","646",2023-07-29 06:00:00,-8199.71428571429,1913,10112.7142857143,907,FALSE,"out1, fill","0.1.4"
"31802","646",2023-07-29 06:15:00,-8153.85714285714,1913,10066.8571428571,907,FALSE,"out1, fill","0.1.4"
"31803","646",2023-07-29 06:30:00,-8108,1913,10021,907,FALSE,NA,"0.1.4"
"31804","646",2023-07-29 06:45:00,-8106,1913,10019,907,FALSE,NA,"0.1.4"
"31805","646",2023-07-29 07:00:00,-8501,1913,10414,907,FALSE,NA,"0.1.4"
"31806","646",2023-07-29 07:15:00,-8567,1913,10480,907,FALSE,NA,"0.1.4"
"31807","646",2023-07-29 07:30:00,-8567,1913,10480,907,FALSE,"jump1","0.1.4"
"31808","646",2023-07-29 07:45:00,-8605.8,1913,10518.8,907,FALSE,"out1, fill","0.1.4"
"31809","646",2023-07-29 08:00:00,-8644.6,1913,10557.6,907,FALSE,"out1, fill","0.1.4"
"31810","646",2023-07-29 08:15:00,-8683.4,1913,10596.4,907,FALSE,"out1, fill","0.1.4"
"31811","646",2023-07-29 08:30:00,-8722.2,1913,10635.2,907,FALSE,"out1, fill","0.1.4"
"31812","646",2023-07-29 08:45:00,-8761,1913,10674,907,FALSE,NA,"0.1.4"
"31813","646",2023-07-29 09:00:00,-8396,1913,10309,907,FALSE,NA,"0.1.4"
"31814","646",2023-07-29 09:15:00,-8852,1913,10765,907,FALSE,NA,"0.1.4"
"31815","646",2023-07-29 09:30:00,-8852,1913,10765,907,FALSE,"jump1","0.1.4"
"31816","646",2023-07-29 09:45:00,-8658,1913,10571,907,FALSE,NA,"0.1.4"
"31817","646",2023-07-29 10:00:00,-8925,1913,10838,907,FALSE,"out1, fill","0.1.4"
"31818","646",2023-07-29 10:15:00,-9192,1913,11105,907,FALSE,NA,"0.1.4"
"31819","646",2023-07-29 10:30:00,-9175,1913,11088,907,FALSE,NA,"0.1.4"
"31820","646",2023-07-29 10:45:00,-9115,1913,11028,907,FALSE,NA,"0.1.4"
"31821","646",2023-07-29 11:00:00,-8886,1913,10799,907,FALSE,"out1, fill","0.1.4"
"31822","646",2023-07-29 11:15:00,-8657,1913,10570,907,FALSE,NA,"0.1.4"
"31823","646",2023-07-29 11:30:00,-8721,1913,10634,907,FALSE,NA,"0.1.4"
"31824","646",2023-07-29 11:45:00,-8721,1913,10634,907,FALSE,"jump1","0.1.4"
"31825","646",2023-07-29 12:00:00,-8680.5,1913,10593.5,907,FALSE,"out1, fill","0.1.4"
"31826","646",2023-07-29 12:15:00,-8640,1913,10553,907,FALSE,"out1, fill","0.1.4"
"31827","646",2023-07-29 12:30:00,-8599.5,1913,10512.5,907,FALSE,"out1, fill","0.1.4"
"31828","646",2023-07-29 12:45:00,-8559,1913,10472,907,FALSE,NA,"0.1.4"
"31829","646",2023-07-29 13:00:00,-8559,1913,10472,907,FALSE,"jump1","0.1.4"
"31830","646",2023-07-29 13:15:00,-8559,1913,10472,907,FALSE,"jump1","0.1.4"
"31831","646",2023-07-29 13:30:00,-8563,1913,10476,907,FALSE,NA,"0.1.4"
"31832","646",2023-07-29 13:45:00,-8562,1913,10475,907,FALSE,NA,"0.1.4"
"31833","646",2023-07-29 14:00:00,-8559,1913,10472,907,FALSE,NA,"0.1.4"
"31834","646",2023-07-29 14:15:00,-8559,1913,10472,907,FALSE,NA,"0.1.4"
"31835","646",2023-07-29 14:30:00,-8559,1913,10472,907,FALSE,NA,"0.1.4"
"31836","646",2023-07-29 14:45:00,-8559,1913,10472,907,FALSE,NA,"0.1.4"
"31837","646",2023-07-29 15:00:00,-8560,1913,10473,907,FALSE,NA,"0.1.4"
"31838","646",2023-07-29 15:15:00,-8559,1913,10472,907,FALSE,NA,"0.1.4"
"31839","646",2023-07-29 15:30:00,-8557,1913,10470,907,FALSE,NA,"0.1.4"
"31840","646",2023-07-29 15:45:00,-8569,1913,10482,907,FALSE,NA,"0.1.4"
"31841","646",2023-07-29 16:00:00,-8922,1913,10835,907,FALSE,NA,"0.1.4"
"31842","646",2023-07-29 16:15:00,-8978,1913,10891,907,FALSE,NA,"0.1.4"
"31843","646",2023-07-29 16:30:00,-8559,1913,10472,907,FALSE,NA,"0.1.4"
"31844","646",2023-07-29 16:45:00,-8595,1913,10508,907,FALSE,NA,"0.1.4"
"31845","646",2023-07-29 17:00:00,-8595,1913,10508,907,FALSE,"jump1","0.1.4"
"31846","646",2023-07-29 17:15:00,-8595,1913,10508,907,FALSE,"jump1","0.1.4"
"31847","646",2023-07-29 17:30:00,-8644,1913,10557,907,FALSE,NA,"0.1.4"
"31848","646",2023-07-29 17:45:00,-9040,1913,10953,907,FALSE,NA,"0.1.4"
"31849","646",2023-07-29 18:00:00,-8600,1913,10513,907,FALSE,NA,"0.1.4"
"31850","646",2023-07-29 18:15:00,-8775,1913,10688,907,FALSE,NA,"0.1.4"
"31851","646",2023-07-29 18:30:00,-8595,1913,10508,907,FALSE,NA,"0.1.4"
"31852","646",2023-07-29 18:45:00,-8724,1913,10637,907,FALSE,NA,"0.1.4"
"31853","646",2023-07-29 19:00:00,-8932,1913,10845,907,FALSE,NA,"0.1.4"
"31854","646",2023-07-29 19:15:00,-8659,1913,10572,907,FALSE,NA,"0.1.4"
"31855","646",2023-07-29 19:30:00,-8933,1913,10846,907,FALSE,NA,"0.1.4"
"31856","646",2023-07-29 19:45:00,-8591,1913,10504,907,FALSE,NA,"0.1.4"
"31857","646",2023-07-29 20:00:00,-8596,1913,10509,907,FALSE,"out1, fill","0.1.4"
"31858","646",2023-07-29 20:15:00,-8601,1913,10514,907,FALSE,"out1, fill","0.1.4"
"31859","646",2023-07-29 20:30:00,-8606,1913,10519,907,FALSE,NA,"0.1.4"
"31860","646",2023-07-29 20:45:00,-8833,1913,10746,907,FALSE,NA,"0.1.4"
"31861","646",2023-07-29 21:00:00,-8657,1913,10570,907,FALSE,NA,"0.1.4"
"31862","646",2023-07-29 21:15:00,-8657,1913,10570,907,FALSE,"jump1","0.1.4"
"31863","646",2023-07-29 21:30:00,-8857,1913,10770,907,FALSE,NA,"0.1.4"
"31864","646",2023-07-29 21:45:00,-8639,1913,10552,907,FALSE,NA,"0.1.4"
"31865","646",2023-07-29 22:00:00,-8497,1913,10410,907,FALSE,NA,"0.1.4"
"31866","646",2023-07-29 22:15:00,-8460,1913,10373,907,FALSE,NA,"0.1.4"
"31867","646",2023-07-29 22:30:00,-8352,1913,10265,907,FALSE,NA,"0.1.4"
"31868","646",2023-07-29 22:45:00,-7999,1913,9912,907,FALSE,NA,"0.1.4"
"31869","646",2023-07-29 23:00:00,-7933,1913,9846,907,FALSE,NA,"0.1.4"
"31870","646",2023-07-29 23:15:00,-8188,1913,10101,907,FALSE,NA,"0.1.4"
"31871","646",2023-07-29 23:30:00,-7943,1913,9856,907,FALSE,NA,"0.1.4"
"31872","646",2023-07-29 23:45:00,-8005,1913,9918,907,FALSE,NA,"0.1.4"
"31873","646",2023-07-30,-7978,1913,9891,907,FALSE,NA,"0.1.4"
"31874","646",2023-07-30 00:15:00,-7897,1913,9810,907,FALSE,NA,"0.1.4"
"31875","646",2023-07-30 00:30:00,-7896,1913,9809,907,FALSE,NA,"0.1.4"
"31876","646",2023-07-30 00:45:00,-7903,1913,9816,907,FALSE,NA,"0.1.4"
"31877","646",2023-07-30 01:00:00,-8116,1913,10029,907,FALSE,NA,"0.1.4"
"31878","646",2023-07-30 01:15:00,-7875,1913,9788,907,FALSE,NA,"0.1.4"
"31879","646",2023-07-30 01:30:00,-7875,1913,9788,907,FALSE,NA,"0.1.4"
"31880","646",2023-07-30 01:45:00,-7874,1913,9787,907,FALSE,NA,"0.1.4"
"31881","646",2023-07-30 02:00:00,-7875,1913,9788,907,FALSE,NA,"0.1.4"
"31882","646",2023-07-30 02:15:00,-7873,1913,9786,907,FALSE,NA,"0.1.4"
"31883","646",2023-07-30 02:30:00,-7872,1913,9785,907,FALSE,NA,"0.1.4"
"31884","646",2023-07-30 02:45:00,-7871,1913,9784,907,FALSE,NA,"0.1.4"
"31885","646",2023-07-30 03:00:00,-7875,1913,9788,907,FALSE,NA,"0.1.4"
"31886","646",2023-07-30 03:15:00,-7895,1913,9808,907,FALSE,NA,"0.1.4"
"31887","646",2023-07-30 03:30:00,-7887.33333333333,1913,9800.33333333333,907,FALSE,"out1, fill","0.1.4"
"31888","646",2023-07-30 03:45:00,-7879.66666666667,1913,9792.66666666667,907,FALSE,"out1, fill","0.1.4"
"31889","646",2023-07-30 04:00:00,-7872,1913,9785,907,FALSE,NA,"0.1.4"
"31890","646",2023-07-30 04:15:00,-7877,1913,9790,907,FALSE,NA,"0.1.4"
"31891","646",2023-07-30 04:30:00,-7903,1913,9816,907,FALSE,NA,"0.1.4"
"31892","646",2023-07-30 04:45:00,-7903,1913,9816,907,FALSE,"jump1","0.1.4"
"31893","646",2023-07-30 05:00:00,-8018,1913,9931,907,FALSE,NA,"0.1.4"
"31894","646",2023-07-30 05:15:00,-7933,1913,9846,907,FALSE,NA,"0.1.4"
"31895","646",2023-07-30 05:30:00,-7964,1913,9877,907,FALSE,NA,"0.1.4"
"31896","646",2023-07-30 05:45:00,-7964,1913,9877,907,FALSE,"jump1","0.1.4"
"31897","646",2023-07-30 06:00:00,-7621.75,1913,9534.75,907,FALSE,"out1, fill","0.1.4"
"31898","646",2023-07-30 06:15:00,-7279.5,1913,9192.5,907,FALSE,"out1, fill","0.1.4"
"31899","646",2023-07-30 06:30:00,-6937.25,1913,8850.25,907,FALSE,"out1, fill","0.1.4"
"31900","646",2023-07-30 06:45:00,-6595,1913,8508,907,FALSE,NA,"0.1.4"
"31901","646",2023-07-30 07:00:00,-6595,1913,8508,907,FALSE,"jump1","0.1.4"
"31902","646",2023-07-30 07:15:00,-6980,1913,8893,907,FALSE,NA,"0.1.4"
"31903","646",2023-07-30 07:30:00,-7278,1913,9191,907,FALSE,NA,"0.1.4"
"31904","646",2023-07-30 07:45:00,-7138,1913,9051,907,FALSE,NA,"0.1.4"
"31905","646",2023-07-30 08:00:00,-7102,1913,9015,907,FALSE,NA,"0.1.4"
"31906","646",2023-07-30 08:15:00,-7048,1913,8961,907,FALSE,NA,"0.1.4"
"31907","646",2023-07-30 08:30:00,-6871,1913,8784,907,FALSE,NA,"0.1.4"
"31908","646",2023-07-30 08:45:00,-6884.5,1913,8797.5,907,FALSE,"out1, fill","0.1.4"
"31909","646",2023-07-30 09:00:00,-6898,1913,8811,907,FALSE,"out1, fill","0.1.4"
"31910","646",2023-07-30 09:15:00,-6911.5,1913,8824.5,907,FALSE,"out1, fill","0.1.4"
"31911","646",2023-07-30 09:30:00,-6925,1913,8838,907,FALSE,NA,"0.1.4"
"31912","646",2023-07-30 09:45:00,-7023,1913,8936,907,FALSE,NA,"0.1.4"
"31913","646",2023-07-30 10:00:00,-7249,1913,9162,907,FALSE,NA,"0.1.4"
"31914","646",2023-07-30 10:15:00,-6952,1913,8865,907,FALSE,NA,"0.1.4"
"31915","646",2023-07-30 10:30:00,-6519.5,1913,8432.5,907,FALSE,"out1, fill","0.1.4"
"31916","646",2023-07-30 10:45:00,-6087,1913,8000,907,FALSE,NA,"0.1.4"
"31917","646",2023-07-30 11:00:00,-6033,1913,7946,907,FALSE,NA,"0.1.4"
"31918","646",2023-07-30 11:15:00,-6000,1913,7913,907,FALSE,NA,"0.1.4"
"31919","646",2023-07-30 11:30:00,-6000,1913,7913,907,FALSE,"jump1","0.1.4"
"31920","646",2023-07-30 11:45:00,-6059,1913,7972,907,FALSE,NA,"0.1.4"
"31921","646",2023-07-30 12:00:00,-6064,1913,7977,907,FALSE,NA,"0.1.4"
"31922","646",2023-07-30 12:15:00,-5907,1913,7820,907,FALSE,NA,"0.1.4"
"31923","646",2023-07-30 12:30:00,-5451,1913,7364,907,FALSE,NA,"0.1.4"
"31924","646",2023-07-30 12:45:00,-5477,1913,7390,907,FALSE,NA,"0.1.4"
"31925","646",2023-07-30 13:00:00,-5457,1913,7370,907,FALSE,NA,"0.1.4"
"31926","646",2023-07-30 13:15:00,-5457,1913,7370,907,FALSE,NA,"0.1.4"
"31927","646",2023-07-30 13:30:00,-5458,1913,7371,907,FALSE,NA,"0.1.4"
"31928","646",2023-07-30 13:45:00,-5952,1913,7865,907,FALSE,NA,"0.1.4"
"31929","646",2023-07-30 14:00:00,-5459,1913,7372,907,FALSE,NA,"0.1.4"
"31930","646",2023-07-30 14:15:00,-5457,1913,7370,907,FALSE,NA,"0.1.4"
"31931","646",2023-07-30 14:30:00,-5456,1913,7369,907,FALSE,NA,"0.1.4"
"31932","646",2023-07-30 14:45:00,-5455,1913,7368,907,FALSE,NA,"0.1.4"
"31933","646",2023-07-30 15:00:00,-5455,1913,7368,907,FALSE,NA,"0.1.4"
"31934","646",2023-07-30 15:15:00,-5455,1913,7368,907,FALSE,NA,"0.1.4"
"31935","646",2023-07-30 15:30:00,-5455,1913,7368,907,FALSE,NA,"0.1.4"
"31936","646",2023-07-30 15:45:00,-5456,1913,7369,907,FALSE,NA,"0.1.4"
"31937","646",2023-07-30 16:00:00,-5457,1913,7370,907,FALSE,NA,"0.1.4"
"31938","646",2023-07-30 16:15:00,-5455,1913,7368,907,FALSE,NA,"0.1.4"
"31939","646",2023-07-30 16:30:00,-5454,1913,7367,907,FALSE,NA,"0.1.4"
"31940","646",2023-07-30 16:45:00,-5450,1913,7363,907,FALSE,NA,"0.1.4"
"31941","646",2023-07-30 17:00:00,-5450,1913,7363,907,FALSE,NA,"0.1.4"
"31942","646",2023-07-30 17:15:00,-5445,1913,7358,907,FALSE,NA,"0.1.4"
"31943","646",2023-07-30 17:30:00,-5442,1913,7355,907,FALSE,NA,"0.1.4"
"31944","646",2023-07-30 17:45:00,-5445,1913,7358,907,FALSE,NA,"0.1.4"
"31945","646",2023-07-30 18:00:00,-5452,1913,7365,907,FALSE,NA,"0.1.4"
"31946","646",2023-07-30 18:15:00,-5455,1913,7368,907,FALSE,NA,"0.1.4"
"31947","646",2023-07-30 18:30:00,-5452,1913,7365,907,FALSE,NA,"0.1.4"
"31948","646",2023-07-30 18:45:00,-5447,1913,7360,907,FALSE,NA,"0.1.4"
"31949","646",2023-07-30 19:00:00,-5455,1913,7368,907,FALSE,NA,"0.1.4"
"31950","646",2023-07-30 19:15:00,-5447,1913,7360,907,FALSE,NA,"0.1.4"
"31951","646",2023-07-30 19:30:00,-5451,1913,7364,907,FALSE,NA,"0.1.4"
"31952","646",2023-07-30 19:45:00,-5456,1913,7369,907,FALSE,NA,"0.1.4"
"31953","646",2023-07-30 20:00:00,-5446,1913,7359,907,FALSE,NA,"0.1.4"
"31954","646",2023-07-30 20:15:00,-5443,1913,7356,907,FALSE,NA,"0.1.4"
"31955","646",2023-07-30 20:30:00,-5449,1913,7362,907,FALSE,NA,"0.1.4"
"31956","646",2023-07-30 20:45:00,-5448,1913,7361,907,FALSE,NA,"0.1.4"
"31957","646",2023-07-30 21:00:00,-5455,1913,7368,907,FALSE,NA,"0.1.4"
"31958","646",2023-07-30 21:15:00,-5445,1913,7358,907,FALSE,NA,"0.1.4"
"31959","646",2023-07-30 21:30:00,-5456,1913,7369,907,FALSE,NA,"0.1.4"
"31960","646",2023-07-30 21:45:00,-5454,1913,7367,907,FALSE,NA,"0.1.4"
"31961","646",2023-07-30 22:00:00,-5449,1913,7362,907,FALSE,NA,"0.1.4"
"31962","646",2023-07-30 22:15:00,-5447,1913,7360,907,FALSE,NA,"0.1.4"
"31963","646",2023-07-30 22:30:00,-5446,1913,7359,907,FALSE,NA,"0.1.4"
"31964","646",2023-07-30 22:45:00,-5446,1913,7359,907,FALSE,NA,"0.1.4"
"31965","646",2023-07-30 23:00:00,-5446,1913,7359,907,FALSE,NA,"0.1.4"
"31966","646",2023-07-30 23:15:00,-5449,1913,7362,907,FALSE,NA,"0.1.4"
"31967","646",2023-07-30 23:30:00,-5449,1913,7362,907,FALSE,NA,"0.1.4"
"31968","646",2023-07-30 23:45:00,-5448,1913,7361,907,FALSE,NA,"0.1.4"
"31969","646",2023-07-31,-5450,1913,7363,907,FALSE,NA,"0.1.4"
"31970","646",2023-07-31 00:15:00,-5448,1913,7361,907,FALSE,NA,"0.1.4"
"31971","646",2023-07-31 00:30:00,-5449,1913,7362,907,FALSE,NA,"0.1.4"
"31972","646",2023-07-31 00:45:00,-5450,1913,7363,907,FALSE,NA,"0.1.4"
"31973","646",2023-07-31 01:00:00,-5450,1913,7363,907,FALSE,NA,"0.1.4"
"31974","646",2023-07-31 01:15:00,-5444,1913,7357,907,FALSE,NA,"0.1.4"
"31975","646",2023-07-31 01:30:00,-5438,1913,7351,907,FALSE,NA,"0.1.4"
"31976","646",2023-07-31 01:45:00,-5449,1913,7362,907,FALSE,NA,"0.1.4"
"31977","646",2023-07-31 02:00:00,-5441,1913,7354,907,FALSE,NA,"0.1.4"
"31978","646",2023-07-31 02:15:00,-5445,1913,7358,907,FALSE,NA,"0.1.4"
"31979","646",2023-07-31 02:30:00,-5442,1913,7355,907,FALSE,NA,"0.1.4"
"31980","646",2023-07-31 02:45:00,-5449,1913,7362,907,FALSE,NA,"0.1.4"
"31981","646",2023-07-31 03:00:00,-5452,1913,7365,907,FALSE,NA,"0.1.4"
"31982","646",2023-07-31 03:15:00,-5441,1913,7354,907,FALSE,NA,"0.1.4"
"31983","646",2023-07-31 03:30:00,-5444,1913,7357,907,FALSE,NA,"0.1.4"
"31984","646",2023-07-31 03:45:00,-5448,1913,7361,907,FALSE,NA,"0.1.4"
"31985","646",2023-07-31 04:00:00,-5458,1913,7371,907,FALSE,NA,"0.1.4"
"31986","646",2023-07-31 04:15:00,-5460,1913,7373,907,FALSE,NA,"0.1.4"
"31987","646",2023-07-31 04:30:00,-5458,1913,7371,907,FALSE,NA,"0.1.4"
"31988","646",2023-07-31 04:45:00,-5457,1913,7370,907,FALSE,NA,"0.1.4"
"31989","646",2023-07-31 05:00:00,-5458,1913,7371,907,FALSE,NA,"0.1.4"
"31990","646",2023-07-31 05:15:00,-5458,1913,7371,907,FALSE,NA,"0.1.4"
"31991","646",2023-07-31 05:30:00,-5458,1913,7371,907,FALSE,NA,"0.1.4"
"31992","646",2023-07-31 05:45:00,-5482,1913,7395,907,FALSE,NA,"0.1.4"
"31993","646",2023-07-31 06:00:00,-5458,1913,7371,907,FALSE,NA,"0.1.4"
"31994","646",2023-07-31 06:15:00,-5458,1913,7371,907,FALSE,NA,"0.1.4"
"31995","646",2023-07-31 06:30:00,-5717,1913,7630,907,FALSE,NA,"0.1.4"
"31996","646",2023-07-31 06:45:00,-5458,1913,7371,907,FALSE,NA,"0.1.4"
"31997","646",2023-07-31 07:00:00,-5465,1913,7378,907,FALSE,NA,"0.1.4"
"31998","646",2023-07-31 07:15:00,-5531,1913,7444,907,FALSE,NA,"0.1.4"
"31999","646",2023-07-31 07:30:00,-5461,1913,7374,907,FALSE,NA,"0.1.4"
"32000","646",2023-07-31 07:45:00,-5497,1913,7410,907,FALSE,NA,"0.1.4"
"32001","646",2023-07-31 08:00:00,-5497,1913,7410,907,FALSE,"jump1","0.1.4"
"32002","646",2023-07-31 08:15:00,-5736,1913,7649,907,FALSE,NA,"0.1.4"
"32003","646",2023-07-31 08:30:00,-5904,1913,7817,907,FALSE,NA,"0.1.4"
"32004","646",2023-07-31 08:45:00,-5605,1913,7518,907,FALSE,NA,"0.1.4"
"32005","646",2023-07-31 09:00:00,-5230.5,1913,7143.5,907,FALSE,"out1, fill","0.1.4"
"32006","646",2023-07-31 09:15:00,-4856,1913,6769,907,FALSE,NA,"0.1.4"
"32007","646",2023-07-31 09:30:00,-4839,1913,6752,907,FALSE,NA,"0.1.4"
"32008","646",2023-07-31 09:45:00,-4966,1913,6879,907,FALSE,NA,"0.1.4"
"32009","646",2023-07-31 10:00:00,-4855,1913,6768,907,FALSE,NA,"0.1.4"
"32010","646",2023-07-31 10:15:00,-4920,1913,6833,907,FALSE,NA,"0.1.4"
"32011","646",2023-07-31 10:30:00,-5165.4,1913,7078.4,907,FALSE,"out1, fill","0.1.4"
"32012","646",2023-07-31 10:45:00,-5410.8,1913,7323.8,907,FALSE,"out1, fill","0.1.4"
"32013","646",2023-07-31 11:00:00,-5656.2,1913,7569.2,907,FALSE,"out1, fill","0.1.4"
"32014","646",2023-07-31 11:15:00,-5901.6,1913,7814.6,907,FALSE,"out1, fill","0.1.4"
"32015","646",2023-07-31 11:30:00,-6147,1913,8060,907,FALSE,NA,"0.1.4"
"32016","646",2023-07-31 11:45:00,-6443,1913,8356,907,FALSE,NA,"0.1.4"
"32017","646",2023-07-31 12:00:00,-6425,1913,8338,907,FALSE,NA,"0.1.4"
"32018","646",2023-07-31 12:15:00,-5978,1913,7891,907,FALSE,"out1, fill","0.1.4"
"32019","646",2023-07-31 12:30:00,-5531,1913,7444,907,FALSE,NA,"0.1.4"
"32020","646",2023-07-31 12:45:00,-5531,1913,7444,907,FALSE,"jump1","0.1.4"
"32021","646",2023-07-31 13:00:00,-5292,1913,7205,907,FALSE,NA,"0.1.4"
"32022","646",2023-07-31 13:15:00,-5761,1913,7674,907,FALSE,NA,"0.1.4"
"32023","646",2023-07-31 13:30:00,-5761,1913,7674,907,FALSE,"out1, fill","0.1.4"
"32024","646",2023-07-31 13:45:00,-5761,1913,7674,907,FALSE,"jump1","0.1.4"
"32025","646",2023-07-31 14:00:00,-5762,1913,7675,907,FALSE,NA,"0.1.4"
"32026","646",2023-07-31 14:15:00,-5803,1913,7716,907,FALSE,NA,"0.1.4"
"32027","646",2023-07-31 14:30:00,-5761,1913,7674,907,FALSE,NA,"0.1.4"
"32028","646",2023-07-31 14:45:00,-5757,1913,7670,907,FALSE,NA,"0.1.4"
"32029","646",2023-07-31 15:00:00,-5757,1913,7670,907,FALSE,NA,"0.1.4"
"32030","646",2023-07-31 15:15:00,-5761,1913,7674,907,FALSE,NA,"0.1.4"
"32031","646",2023-07-31 15:30:00,-5833,1913,7746,907,FALSE,NA,"0.1.4"
"32032","646",2023-07-31 15:45:00,-5955,1913,7868,907,FALSE,NA,"0.1.4"
"32033","646",2023-07-31 16:00:00,-5922,1913,7835,907,FALSE,NA,"0.1.4"
"32034","646",2023-07-31 16:15:00,-5864,1913,7777,907,FALSE,NA,"0.1.4"
"32035","646",2023-07-31 16:30:00,-5867,1913,7780,907,FALSE,NA,"0.1.4"
"32036","646",2023-07-31 16:45:00,-5804,1913,7717,907,FALSE,NA,"0.1.4"
"32037","646",2023-07-31 17:00:00,-5816,1913,7729,907,FALSE,NA,"0.1.4"
"32038","646",2023-07-31 17:15:00,-5757,1913,7670,907,FALSE,NA,"0.1.4"
"32039","646",2023-07-31 17:30:00,-5761,1913,7674,907,FALSE,NA,"0.1.4"
"32040","646",2023-07-31 17:45:00,-5762,1913,7675,907,FALSE,NA,"0.1.4"
"32041","646",2023-07-31 18:00:00,-5757,1913,7670,907,FALSE,NA,"0.1.4"
"32042","646",2023-07-31 18:15:00,-5756,1913,7669,907,FALSE,NA,"0.1.4"
"32043","646",2023-07-31 18:30:00,-5748,1913,7661,907,FALSE,NA,"0.1.4"
"32044","646",2023-07-31 18:45:00,-5760,1913,7673,907,FALSE,NA,"0.1.4"
"32045","646",2023-07-31 19:00:00,-5760,1913,7673,907,FALSE,NA,"0.1.4"
"32046","646",2023-07-31 19:15:00,-5762,1913,7675,907,FALSE,NA,"0.1.4"
"32047","646",2023-07-31 19:30:00,-5758,1913,7671,907,FALSE,NA,"0.1.4"
"32048","646",2023-07-31 19:45:00,-5763,1913,7676,907,FALSE,NA,"0.1.4"
"32049","646",2023-07-31 20:00:00,-5763,1913,7676,907,FALSE,NA,"0.1.4"
"32050","646",2023-07-31 20:15:00,-5761,1913,7674,907,FALSE,NA,"0.1.4"
"32051","646",2023-07-31 20:30:00,-5763,1913,7676,907,FALSE,NA,"0.1.4"
"32052","646",2023-07-31 20:45:00,-5761,1913,7674,907,FALSE,NA,"0.1.4"
"32053","646",2023-07-31 21:00:00,-5763,1913,7676,907,FALSE,NA,"0.1.4"
"32054","646",2023-07-31 21:15:00,-5750,1913,7663,907,FALSE,NA,"0.1.4"
"32055","646",2023-07-31 21:30:00,-5758,1913,7671,907,FALSE,NA,"0.1.4"
"32056","646",2023-07-31 21:45:00,-5744,1913,7657,907,FALSE,NA,"0.1.4"
"32057","646",2023-07-31 22:00:00,-5747,1913,7660,907,FALSE,NA,"0.1.4"
"32058","646",2023-07-31 22:15:00,-5760,1913,7673,907,FALSE,NA,"0.1.4"
"32059","646",2023-07-31 22:30:00,-5763,1913,7676,907,FALSE,NA,"0.1.4"
"32060","646",2023-07-31 22:45:00,-5763,1913,7676,907,FALSE,NA,"0.1.4"
"32061","646",2023-07-31 23:00:00,-5763,1913,7676,907,FALSE,NA,"0.1.4"
"32062","646",2023-07-31 23:15:00,-5749,1913,7662,907,FALSE,NA,"0.1.4"
"32063","646",2023-07-31 23:30:00,-5763,1913,7676,907,FALSE,NA,"0.1.4"
"32064","646",2023-07-31 23:45:00,-5763,1913,7676,907,FALSE,NA,"0.1.4"
"32065","646",2023-08-01,-5748,1913,7661,907,FALSE,NA,"0.1.4"
"32066","646",2023-08-01 00:15:00,-5753,1913,7666,907,FALSE,NA,"0.1.4"
"32067","646",2023-08-01 00:30:00,-5755,1913,7668,907,FALSE,NA,"0.1.4"
"32068","646",2023-08-01 00:45:00,-5754,1913,7667,907,FALSE,NA,"0.1.4"
"32069","646",2023-08-01 01:00:00,-5762,1913,7675,907,FALSE,NA,"0.1.4"
"32070","646",2023-08-01 01:15:00,-5763,1913,7676,907,FALSE,NA,"0.1.4"
"32071","646",2023-08-01 01:30:00,-5763,1913,7676,907,FALSE,NA,"0.1.4"
"32072","646",2023-08-01 01:45:00,-5762,1913,7675,907,FALSE,NA,"0.1.4"
"32073","646",2023-08-01 02:00:00,-5762,1913,7675,907,FALSE,NA,"0.1.4"
"32074","646",2023-08-01 02:15:00,-5763,1913,7676,907,FALSE,NA,"0.1.4"
"32075","646",2023-08-01 02:30:00,-5776,1913,7689,907,FALSE,NA,"0.1.4"
"32076","646",2023-08-01 02:45:00,-5767,1913,7680,907,FALSE,NA,"0.1.4"
"32077","646",2023-08-01 03:00:00,-5761,1913,7674,907,FALSE,NA,"0.1.4"
"32078","646",2023-08-01 03:15:00,-5764,1913,7677,907,FALSE,NA,"0.1.4"
"32079","646",2023-08-01 03:30:00,-5761,1913,7674,907,FALSE,NA,"0.1.4"
"32080","646",2023-08-01 03:45:00,-5776,1913,7689,907,FALSE,NA,"0.1.4"
"32081","646",2023-08-01 04:00:00,-5776,1913,7689,907,FALSE,"jump1","0.1.4"
"32082","646",2023-08-01 04:15:00,-5771,1913,7684,907,FALSE,NA,"0.1.4"
"32083","646",2023-08-01 04:30:00,-5771,1913,7684,907,FALSE,"jump1","0.1.4"
"32084","646",2023-08-01 04:45:00,-5807,1913,7720,907,FALSE,NA,"0.1.4"
"32085","646",2023-08-01 05:00:00,-5775,1913,7688,907,FALSE,NA,"0.1.4"
"32086","646",2023-08-01 05:15:00,-5775,1913,7688,907,FALSE,NA,"0.1.4"
"32087","646",2023-08-01 05:30:00,-5775,1913,7688,907,FALSE,NA,"0.1.4"
"32088","646",2023-08-01 05:45:00,-5972.66666666667,1913,7885.66666666667,907,FALSE,"out1, fill","0.1.4"
"32089","646",2023-08-01 06:00:00,-6170.33333333333,1913,8083.33333333333,907,FALSE,"out1, fill","0.1.4"
"32090","646",2023-08-01 06:15:00,-6368,1913,8281,907,FALSE,NA,"0.1.4"
"32091","646",2023-08-01 06:30:00,-6851,1913,8764,907,FALSE,NA,"0.1.4"
"32092","646",2023-08-01 06:45:00,-7220,1913,9133,907,FALSE,NA,"0.1.4"
"32093","646",2023-08-01 07:00:00,-6978.5,1913,8891.5,907,FALSE,"out1, fill","0.1.4"
"32094","646",2023-08-01 07:15:00,-6737,1913,8650,907,FALSE,"out1, fill","0.1.4"
"32095","646",2023-08-01 07:30:00,-6495.5,1913,8408.5,907,FALSE,"out1, fill","0.1.4"
"32096","646",2023-08-01 07:45:00,-6254,1913,8167,907,FALSE,"out1, fill","0.1.4"
"32097","646",2023-08-01 08:00:00,-6012.5,1913,7925.5,907,FALSE,"out1, fill","0.1.4"
"32098","646",2023-08-01 08:15:00,-5771,1913,7684,907,FALSE,NA,"0.1.4"
"32099","646",2023-08-01 08:30:00,-5905,1913,7818,907,FALSE,NA,"0.1.4"
"32100","646",2023-08-01 08:45:00,-5937,1913,7850,907,FALSE,NA,"0.1.4"
"32101","646",2023-08-01 09:00:00,-6191.5,1913,8104.5,907,FALSE,"out1, fill","0.1.4"
"32102","646",2023-08-01 09:15:00,-6446,1913,8359,907,FALSE,NA,"0.1.4"
"32103","646",2023-08-01 09:30:00,-6446,1913,8359,907,FALSE,"jump1","0.1.4"
"32104","646",2023-08-01 09:45:00,-6408,1913,8321,907,FALSE,NA,"0.1.4"
"32105","646",2023-08-01 10:00:00,-6408,1913,8321,907,FALSE,NA,"0.1.4"
"32106","646",2023-08-01 10:15:00,-6409,1913,8322,907,FALSE,NA,"0.1.4"
"32107","646",2023-08-01 10:30:00,-6409,1913,8322,907,FALSE,NA,"0.1.4"
"32108","646",2023-08-01 10:45:00,-6408,1913,8321,907,FALSE,NA,"0.1.4"
"32109","646",2023-08-01 11:00:00,-6408,1913,8321,907,FALSE,NA,"0.1.4"
"32110","646",2023-08-01 11:15:00,-6612.16666666667,1913,8525.16666666667,907,FALSE,"out1, fill","0.1.4"
"32111","646",2023-08-01 11:30:00,-6816.33333333333,1913,8729.33333333333,907,FALSE,"out1, fill","0.1.4"
"32112","646",2023-08-01 11:45:00,-7020.5,1913,8933.5,907,FALSE,"out1, fill","0.1.4"
"32113","646",2023-08-01 12:00:00,-7224.66666666667,1913,9137.66666666667,907,FALSE,"out1, fill","0.1.4"
"32114","646",2023-08-01 12:15:00,-7428.83333333333,1913,9341.83333333333,907,FALSE,"out1, fill","0.1.4"
"32115","646",2023-08-01 12:30:00,-7633,1913,9546,907,FALSE,NA,"0.1.4"
"32116","646",2023-08-01 12:45:00,-7442,1913,9355,907,FALSE,NA,"0.1.4"
"32117","646",2023-08-01 13:00:00,-7535,1913,9448,907,FALSE,NA,"0.1.4"
"32118","646",2023-08-01 13:15:00,-7530,1913,9443,907,FALSE,NA,"0.1.4"
"32119","646",2023-08-01 13:30:00,-7499,1913,9412,907,FALSE,NA,"0.1.4"
"32120","646",2023-08-01 13:45:00,-7435,1913,9348,907,FALSE,NA,"0.1.4"
"32121","646",2023-08-01 14:00:00,-7273,1913,9186,907,FALSE,NA,"0.1.4"
"32122","646",2023-08-01 14:15:00,-6863,1913,8776,907,FALSE,NA,"0.1.4"
"32123","646",2023-08-01 14:30:00,-7205,1913,9118,907,FALSE,NA,"0.1.4"
"32124","646",2023-08-01 14:45:00,-7105,1913,9018,907,FALSE,NA,"0.1.4"
"32125","646",2023-08-01 15:00:00,-7491,1913,9404,907,FALSE,NA,"0.1.4"
"32126","646",2023-08-01 15:15:00,-7617,1913,9530,907,FALSE,NA,"0.1.4"
"32127","646",2023-08-01 15:30:00,-7617,1913,9530,907,FALSE,"jump1","0.1.4"
"32128","646",2023-08-01 15:45:00,-8101,1913,10014,907,FALSE,NA,"0.1.4"
"32129","646",2023-08-01 16:00:00,-8287,1913,10200,907,FALSE,NA,"0.1.4"
"32130","646",2023-08-01 16:15:00,-8259,1913,10172,907,FALSE,NA,"0.1.4"
"32131","646",2023-08-01 16:30:00,-8296,1913,10209,907,FALSE,NA,"0.1.4"
"32132","646",2023-08-01 16:45:00,-8133.75,1913,10046.75,907,FALSE,"out1, fill","0.1.4"
"32133","646",2023-08-01 17:00:00,-7971.5,1913,9884.5,907,FALSE,"out1, fill","0.1.4"
"32134","646",2023-08-01 17:15:00,-7809.25,1913,9722.25,907,FALSE,"out1, fill","0.1.4"
"32135","646",2023-08-01 17:30:00,-7647,1913,9560,907,FALSE,"out1, fill","0.1.4"
"32136","646",2023-08-01 17:45:00,-7484.75,1913,9397.75,907,FALSE,"out1, fill","0.1.4"
"32137","646",2023-08-01 18:00:00,-7322.5,1913,9235.5,907,FALSE,"out1, fill","0.1.4"
"32138","646",2023-08-01 18:15:00,-7160.25,1913,9073.25,907,FALSE,"out1, fill","0.1.4"
"32139","646",2023-08-01 18:30:00,-6998,1913,8911,907,FALSE,NA,"0.1.4"
"32140","646",2023-08-01 18:45:00,-6945,1913,8858,907,FALSE,NA,"0.1.4"
"32141","646",2023-08-01 19:00:00,-6945,1913,8858,907,FALSE,NA,"0.1.4"
"32142","646",2023-08-01 19:15:00,-7054,1913,8967,907,FALSE,NA,"0.1.4"
"32143","646",2023-08-01 19:30:00,-6948,1913,8861,907,FALSE,NA,"0.1.4"
"32144","646",2023-08-01 19:45:00,-6926,1913,8839,907,FALSE,NA,"0.1.4"
"32145","646",2023-08-01 20:00:00,-6950,1913,8863,907,FALSE,NA,"0.1.4"
"32146","646",2023-08-01 20:15:00,-6948.4,1913,8861.4,907,FALSE,"out1, fill","0.1.4"
"32147","646",2023-08-01 20:30:00,-6946.8,1913,8859.8,907,FALSE,"out1, fill","0.1.4"
"32148","646",2023-08-01 20:45:00,-6945.2,1913,8858.2,907,FALSE,"out1, fill","0.1.4"
"32149","646",2023-08-01 21:00:00,-6943.6,1913,8856.6,907,FALSE,"out1, fill","0.1.4"
"32150","646",2023-08-01 21:15:00,-6942,1913,8855,907,FALSE,NA,"0.1.4"
"32151","646",2023-08-01 21:30:00,-6936,1913,8849,907,FALSE,NA,"0.1.4"
"32152","646",2023-08-01 21:45:00,-6945,1913,8858,907,FALSE,NA,"0.1.4"
"32153","646",2023-08-01 22:00:00,-6944,1913,8857,907,FALSE,NA,"0.1.4"
"32154","646",2023-08-01 22:15:00,-6944,1913,8857,907,FALSE,NA,"0.1.4"
"32155","646",2023-08-01 22:30:00,-6944,1913,8857,907,FALSE,NA,"0.1.4"
"32156","646",2023-08-01 22:45:00,-6944,1913,8857,907,FALSE,NA,"0.1.4"
"32157","646",2023-08-01 23:00:00,-6941,1913,8854,907,FALSE,NA,"0.1.4"
"32158","646",2023-08-01 23:15:00,-6942,1913,8855,907,FALSE,NA,"0.1.4"
"32159","646",2023-08-01 23:30:00,-6945,1913,8858,907,FALSE,NA,"0.1.4"
"32160","646",2023-08-01 23:45:00,-6950,1913,8863,907,FALSE,NA,"0.1.4"
"32161","646",2023-08-02,-6950,1913,8863,907,FALSE,NA,"0.1.4"
"32162","646",2023-08-02 00:15:00,-6949,1913,8862,907,FALSE,NA,"0.1.4"
"32163","646",2023-08-02 00:30:00,-6950,1913,8863,907,FALSE,NA,"0.1.4"
"32164","646",2023-08-02 00:45:00,-6947,1913,8860,907,FALSE,NA,"0.1.4"
"32165","646",2023-08-02 01:00:00,-6930,1913,8843,907,FALSE,NA,"0.1.4"
"32166","646",2023-08-02 01:15:00,-6937,1913,8850,907,FALSE,NA,"0.1.4"
"32167","646",2023-08-02 01:30:00,-7032,1913,8945,907,FALSE,NA,"0.1.4"
"32168","646",2023-08-02 01:45:00,-7023.11111111111,1913,8936.11111111111,907,FALSE,"out1, fill","0.1.4"
"32169","646",2023-08-02 02:00:00,-7014.22222222222,1913,8927.22222222222,907,FALSE,"out1, fill","0.1.4"
"32170","646",2023-08-02 02:15:00,-7005.33333333333,1913,8918.33333333333,907,FALSE,"out1, fill","0.1.4"
"32171","646",2023-08-02 02:30:00,-6996.44444444444,1913,8909.44444444445,907,FALSE,"out1, fill","0.1.4"
"32172","646",2023-08-02 02:45:00,-6987.55555555556,1913,8900.55555555555,907,FALSE,"out1, fill","0.1.4"
"32173","646",2023-08-02 03:00:00,-6978.66666666667,1913,8891.66666666667,907,FALSE,"out1, fill","0.1.4"
"32174","646",2023-08-02 03:15:00,-6969.77777777778,1913,8882.77777777778,907,FALSE,"out1, fill","0.1.4"
"32175","646",2023-08-02 03:30:00,-6960.88888888889,1913,8873.88888888889,907,FALSE,"out1, fill","0.1.4"
"32176","646",2023-08-02 03:45:00,-6952,1913,8865,907,FALSE,NA,"0.1.4"
"32177","646",2023-08-02 04:00:00,-7108,1913,9021,907,FALSE,NA,"0.1.4"
"32178","646",2023-08-02 04:15:00,-7591,1913,9504,907,FALSE,NA,"0.1.4"
"32179","646",2023-08-02 04:30:00,-7591,1913,9504,907,FALSE,"jump1","0.1.4"
"32180","646",2023-08-02 04:45:00,-7591,1913,9504,907,FALSE,NA,"0.1.4"
"32181","646",2023-08-02 05:00:00,-7763,1913,9676,907,FALSE,NA,"0.1.4"
"32182","646",2023-08-02 05:15:00,-7590,1913,9503,907,FALSE,NA,"0.1.4"
"32183","646",2023-08-02 05:30:00,-7593,1913,9506,907,FALSE,NA,"0.1.4"
"32184","646",2023-08-02 05:45:00,-7593,1913,9506,907,FALSE,"out1, fill","0.1.4"
"32185","646",2023-08-02 06:00:00,-7593,1913,9506,907,FALSE,"jump1","0.1.4"
"32186","646",2023-08-02 06:15:00,-7430,1913,9343,907,FALSE,NA,"0.1.4"
"32187","646",2023-08-02 06:30:00,-7326,1913,9239,907,FALSE,NA,"0.1.4"
"32188","646",2023-08-02 06:45:00,-6893.5,1913,8806.5,907,FALSE,"out1, fill","0.1.4"
"32189","646",2023-08-02 07:00:00,-6461,1913,8374,907,FALSE,NA,"0.1.4"
"32190","646",2023-08-02 07:15:00,-6482,1913,8395,907,FALSE,NA,"0.1.4"
"32191","646",2023-08-02 07:30:00,-6504,1913,8417,907,FALSE,NA,"0.1.4"
"32192","646",2023-08-02 07:45:00,-6447,1913,8360,907,FALSE,NA,"0.1.4"
"32193","646",2023-08-02 08:00:00,-6659.5,1913,8572.5,907,FALSE,"out1, fill","0.1.4"
"32194","646",2023-08-02 08:15:00,-6872,1913,8785,907,FALSE,NA,"0.1.4"
"32195","646",2023-08-02 08:30:00,-6795,1913,8708,907,FALSE,NA,"0.1.4"
"32196","646",2023-08-02 08:45:00,-6446,1913,8359,907,FALSE,NA,"0.1.4"
"32197","646",2023-08-02 09:00:00,-6447,1913,8360,907,FALSE,"out1, fill","0.1.4"
"32198","646",2023-08-02 09:15:00,-6448,1913,8361,907,FALSE,"out1, fill","0.1.4"
"32199","646",2023-08-02 09:30:00,-6449,1913,8362,907,FALSE,NA,"0.1.4"
"32200","646",2023-08-02 09:45:00,-6450,1913,8363,907,FALSE,NA,"0.1.4"
"32201","646",2023-08-02 10:00:00,-6447,1913,8360,907,FALSE,NA,"0.1.4"
"32202","646",2023-08-02 10:15:00,-6449,1913,8362,907,FALSE,NA,"0.1.4"
"32203","646",2023-08-02 10:30:00,-6444,1913,8357,907,FALSE,NA,"0.1.4"
"32204","646",2023-08-02 10:45:00,-6444,1913,8357,907,FALSE,NA,"0.1.4"
"32205","646",2023-08-02 11:00:00,-6453,1913,8366,907,FALSE,NA,"0.1.4"
"32206","646",2023-08-02 11:15:00,-6593,1913,8506,907,FALSE,NA,"0.1.4"
"32207","646",2023-08-02 11:30:00,-6515,1913,8428,907,FALSE,NA,"0.1.4"
"32208","646",2023-08-02 11:45:00,-6943,1913,8856,907,FALSE,NA,"0.1.4"
"32209","646",2023-08-02 12:00:00,-6989.4,1913,8902.4,907,FALSE,"out1, fill","0.1.4"
"32210","646",2023-08-02 12:15:00,-7035.8,1913,8948.8,907,FALSE,"out1, fill","0.1.4"
"32211","646",2023-08-02 12:30:00,-7082.2,1913,8995.2,907,FALSE,"out1, fill","0.1.4"
"32212","646",2023-08-02 12:45:00,-7128.6,1913,9041.6,907,FALSE,"out1, fill","0.1.4"
"32213","646",2023-08-02 13:00:00,-7175,1913,9088,907,FALSE,NA,"0.1.4"
"32214","646",2023-08-02 13:15:00,-6810,1913,8723,907,FALSE,NA,"0.1.4"
"32215","646",2023-08-02 13:30:00,-6800,1913,8713,907,FALSE,NA,"0.1.4"
"32216","646",2023-08-02 13:45:00,-6665,1913,8578,907,FALSE,NA,"0.1.4"
"32217","646",2023-08-02 14:00:00,-7120.5,1913,9033.5,907,FALSE,"out1, fill","0.1.4"
"32218","646",2023-08-02 14:15:00,-7576,1913,9489,907,FALSE,NA,"0.1.4"
"32219","646",2023-08-02 14:30:00,-7547,1913,9460,907,FALSE,NA,"0.1.4"
"32220","646",2023-08-02 14:45:00,-7547,1913,9460,907,FALSE,"jump1","0.1.4"
"32221","646",2023-08-02 15:00:00,-7285,1913,9198,907,FALSE,NA,"0.1.4"
"32222","646",2023-08-02 15:15:00,-7195,1913,9108,907,FALSE,NA,"0.1.4"
"32223","646",2023-08-02 15:30:00,-7200,1913,9113,907,FALSE,NA,"0.1.4"
"32224","646",2023-08-02 15:45:00,-7236,1913,9149,907,FALSE,NA,"0.1.4"
"32225","646",2023-08-02 16:00:00,-7227.92857142857,1913,9140.92857142857,907,FALSE,"out1, fill","0.1.4"
"32226","646",2023-08-02 16:15:00,-7219.85714285714,1913,9132.85714285714,907,FALSE,"out1, fill","0.1.4"
"32227","646",2023-08-02 16:30:00,-7211.78571428571,1913,9124.78571428571,907,FALSE,"out1, fill","0.1.4"
"32228","646",2023-08-02 16:45:00,-7203.71428571429,1913,9116.71428571429,907,FALSE,"out1, fill","0.1.4"
"32229","646",2023-08-02 17:00:00,-7195.64285714286,1913,9108.64285714286,907,FALSE,"out1, fill","0.1.4"
"32230","646",2023-08-02 17:15:00,-7187.57142857143,1913,9100.57142857143,907,FALSE,"out1, fill","0.1.4"
"32231","646",2023-08-02 17:30:00,-7179.5,1913,9092.5,907,FALSE,"out1, fill","0.1.4"
"32232","646",2023-08-02 17:45:00,-7171.42857142857,1913,9084.42857142857,907,FALSE,"out1, fill","0.1.4"
"32233","646",2023-08-02 18:00:00,-7163.35714285714,1913,9076.35714285714,907,FALSE,"out1, fill","0.1.4"
"32234","646",2023-08-02 18:15:00,-7155.28571428571,1913,9068.28571428571,907,FALSE,"out1, fill","0.1.4"
"32235","646",2023-08-02 18:30:00,-7147.21428571429,1913,9060.21428571429,907,FALSE,"out1, fill","0.1.4"
"32236","646",2023-08-02 18:45:00,-7139.14285714286,1913,9052.14285714286,907,FALSE,"out1, fill","0.1.4"
"32237","646",2023-08-02 19:00:00,-7131.07142857143,1913,9044.07142857143,907,FALSE,"out1, fill","0.1.4"
"32238","646",2023-08-02 19:15:00,-7123,1913,9036,907,FALSE,NA,"0.1.4"
"32239","646",2023-08-02 19:30:00,-7124,1913,9037,907,FALSE,NA,"0.1.4"
"32240","646",2023-08-02 19:45:00,-7124,1913,9037,907,FALSE,NA,"0.1.4"
"32241","646",2023-08-02 20:00:00,-7123,1913,9036,907,FALSE,NA,"0.1.4"
"32242","646",2023-08-02 20:15:00,-7125,1913,9038,907,FALSE,NA,"0.1.4"
"32243","646",2023-08-02 20:30:00,-7124,1913,9037,907,FALSE,NA,"0.1.4"
"32244","646",2023-08-02 20:45:00,-7121,1913,9034,907,FALSE,NA,"0.1.4"
"32245","646",2023-08-02 21:00:00,-7125,1913,9038,907,FALSE,NA,"0.1.4"
"32246","646",2023-08-02 21:15:00,-7125,1913,9038,907,FALSE,"jump1","0.1.4"
"32247","646",2023-08-02 21:30:00,-6858,1913,8771,907,FALSE,NA,"0.1.4"
"32248","646",2023-08-02 21:45:00,-6858,1913,8771,907,FALSE,"jump1","0.1.4"
"32249","646",2023-08-02 22:00:00,-6586,1913,8499,907,FALSE,NA,"0.1.4"
"32250","646",2023-08-02 22:15:00,-6554,1913,8467,907,FALSE,NA,"0.1.4"
"32251","646",2023-08-02 22:30:00,-6323,1913,8236,907,FALSE,NA,"0.1.4"
"32252","646",2023-08-02 22:45:00,-6433,1913,8346,907,FALSE,NA,"0.1.4"
"32253","646",2023-08-02 23:00:00,-6661,1913,8574,907,FALSE,NA,"0.1.4"
"32254","646",2023-08-02 23:15:00,-6698,1913,8611,907,FALSE,NA,"0.1.4"
"32255","646",2023-08-02 23:30:00,-6661,1913,8574,907,FALSE,NA,"0.1.4"
"32256","646",2023-08-02 23:45:00,-6631.5,1913,8544.5,907,FALSE,"out1, fill","0.1.4"
"32257","646",2023-08-03,-6602,1913,8515,907,FALSE,NA,"0.1.4"
"32258","646",2023-08-03 00:15:00,-6211,1913,8124,907,FALSE,NA,"0.1.4"
"32259","646",2023-08-03 00:30:00,-5894,1913,7807,907,FALSE,NA,"0.1.4"
"32260","646",2023-08-03 00:45:00,-5895,1913,7808,907,FALSE,NA,"0.1.4"
"32261","646",2023-08-03 01:00:00,-5895,1913,7808,907,FALSE,NA,"0.1.4"
"32262","646",2023-08-03 01:15:00,-5895,1913,7808,907,FALSE,"out1, fill","0.1.4"
"32263","646",2023-08-03 01:30:00,-5895,1913,7808,907,FALSE,"jump1","0.1.4"
"32264","646",2023-08-03 01:45:00,-5895,1913,7808,907,FALSE,"jump1","0.1.4"
"32265","646",2023-08-03 02:00:00,-5982,1913,7895,907,FALSE,NA,"0.1.4"
"32266","646",2023-08-03 02:15:00,-5982,1913,7895,907,FALSE,"jump1","0.1.4"
"32267","646",2023-08-03 02:30:00,-5974,1913,7887,907,FALSE,NA,"0.1.4"
"32268","646",2023-08-03 02:45:00,-5978.33333333333,1913,7891.33333333333,907,FALSE,"out1, fill","0.1.4"
"32269","646",2023-08-03 03:00:00,-5982.66666666667,1913,7895.66666666667,907,FALSE,"out1, fill","0.1.4"
"32270","646",2023-08-03 03:15:00,-5987,1913,7900,907,FALSE,NA,"0.1.4"
"32271","646",2023-08-03 03:30:00,-6121,1913,8034,907,FALSE,NA,"0.1.4"
"32272","646",2023-08-03 03:45:00,-6285,1913,8198,907,FALSE,NA,"0.1.4"
"32273","646",2023-08-03 04:00:00,-5972,1913,7885,907,FALSE,NA,"0.1.4"
"32274","646",2023-08-03 04:15:00,-5972,1913,7885,907,FALSE,"jump1","0.1.4"
"32275","646",2023-08-03 04:30:00,-5858,1913,7771,907,FALSE,NA,"0.1.4"
"32276","646",2023-08-03 04:45:00,-6095,1913,8008,907,FALSE,NA,"0.1.4"
"32277","646",2023-08-03 05:00:00,-6457,1913,8370,907,FALSE,NA,"0.1.4"
"32278","646",2023-08-03 05:15:00,-6241,1913,8154,907,FALSE,"out1, fill","0.1.4"
"32279","646",2023-08-03 05:30:00,-6025,1913,7938,907,FALSE,NA,"0.1.4"
"32280","646",2023-08-03 05:45:00,-5844,1913,7757,907,FALSE,NA,"0.1.4"
"32281","646",2023-08-03 06:00:00,-5510,1913,7423,907,FALSE,NA,"0.1.4"
"32282","646",2023-08-03 06:15:00,-5796,1913,7709,907,FALSE,NA,"0.1.4"
"32283","646",2023-08-03 06:30:00,-5302,1913,7215,907,FALSE,NA,"0.1.4"
"32284","646",2023-08-03 06:45:00,-5302,1913,7215,907,FALSE,NA,"0.1.4"
"32285","646",2023-08-03 07:00:00,-5302,1913,7215,907,FALSE,NA,"0.1.4"
"32286","646",2023-08-03 07:15:00,-5301,1913,7214,907,FALSE,NA,"0.1.4"
"32287","646",2023-08-03 07:30:00,-5452,1913,7365,907,FALSE,NA,"0.1.4"
"32288","646",2023-08-03 07:45:00,-5642.66666666667,1913,7555.66666666667,907,FALSE,"out1, fill","0.1.4"
"32289","646",2023-08-03 08:00:00,-5833.33333333333,1913,7746.33333333333,907,FALSE,"out1, fill","0.1.4"
"32290","646",2023-08-03 08:15:00,-6024,1913,7937,907,FALSE,"out1, fill","0.1.4"
"32291","646",2023-08-03 08:30:00,-6214.66666666667,1913,8127.66666666667,907,FALSE,"out1, fill","0.1.4"
"32292","646",2023-08-03 08:45:00,-6405.33333333333,1913,8318.33333333333,907,FALSE,"out1, fill","0.1.4"
"32293","646",2023-08-03 09:00:00,-6596,1913,8509,907,FALSE,NA,"0.1.4"
"32294","646",2023-08-03 09:15:00,-6606,1913,8519,907,FALSE,NA,"0.1.4"
"32295","646",2023-08-03 09:30:00,-6918,1913,8831,907,FALSE,NA,"0.1.4"
"32296","646",2023-08-03 09:45:00,-6918,1913,8831,907,FALSE,"jump1","0.1.4"
"32297","646",2023-08-03 10:00:00,-6918,1913,8831,907,FALSE,"jump1","0.1.4"
"32298","646",2023-08-03 10:15:00,-6836,1913,8749,907,FALSE,NA,"0.1.4"
"32299","646",2023-08-03 10:30:00,-6771,1913,8684,907,FALSE,NA,"0.1.4"
"32300","646",2023-08-03 10:45:00,-6965,1913,8878,907,FALSE,NA,"0.1.4"
"32301","646",2023-08-03 11:00:00,-6923,1913,8836,907,FALSE,NA,"0.1.4"
"32302","646",2023-08-03 11:15:00,-6923,1913,8836,907,FALSE,"jump1","0.1.4"
"32303","646",2023-08-03 11:30:00,-6833,1913,8746,907,FALSE,NA,"0.1.4"
"32304","646",2023-08-03 11:45:00,-6933,1913,8846,907,FALSE,NA,"0.1.4"
"32305","646",2023-08-03 12:00:00,-6445,1913,8358,907,FALSE,NA,"0.1.4"
"32306","646",2023-08-03 12:15:00,-6944,1913,8857,907,FALSE,NA,"0.1.4"
"32307","646",2023-08-03 12:30:00,-6934,1913,8847,907,FALSE,NA,"0.1.4"
"32308","646",2023-08-03 12:45:00,-7112,1913,9025,907,FALSE,NA,"0.1.4"
"32309","646",2023-08-03 13:00:00,-6823.75,1913,8736.75,907,FALSE,"out1, fill","0.1.4"
"32310","646",2023-08-03 13:15:00,-6535.5,1913,8448.5,907,FALSE,"out1, fill","0.1.4"
"32311","646",2023-08-03 13:30:00,-6247.25,1913,8160.25,907,FALSE,"out1, fill","0.1.4"
"32312","646",2023-08-03 13:45:00,-5959,1913,7872,907,FALSE,NA,"0.1.4"
"32313","646",2023-08-03 14:00:00,-5917,1913,7830,907,FALSE,NA,"0.1.4"
"32314","646",2023-08-03 14:15:00,-5923,1913,7836,907,FALSE,NA,"0.1.4"
"32315","646",2023-08-03 14:30:00,-5916,1913,7829,907,FALSE,NA,"0.1.4"
"32316","646",2023-08-03 14:45:00,-5918,1913,7831,907,FALSE,NA,"0.1.4"
"32317","646",2023-08-03 15:00:00,-5917,1913,7830,907,FALSE,NA,"0.1.4"
"32318","646",2023-08-03 15:15:00,-6096,1913,8009,907,FALSE,NA,"0.1.4"
"32319","646",2023-08-03 15:30:00,-6500,1913,8413,907,FALSE,NA,"0.1.4"
"32320","646",2023-08-03 15:45:00,-6088,1913,8001,907,FALSE,NA,"0.1.4"
"32321","646",2023-08-03 16:00:00,-5909,1913,7822,907,FALSE,NA,"0.1.4"
"32322","646",2023-08-03 16:15:00,-5907,1913,7820,907,FALSE,NA,"0.1.4"
"32323","646",2023-08-03 16:30:00,-5901,1913,7814,907,FALSE,NA,"0.1.4"
"32324","646",2023-08-03 16:45:00,-5889,1913,7802,907,FALSE,NA,"0.1.4"
"32325","646",2023-08-03 17:00:00,-6052,1913,7965,907,FALSE,NA,"0.1.4"
"32326","646",2023-08-03 17:15:00,-5972,1913,7885,907,FALSE,NA,"0.1.4"
"32327","646",2023-08-03 17:30:00,-5941.66666666667,1913,7854.66666666667,907,FALSE,"out1, fill","0.1.4"
"32328","646",2023-08-03 17:45:00,-5911.33333333333,1913,7824.33333333333,907,FALSE,"out1, fill","0.1.4"
"32329","646",2023-08-03 18:00:00,-5881,1913,7794,907,FALSE,NA,"0.1.4"
"32330","646",2023-08-03 18:15:00,-6049,1913,7962,907,FALSE,NA,"0.1.4"
"32331","646",2023-08-03 18:30:00,-5891,1913,7804,907,FALSE,NA,"0.1.4"
"32332","646",2023-08-03 18:45:00,-5891,1913,7804,907,FALSE,NA,"0.1.4"
"32333","646",2023-08-03 19:00:00,-5893,1913,7806,907,FALSE,NA,"0.1.4"
"32334","646",2023-08-03 19:15:00,-6083,1913,7996,907,FALSE,NA,"0.1.4"
"32335","646",2023-08-03 19:30:00,-5981,1913,7894,907,FALSE,NA,"0.1.4"
"32336","646",2023-08-03 19:45:00,-5895,1913,7808,907,FALSE,NA,"0.1.4"
"32337","646",2023-08-03 20:00:00,-5895,1913,7808,907,FALSE,NA,"0.1.4"
"32338","646",2023-08-03 20:15:00,-5894,1913,7807,907,FALSE,NA,"0.1.4"
"32339","646",2023-08-03 20:30:00,-5895,1913,7808,907,FALSE,NA,"0.1.4"
"32340","646",2023-08-03 20:45:00,-5895,1913,7808,907,FALSE,NA,"0.1.4"
"32341","646",2023-08-03 21:00:00,-5893,1913,7806,907,FALSE,NA,"0.1.4"
"32342","646",2023-08-03 21:15:00,-5895,1913,7808,907,FALSE,NA,"0.1.4"
"32343","646",2023-08-03 21:30:00,-6169,1913,8082,907,FALSE,NA,"0.1.4"
"32344","646",2023-08-03 21:45:00,-5991,1913,7904,907,FALSE,NA,"0.1.4"
"32345","646",2023-08-03 22:00:00,-6062,1913,7975,907,FALSE,NA,"0.1.4"
"32346","646",2023-08-03 22:15:00,-5929,1913,7842,907,FALSE,NA,"0.1.4"
"32347","646",2023-08-03 22:30:00,-5899,1913,7812,907,FALSE,NA,"0.1.4"
"32348","646",2023-08-03 22:45:00,-5902,1913,7815,907,FALSE,NA,"0.1.4"
"32349","646",2023-08-03 23:00:00,-5918,1913,7831,907,FALSE,NA,"0.1.4"
"32350","646",2023-08-03 23:15:00,-5914,1913,7827,907,FALSE,NA,"0.1.4"
"32351","646",2023-08-03 23:30:00,-5920,1913,7833,907,FALSE,NA,"0.1.4"
"32352","646",2023-08-03 23:45:00,-5904,1913,7817,907,FALSE,NA,"0.1.4"
"32353","646",2023-08-04,-5910,1913,7823,907,FALSE,NA,"0.1.4"
"32354","646",2023-08-04 00:15:00,-5920,1913,7833,907,FALSE,NA,"0.1.4"
"32355","646",2023-08-04 00:30:00,-5903,1913,7816,907,FALSE,NA,"0.1.4"
"32356","646",2023-08-04 00:45:00,-6293,1913,8206,907,FALSE,NA,"0.1.4"
"32357","646",2023-08-04 01:00:00,-5934,1913,7847,907,FALSE,NA,"0.1.4"
"32358","646",2023-08-04 01:15:00,-5895,1913,7808,907,FALSE,NA,"0.1.4"
"32359","646",2023-08-04 01:30:00,-5893,1913,7806,907,FALSE,NA,"0.1.4"
"32360","646",2023-08-04 01:45:00,-5909,1913,7822,907,FALSE,NA,"0.1.4"
"32361","646",2023-08-04 02:00:00,-5906.71428571429,1913,7819.71428571429,907,FALSE,"out1, fill","0.1.4"
"32362","646",2023-08-04 02:15:00,-5904.42857142857,1913,7817.42857142857,907,FALSE,"out1, fill","0.1.4"
"32363","646",2023-08-04 02:30:00,-5902.14285714286,1913,7815.14285714286,907,FALSE,"out1, fill","0.1.4"
"32364","646",2023-08-04 02:45:00,-5899.85714285714,1913,7812.85714285714,907,FALSE,"out1, fill","0.1.4"
"32365","646",2023-08-04 03:00:00,-5897.57142857143,1913,7810.57142857143,907,FALSE,"out1, fill","0.1.4"
"32366","646",2023-08-04 03:15:00,-5895.28571428571,1913,7808.28571428571,907,FALSE,"out1, fill","0.1.4"
"32367","646",2023-08-04 03:30:00,-5893,1913,7806,907,FALSE,NA,"0.1.4"
"32368","646",2023-08-04 03:45:00,-6385,1913,8298,907,FALSE,NA,"0.1.4"
"32369","646",2023-08-04 04:00:00,-5891,1913,7804,907,FALSE,NA,"0.1.4"
"32370","646",2023-08-04 04:15:00,-5898,1913,7811,907,FALSE,NA,"0.1.4"
"32371","646",2023-08-04 04:30:00,-5893,1913,7806,907,FALSE,NA,"0.1.4"
"32372","646",2023-08-04 04:45:00,-5892,1913,7805,907,FALSE,NA,"0.1.4"
"32373","646",2023-08-04 05:00:00,-5892,1913,7805,907,FALSE,NA,"0.1.4"
"32374","646",2023-08-04 05:15:00,-5891,1913,7804,907,FALSE,NA,"0.1.4"
"32375","646",2023-08-04 05:30:00,-5897,1913,7810,907,FALSE,NA,"0.1.4"
"32376","646",2023-08-04 05:45:00,-5890,1913,7803,907,FALSE,NA,"0.1.4"
"32377","646",2023-08-04 06:00:00,-5901,1913,7814,907,FALSE,NA,"0.1.4"
"32378","646",2023-08-04 06:15:00,-5890,1913,7803,907,FALSE,NA,"0.1.4"
"32379","646",2023-08-04 06:30:00,-5993.85714285714,1913,7906.85714285714,907,FALSE,"out1, fill","0.1.4"
"32380","646",2023-08-04 06:45:00,-6097.71428571429,1913,8010.71428571429,907,FALSE,"out1, fill","0.1.4"
"32381","646",2023-08-04 07:00:00,-6201.57142857143,1913,8114.57142857143,907,FALSE,"out1, fill","0.1.4"
"32382","646",2023-08-04 07:15:00,-6305.42857142857,1913,8218.42857142857,907,FALSE,"out1, fill","0.1.4"
"32383","646",2023-08-04 07:30:00,-6409.28571428571,1913,8322.28571428571,907,FALSE,"out1, fill","0.1.4"
"32384","646",2023-08-04 07:45:00,-6513.14285714286,1913,8426.14285714286,907,FALSE,"out1, fill","0.1.4"
"32385","646",2023-08-04 08:00:00,-6617,1913,8530,907,FALSE,NA,"0.1.4"
"32386","646",2023-08-04 08:15:00,-6617,1913,8530,907,FALSE,"jump1","0.1.4"
"32387","646",2023-08-04 08:30:00,-6617,1913,8530,907,FALSE,"jump1","0.1.4"
"32388","646",2023-08-04 08:45:00,-6605,1913,8518,907,FALSE,NA,"0.1.4"
"32389","646",2023-08-04 09:00:00,-7020,1913,8933,907,FALSE,NA,"0.1.4"
"32390","646",2023-08-04 09:15:00,-7093,1913,9006,907,FALSE,NA,"0.1.4"
"32391","646",2023-08-04 09:30:00,-7137,1913,9050,907,FALSE,NA,"0.1.4"
"32392","646",2023-08-04 09:45:00,-6681.5,1913,8594.5,907,FALSE,"out1, fill","0.1.4"
"32393","646",2023-08-04 10:00:00,-6226,1913,8139,907,FALSE,NA,"0.1.4"
"32394","646",2023-08-04 10:15:00,-6339,1913,8252,907,FALSE,NA,"0.1.4"
"32395","646",2023-08-04 10:30:00,-6727,1913,8640,907,FALSE,NA,"0.1.4"
"32396","646",2023-08-04 10:45:00,-6727,1913,8640,907,FALSE,"jump1","0.1.4"
"32397","646",2023-08-04 11:00:00,-6791,1913,8704,907,FALSE,NA,"0.1.4"
"32398","646",2023-08-04 11:15:00,-6867,1913,8780,907,FALSE,NA,"0.1.4"
"32399","646",2023-08-04 11:30:00,-7079,1913,8992,907,FALSE,NA,"0.1.4"
"32400","646",2023-08-04 11:45:00,-7345,1913,9258,907,FALSE,NA,"0.1.4"
"32401","646",2023-08-04 12:00:00,-6888,1913,8801,907,FALSE,NA,"0.1.4"
"32402","646",2023-08-04 12:15:00,-6893,1913,8806,907,FALSE,"out1, fill","0.1.4"
"32403","646",2023-08-04 12:30:00,-6898,1913,8811,907,FALSE,"out1, fill","0.1.4"
"32404","646",2023-08-04 12:45:00,-6903,1913,8816,907,FALSE,NA,"0.1.4"
"32405","646",2023-08-04 13:00:00,-7122,1913,9035,907,FALSE,NA,"0.1.4"
"32406","646",2023-08-04 13:15:00,-7070,1913,8983,907,FALSE,NA,"0.1.4"
"32407","646",2023-08-04 13:30:00,-7276,1913,9189,907,FALSE,NA,"0.1.4"
"32408","646",2023-08-04 13:45:00,-6845,1913,8758,907,FALSE,NA,"0.1.4"
"32409","646",2023-08-04 14:00:00,-6876,1913,8789,907,FALSE,NA,"0.1.4"
"32410","646",2023-08-04 14:15:00,-6833,1913,8746,907,FALSE,NA,"0.1.4"
"32411","646",2023-08-04 14:30:00,-7072,1913,8985,907,FALSE,NA,"0.1.4"
"32412","646",2023-08-04 14:45:00,-7545,1913,9458,907,FALSE,NA,"0.1.4"
"32413","646",2023-08-04 15:00:00,-7391.66666666667,1913,9304.66666666667,907,FALSE,"out1, fill","0.1.4"
"32414","646",2023-08-04 15:15:00,-7238.33333333333,1913,9151.33333333333,907,FALSE,"out1, fill","0.1.4"
"32415","646",2023-08-04 15:30:00,-7085,1913,8998,907,FALSE,NA,"0.1.4"
"32416","646",2023-08-04 15:45:00,-7085,1913,8998,907,FALSE,"jump1","0.1.4"
"32417","646",2023-08-04 16:00:00,-7272,1913,9185,907,FALSE,NA,"0.1.4"
"32418","646",2023-08-04 16:15:00,-7614,1913,9527,907,FALSE,NA,"0.1.4"
"32419","646",2023-08-04 16:30:00,-7871,1913,9784,907,FALSE,NA,"0.1.4"
"32420","646",2023-08-04 16:45:00,-7657,1913,9570,907,FALSE,NA,"0.1.4"
"32421","646",2023-08-04 17:00:00,-7655,1913,9568,907,FALSE,NA,"0.1.4"
"32422","646",2023-08-04 17:15:00,-7455.25,1913,9368.25,907,FALSE,"out1, fill","0.1.4"
"32423","646",2023-08-04 17:30:00,-7255.5,1913,9168.5,907,FALSE,"out1, fill","0.1.4"
"32424","646",2023-08-04 17:45:00,-7055.75,1913,8968.75,907,FALSE,"out1, fill","0.1.4"
"32425","646",2023-08-04 18:00:00,-6856,1913,8769,907,FALSE,NA,"0.1.4"
"32426","646",2023-08-04 18:15:00,-7142,1913,9055,907,FALSE,NA,"0.1.4"
"32427","646",2023-08-04 18:30:00,-6759,1913,8672,907,FALSE,NA,"0.1.4"
"32428","646",2023-08-04 18:45:00,-6759,1913,8672,907,FALSE,"jump1","0.1.4"
"32429","646",2023-08-04 19:00:00,-6559,1913,8472,907,FALSE,NA,"0.1.4"
"32430","646",2023-08-04 19:15:00,-6558,1913,8471,907,FALSE,NA,"0.1.4"
"32431","646",2023-08-04 19:30:00,-6560,1913,8473,907,FALSE,NA,"0.1.4"
"32432","646",2023-08-04 19:45:00,-6560,1913,8473,907,FALSE,NA,"0.1.4"
"32433","646",2023-08-04 20:00:00,-6558,1913,8471,907,FALSE,NA,"0.1.4"
"32434","646",2023-08-04 20:15:00,-6629,1913,8542,907,FALSE,NA,"0.1.4"
"32435","646",2023-08-04 20:30:00,-6553,1913,8466,907,FALSE,NA,"0.1.4"
"32436","646",2023-08-04 20:45:00,-6548,1913,8461,907,FALSE,NA,"0.1.4"
"32437","646",2023-08-04 21:00:00,-6557,1913,8470,907,FALSE,NA,"0.1.4"
"32438","646",2023-08-04 21:15:00,-6554,1913,8467,907,FALSE,NA,"0.1.4"
"32439","646",2023-08-04 21:30:00,-6575,1913,8488,907,FALSE,NA,"0.1.4"
"32440","646",2023-08-04 21:45:00,-6548,1913,8461,907,FALSE,NA,"0.1.4"
"32441","646",2023-08-04 22:00:00,-6558,1913,8471,907,FALSE,NA,"0.1.4"
"32442","646",2023-08-04 22:15:00,-6561,1913,8474,907,FALSE,NA,"0.1.4"
"32443","646",2023-08-04 22:30:00,-6560,1913,8473,907,FALSE,NA,"0.1.4"
"32444","646",2023-08-04 22:45:00,-6560,1913,8473,907,FALSE,NA,"0.1.4"
"32445","646",2023-08-04 23:00:00,-6557,1913,8470,907,FALSE,NA,"0.1.4"
"32446","646",2023-08-04 23:15:00,-6561,1913,8474,907,FALSE,NA,"0.1.4"
"32447","646",2023-08-04 23:30:00,-6560,1913,8473,907,FALSE,NA,"0.1.4"
"32448","646",2023-08-04 23:45:00,-6561,1913,8474,907,FALSE,NA,"0.1.4"
"32449","646",2023-08-05,-6553,1913,8466,907,FALSE,NA,"0.1.4"
"32450","646",2023-08-05 00:15:00,-6551,1913,8464,907,FALSE,NA,"0.1.4"
"32451","646",2023-08-05 00:30:00,-6560,1913,8473,907,FALSE,NA,"0.1.4"
"32452","646",2023-08-05 00:45:00,-6560,1913,8473,907,FALSE,NA,"0.1.4"
"32453","646",2023-08-05 01:00:00,-6557,1913,8470,907,FALSE,NA,"0.1.4"
"32454","646",2023-08-05 01:15:00,-6556,1913,8469,907,FALSE,NA,"0.1.4"
"32455","646",2023-08-05 01:30:00,-6561,1913,8474,907,FALSE,NA,"0.1.4"
"32456","646",2023-08-05 01:45:00,-6599,1913,8512,907,FALSE,NA,"0.1.4"
"32457","646",2023-08-05 02:00:00,-6546,1913,8459,907,FALSE,NA,"0.1.4"
"32458","646",2023-08-05 02:15:00,-6579,1913,8492,907,FALSE,NA,"0.1.4"
"32459","646",2023-08-05 02:30:00,-6595,1913,8508,907,FALSE,NA,"0.1.4"
"32460","646",2023-08-05 02:45:00,-6534,1913,8447,907,FALSE,NA,"0.1.4"
"32461","646",2023-08-05 03:00:00,-6542,1913,8455,907,FALSE,NA,"0.1.4"
"32462","646",2023-08-05 03:15:00,-6590,1913,8503,907,FALSE,NA,"0.1.4"
"32463","646",2023-08-05 03:30:00,-7061,1913,8974,907,FALSE,"out1, fill","0.1.4"
"32464","646",2023-08-05 03:45:00,-7532,1913,9445,907,FALSE,"out1, fill","0.1.4"
"32465","646",2023-08-05 04:00:00,-8003,1913,9916,907,FALSE,NA,"0.1.4"
"32466","646",2023-08-05 04:15:00,-7588,1913,9501,907,FALSE,NA,"0.1.4"
"32467","646",2023-08-05 04:30:00,-7588,1913,9501,907,FALSE,"jump1","0.1.4"
"32468","646",2023-08-05 04:45:00,-7116,1913,9029,907,FALSE,NA,"0.1.4"
"32469","646",2023-08-05 05:00:00,-7116,1913,9029,907,FALSE,"out1, fill","0.1.4"
"32470","646",2023-08-05 05:15:00,-7116,1913,9029,907,FALSE,"jump1","0.1.4"
"32471","646",2023-08-05 05:30:00,-7040,1913,8953,907,FALSE,NA,"0.1.4"
"32472","646",2023-08-05 05:45:00,-6732,1913,8645,907,FALSE,NA,"0.1.4"
"32473","646",2023-08-05 06:00:00,-6862,1913,8775,907,FALSE,NA,"0.1.4"
"32474","646",2023-08-05 06:15:00,-6898.66666666667,1913,8811.66666666667,907,FALSE,"out1, fill","0.1.4"
"32475","646",2023-08-05 06:30:00,-6935.33333333333,1913,8848.33333333333,907,FALSE,"out1, fill","0.1.4"
"32476","646",2023-08-05 06:45:00,-6972,1913,8885,907,FALSE,NA,"0.1.4"
"32477","646",2023-08-05 07:00:00,-6483,1913,8396,907,FALSE,NA,"0.1.4"
"32478","646",2023-08-05 07:15:00,-6510,1913,8423,907,FALSE,NA,"0.1.4"
"32479","646",2023-08-05 07:30:00,-6074,1913,7987,907,FALSE,"out1, fill","0.1.4"
"32480","646",2023-08-05 07:45:00,-5638,1913,7551,907,FALSE,NA,"0.1.4"
"32481","646",2023-08-05 08:00:00,-5637,1913,7550,907,FALSE,NA,"0.1.4"
"32482","646",2023-08-05 08:15:00,-5635,1913,7548,907,FALSE,NA,"0.1.4"
"32483","646",2023-08-05 08:30:00,-5635,1913,7548,907,FALSE,"out1, fill","0.1.4"
"32484","646",2023-08-05 08:45:00,-5635,1913,7548,907,FALSE,"jump1","0.1.4"
"32485","646",2023-08-05 09:00:00,-5668,1913,7581,907,FALSE,NA,"0.1.4"
"32486","646",2023-08-05 09:15:00,-5370,1913,7283,907,FALSE,NA,"0.1.4"
"32487","646",2023-08-05 09:30:00,-5497,1913,7410,907,FALSE,NA,"0.1.4"
"32488","646",2023-08-05 09:45:00,-5426,1913,7339,907,FALSE,NA,"0.1.4"
"32489","646",2023-08-05 10:00:00,-5628,1913,7541,907,FALSE,NA,"0.1.4"
"32490","646",2023-08-05 10:15:00,-5907,1913,7820,907,FALSE,NA,"0.1.4"
"32491","646",2023-08-05 10:30:00,NA,NA,NA,NA,NA,"out1","0.1.4"
"32492","646",2023-08-05 10:45:00,NA,NA,NA,NA,NA,"out1","0.1.4"
"32493","646",2023-08-05 11:00:00,NA,NA,NA,NA,NA,"out1","0.1.4"
"32494","646",2023-08-05 11:15:00,NA,NA,NA,NA,NA,"out1","0.1.4"
"32495","646",2023-08-05 11:30:00,NA,NA,NA,NA,NA,"out1","0.1.4"
"32496","646",2023-08-05 11:45:00,NA,NA,NA,NA,NA,"out1","0.1.4"
"32497","646",2023-08-05 12:00:00,NA,NA,NA,NA,NA,"out1","0.1.4"
"32498","646",2023-08-05 12:15:00,NA,NA,NA,NA,NA,"out1","0.1.4"
"32499","646",2023-08-05 12:30:00,NA,NA,NA,NA,NA,"out1","0.1.4"
"32500","646",2023-08-05 12:45:00,NA,NA,NA,NA,NA,"out1","0.1.4"
"32501","646",2023-08-05 13:00:00,NA,NA,NA,NA,NA,"out1","0.1.4"
"32502","646",2023-08-05 13:15:00,NA,NA,NA,NA,NA,"out1","0.1.4"
"32503","646",2023-08-05 13:30:00,NA,NA,NA,NA,NA,"out1","0.1.4"
"32504","646",2023-08-05 13:45:00,NA,NA,NA,NA,NA,"out1","0.1.4"
"32505","646",2023-08-05 14:00:00,NA,NA,NA,NA,NA,"out1","0.1.4"
"32506","646",2023-08-05 14:15:00,NA,NA,NA,NA,NA,"out1","0.1.4"
"32507","646",2023-08-05 14:30:00,NA,NA,NA,NA,NA,"out1","0.1.4"
"32508","646",2023-08-05 14:45:00,-5839,1913,7752,907,FALSE,NA,"0.1.4"
"32509","646",2023-08-05 15:00:00,-5528,1913,7441,907,FALSE,NA,"0.1.4"
"32510","646",2023-08-05 15:15:00,-5528,1913,7441,907,FALSE,"jump1","0.1.4"
"32511","646",2023-08-05 15:30:00,-5590,1913,7503,907,FALSE,NA,"0.1.4"
"32512","646",2023-08-05 15:45:00,-5590,1913,7503,907,FALSE,"jump1","0.1.4"
"32513","646",2023-08-05 16:00:00,-5590,1913,7503,907,FALSE,"jump1","0.1.4"
"32514","646",2023-08-05 16:15:00,-5590,1913,7503,907,FALSE,"out1, fill","0.1.4"
"32515","646",2023-08-05 16:30:00,-5590,1913,7503,907,FALSE,"jump1","0.1.4"
"32516","646",2023-08-05 16:45:00,-5532,1913,7445,907,FALSE,NA,"0.1.4"
"32517","646",2023-08-05 17:00:00,-5566,1913,7479,907,FALSE,NA,"0.1.4"
"32518","646",2023-08-05 17:15:00,-5617,1913,7530,907,FALSE,NA,"0.1.4"
"32519","646",2023-08-05 17:30:00,-5868,1913,7781,907,FALSE,NA,"0.1.4"
"32520","646",2023-08-05 17:45:00,-5601,1913,7514,907,FALSE,NA,"0.1.4"
"32521","646",2023-08-05 18:00:00,-5612,1913,7525,907,FALSE,NA,"0.1.4"
"32522","646",2023-08-05 18:15:00,-5490,1913,7403,907,FALSE,NA,"0.1.4"
"32523","646",2023-08-05 18:30:00,-5483,1913,7396,907,FALSE,NA,"0.1.4"
"32524","646",2023-08-05 18:45:00,-5506,1913,7419,907,FALSE,NA,"0.1.4"
"32525","646",2023-08-05 19:00:00,-5490,1913,7403,907,FALSE,NA,"0.1.4"
"32526","646",2023-08-05 19:15:00,-5490,1913,7403,907,FALSE,NA,"0.1.4"
"32527","646",2023-08-05 19:30:00,-5505,1913,7418,907,FALSE,NA,"0.1.4"
"32528","646",2023-08-05 19:45:00,-5506,1913,7419,907,FALSE,NA,"0.1.4"
"32529","646",2023-08-05 20:00:00,-5506,1913,7419,907,FALSE,NA,"0.1.4"
"32530","646",2023-08-05 20:15:00,-5506,1913,7419,907,FALSE,NA,"0.1.4"
"32531","646",2023-08-05 20:30:00,-5504,1913,7417,907,FALSE,NA,"0.1.4"
"32532","646",2023-08-05 20:45:00,-5493,1913,7406,907,FALSE,NA,"0.1.4"
"32533","646",2023-08-05 21:00:00,-5506,1913,7419,907,FALSE,NA,"0.1.4"
"32534","646",2023-08-05 21:15:00,-5494,1913,7407,907,FALSE,NA,"0.1.4"
"32535","646",2023-08-05 21:30:00,-5496,1913,7409,907,FALSE,NA,"0.1.4"
"32536","646",2023-08-05 21:45:00,-5507,1913,7420,907,FALSE,NA,"0.1.4"
"32537","646",2023-08-05 22:00:00,-5507,1913,7420,907,FALSE,NA,"0.1.4"
"32538","646",2023-08-05 22:15:00,-5504,1913,7417,907,FALSE,NA,"0.1.4"
"32539","646",2023-08-05 22:30:00,-5463,1913,7376,907,FALSE,NA,"0.1.4"
"32540","646",2023-08-05 22:45:00,-5467,1913,7380,907,FALSE,NA,"0.1.4"
"32541","646",2023-08-05 23:00:00,-5480.66666666667,1913,7393.66666666667,907,FALSE,"out1, fill","0.1.4"
"32542","646",2023-08-05 23:15:00,-5494.33333333333,1913,7407.33333333333,907,FALSE,"out1, fill","0.1.4"
"32543","646",2023-08-05 23:30:00,-5508,1913,7421,907,FALSE,NA,"0.1.4"
"32544","646",2023-08-05 23:45:00,-5508,1913,7421,907,FALSE,NA,"0.1.4"
"32545","646",2023-08-06,-5501,1913,7414,907,FALSE,NA,"0.1.4"
"32546","646",2023-08-06 00:15:00,-5516,1913,7429,907,FALSE,NA,"0.1.4"
"32547","646",2023-08-06 00:30:00,-5505,1913,7418,907,FALSE,NA,"0.1.4"
"32548","646",2023-08-06 00:45:00,-5515,1913,7428,907,FALSE,NA,"0.1.4"
"32549","646",2023-08-06 01:00:00,-5517,1913,7430,907,FALSE,NA,"0.1.4"
"32550","646",2023-08-06 01:15:00,-5515,1913,7428,907,FALSE,NA,"0.1.4"
"32551","646",2023-08-06 01:30:00,-5516,1913,7429,907,FALSE,NA,"0.1.4"
"32552","646",2023-08-06 01:45:00,-5518,1913,7431,907,FALSE,NA,"0.1.4"
"32553","646",2023-08-06 02:00:00,-5508,1913,7421,907,FALSE,NA,"0.1.4"
"32554","646",2023-08-06 02:15:00,-5498,1913,7411,907,FALSE,NA,"0.1.4"
"32555","646",2023-08-06 02:30:00,-5507,1913,7420,907,FALSE,NA,"0.1.4"
"32556","646",2023-08-06 02:45:00,-5508,1913,7421,907,FALSE,NA,"0.1.4"
"32557","646",2023-08-06 03:00:00,-5508,1913,7421,907,FALSE,NA,"0.1.4"
"32558","646",2023-08-06 03:15:00,-5505,1913,7418,907,FALSE,NA,"0.1.4"
"32559","646",2023-08-06 03:30:00,-5507,1913,7420,907,FALSE,NA,"0.1.4"
"32560","646",2023-08-06 03:45:00,-5508,1913,7421,907,FALSE,NA,"0.1.4"
"32561","646",2023-08-06 04:00:00,-5507,1913,7420,907,FALSE,NA,"0.1.4"
"32562","646",2023-08-06 04:15:00,-5507,1913,7420,907,FALSE,NA,"0.1.4"
"32563","646",2023-08-06 04:30:00,-5508,1913,7421,907,FALSE,NA,"0.1.4"
"32564","646",2023-08-06 04:45:00,-5504,1913,7417,907,FALSE,NA,"0.1.4"
"32565","646",2023-08-06 05:00:00,-5507,1913,7420,907,FALSE,NA,"0.1.4"
"32566","646",2023-08-06 05:15:00,-5505,1913,7418,907,FALSE,NA,"0.1.4"
"32567","646",2023-08-06 05:30:00,-5505,1913,7418,907,FALSE,NA,"0.1.4"
"32568","646",2023-08-06 05:45:00,-5508,1913,7421,907,FALSE,NA,"0.1.4"
"32569","646",2023-08-06 06:00:00,-5507,1913,7420,907,FALSE,NA,"0.1.4"
"32570","646",2023-08-06 06:15:00,-5498,1913,7411,907,FALSE,NA,"0.1.4"
"32571","646",2023-08-06 06:30:00,-5489,1913,7402,907,FALSE,NA,"0.1.4"
"32572","646",2023-08-06 06:45:00,-5494.8,1913,7407.8,907,FALSE,"out1, fill","0.1.4"
"32573","646",2023-08-06 07:00:00,-5500.6,1913,7413.6,907,FALSE,"out1, fill","0.1.4"
"32574","646",2023-08-06 07:15:00,-5506.4,1913,7419.4,907,FALSE,"out1, fill","0.1.4"
"32575","646",2023-08-06 07:30:00,-5512.2,1913,7425.2,907,FALSE,"out1, fill","0.1.4"
"32576","646",2023-08-06 07:45:00,-5518,1913,7431,907,FALSE,"out1, fill","0.1.4"
"32577","646",2023-08-06 08:00:00,-5523.8,1913,7436.8,907,FALSE,"out1, fill","0.1.4"
"32578","646",2023-08-06 08:15:00,-5529.6,1913,7442.6,907,FALSE,"out1, fill","0.1.4"
"32579","646",2023-08-06 08:30:00,-5535.4,1913,7448.4,907,FALSE,"out1, fill","0.1.4"
"32580","646",2023-08-06 08:45:00,-5541.2,1913,7454.2,907,FALSE,"out1, fill","0.1.4"
"32581","646",2023-08-06 09:00:00,-5547,1913,7460,907,FALSE,NA,"0.1.4"
"32582","646",2023-08-06 09:15:00,-5547,1913,7460,907,FALSE,"jump1","0.1.4"
"32583","646",2023-08-06 09:30:00,-5173,1913,7086,907,FALSE,NA,"0.1.4"
"32584","646",2023-08-06 09:45:00,-5566.5,1913,7479.5,907,FALSE,"out1, fill","0.1.4"
"32585","646",2023-08-06 10:00:00,-5960,1913,7873,907,FALSE,NA,"0.1.4"
"32586","646",2023-08-06 10:15:00,-5778,1913,7691,907,FALSE,NA,"0.1.4"
"32587","646",2023-08-06 10:30:00,-6232,1913,8145,907,FALSE,NA,"0.1.4"
"32588","646",2023-08-06 10:45:00,-5937,1913,7850,907,FALSE,NA,"0.1.4"
"32589","646",2023-08-06 11:00:00,-5669,1913,7582,907,FALSE,NA,"0.1.4"
"32590","646",2023-08-06 11:15:00,-5994,1913,7907,907,FALSE,NA,"0.1.4"
"32591","646",2023-08-06 11:30:00,-6324,1913,8237,907,FALSE,NA,"0.1.4"
"32592","646",2023-08-06 11:45:00,-6236,1913,8149,907,FALSE,NA,"0.1.4"
"32593","646",2023-08-06 12:00:00,-6380,1913,8293,907,FALSE,NA,"0.1.4"
"32594","646",2023-08-06 12:15:00,-6324,1913,8237,907,FALSE,NA,"0.1.4"
"32595","646",2023-08-06 12:30:00,-6057,1913,7970,907,FALSE,NA,"0.1.4"
"32596","646",2023-08-06 12:45:00,-6156,1913,8069,907,FALSE,NA,"0.1.4"
"32597","646",2023-08-06 13:00:00,-6165,1913,8078,907,FALSE,NA,"0.1.4"
"32598","646",2023-08-06 13:15:00,-6165,1913,8078,907,FALSE,"jump1","0.1.4"
"32599","646",2023-08-06 13:30:00,-6610.5,1913,8523.5,907,FALSE,"out1, fill","0.1.4"
"32600","646",2023-08-06 13:45:00,-7056,1913,8969,907,FALSE,NA,"0.1.4"
"32601","646",2023-08-06 14:00:00,-7534,1913,9447,907,FALSE,NA,"0.1.4"
"32602","646",2023-08-06 14:15:00,-7539,1913,9452,907,FALSE,NA,"0.1.4"
"32603","646",2023-08-06 14:30:00,-7413,1913,9326,907,FALSE,NA,"0.1.4"
"32604","646",2023-08-06 14:45:00,-7267,1913,9180,907,FALSE,NA,"0.1.4"
"32605","646",2023-08-06 15:00:00,-7459,1913,9372,907,FALSE,NA,"0.1.4"
"32606","646",2023-08-06 15:15:00,-7093,1913,9006,907,FALSE,"out1, fill","0.1.4"
"32607","646",2023-08-06 15:30:00,-6727,1913,8640,907,FALSE,NA,"0.1.4"
"32608","646",2023-08-06 15:45:00,-6672,1913,8585,907,FALSE,NA,"0.1.4"
"32609","646",2023-08-06 16:00:00,-6703,1913,8616,907,FALSE,NA,"0.1.4"
"32610","646",2023-08-06 16:15:00,-6963,1913,8876,907,FALSE,"out1, fill","0.1.4"
"32611","646",2023-08-06 16:30:00,-7223,1913,9136,907,FALSE,NA,"0.1.4"
"32612","646",2023-08-06 16:45:00,-7118,1913,9031,907,FALSE,NA,"0.1.4"
"32613","646",2023-08-06 17:00:00,-7355,1913,9268,907,FALSE,NA,"0.1.4"
"32614","646",2023-08-06 17:15:00,-7289,1913,9202,907,FALSE,NA,"0.1.4"
"32615","646",2023-08-06 17:30:00,-6894,1913,8807,907,FALSE,NA,"0.1.4"
"32616","646",2023-08-06 17:45:00,-7250,1913,9163,907,FALSE,NA,"0.1.4"
"32617","646",2023-08-06 18:00:00,-6946,1913,8859,907,FALSE,NA,"0.1.4"
"32618","646",2023-08-06 18:15:00,-6915,1913,8828,907,FALSE,NA,"0.1.4"
"32619","646",2023-08-06 18:30:00,-6674,1913,8587,907,FALSE,NA,"0.1.4"
"32620","646",2023-08-06 18:45:00,-6699,1913,8612,907,FALSE,NA,"0.1.4"
"32621","646",2023-08-06 19:00:00,-6430,1913,8343,907,FALSE,NA,"0.1.4"
"32622","646",2023-08-06 19:15:00,-5981.5,1913,7894.5,907,FALSE,"out1, fill","0.1.4"
"32623","646",2023-08-06 19:30:00,-5533,1913,7446,907,FALSE,NA,"0.1.4"
"32624","646",2023-08-06 19:45:00,-5674,1913,7587,907,FALSE,NA,"0.1.4"
"32625","646",2023-08-06 20:00:00,-5728,1913,7641,907,FALSE,NA,"0.1.4"
"32626","646",2023-08-06 20:15:00,-5487,1913,7400,907,FALSE,NA,"0.1.4"
"32627","646",2023-08-06 20:30:00,-5505,1913,7418,907,FALSE,NA,"0.1.4"
"32628","646",2023-08-06 20:45:00,-5544.33333333333,1913,7457.33333333333,907,FALSE,"out1, fill","0.1.4"
"32629","646",2023-08-06 21:00:00,-5583.66666666667,1913,7496.66666666667,907,FALSE,"out1, fill","0.1.4"
"32630","646",2023-08-06 21:15:00,-5623,1913,7536,907,FALSE,NA,"0.1.4"
"32631","646",2023-08-06 21:30:00,-5495,1913,7408,907,FALSE,NA,"0.1.4"
"32632","646",2023-08-06 21:45:00,-5494,1913,7407,907,FALSE,NA,"0.1.4"
"32633","646",2023-08-06 22:00:00,-5773,1913,7686,907,FALSE,"out1, fill","0.1.4"
"32634","646",2023-08-06 22:15:00,-6052,1913,7965,907,FALSE,NA,"0.1.4"
"32635","646",2023-08-06 22:30:00,-6166,1913,8079,907,FALSE,NA,"0.1.4"
"32636","646",2023-08-06 22:45:00,-5844,1913,7757,907,FALSE,NA,"0.1.4"
"32637","646",2023-08-06 23:00:00,-5603,1913,7516,907,FALSE,NA,"0.1.4"
"32638","646",2023-08-06 23:15:00,-5612,1913,7525,907,FALSE,NA,"0.1.4"
"32639","646",2023-08-06 23:30:00,-5503,1913,7416,907,FALSE,NA,"0.1.4"
"32640","646",2023-08-06 23:45:00,-5510,1913,7423,907,FALSE,NA,"0.1.4"
"32641","646",2023-08-07,-5501.66666666667,1913,7414.66666666667,907,FALSE,"out1, fill","0.1.4"
"32642","646",2023-08-07 00:15:00,-5493.33333333333,1913,7406.33333333333,907,FALSE,"out1, fill","0.1.4"
"32643","646",2023-08-07 00:30:00,-5485,1913,7398,907,FALSE,NA,"0.1.4"
"32644","646",2023-08-07 00:45:00,-5606,1913,7519,907,FALSE,NA,"0.1.4"
"32645","646",2023-08-07 01:00:00,-5556,1913,7469,907,FALSE,NA,"0.1.4"
"32646","646",2023-08-07 01:15:00,-5666,1913,7579,907,FALSE,"out1, fill","0.1.4"
"32647","646",2023-08-07 01:30:00,-5776,1913,7689,907,FALSE,"out1, fill","0.1.4"
"32648","646",2023-08-07 01:45:00,-5886,1913,7799,907,FALSE,NA,"0.1.4"
"32649","646",2023-08-07 02:00:00,-6288,1913,8201,907,FALSE,NA,"0.1.4"
"32650","646",2023-08-07 02:15:00,-6288,1913,8201,907,FALSE,"jump1","0.1.4"
"32651","646",2023-08-07 02:30:00,-6641.5,1913,8554.5,907,FALSE,"out1, fill","0.1.4"
"32652","646",2023-08-07 02:45:00,-6995,1913,8908,907,FALSE,"out1, fill","0.1.4"
"32653","646",2023-08-07 03:00:00,-7348.5,1913,9261.5,907,FALSE,"out1, fill","0.1.4"
"32654","646",2023-08-07 03:15:00,-7702,1913,9615,907,FALSE,NA,"0.1.4"
"32655","646",2023-08-07 03:30:00,-7376,1913,9289,907,FALSE,NA,"0.1.4"
"32656","646",2023-08-07 03:45:00,-7480,1913,9393,907,FALSE,NA,"0.1.4"
"32657","646",2023-08-07 04:00:00,-7457.8,1913,9370.8,907,FALSE,"out1, fill","0.1.4"
"32658","646",2023-08-07 04:15:00,-7435.6,1913,9348.6,907,FALSE,"out1, fill","0.1.4"
"32659","646",2023-08-07 04:30:00,-7413.4,1913,9326.4,907,FALSE,"out1, fill","0.1.4"
"32660","646",2023-08-07 04:45:00,-7391.2,1913,9304.2,907,FALSE,"out1, fill","0.1.4"
"32661","646",2023-08-07 05:00:00,-7369,1913,9282,907,FALSE,NA,"0.1.4"
"32662","646",2023-08-07 05:15:00,-7570,1913,9483,907,FALSE,NA,"0.1.4"
"32663","646",2023-08-07 05:30:00,-7210,1913,9123,907,FALSE,NA,"0.1.4"
"32664","646",2023-08-07 05:45:00,-7477.5,1913,9390.5,907,FALSE,"out1, fill","0.1.4"
"32665","646",2023-08-07 06:00:00,-7745,1913,9658,907,FALSE,NA,"0.1.4"
"32666","646",2023-08-07 06:15:00,-7455,1913,9368,907,FALSE,NA,"0.1.4"
"32667","646",2023-08-07 06:30:00,-7454,1913,9367,907,FALSE,NA,"0.1.4"
"32668","646",2023-08-07 06:45:00,-7454,1913,9367,907,FALSE,"jump1","0.1.4"
"32669","646",2023-08-07 07:00:00,-7399,1913,9312,907,FALSE,NA,"0.1.4"
"32670","646",2023-08-07 07:15:00,-7555.5,1913,9468.5,907,FALSE,"out1, fill","0.1.4"
"32671","646",2023-08-07 07:30:00,-7712,1913,9625,907,FALSE,NA,"0.1.4"
"32672","646",2023-08-07 07:45:00,-7840,1913,9753,907,FALSE,NA,"0.1.4"
"32673","646",2023-08-07 08:00:00,-7883,1913,9796,907,FALSE,NA,"0.1.4"
"32674","646",2023-08-07 08:15:00,-7977,1913,9890,907,FALSE,NA,"0.1.4"
"32675","646",2023-08-07 08:30:00,-8111,1913,10024,907,FALSE,NA,"0.1.4"
"32676","646",2023-08-07 08:45:00,-7807.66666666667,1913,9720.66666666667,907,FALSE,"out1, fill","0.1.4"
"32677","646",2023-08-07 09:00:00,-7504.33333333333,1913,9417.33333333333,907,FALSE,"out1, fill","0.1.4"
"32678","646",2023-08-07 09:15:00,-7201,1913,9114,907,FALSE,NA,"0.1.4"
"32679","646",2023-08-07 09:30:00,-7570,1913,9483,907,FALSE,NA,"0.1.4"
"32680","646",2023-08-07 09:45:00,-7384,1913,9297,907,FALSE,NA,"0.1.4"
"32681","646",2023-08-07 10:00:00,-7384,1913,9297,907,FALSE,"jump1","0.1.4"
"32682","646",2023-08-07 10:15:00,-7301,1913,9214,907,FALSE,NA,"0.1.4"
"32683","646",2023-08-07 10:30:00,-7299,1913,9212,907,FALSE,NA,"0.1.4"
"32684","646",2023-08-07 10:45:00,-7298.66666666667,1913,9211.66666666667,907,FALSE,"out1, fill","0.1.4"
"32685","646",2023-08-07 11:00:00,-7298.33333333333,1913,9211.33333333333,907,FALSE,"out1, fill","0.1.4"
"32686","646",2023-08-07 11:15:00,-7298,1913,9211,907,FALSE,NA,"0.1.4"
"32687","646",2023-08-07 11:30:00,-7316,1913,9229,907,FALSE,NA,"0.1.4"
"32688","646",2023-08-07 11:45:00,-7301,1913,9214,907,FALSE,NA,"0.1.4"
"32689","646",2023-08-07 12:00:00,-7301,1913,9214,907,FALSE,"jump1","0.1.4"
"32690","646",2023-08-07 12:15:00,-7201,1913,9114,907,FALSE,NA,"0.1.4"
"32691","646",2023-08-07 12:30:00,-7201,1913,9114,907,FALSE,"jump1","0.1.4"
"32692","646",2023-08-07 12:45:00,-6958,1913,8871,907,FALSE,NA,"0.1.4"
"32693","646",2023-08-07 13:00:00,-7141,1913,9054,907,FALSE,NA,"0.1.4"
"32694","646",2023-08-07 13:15:00,-6679,1913,8592,907,FALSE,NA,"0.1.4"
"32695","646",2023-08-07 13:30:00,-6419,1913,8332,907,FALSE,NA,"0.1.4"
"32696","646",2023-08-07 13:45:00,-6250,1913,8163,907,FALSE,NA,"0.1.4"
"32697","646",2023-08-07 14:00:00,-6420,1913,8333,907,FALSE,NA,"0.1.4"
"32698","646",2023-08-07 14:15:00,-6439,1913,8352,907,FALSE,NA,"0.1.4"
"32699","646",2023-08-07 14:30:00,-6411,1913,8324,907,FALSE,NA,"0.1.4"
"32700","646",2023-08-07 14:45:00,-6357,1913,8270,907,FALSE,NA,"0.1.4"
"32701","646",2023-08-07 15:00:00,-5957,1913,7870,907,FALSE,NA,"0.1.4"
"32702","646",2023-08-07 15:15:00,-6003,1913,7916,907,FALSE,NA,"0.1.4"
"32703","646",2023-08-07 15:30:00,-6143,1913,8056,907,FALSE,"out1, fill","0.1.4"
"32704","646",2023-08-07 15:45:00,-6283,1913,8196,907,FALSE,NA,"0.1.4"
"32705","646",2023-08-07 16:00:00,-6531,1913,8444,907,FALSE,NA,"0.1.4"
"32706","646",2023-08-07 16:15:00,-6414,1913,8327,907,FALSE,NA,"0.1.4"
"32707","646",2023-08-07 16:30:00,-6549,1913,8462,907,FALSE,NA,"0.1.4"
"32708","646",2023-08-07 16:45:00,-6263,1913,8176,907,FALSE,NA,"0.1.4"
"32709","646",2023-08-07 17:00:00,-6391,1913,8304,907,FALSE,NA,"0.1.4"
"32710","646",2023-08-07 17:15:00,-6575,1913,8488,907,FALSE,NA,"0.1.4"
"32711","646",2023-08-07 17:30:00,-6575,1913,8488,907,FALSE,"jump1","0.1.4"
"32712","646",2023-08-07 17:45:00,-6894,1913,8807,907,FALSE,NA,"0.1.4"
"32713","646",2023-08-07 18:00:00,-6626,1913,8539,907,FALSE,NA,"0.1.4"
"32714","646",2023-08-07 18:15:00,-6805,1913,8718,907,FALSE,NA,"0.1.4"
"32715","646",2023-08-07 18:30:00,-6578,1913,8491,907,FALSE,NA,"0.1.4"
"32716","646",2023-08-07 18:45:00,-6578,1913,8491,907,FALSE,"jump1","0.1.4"
"32717","646",2023-08-07 19:00:00,-6578,1913,8491,907,FALSE,"jump1","0.1.4"
"32718","646",2023-08-07 19:15:00,-6571,1913,8484,907,FALSE,NA,"0.1.4"
"32719","646",2023-08-07 19:30:00,-6571,1913,8484,907,FALSE,"jump1","0.1.4"
"32720","646",2023-08-07 19:45:00,-6571,1913,8484,907,FALSE,"jump1","0.1.4"
"32721","646",2023-08-07 20:00:00,-6902,1913,8815,907,FALSE,NA,"0.1.4"
"32722","646",2023-08-07 20:15:00,-6557,1913,8470,907,FALSE,NA,"0.1.4"
"32723","646",2023-08-07 20:30:00,-6692,1913,8605,907,FALSE,NA,"0.1.4"
"32724","646",2023-08-07 20:45:00,-6789,1913,8702,907,FALSE,NA,"0.1.4"
"32725","646",2023-08-07 21:00:00,-7082,1913,8995,907,FALSE,NA,"0.1.4"
"32726","646",2023-08-07 21:15:00,-7082,1913,8995,907,FALSE,"jump1","0.1.4"
"32727","646",2023-08-07 21:30:00,-7108,1913,9021,907,FALSE,NA,"0.1.4"
"32728","646",2023-08-07 21:45:00,-7085.33333333333,1913,8998.33333333333,907,FALSE,"out1, fill","0.1.4"
"32729","646",2023-08-07 22:00:00,-7062.66666666667,1913,8975.66666666667,907,FALSE,"out1, fill","0.1.4"
"32730","646",2023-08-07 22:15:00,-7040,1913,8953,907,FALSE,NA,"0.1.4"
"32731","646",2023-08-07 22:30:00,-7033,1913,8946,907,FALSE,NA,"0.1.4"
"32732","646",2023-08-07 22:45:00,-7032,1913,8945,907,FALSE,NA,"0.1.4"
"32733","646",2023-08-07 23:00:00,-7032,1913,8945,907,FALSE,"jump1","0.1.4"
"32734","646",2023-08-07 23:15:00,-6721,1913,8634,907,FALSE,NA,"0.1.4"
"32735","646",2023-08-07 23:30:00,-6388,1913,8301,907,FALSE,NA,"0.1.4"
"32736","646",2023-08-07 23:45:00,-6619,1913,8532,907,FALSE,NA,"0.1.4"
"32737","646",2023-08-08,-6801.875,1913,8714.875,907,FALSE,"out1, fill","0.1.4"
"32738","646",2023-08-08 00:15:00,-6984.75,1913,8897.75,907,FALSE,"out1, fill","0.1.4"
"32739","646",2023-08-08 00:30:00,-7167.625,1913,9080.625,907,FALSE,"out1, fill","0.1.4"
"32740","646",2023-08-08 00:45:00,-7350.5,1913,9263.5,907,FALSE,"out1, fill","0.1.4"
"32741","646",2023-08-08 01:00:00,-7533.375,1913,9446.375,907,FALSE,"out1, fill","0.1.4"
"32742","646",2023-08-08 01:15:00,-7716.25,1913,9629.25,907,FALSE,"out1, fill","0.1.4"
"32743","646",2023-08-08 01:30:00,-7899.125,1913,9812.125,907,FALSE,"out1, fill","0.1.4"
"32744","646",2023-08-08 01:45:00,-8082,1913,9995,907,FALSE,NA,"0.1.4"
"32745","646",2023-08-08 02:00:00,-7910,1913,9823,907,FALSE,NA,"0.1.4"
"32746","646",2023-08-08 02:15:00,-7741,1913,9654,907,FALSE,NA,"0.1.4"
"32747","646",2023-08-08 02:30:00,-7544,1913,9457,907,FALSE,NA,"0.1.4"
"32748","646",2023-08-08 02:45:00,-7544,1913,9457,907,FALSE,"jump1","0.1.4"
"32749","646",2023-08-08 03:00:00,-7268.5,1913,9181.5,907,FALSE,"out1, fill","0.1.4"
"32750","646",2023-08-08 03:15:00,-6993,1913,8906,907,FALSE,"out1, fill","0.1.4"
"32751","646",2023-08-08 03:30:00,-6717.5,1913,8630.5,907,FALSE,"out1, fill","0.1.4"
"32752","646",2023-08-08 03:45:00,-6442,1913,8355,907,FALSE,"out1, fill","0.1.4"
"32753","646",2023-08-08 04:00:00,-6166.5,1913,8079.5,907,FALSE,"out1, fill","0.1.4"
"32754","646",2023-08-08 04:15:00,-5891,1913,7804,907,FALSE,NA,"0.1.4"
"32755","646",2023-08-08 04:30:00,-5892,1913,7805,907,FALSE,NA,"0.1.4"
"32756","646",2023-08-08 04:45:00,-6140,1913,8053,907,FALSE,NA,"0.1.4"
"32757","646",2023-08-08 05:00:00,-6636.5,1913,8549.5,907,FALSE,"out1, fill","0.1.4"
"32758","646",2023-08-08 05:15:00,-7133,1913,9046,907,FALSE,NA,"0.1.4"
"32759","646",2023-08-08 05:30:00,-7060,1913,8973,907,FALSE,NA,"0.1.4"
"32760","646",2023-08-08 05:45:00,-7013,1913,8926,907,FALSE,NA,"0.1.4"
"32761","646",2023-08-08 06:00:00,-7082,1913,8995,907,FALSE,NA,"0.1.4"
"32762","646",2023-08-08 06:15:00,-7113,1913,9026,907,FALSE,NA,"0.1.4"
"32763","646",2023-08-08 06:30:00,-7451,1913,9364,907,FALSE,NA,"0.1.4"
"32764","646",2023-08-08 06:45:00,-7210,1913,9123,907,FALSE,NA,"0.1.4"
"32765","646",2023-08-08 07:00:00,-7429,1913,9342,907,FALSE,NA,"0.1.4"
"32766","646",2023-08-08 07:15:00,-7268,1913,9181,907,FALSE,NA,"0.1.4"
"32767","646",2023-08-08 07:30:00,-7388,1913,9301,907,FALSE,NA,"0.1.4"
"32768","646",2023-08-08 07:45:00,-7483,1913,9396,907,FALSE,NA,"0.1.4"
"32769","646",2023-08-08 08:00:00,-7138,1913,9051,907,FALSE,NA,"0.1.4"
"32770","646",2023-08-08 08:15:00,-7016,1913,8929,907,FALSE,NA,"0.1.4"
"32771","646",2023-08-08 08:30:00,-7300,1913,9213,907,FALSE,NA,"0.1.4"
"32772","646",2023-08-08 08:45:00,-6829,1913,8742,907,FALSE,NA,"0.1.4"
"32773","646",2023-08-08 09:00:00,-7038,1913,8951,907,FALSE,NA,"0.1.4"
"32774","646",2023-08-08 09:15:00,-7142,1913,9055,907,FALSE,NA,"0.1.4"
"32775","646",2023-08-08 09:30:00,-7282,1913,9195,907,FALSE,NA,"0.1.4"
"32776","646",2023-08-08 09:45:00,-7009,1913,8922,907,FALSE,NA,"0.1.4"
"32777","646",2023-08-08 10:00:00,-6921,1913,8834,907,FALSE,NA,"0.1.4"
"32778","646",2023-08-08 10:15:00,-7326,1913,9239,907,FALSE,NA,"0.1.4"
"32779","646",2023-08-08 10:30:00,-7326,1913,9239,907,FALSE,"jump1","0.1.4"
"32780","646",2023-08-08 10:45:00,-7755,1913,9668,907,FALSE,NA,"0.1.4"
"32781","646",2023-08-08 11:00:00,-7704,1913,9617,907,FALSE,NA,"0.1.4"
"32782","646",2023-08-08 11:15:00,-7376,1913,9289,907,FALSE,NA,"0.1.4"
"32783","646",2023-08-08 11:30:00,-7010,1913,8923,907,FALSE,NA,"0.1.4"
"32784","646",2023-08-08 11:45:00,-7183,1913,9096,907,FALSE,"out1, fill","0.1.4"
"32785","646",2023-08-08 12:00:00,-7356,1913,9269,907,FALSE,"out1, fill","0.1.4"
"32786","646",2023-08-08 12:15:00,-7529,1913,9442,907,FALSE,NA,"0.1.4"
"32787","646",2023-08-08 12:30:00,-7896,1913,9809,907,FALSE,NA,"0.1.4"
"32788","646",2023-08-08 12:45:00,-7600,1913,9513,907,FALSE,NA,"0.1.4"
"32789","646",2023-08-08 13:00:00,-7687.33333333333,1913,9600.33333333333,907,FALSE,"out1, fill","0.1.4"
"32790","646",2023-08-08 13:15:00,-7774.66666666667,1913,9687.66666666667,907,FALSE,"out1, fill","0.1.4"
"32791","646",2023-08-08 13:30:00,-7862,1913,9775,907,FALSE,NA,"0.1.4"
"32792","646",2023-08-08 13:45:00,-7891,1913,9804,907,FALSE,NA,"0.1.4"
"32793","646",2023-08-08 14:00:00,-7923,1913,9836,907,FALSE,NA,"0.1.4"
"32794","646",2023-08-08 14:15:00,-7718,1913,9631,907,FALSE,NA,"0.1.4"
"32795","646",2023-08-08 14:30:00,-7736,1913,9649,907,FALSE,NA,"0.1.4"
"32796","646",2023-08-08 14:45:00,-7644,1913,9557,907,FALSE,NA,"0.1.4"
"32797","646",2023-08-08 15:00:00,-7644,1913,9557,907,FALSE,"out1, fill","0.1.4"
"32798","646",2023-08-08 15:15:00,-7644,1913,9557,907,FALSE,"jump1","0.1.4"
"32799","646",2023-08-08 15:30:00,-7645,1913,9558,907,FALSE,NA,"0.1.4"
"32800","646",2023-08-08 15:45:00,-7660,1913,9573,907,FALSE,NA,"0.1.4"
"32801","646",2023-08-08 16:00:00,-7660,1913,9573,907,FALSE,"jump1","0.1.4"
"32802","646",2023-08-08 16:15:00,-7660,1913,9573,907,FALSE,"jump1","0.1.4"
"32803","646",2023-08-08 16:30:00,-7740,1913,9653,907,FALSE,NA,"0.1.4"
"32804","646",2023-08-08 16:45:00,-7623,1913,9536,907,FALSE,NA,"0.1.4"
"32805","646",2023-08-08 17:00:00,-7621.66666666667,1913,9534.66666666667,907,FALSE,"out1, fill","0.1.4"
"32806","646",2023-08-08 17:15:00,-7620.33333333333,1913,9533.33333333333,907,FALSE,"out1, fill","0.1.4"
"32807","646",2023-08-08 17:30:00,-7619,1913,9532,907,FALSE,NA,"0.1.4"
"32808","646",2023-08-08 17:45:00,-7829,1913,9742,907,FALSE,NA,"0.1.4"
"32809","646",2023-08-08 18:00:00,-7612,1913,9525,907,FALSE,NA,"0.1.4"
"32810","646",2023-08-08 18:15:00,-7642,1913,9555,907,FALSE,NA,"0.1.4"
"32811","646",2023-08-08 18:30:00,-7642,1913,9555,907,FALSE,NA,"0.1.4"
"32812","646",2023-08-08 18:45:00,-7611,1913,9524,907,FALSE,NA,"0.1.4"
"32813","646",2023-08-08 19:00:00,-7630,1913,9543,907,FALSE,NA,"0.1.4"
"32814","646",2023-08-08 19:15:00,-7908,1913,9821,907,FALSE,NA,"0.1.4"
"32815","646",2023-08-08 19:30:00,-7653,1913,9566,907,FALSE,NA,"0.1.4"
"32816","646",2023-08-08 19:45:00,-7727.33333333333,1913,9640.33333333333,907,FALSE,"out1, fill","0.1.4"
"32817","646",2023-08-08 20:00:00,-7801.66666666667,1913,9714.66666666667,907,FALSE,"out1, fill","0.1.4"
"32818","646",2023-08-08 20:15:00,-7876,1913,9789,907,FALSE,NA,"0.1.4"
"32819","646",2023-08-08 20:30:00,-7719,1913,9632,907,FALSE,NA,"0.1.4"
"32820","646",2023-08-08 20:45:00,-7582,1913,9495,907,FALSE,NA,"0.1.4"
"32821","646",2023-08-08 21:00:00,-7980,1913,9893,907,FALSE,"out1, fill","0.1.4"
"32822","646",2023-08-08 21:15:00,-8378,1913,10291,907,FALSE,NA,"0.1.4"
"32823","646",2023-08-08 21:30:00,-8805,1913,10718,907,FALSE,NA,"0.1.4"
"32824","646",2023-08-08 21:45:00,-8412,1913,10325,907,FALSE,NA,"0.1.4"
"32825","646",2023-08-08 22:00:00,-8521.14285714286,1913,10434.1428571429,907,FALSE,"out1, fill","0.1.4"
"32826","646",2023-08-08 22:15:00,-8630.28571428571,1913,10543.2857142857,907,FALSE,"out1, fill","0.1.4"
"32827","646",2023-08-08 22:30:00,-8739.42857142857,1913,10652.4285714286,907,FALSE,"out1, fill","0.1.4"
"32828","646",2023-08-08 22:45:00,-8848.57142857143,1913,10761.5714285714,907,FALSE,"out1, fill","0.1.4"
"32829","646",2023-08-08 23:00:00,-8957.71428571429,1913,10870.7142857143,907,FALSE,"out1, fill","0.1.4"
"32830","646",2023-08-08 23:15:00,-9066.85714285714,1913,10979.8571428571,907,FALSE,"out1, fill","0.1.4"
"32831","646",2023-08-08 23:30:00,-9176,1913,11089,907,FALSE,NA,"0.1.4"
"32832","646",2023-08-08 23:45:00,-8869,1913,10782,907,FALSE,NA,"0.1.4"
"32833","646",2023-08-09,-9118,1913,11031,907,FALSE,NA,"0.1.4"
"32834","646",2023-08-09 00:15:00,-9152,1913,11065,907,FALSE,NA,"0.1.4"
"32835","646",2023-08-09 00:30:00,-9206,1913,11119,907,FALSE,NA,"0.1.4"
"32836","646",2023-08-09 00:45:00,-9243,1913,11156,907,FALSE,NA,"0.1.4"
"32837","646",2023-08-09 01:00:00,-9289,1913,11202,907,FALSE,NA,"0.1.4"
"32838","646",2023-08-09 01:15:00,-9398,1913,11311,907,FALSE,NA,"0.1.4"
"32839","646",2023-08-09 01:30:00,-9529,1913,11442,907,FALSE,NA,"0.1.4"
"32840","646",2023-08-09 01:45:00,-9599,1913,11512,907,FALSE,NA,"0.1.4"
"32841","646",2023-08-09 02:00:00,-9369,1913,11282,907,FALSE,NA,"0.1.4"
"32842","646",2023-08-09 02:15:00,-9668,1913,11581,907,FALSE,NA,"0.1.4"
"32843","646",2023-08-09 02:30:00,-9595,1913,11508,907,FALSE,NA,"0.1.4"
"32844","646",2023-08-09 02:45:00,-9736,1913,11649,907,FALSE,NA,"0.1.4"
"32845","646",2023-08-09 03:00:00,-9690,1913,11603,907,FALSE,NA,"0.1.4"
"32846","646",2023-08-09 03:15:00,-9690,1913,11603,907,FALSE,NA,"0.1.4"
"32847","646",2023-08-09 03:30:00,-9692,1913,11605,907,FALSE,NA,"0.1.4"
"32848","646",2023-08-09 03:45:00,-9331,1913,11244,907,FALSE,NA,"0.1.4"
"32849","646",2023-08-09 04:00:00,-9640,1913,11553,907,FALSE,NA,"0.1.4"
"32850","646",2023-08-09 04:15:00,-9164,1913,11077,907,FALSE,NA,"0.1.4"
"32851","646",2023-08-09 04:30:00,-9149,1913,11062,907,FALSE,NA,"0.1.4"
"32852","646",2023-08-09 04:45:00,-9195,1913,11108,907,FALSE,NA,"0.1.4"
"32853","646",2023-08-09 05:00:00,-9001,1913,10914,907,FALSE,NA,"0.1.4"
"32854","646",2023-08-09 05:15:00,-8864,1913,10777,907,FALSE,NA,"0.1.4"
"32855","646",2023-08-09 05:30:00,-8818,1913,10731,907,FALSE,NA,"0.1.4"
"32856","646",2023-08-09 05:45:00,-9047,1913,10960,907,FALSE,NA,"0.1.4"
"32857","646",2023-08-09 06:00:00,-9212,1913,11125,907,FALSE,NA,"0.1.4"
"32858","646",2023-08-09 06:15:00,-8861,1913,10774,907,FALSE,NA,"0.1.4"
"32859","646",2023-08-09 06:30:00,-8787,1913,10700,907,FALSE,NA,"0.1.4"
"32860","646",2023-08-09 06:45:00,-9257,1913,11170,907,FALSE,NA,"0.1.4"
"32861","646",2023-08-09 07:00:00,-9204,1913,11117,907,FALSE,NA,"0.1.4"
"32862","646",2023-08-09 07:15:00,-9268,1913,11181,907,FALSE,NA,"0.1.4"
"32863","646",2023-08-09 07:30:00,-9291.66666666667,1913,11204.6666666667,907,FALSE,"out1, fill","0.1.4"
"32864","646",2023-08-09 07:45:00,-9315.33333333333,1913,11228.3333333333,907,FALSE,"out1, fill","0.1.4"
"32865","646",2023-08-09 08:00:00,-9339,1913,11252,907,FALSE,NA,"0.1.4"
"32866","646",2023-08-09 08:15:00,-9243,1913,11156,907,FALSE,NA,"0.1.4"
"32867","646",2023-08-09 08:30:00,-9333,1913,11246,907,FALSE,NA,"0.1.4"
"32868","646",2023-08-09 08:45:00,-9356,1913,11269,907,FALSE,"out1, fill","0.1.4"
"32869","646",2023-08-09 09:00:00,-9379,1913,11292,907,FALSE,"out1, fill","0.1.4"
"32870","646",2023-08-09 09:15:00,-9402,1913,11315,907,FALSE,NA,"0.1.4"
"32871","646",2023-08-09 09:30:00,-9008,1913,10921,907,FALSE,NA,"0.1.4"
"32872","646",2023-08-09 09:45:00,-9492,1913,11405,907,FALSE,NA,"0.1.4"
"32873","646",2023-08-09 10:00:00,-9059,1913,10972,907,FALSE,NA,"0.1.4"
"32874","646",2023-08-09 10:15:00,-8721,1913,10634,907,FALSE,NA,"0.1.4"
"32875","646",2023-08-09 10:30:00,-8494,1913,10407,907,FALSE,NA,"0.1.4"
"32876","646",2023-08-09 10:45:00,-8478,1913,10391,907,FALSE,NA,"0.1.4"
"32877","646",2023-08-09 11:00:00,-8323,1913,10236,907,FALSE,NA,"0.1.4"
"32878","646",2023-08-09 11:15:00,-8494,1913,10407,907,FALSE,NA,"0.1.4"
"32879","646",2023-08-09 11:30:00,-8123,1913,10036,907,FALSE,NA,"0.1.4"
"32880","646",2023-08-09 11:45:00,-8123,1913,10036,907,FALSE,"out1, fill","0.1.4"
"32881","646",2023-08-09 12:00:00,-8123,1913,10036,907,FALSE,"jump1","0.1.4"
"32882","646",2023-08-09 12:15:00,-8380,1913,10293,907,FALSE,NA,"0.1.4"
"32883","646",2023-08-09 12:30:00,-8464,1913,10377,907,FALSE,NA,"0.1.4"
"32884","646",2023-08-09 12:45:00,-8447,1913,10360,907,FALSE,NA,"0.1.4"
"32885","646",2023-08-09 13:00:00,-8391,1913,10304,907,FALSE,NA,"0.1.4"
"32886","646",2023-08-09 13:15:00,-8266,1913,10179,907,FALSE,"out1, fill","0.1.4"
"32887","646",2023-08-09 13:30:00,-8141,1913,10054,907,FALSE,"out1, fill","0.1.4"
"32888","646",2023-08-09 13:45:00,-8016,1913,9929,907,FALSE,"out1, fill","0.1.4"
"32889","646",2023-08-09 14:00:00,-7891,1913,9804,907,FALSE,NA,"0.1.4"
"32890","646",2023-08-09 14:15:00,-7728,1913,9641,907,FALSE,NA,"0.1.4"
"32891","646",2023-08-09 14:30:00,-7537,1913,9450,907,FALSE,NA,"0.1.4"
"32892","646",2023-08-09 14:45:00,-7543,1913,9456,907,FALSE,NA,"0.1.4"
"32893","646",2023-08-09 15:00:00,-7794,1913,9707,907,FALSE,NA,"0.1.4"
"32894","646",2023-08-09 15:15:00,-7740,1913,9653,907,FALSE,NA,"0.1.4"
"32895","646",2023-08-09 15:30:00,-7571.75,1913,9484.75,907,FALSE,"out1, fill","0.1.4"
"32896","646",2023-08-09 15:45:00,-7403.5,1913,9316.5,907,FALSE,"out1, fill","0.1.4"
"32897","646",2023-08-09 16:00:00,-7235.25,1913,9148.25,907,FALSE,"out1, fill","0.1.4"
"32898","646",2023-08-09 16:15:00,-7067,1913,8980,907,FALSE,NA,"0.1.4"
"32899","646",2023-08-09 16:30:00,-7067,1913,8980,907,FALSE,"jump1","0.1.4"
"32900","646",2023-08-09 16:45:00,-7127,1913,9040,907,FALSE,NA,"0.1.4"
"32901","646",2023-08-09 17:00:00,-7517,1913,9430,907,FALSE,NA,"0.1.4"
"32902","646",2023-08-09 17:15:00,-7138,1913,9051,907,FALSE,NA,"0.1.4"
"32903","646",2023-08-09 17:30:00,-7237,1913,9150,907,FALSE,NA,"0.1.4"
"32904","646",2023-08-09 17:45:00,-6936,1913,8849,907,FALSE,NA,"0.1.4"
"32905","646",2023-08-09 18:00:00,-6936,1913,8849,907,FALSE,"jump1","0.1.4"
"32906","646",2023-08-09 18:15:00,-6639,1913,8552,907,FALSE,NA,"0.1.4"
"32907","646",2023-08-09 18:30:00,-6681.5,1913,8594.5,907,FALSE,"out1, fill","0.1.4"
"32908","646",2023-08-09 18:45:00,-6724,1913,8637,907,FALSE,"out1, fill","0.1.4"
"32909","646",2023-08-09 19:00:00,-6766.5,1913,8679.5,907,FALSE,"out1, fill","0.1.4"
"32910","646",2023-08-09 19:15:00,-6809,1913,8722,907,FALSE,NA,"0.1.4"
"32911","646",2023-08-09 19:30:00,-6943,1913,8856,907,FALSE,NA,"0.1.4"
"32912","646",2023-08-09 19:45:00,-6824,1913,8737,907,FALSE,NA,"0.1.4"
"32913","646",2023-08-09 20:00:00,-7035,1913,8948,907,FALSE,"out1, fill","0.1.4"
"32914","646",2023-08-09 20:15:00,-7246,1913,9159,907,FALSE,"out1, fill","0.1.4"
"32915","646",2023-08-09 20:30:00,-7457,1913,9370,907,FALSE,"out1, fill","0.1.4"
"32916","646",2023-08-09 20:45:00,-7668,1913,9581,907,FALSE,"out1, fill","0.1.4"
"32917","646",2023-08-09 21:00:00,-7879,1913,9792,907,FALSE,NA,"0.1.4"
"32918","646",2023-08-09 21:15:00,-7879,1913,9792,907,FALSE,"jump1","0.1.4"
"32919","646",2023-08-09 21:30:00,-8331,1913,10244,907,FALSE,NA,"0.1.4"
"32920","646",2023-08-09 21:45:00,-8198,1913,10111,907,FALSE,"out1, fill","0.1.4"
"32921","646",2023-08-09 22:00:00,-8065,1913,9978,907,FALSE,"out1, fill","0.1.4"
"32922","646",2023-08-09 22:15:00,-7932,1913,9845,907,FALSE,NA,"0.1.4"
"32923","646",2023-08-09 22:30:00,-7932,1913,9845,907,FALSE,"jump1","0.1.4"
"32924","646",2023-08-09 22:45:00,-7713,1913,9626,907,FALSE,NA,"0.1.4"
"32925","646",2023-08-09 23:00:00,-7467,1913,9380,907,FALSE,NA,"0.1.4"
"32926","646",2023-08-09 23:15:00,-7741,1913,9654,907,FALSE,NA,"0.1.4"
"32927","646",2023-08-09 23:30:00,-7616,1913,9529,907,FALSE,NA,"0.1.4"
"32928","646",2023-08-09 23:45:00,-7770.33333333333,1913,9683.33333333333,907,FALSE,"out1, fill","0.1.4"
"32929","646",2023-08-10,-7924.66666666667,1913,9837.66666666667,907,FALSE,"out1, fill","0.1.4"
"32930","646",2023-08-10 00:15:00,-8079,1913,9992,907,FALSE,NA,"0.1.4"
"32931","646",2023-08-10 00:30:00,-8037,1913,9950,907,FALSE,NA,"0.1.4"
"32932","646",2023-08-10 00:45:00,-7657,1913,9570,907,FALSE,NA,"0.1.4"
"32933","646",2023-08-10 01:00:00,-7285,1913,9198,907,FALSE,NA,"0.1.4"
"32934","646",2023-08-10 01:15:00,-7706.5,1913,9619.5,907,FALSE,"out1, fill","0.1.4"
"32935","646",2023-08-10 01:30:00,-8128,1913,10041,907,FALSE,NA,"0.1.4"
"32936","646",2023-08-10 01:45:00,-8071,1913,9984,907,FALSE,NA,"0.1.4"
"32937","646",2023-08-10 02:00:00,-8287,1913,10200,907,FALSE,NA,"0.1.4"
"32938","646",2023-08-10 02:15:00,-8042,1913,9955,907,FALSE,NA,"0.1.4"
"32939","646",2023-08-10 02:30:00,-8144,1913,10057,907,FALSE,NA,"0.1.4"
"32940","646",2023-08-10 02:45:00,-8144,1913,10057,907,FALSE,"jump1","0.1.4"
"32941","646",2023-08-10 03:00:00,-8144,1913,10057,907,FALSE,"jump1","0.1.4"
"32942","646",2023-08-10 03:15:00,-8176,1913,10089,907,FALSE,NA,"0.1.4"
"32943","646",2023-08-10 03:30:00,-8325,1913,10238,907,FALSE,NA,"0.1.4"
"32944","646",2023-08-10 03:45:00,-8211,1913,10124,907,FALSE,NA,"0.1.4"
"32945","646",2023-08-10 04:00:00,-8407,1913,10320,907,FALSE,NA,"0.1.4"
"32946","646",2023-08-10 04:15:00,-8011,1913,9924,907,FALSE,NA,"0.1.4"
"32947","646",2023-08-10 04:30:00,-8052.33333333333,1913,9965.33333333333,907,FALSE,"out1, fill","0.1.4"
"32948","646",2023-08-10 04:45:00,-8093.66666666667,1913,10006.6666666667,907,FALSE,"out1, fill","0.1.4"
"32949","646",2023-08-10 05:00:00,-8135,1913,10048,907,FALSE,NA,"0.1.4"
"32950","646",2023-08-10 05:15:00,-8233,1913,10146,907,FALSE,NA,"0.1.4"
"32951","646",2023-08-10 05:30:00,-7993,1913,9906,907,FALSE,NA,"0.1.4"
"32952","646",2023-08-10 05:45:00,-8212,1913,10125,907,FALSE,NA,"0.1.4"
"32953","646",2023-08-10 06:00:00,-8304,1913,10217,907,FALSE,NA,"0.1.4"
"32954","646",2023-08-10 06:15:00,-7856,1913,9769,907,FALSE,NA,"0.1.4"
"32955","646",2023-08-10 06:30:00,-7839.6,1913,9752.6,907,FALSE,"out1, fill","0.1.4"
"32956","646",2023-08-10 06:45:00,-7823.2,1913,9736.2,907,FALSE,"out1, fill","0.1.4"
"32957","646",2023-08-10 07:00:00,-7806.8,1913,9719.8,907,FALSE,"out1, fill","0.1.4"
"32958","646",2023-08-10 07:15:00,-7790.4,1913,9703.4,907,FALSE,"out1, fill","0.1.4"
"32959","646",2023-08-10 07:30:00,-7774,1913,9687,907,FALSE,NA,"0.1.4"
"32960","646",2023-08-10 07:45:00,-8056,1913,9969,907,FALSE,NA,"0.1.4"
"32961","646",2023-08-10 08:00:00,-8152,1913,10065,907,FALSE,NA,"0.1.4"
"32962","646",2023-08-10 08:15:00,-8143,1913,10056,907,FALSE,NA,"0.1.4"
"32963","646",2023-08-10 08:30:00,-7912,1913,9825,907,FALSE,NA,"0.1.4"
"32964","646",2023-08-10 08:45:00,-7924,1913,9837,907,FALSE,NA,"0.1.4"
"32965","646",2023-08-10 09:00:00,-8025,1913,9938,907,FALSE,NA,"0.1.4"
"32966","646",2023-08-10 09:15:00,-8066,1913,9979,907,FALSE,NA,"0.1.4"
"32967","646",2023-08-10 09:30:00,-8058,1913,9971,907,FALSE,NA,"0.1.4"
"32968","646",2023-08-10 09:45:00,-7934,1913,9847,907,FALSE,NA,"0.1.4"
"32969","646",2023-08-10 10:00:00,-8144,1913,10057,907,FALSE,NA,"0.1.4"
"32970","646",2023-08-10 10:15:00,-8084,1913,9997,907,FALSE,NA,"0.1.4"
"32971","646",2023-08-10 10:30:00,-7933,1913,9846,907,FALSE,NA,"0.1.4"
"32972","646",2023-08-10 10:45:00,-8023,1913,9936,907,FALSE,NA,"0.1.4"
"32973","646",2023-08-10 11:00:00,-7895,1913,9808,907,FALSE,NA,"0.1.4"
"32974","646",2023-08-10 11:15:00,-8003,1913,9916,907,FALSE,NA,"0.1.4"
"32975","646",2023-08-10 11:30:00,-7941,1913,9854,907,FALSE,NA,"0.1.4"
"32976","646",2023-08-10 11:45:00,-7873,1913,9786,907,FALSE,NA,"0.1.4"
"32977","646",2023-08-10 12:00:00,-7834,1913,9747,907,FALSE,NA,"0.1.4"
"32978","646",2023-08-10 12:15:00,-7890,1913,9803,907,FALSE,NA,"0.1.4"
"32979","646",2023-08-10 12:30:00,-7557,1913,9470,907,FALSE,NA,"0.1.4"
"32980","646",2023-08-10 12:45:00,-7758,1913,9671,907,FALSE,NA,"0.1.4"
"32981","646",2023-08-10 13:00:00,-7825.66666666667,1913,9738.66666666667,907,FALSE,"out1, fill","0.1.4"
"32982","646",2023-08-10 13:15:00,-7893.33333333333,1913,9806.33333333333,907,FALSE,"out1, fill","0.1.4"
"32983","646",2023-08-10 13:30:00,-7961,1913,9874,907,FALSE,NA,"0.1.4"
"32984","646",2023-08-10 13:45:00,-7961,1913,9874,907,FALSE,"jump1","0.1.4"
"32985","646",2023-08-10 14:00:00,-7802,1913,9715,907,FALSE,NA,"0.1.4"
"32986","646",2023-08-10 14:15:00,-8295,1913,10208,907,FALSE,NA,"0.1.4"
"32987","646",2023-08-10 14:30:00,-8255,1913,10168,907,FALSE,NA,"0.1.4"
"32988","646",2023-08-10 14:45:00,-8368,1913,10281,907,FALSE,NA,"0.1.4"
"32989","646",2023-08-10 15:00:00,-8450,1913,10363,907,FALSE,NA,"0.1.4"
"32990","646",2023-08-10 15:15:00,-8431,1913,10344,907,FALSE,NA,"0.1.4"
"32991","646",2023-08-10 15:30:00,NA,NA,NA,NA,NA,"out1","0.1.4"
"32992","646",2023-08-10 15:45:00,NA,NA,NA,NA,NA,"out1","0.1.4"
"32993","646",2023-08-10 16:00:00,NA,NA,NA,NA,NA,"out1","0.1.4"
"32994","646",2023-08-10 16:15:00,NA,NA,NA,NA,NA,"out1","0.1.4"
"32995","646",2023-08-10 16:30:00,NA,NA,NA,NA,NA,"out1","0.1.4"
"32996","646",2023-08-10 16:45:00,NA,NA,NA,NA,NA,"out1","0.1.4"
"32997","646",2023-08-10 17:00:00,NA,NA,NA,NA,NA,"out1","0.1.4"
"32998","646",2023-08-10 17:15:00,NA,NA,NA,NA,NA,"out1","0.1.4"
"32999","646",2023-08-10 17:30:00,NA,NA,NA,NA,NA,"out1","0.1.4"
"33000","646",2023-08-10 17:45:00,NA,NA,NA,NA,NA,"out1","0.1.4"
"33001","646",2023-08-10 18:00:00,NA,NA,NA,NA,NA,"out1","0.1.4"
"33002","646",2023-08-10 18:15:00,NA,NA,NA,NA,NA,"out1","0.1.4"
"33003","646",2023-08-10 18:30:00,NA,NA,NA,NA,NA,"out1","0.1.4"
"33004","646",2023-08-10 18:45:00,NA,NA,NA,NA,NA,"out1","0.1.4"
"33005","646",2023-08-10 19:00:00,NA,NA,NA,NA,NA,"out1","0.1.4"
"33006","646",2023-08-10 19:15:00,NA,NA,NA,NA,NA,"out1","0.1.4"
"33007","646",2023-08-10 19:30:00,NA,NA,NA,NA,NA,"out1","0.1.4"
"33008","646",2023-08-10 19:45:00,-8372,1913,10285,907,FALSE,NA,"0.1.4"
"33009","646",2023-08-10 20:00:00,-8245,1913,10158,907,FALSE,NA,"0.1.4"
"33010","646",2023-08-10 20:15:00,-8245,1913,10158,907,FALSE,"jump1","0.1.4"
"33011","646",2023-08-10 20:30:00,-8245,1913,10158,907,FALSE,"jump1","0.1.4"
"33012","646",2023-08-10 20:45:00,-8245,1913,10158,907,FALSE,NA,"0.1.4"
"33013","646",2023-08-10 21:00:00,-8255,1913,10168,907,FALSE,NA,"0.1.4"
"33014","646",2023-08-10 21:15:00,-8249,1913,10162,907,FALSE,NA,"0.1.4"
"33015","646",2023-08-10 21:30:00,-8540.2,1913,10453.2,907,FALSE,"out1, fill","0.1.4"
"33016","646",2023-08-10 21:45:00,-8831.4,1913,10744.4,907,FALSE,"out1, fill","0.1.4"
"33017","646",2023-08-10 22:00:00,-9122.6,1913,11035.6,907,FALSE,"out1, fill","0.1.4"
"33018","646",2023-08-10 22:15:00,-9413.8,1913,11326.8,907,FALSE,"out1, fill","0.1.4"
"33019","646",2023-08-10 22:30:00,-9705,1913,11618,907,FALSE,NA,"0.1.4"
"33020","646",2023-08-10 22:45:00,-9418,1913,11331,907,FALSE,NA,"0.1.4"
"33021","646",2023-08-10 23:00:00,-9331,1913,11244,907,FALSE,NA,"0.1.4"
"33022","646",2023-08-10 23:15:00,-9367,1913,11280,907,FALSE,NA,"0.1.4"
"33023","646",2023-08-10 23:30:00,-9530,1913,11443,907,FALSE,NA,"0.1.4"
"33024","646",2023-08-10 23:45:00,-9306,1913,11219,907,FALSE,NA,"0.1.4"
"33025","646",2023-08-11,-9652,1913,11565,907,FALSE,NA,"0.1.4"
"33026","646",2023-08-11 00:15:00,-9843,1913,11756,907,FALSE,NA,"0.1.4"
"33027","646",2023-08-11 00:30:00,-9913,1913,11826,907,FALSE,NA,"0.1.4"
"33028","646",2023-08-11 00:45:00,-9594,1913,11507,907,FALSE,NA,"0.1.4"
"33029","646",2023-08-11 01:00:00,-9671,1913,11584,907,FALSE,"out1, fill","0.1.4"
"33030","646",2023-08-11 01:15:00,-9748,1913,11661,907,FALSE,"out1, fill","0.1.4"
"33031","646",2023-08-11 01:30:00,-9825,1913,11738,907,FALSE,NA,"0.1.4"
"33032","646",2023-08-11 01:45:00,-9787,1913,11700,907,FALSE,NA,"0.1.4"
"33033","646",2023-08-11 02:00:00,-9819,1913,11732,907,FALSE,NA,"0.1.4"
"33034","646",2023-08-11 02:15:00,-9899,1913,11812,907,FALSE,NA,"0.1.4"
"33035","646",2023-08-11 02:30:00,-9968,1913,11881,907,FALSE,NA,"0.1.4"
"33036","646",2023-08-11 02:45:00,-9968,1913,11881,907,FALSE,"jump1","0.1.4"
"33037","646",2023-08-11 03:00:00,-9546,1913,11459,907,FALSE,NA,"0.1.4"
"33038","646",2023-08-11 03:15:00,-9948,1913,11861,907,FALSE,"out1, fill","0.1.4"
"33039","646",2023-08-11 03:30:00,-10350,1913,12263,907,FALSE,NA,"0.1.4"
"33040","646",2023-08-11 03:45:00,-10464,1913,12377,907,FALSE,NA,"0.1.4"
"33041","646",2023-08-11 04:00:00,-10691,1913,12604,907,FALSE,NA,"0.1.4"
"33042","646",2023-08-11 04:15:00,-10634,1913,12547,907,FALSE,NA,"0.1.4"
"33043","646",2023-08-11 04:30:00,-10257,1913,12170,907,FALSE,NA,"0.1.4"
"33044","646",2023-08-11 04:45:00,-10743,1913,12656,907,FALSE,NA,"0.1.4"
"33045","646",2023-08-11 05:00:00,-10701,1913,12614,907,FALSE,NA,"0.1.4"
"33046","646",2023-08-11 05:15:00,-10553,1913,12466,907,FALSE,NA,"0.1.4"
"33047","646",2023-08-11 05:30:00,-10775,1913,12688,907,FALSE,NA,"0.1.4"
"33048","646",2023-08-11 05:45:00,-10532,1913,12445,907,FALSE,NA,"0.1.4"
"33049","646",2023-08-11 06:00:00,-10811,1913,12724,907,FALSE,NA,"0.1.4"
"33050","646",2023-08-11 06:15:00,-10791,1913,12704,907,FALSE,"out1, fill","0.1.4"
"33051","646",2023-08-11 06:30:00,-10771,1913,12684,907,FALSE,"out1, fill","0.1.4"
"33052","646",2023-08-11 06:45:00,-10751,1913,12664,907,FALSE,NA,"0.1.4"
"33053","646",2023-08-11 07:00:00,-10702,1913,12615,907,FALSE,NA,"0.1.4"
"33054","646",2023-08-11 07:15:00,-10863,1913,12776,907,FALSE,NA,"0.1.4"
"33055","646",2023-08-11 07:30:00,-10744,1913,12657,907,FALSE,NA,"0.1.4"
"33056","646",2023-08-11 07:45:00,-10555.5,1913,12468.5,907,FALSE,"out1, fill","0.1.4"
"33057","646",2023-08-11 08:00:00,-10367,1913,12280,907,FALSE,NA,"0.1.4"
"33058","646",2023-08-11 08:15:00,-10761,1913,12674,907,FALSE,NA,"0.1.4"
"33059","646",2023-08-11 08:30:00,-10746,1913,12659,907,FALSE,NA,"0.1.4"
"33060","646",2023-08-11 08:45:00,-10746,1913,12659,907,FALSE,"jump1","0.1.4"
"33061","646",2023-08-11 09:00:00,-10411,1913,12324,907,FALSE,NA,"0.1.4"
"33062","646",2023-08-11 09:15:00,-10861.5,1913,12774.5,907,FALSE,"out1, fill","0.1.4"
"33063","646",2023-08-11 09:30:00,-11312,1913,13225,907,FALSE,NA,"0.1.4"
"33064","646",2023-08-11 09:45:00,-11370,1913,13283,907,FALSE,NA,"0.1.4"
"33065","646",2023-08-11 10:00:00,-11280,1913,13193,907,FALSE,NA,"0.1.4"
"33066","646",2023-08-11 10:15:00,-11237,1913,13150,907,FALSE,NA,"0.1.4"
"33067","646",2023-08-11 10:30:00,-11254,1913,13167,907,FALSE,NA,"0.1.4"
"33068","646",2023-08-11 10:45:00,-11365,1913,13278,907,FALSE,NA,"0.1.4"
"33069","646",2023-08-11 11:00:00,-11365,1913,13278,907,FALSE,"jump1","0.1.4"
"33070","646",2023-08-11 11:15:00,-11365,1913,13278,907,FALSE,"jump1","0.1.4"
"33071","646",2023-08-11 11:30:00,-11365,1913,13278,907,FALSE,"jump1","0.1.4"
"33072","646",2023-08-11 11:45:00,-11365,1913,13278,907,FALSE,"jump1","0.1.4"
"33073","646",2023-08-11 12:00:00,-10894,1913,12807,907,FALSE,NA,"0.1.4"
"33074","646",2023-08-11 12:15:00,-11167,1913,13080,907,FALSE,NA,"0.1.4"
"33075","646",2023-08-11 12:30:00,-11577,1913,13490,907,FALSE,NA,"0.1.4"
"33076","646",2023-08-11 12:45:00,-11329,1913,13242,907,FALSE,NA,"0.1.4"
"33077","646",2023-08-11 13:00:00,-11408,1913,13321,907,FALSE,NA,"0.1.4"
"33078","646",2023-08-11 13:15:00,-11465,1913,13378,907,FALSE,NA,"0.1.4"
"33079","646",2023-08-11 13:30:00,-11395,1913,13308,907,FALSE,"out1, fill","0.1.4"
"33080","646",2023-08-11 13:45:00,-11325,1913,13238,907,FALSE,"out1, fill","0.1.4"
"33081","646",2023-08-11 14:00:00,-11255,1913,13168,907,FALSE,NA,"0.1.4"
"33082","646",2023-08-11 14:15:00,-11258,1913,13171,907,FALSE,NA,"0.1.4"
"33083","646",2023-08-11 14:30:00,-11247,1913,13160,907,FALSE,NA,"0.1.4"
"33084","646",2023-08-11 14:45:00,-11335,1913,13248,907,FALSE,NA,"0.1.4"
"33085","646",2023-08-11 15:00:00,-11335,1913,13248,907,FALSE,"jump1","0.1.4"
"33086","646",2023-08-11 15:15:00,-11594,1913,13507,907,FALSE,NA,"0.1.4"
"33087","646",2023-08-11 15:30:00,-11707,1913,13620,907,FALSE,NA,"0.1.4"
"33088","646",2023-08-11 15:45:00,-11626,1913,13539,907,FALSE,"out1, fill","0.1.4"
"33089","646",2023-08-11 16:00:00,-11545,1913,13458,907,FALSE,"out1, fill","0.1.4"
"33090","646",2023-08-11 16:15:00,-11464,1913,13377,907,FALSE,"out1, fill","0.1.4"
"33091","646",2023-08-11 16:30:00,-11383,1913,13296,907,FALSE,"out1, fill","0.1.4"
"33092","646",2023-08-11 16:45:00,-11302,1913,13215,907,FALSE,NA,"0.1.4"
"33093","646",2023-08-11 17:00:00,-11474,1913,13387,907,FALSE,NA,"0.1.4"
"33094","646",2023-08-11 17:15:00,-11330,1913,13243,907,FALSE,NA,"0.1.4"
"33095","646",2023-08-11 17:30:00,-11325.8,1913,13238.8,907,FALSE,"out1, fill","0.1.4"
"33096","646",2023-08-11 17:45:00,-11321.6,1913,13234.6,907,FALSE,"out1, fill","0.1.4"
"33097","646",2023-08-11 18:00:00,-11317.4,1913,13230.4,907,FALSE,"out1, fill","0.1.4"
"33098","646",2023-08-11 18:15:00,-11313.2,1913,13226.2,907,FALSE,"out1, fill","0.1.4"
"33099","646",2023-08-11 18:30:00,-11309,1913,13222,907,FALSE,"out1, fill","0.1.4"
"33100","646",2023-08-11 18:45:00,-11304.8,1913,13217.8,907,FALSE,"out1, fill","0.1.4"
"33101","646",2023-08-11 19:00:00,-11300.6,1913,13213.6,907,FALSE,"out1, fill","0.1.4"
"33102","646",2023-08-11 19:15:00,-11296.4,1913,13209.4,907,FALSE,"out1, fill","0.1.4"
"33103","646",2023-08-11 19:30:00,-11292.2,1913,13205.2,907,FALSE,"out1, fill","0.1.4"
"33104","646",2023-08-11 19:45:00,-11288,1913,13201,907,FALSE,NA,"0.1.4"
"33105","646",2023-08-11 20:00:00,-11219,1913,13132,907,FALSE,NA,"0.1.4"
"33106","646",2023-08-11 20:15:00,-11486,1913,13399,907,FALSE,NA,"0.1.4"
"33107","646",2023-08-11 20:30:00,-11156,1913,13069,907,FALSE,NA,"0.1.4"
"33108","646",2023-08-11 20:45:00,-11371,1913,13284,907,FALSE,NA,"0.1.4"
"33109","646",2023-08-11 21:00:00,-11545,1913,13458,907,FALSE,NA,"0.1.4"
"33110","646",2023-08-11 21:15:00,-11156,1913,13069,907,FALSE,NA,"0.1.4"
"33111","646",2023-08-11 21:30:00,-11604,1913,13517,907,FALSE,NA,"0.1.4"
"33112","646",2023-08-11 21:45:00,-11586.1666666667,1913,13499.1666666667,907,FALSE,"out1, fill","0.1.4"
"33113","646",2023-08-11 22:00:00,-11568.3333333333,1913,13481.3333333333,907,FALSE,"out1, fill","0.1.4"
"33114","646",2023-08-11 22:15:00,-11550.5,1913,13463.5,907,FALSE,"out1, fill","0.1.4"
"33115","646",2023-08-11 22:30:00,-11532.6666666667,1913,13445.6666666667,907,FALSE,"out1, fill","0.1.4"
"33116","646",2023-08-11 22:45:00,-11514.8333333333,1913,13427.8333333333,907,FALSE,"out1, fill","0.1.4"
"33117","646",2023-08-11 23:00:00,-11497,1913,13410,907,FALSE,NA,"0.1.4"
"33118","646",2023-08-11 23:15:00,-11405,1913,13318,907,FALSE,NA,"0.1.4"
"33119","646",2023-08-11 23:30:00,-11666,1913,13579,907,FALSE,NA,"0.1.4"
"33120","646",2023-08-11 23:45:00,-11658,1913,13571,907,FALSE,NA,"0.1.4"
"33121","646",2023-08-12,-11562,1913,13475,907,FALSE,NA,"0.1.4"
"33122","646",2023-08-12 00:15:00,-11571,1913,13484,907,FALSE,NA,"0.1.4"
"33123","646",2023-08-12 00:30:00,-11511,1913,13424,907,FALSE,NA,"0.1.4"
"33124","646",2023-08-12 00:45:00,-11710,1913,13623,907,FALSE,NA,"0.1.4"
"33125","646",2023-08-12 01:00:00,-11480,1913,13393,907,FALSE,NA,"0.1.4"
"33126","646",2023-08-12 01:15:00,-11460,1913,13373,907,FALSE,NA,"0.1.4"
"33127","646",2023-08-12 01:30:00,-11815,1913,13728,907,FALSE,NA,"0.1.4"
"33128","646",2023-08-12 01:45:00,-11819,1913,13732,907,FALSE,NA,"0.1.4"
"33129","646",2023-08-12 02:00:00,-11602,1913,13515,907,FALSE,NA,"0.1.4"
"33130","646",2023-08-12 02:15:00,-11712,1913,13625,907,FALSE,NA,"0.1.4"
"33131","646",2023-08-12 02:30:00,-11989,1913,13902,907,FALSE,NA,"0.1.4"
"33132","646",2023-08-12 02:45:00,-11684,1913,13597,907,FALSE,NA,"0.1.4"
"33133","646",2023-08-12 03:00:00,-11733,1913,13646,907,FALSE,NA,"0.1.4"
"33134","646",2023-08-12 03:15:00,-11950,1913,13863,907,FALSE,NA,"0.1.4"
"33135","646",2023-08-12 03:30:00,-11546,1913,13459,907,FALSE,NA,"0.1.4"
"33136","646",2023-08-12 03:45:00,-11724,1913,13637,907,FALSE,NA,"0.1.4"
"33137","646",2023-08-12 04:00:00,-11961,1913,13874,907,FALSE,NA,"0.1.4"
"33138","646",2023-08-12 04:15:00,-11993,1913,13906,907,FALSE,NA,"0.1.4"
"33139","646",2023-08-12 04:30:00,-11913,1913,13826,907,FALSE,NA,"0.1.4"
"33140","646",2023-08-12 04:45:00,-11963,1913,13876,907,FALSE,NA,"0.1.4"
"33141","646",2023-08-12 05:00:00,-11843,1913,13756,907,FALSE,NA,"0.1.4"
"33142","646",2023-08-12 05:15:00,-11699,1913,13612,907,FALSE,NA,"0.1.4"
"33143","646",2023-08-12 05:30:00,-11985,1913,13898,907,FALSE,NA,"0.1.4"
"33144","646",2023-08-12 05:45:00,-11620,1913,13533,907,FALSE,NA,"0.1.4"
"33145","646",2023-08-12 06:00:00,-11777,1913,13690,907,FALSE,NA,"0.1.4"
"33146","646",2023-08-12 06:15:00,-11596,1913,13509,907,FALSE,NA,"0.1.4"
"33147","646",2023-08-12 06:30:00,-11995,1913,13908,907,FALSE,NA,"0.1.4"
"33148","646",2023-08-12 06:45:00,-11891,1913,13804,907,FALSE,NA,"0.1.4"
"33149","646",2023-08-12 07:00:00,-11935,1913,13848,907,FALSE,NA,"0.1.4"
"33150","646",2023-08-12 07:15:00,-12004,1913,13917,907,FALSE,NA,"0.1.4"
"33151","646",2023-08-12 07:30:00,-11820,1913,13733,907,FALSE,NA,"0.1.4"
"33152","646",2023-08-12 07:45:00,-11495,1913,13408,907,FALSE,NA,"0.1.4"
"33153","646",2023-08-12 08:00:00,-11859,1913,13772,907,FALSE,NA,"0.1.4"
"33154","646",2023-08-12 08:15:00,-12027,1913,13940,907,FALSE,NA,"0.1.4"
"33155","646",2023-08-12 08:30:00,-11581,1913,13494,907,FALSE,NA,"0.1.4"
"33156","646",2023-08-12 08:45:00,-11806,1913,13719,907,FALSE,NA,"0.1.4"
"33157","646",2023-08-12 09:00:00,-11928,1913,13841,907,FALSE,NA,"0.1.4"
"33158","646",2023-08-12 09:15:00,-11550,1913,13463,907,FALSE,NA,"0.1.4"
"33159","646",2023-08-12 09:30:00,-11943,1913,13856,907,FALSE,NA,"0.1.4"
"33160","646",2023-08-12 09:45:00,-11948.6666666667,1913,13861.6666666667,907,FALSE,"out1, fill","0.1.4"
"33161","646",2023-08-12 10:00:00,-11954.3333333333,1913,13867.3333333333,907,FALSE,"out1, fill","0.1.4"
"33162","646",2023-08-12 10:15:00,-11960,1913,13873,907,FALSE,NA,"0.1.4"
"33163","646",2023-08-12 10:30:00,-12057,1913,13970,907,FALSE,NA,"0.1.4"
"33164","646",2023-08-12 10:45:00,-11739,1913,13652,907,FALSE,NA,"0.1.4"
"33165","646",2023-08-12 11:00:00,-12039,1913,13952,907,FALSE,NA,"0.1.4"
"33166","646",2023-08-12 11:15:00,-11761,1913,13674,907,FALSE,NA,"0.1.4"
"33167","646",2023-08-12 11:30:00,-11868,1913,13781,907,FALSE,NA,"0.1.4"
"33168","646",2023-08-12 11:45:00,-11812,1913,13725,907,FALSE,NA,"0.1.4"
"33169","646",2023-08-12 12:00:00,-11447,1913,13360,907,FALSE,NA,"0.1.4"
"33170","646",2023-08-12 12:15:00,-11796,1913,13709,907,FALSE,NA,"0.1.4"
"33171","646",2023-08-12 12:30:00,-11859,1913,13772,907,FALSE,NA,"0.1.4"
"33172","646",2023-08-12 12:45:00,-11869,1913,13782,907,FALSE,NA,"0.1.4"
"33173","646",2023-08-12 13:00:00,-12026,1913,13939,907,FALSE,NA,"0.1.4"
"33174","646",2023-08-12 13:15:00,-11835,1913,13748,907,FALSE,NA,"0.1.4"
"33175","646",2023-08-12 13:30:00,-11951,1913,13864,907,FALSE,NA,"0.1.4"
"33176","646",2023-08-12 13:45:00,-11615.25,1913,13528.25,907,FALSE,"out1, fill","0.1.4"
"33177","646",2023-08-12 14:00:00,-11279.5,1913,13192.5,907,FALSE,"out1, fill","0.1.4"
"33178","646",2023-08-12 14:15:00,-10943.75,1913,12856.75,907,FALSE,"out1, fill","0.1.4"
"33179","646",2023-08-12 14:30:00,-10608,1913,12521,907,FALSE,NA,"0.1.4"
"33180","646",2023-08-12 14:45:00,-10163,1913,12076,907,FALSE,NA,"0.1.4"
"33181","646",2023-08-12 15:00:00,-10124,1913,12037,907,FALSE,NA,"0.1.4"
"33182","646",2023-08-12 15:15:00,-10138,1913,12051,907,FALSE,NA,"0.1.4"
"33183","646",2023-08-12 15:30:00,-10431,1913,12344,907,FALSE,NA,"0.1.4"
"33184","646",2023-08-12 15:45:00,NA,NA,NA,NA,NA,"out1","0.1.4"
"33185","646",2023-08-12 16:00:00,NA,NA,NA,NA,NA,"out1","0.1.4"
"33186","646",2023-08-12 16:15:00,NA,NA,NA,NA,NA,"out1","0.1.4"
"33187","646",2023-08-12 16:30:00,NA,NA,NA,NA,NA,"out1","0.1.4"
"33188","646",2023-08-12 16:45:00,NA,NA,NA,NA,NA,"out1","0.1.4"
"33189","646",2023-08-12 17:00:00,NA,NA,NA,NA,NA,"out1","0.1.4"
"33190","646",2023-08-12 17:15:00,NA,NA,NA,NA,NA,"out1","0.1.4"
"33191","646",2023-08-12 17:30:00,NA,NA,NA,NA,NA,"out1","0.1.4"
"33192","646",2023-08-12 17:45:00,NA,NA,NA,NA,NA,"out1","0.1.4"
"33193","646",2023-08-12 18:00:00,NA,NA,NA,NA,NA,"out1","0.1.4"
"33194","646",2023-08-12 18:15:00,NA,NA,NA,NA,NA,"out1","0.1.4"
"33195","646",2023-08-12 18:30:00,NA,NA,NA,NA,NA,"out1","0.1.4"
"33196","646",2023-08-12 18:45:00,NA,NA,NA,NA,NA,"out1","0.1.4"
"33197","646",2023-08-12 19:00:00,NA,NA,NA,NA,NA,"out1","0.1.4"
"33198","646",2023-08-12 19:15:00,NA,NA,NA,NA,NA,"out1","0.1.4"
"33199","646",2023-08-12 19:30:00,NA,NA,NA,NA,NA,"out1","0.1.4"
"33200","646",2023-08-12 19:45:00,NA,NA,NA,NA,NA,"out1","0.1.4"
"33201","646",2023-08-12 20:00:00,NA,NA,NA,NA,NA,"out1","0.1.4"
"33202","646",2023-08-12 20:15:00,NA,NA,NA,NA,NA,"out1","0.1.4"
"33203","646",2023-08-12 20:30:00,NA,NA,NA,NA,NA,"out1","0.1.4"
"33204","646",2023-08-12 20:45:00,-10939,1913,12852,907,FALSE,NA,"0.1.4"
"33205","646",2023-08-12 21:00:00,-11037,1913,12950,907,FALSE,NA,"0.1.4"
"33206","646",2023-08-12 21:15:00,-11386,1913,13299,907,FALSE,NA,"0.1.4"
"33207","646",2023-08-12 21:30:00,-11357,1913,13270,907,FALSE,"out1, fill","0.1.4"
"33208","646",2023-08-12 21:45:00,-11328,1913,13241,907,FALSE,"out1, fill","0.1.4"
"33209","646",2023-08-12 22:00:00,-11299,1913,13212,907,FALSE,"out1, fill","0.1.4"
"33210","646",2023-08-12 22:15:00,-11270,1913,13183,907,FALSE,"out1, fill","0.1.4"
"33211","646",2023-08-12 22:30:00,-11241,1913,13154,907,FALSE,NA,"0.1.4"
"33212","646",2023-08-12 22:45:00,-11659,1913,13572,907,FALSE,NA,"0.1.4"
"33213","646",2023-08-12 23:00:00,-11367,1913,13280,907,FALSE,NA,"0.1.4"
"33214","646",2023-08-12 23:15:00,-11652,1913,13565,907,FALSE,NA,"0.1.4"
"33215","646",2023-08-12 23:30:00,-11291,1913,13204,907,FALSE,NA,"0.1.4"
"33216","646",2023-08-12 23:45:00,-11298,1913,13211,907,FALSE,NA,"0.1.4"
"33217","646",2023-08-13,-11340,1913,13253,907,FALSE,NA,"0.1.4"
"33218","646",2023-08-13 00:15:00,-11836,1913,13749,907,FALSE,NA,"0.1.4"
"33219","646",2023-08-13 00:30:00,-11692,1913,13605,907,FALSE,NA,"0.1.4"
"33220","646",2023-08-13 00:45:00,-11593,1913,13506,907,FALSE,NA,"0.1.4"
"33221","646",2023-08-13 01:00:00,-11110,1913,13023,907,FALSE,NA,"0.1.4"
"33222","646",2023-08-13 01:15:00,-11110,1913,13023,907,FALSE,"jump1","0.1.4"
"33223","646",2023-08-13 01:30:00,-11098,1913,13011,907,FALSE,NA,"0.1.4"
"33224","646",2023-08-13 01:45:00,-11197,1913,13110,907,FALSE,NA,"0.1.4"
"33225","646",2023-08-13 02:00:00,-11362,1913,13275,907,FALSE,NA,"0.1.4"
"33226","646",2023-08-13 02:15:00,-11278,1913,13191,907,FALSE,NA,"0.1.4"
"33227","646",2023-08-13 02:30:00,-11362,1913,13275,907,FALSE,NA,"0.1.4"
"33228","646",2023-08-13 02:45:00,-11349,1913,13262,907,FALSE,NA,"0.1.4"
"33229","646",2023-08-13 03:00:00,-11357,1913,13270,907,FALSE,NA,"0.1.4"
"33230","646",2023-08-13 03:15:00,-11357,1913,13270,907,FALSE,"jump1","0.1.4"
"33231","646",2023-08-13 03:30:00,-11357,1913,13270,907,FALSE,"jump1","0.1.4"
"33232","646",2023-08-13 03:45:00,-11328,1913,13241,907,FALSE,NA,"0.1.4"
"33233","646",2023-08-13 04:00:00,-11029,1913,12942,907,FALSE,NA,"0.1.4"
"33234","646",2023-08-13 04:15:00,-11237,1913,13150,907,FALSE,NA,"0.1.4"
"33235","646",2023-08-13 04:30:00,-10878,1913,12791,907,FALSE,NA,"0.1.4"
"33236","646",2023-08-13 04:45:00,-11067,1913,12980,907,FALSE,NA,"0.1.4"
"33237","646",2023-08-13 05:00:00,-11435,1913,13348,907,FALSE,NA,"0.1.4"
"33238","646",2023-08-13 05:15:00,-11363,1913,13276,907,FALSE,NA,"0.1.4"
"33239","646",2023-08-13 05:30:00,-11316,1913,13229,907,FALSE,NA,"0.1.4"
"33240","646",2023-08-13 05:45:00,-10910,1913,12823,907,FALSE,NA,"0.1.4"
"33241","646",2023-08-13 06:00:00,-11381,1913,13294,907,FALSE,NA,"0.1.4"
"33242","646",2023-08-13 06:15:00,-11205,1913,13118,907,FALSE,NA,"0.1.4"
"33243","646",2023-08-13 06:30:00,-11165,1913,13078,907,FALSE,NA,"0.1.4"
"33244","646",2023-08-13 06:45:00,-11078,1913,12991,907,FALSE,NA,"0.1.4"
"33245","646",2023-08-13 07:00:00,-11330,1913,13243,907,FALSE,NA,"0.1.4"
"33246","646",2023-08-13 07:15:00,-11036,1913,12949,907,FALSE,NA,"0.1.4"
"33247","646",2023-08-13 07:30:00,-11297,1913,13210,907,FALSE,NA,"0.1.4"
"33248","646",2023-08-13 07:45:00,-11280.3333333333,1913,13193.3333333333,907,FALSE,"out1, fill","0.1.4"
"33249","646",2023-08-13 08:00:00,-11263.6666666667,1913,13176.6666666667,907,FALSE,"out1, fill","0.1.4"
"33250","646",2023-08-13 08:15:00,-11247,1913,13160,907,FALSE,NA,"0.1.4"
"33251","646",2023-08-13 08:30:00,-11226,1913,13139,907,FALSE,NA,"0.1.4"
"33252","646",2023-08-13 08:45:00,-10972,1913,12885,907,FALSE,NA,"0.1.4"
"33253","646",2023-08-13 09:00:00,-11347,1913,13260,907,FALSE,NA,"0.1.4"
"33254","646",2023-08-13 09:15:00,-11083,1913,12996,907,FALSE,NA,"0.1.4"
"33255","646",2023-08-13 09:30:00,-11086,1913,12999,907,FALSE,NA,"0.1.4"
"33256","646",2023-08-13 09:45:00,-11215,1913,13128,907,FALSE,NA,"0.1.4"
"33257","646",2023-08-13 10:00:00,-11420,1913,13333,907,FALSE,NA,"0.1.4"
"33258","646",2023-08-13 10:15:00,-11215,1913,13128,907,FALSE,NA,"0.1.4"
"33259","646",2023-08-13 10:30:00,-11231,1913,13144,907,FALSE,NA,"0.1.4"
"33260","646",2023-08-13 10:45:00,-11179,1913,13092,907,FALSE,NA,"0.1.4"
"33261","646",2023-08-13 11:00:00,-11303,1913,13216,907,FALSE,NA,"0.1.4"
"33262","646",2023-08-13 11:15:00,-10956,1913,12869,907,FALSE,NA,"0.1.4"
"33263","646",2023-08-13 11:30:00,-10961,1913,12874,907,FALSE,NA,"0.1.4"
"33264","646",2023-08-13 11:45:00,-11294,1913,13207,907,FALSE,NA,"0.1.4"
"33265","646",2023-08-13 12:00:00,-11337,1913,13250,907,FALSE,NA,"0.1.4"
"33266","646",2023-08-13 12:15:00,-11511,1913,13424,907,FALSE,NA,"0.1.4"
"33267","646",2023-08-13 12:30:00,-11511,1913,13424,907,FALSE,"jump1","0.1.4"
"33268","646",2023-08-13 12:45:00,-11956,1913,13869,907,FALSE,NA,"0.1.4"
"33269","646",2023-08-13 13:00:00,-11956,1913,13869,907,FALSE,"jump1","0.1.4"
"33270","646",2023-08-13 13:15:00,-11792,1913,13705,907,FALSE,NA,"0.1.4"
"33271","646",2023-08-13 13:30:00,-12171,1913,14084,907,FALSE,NA,"0.1.4"
"33272","646",2023-08-13 13:45:00,-12183,1913,14096,907,FALSE,NA,"0.1.4"
"33273","646",2023-08-13 14:00:00,-12351,1913,14264,907,FALSE,NA,"0.1.4"
"33274","646",2023-08-13 14:15:00,-12383,1913,14296,907,FALSE,NA,"0.1.4"
"33275","646",2023-08-13 14:30:00,-12249,1913,14162,907,FALSE,NA,"0.1.4"
"33276","646",2023-08-13 14:45:00,-12381,1913,14294,907,FALSE,NA,"0.1.4"
"33277","646",2023-08-13 15:00:00,-12306.1538461538,1913,14219.1538461538,907,FALSE,"out1, fill","0.1.4"
"33278","646",2023-08-13 15:15:00,-12231.3076923077,1913,14144.3076923077,907,FALSE,"out1, fill","0.1.4"
"33279","646",2023-08-13 15:30:00,-12156.4615384615,1913,14069.4615384615,907,FALSE,"out1, fill","0.1.4"
"33280","646",2023-08-13 15:45:00,-12081.6153846154,1913,13994.6153846154,907,FALSE,"out1, fill","0.1.4"
"33281","646",2023-08-13 16:00:00,-12006.7692307692,1913,13919.7692307692,907,FALSE,"out1, fill","0.1.4"
"33282","646",2023-08-13 16:15:00,-11931.9230769231,1913,13844.9230769231,907,FALSE,"out1, fill","0.1.4"
"33283","646",2023-08-13 16:30:00,-11857.0769230769,1913,13770.0769230769,907,FALSE,"out1, fill","0.1.4"
"33284","646",2023-08-13 16:45:00,-11782.2307692308,1913,13695.2307692308,907,FALSE,"out1, fill","0.1.4"
"33285","646",2023-08-13 17:00:00,-11707.3846153846,1913,13620.3846153846,907,FALSE,"out1, fill","0.1.4"
"33286","646",2023-08-13 17:15:00,-11632.5384615385,1913,13545.5384615385,907,FALSE,"out1, fill","0.1.4"
"33287","646",2023-08-13 17:30:00,-11557.6923076923,1913,13470.6923076923,907,FALSE,"out1, fill","0.1.4"
"33288","646",2023-08-13 17:45:00,-11482.8461538462,1913,13395.8461538462,907,FALSE,"out1, fill","0.1.4"
"33289","646",2023-08-13 18:00:00,-11408,1913,13321,907,FALSE,NA,"0.1.4"
"33290","646",2023-08-13 18:15:00,-11408,1913,13321,907,FALSE,"jump1","0.1.4"
"33291","646",2023-08-13 18:30:00,-11408,1913,13321,907,FALSE,"jump1","0.1.4"
"33292","646",2023-08-13 18:45:00,-11408,1913,13321,907,FALSE,"jump1","0.1.4"
"33293","646",2023-08-13 19:00:00,-11427,1913,13340,907,FALSE,NA,"0.1.4"
"33294","646",2023-08-13 19:15:00,-11427,1913,13340,907,FALSE,"jump1","0.1.4"
"33295","646",2023-08-13 19:30:00,-11194,1913,13107,907,FALSE,NA,"0.1.4"
"33296","646",2023-08-13 19:45:00,-11637,1913,13550,907,FALSE,NA,"0.1.4"
"33297","646",2023-08-13 20:00:00,-11646,1913,13559,907,FALSE,NA,"0.1.4"
"33298","646",2023-08-13 20:15:00,-11975,1913,13888,907,FALSE,NA,"0.1.4"
"33299","646",2023-08-13 20:30:00,-11738,1913,13651,907,FALSE,NA,"0.1.4"
"33300","646",2023-08-13 20:45:00,-11744,1913,13657,907,FALSE,NA,"0.1.4"
"33301","646",2023-08-13 21:00:00,-11909,1913,13822,907,FALSE,NA,"0.1.4"
"33302","646",2023-08-13 21:15:00,-11924,1913,13837,907,FALSE,NA,"0.1.4"
"33303","646",2023-08-13 21:30:00,-11999,1913,13912,907,FALSE,NA,"0.1.4"
"33304","646",2023-08-13 21:45:00,-12254,1913,14167,907,FALSE,NA,"0.1.4"
"33305","646",2023-08-13 22:00:00,-12105,1913,14018,907,FALSE,NA,"0.1.4"
"33306","646",2023-08-13 22:15:00,-11926,1913,13839,907,FALSE,NA,"0.1.4"
"33307","646",2023-08-13 22:30:00,-11670,1913,13583,907,FALSE,NA,"0.1.4"
"33308","646",2023-08-13 22:45:00,-11851,1913,13764,907,FALSE,NA,"0.1.4"
"33309","646",2023-08-13 23:00:00,-11992,1913,13905,907,FALSE,NA,"0.1.4"
"33310","646",2023-08-13 23:15:00,-11810,1913,13723,907,FALSE,NA,"0.1.4"
"33311","646",2023-08-13 23:30:00,-11868.6363636364,1913,13781.6363636364,907,FALSE,"out1, fill","0.1.4"
"33312","646",2023-08-13 23:45:00,-11927.2727272727,1913,13840.2727272727,907,FALSE,"out1, fill","0.1.4"
"33313","646",2023-08-14,-11985.9090909091,1913,13898.9090909091,907,FALSE,"out1, fill","0.1.4"
"33314","646",2023-08-14 00:15:00,-12044.5454545455,1913,13957.5454545455,907,FALSE,"out1, fill","0.1.4"
"33315","646",2023-08-14 00:30:00,-12103.1818181818,1913,14016.1818181818,907,FALSE,"out1, fill","0.1.4"
"33316","646",2023-08-14 00:45:00,-12161.8181818182,1913,14074.8181818182,907,FALSE,"out1, fill","0.1.4"
"33317","646",2023-08-14 01:00:00,-12220.4545454545,1913,14133.4545454545,907,FALSE,"out1, fill","0.1.4"
"33318","646",2023-08-14 01:15:00,-12279.0909090909,1913,14192.0909090909,907,FALSE,"out1, fill","0.1.4"
"33319","646",2023-08-14 01:30:00,-12337.7272727273,1913,14250.7272727273,907,FALSE,"out1, fill","0.1.4"
"33320","646",2023-08-14 01:45:00,-12396.3636363636,1913,14309.3636363636,907,FALSE,"out1, fill","0.1.4"
"33321","646",2023-08-14 02:00:00,-12455,1913,14368,907,FALSE,NA,"0.1.4"
"33322","646",2023-08-14 02:15:00,-12520,1913,14433,907,FALSE,NA,"0.1.4"
"33323","646",2023-08-14 02:30:00,-12629,1913,14542,907,FALSE,NA,"0.1.4"
"33324","646",2023-08-14 02:45:00,-12436,1913,14349,907,FALSE,NA,"0.1.4"
"33325","646",2023-08-14 03:00:00,-12588,1913,14501,907,FALSE,NA,"0.1.4"
"33326","646",2023-08-14 03:15:00,-12222,1913,14135,907,FALSE,NA,"0.1.4"
"33327","646",2023-08-14 03:30:00,-12231,1913,14144,907,FALSE,NA,"0.1.4"
"33328","646",2023-08-14 03:45:00,-12486,1913,14399,907,FALSE,NA,"0.1.4"
"33329","646",2023-08-14 04:00:00,-12599,1913,14512,907,FALSE,NA,"0.1.4"
"33330","646",2023-08-14 04:15:00,-12555,1913,14468,907,FALSE,NA,"0.1.4"
"33331","646",2023-08-14 04:30:00,-12405,1913,14318,907,FALSE,NA,"0.1.4"
"33332","646",2023-08-14 04:45:00,-12596,1913,14509,907,FALSE,NA,"0.1.4"
"33333","646",2023-08-14 05:00:00,-12628,1913,14541,907,FALSE,NA,"0.1.4"
"33334","646",2023-08-14 05:15:00,-12554,1913,14467,907,FALSE,NA,"0.1.4"
"33335","646",2023-08-14 05:30:00,-12203,1913,14116,907,FALSE,NA,"0.1.4"
"33336","646",2023-08-14 05:45:00,-12310,1913,14223,907,FALSE,NA,"0.1.4"
"33337","646",2023-08-14 06:00:00,-12527,1913,14440,907,FALSE,NA,"0.1.4"
"33338","646",2023-08-14 06:15:00,-12383,1913,14296,907,FALSE,NA,"0.1.4"
"33339","646",2023-08-14 06:30:00,-12481,1913,14394,907,FALSE,NA,"0.1.4"
"33340","646",2023-08-14 06:45:00,-12660,1913,14573,907,FALSE,NA,"0.1.4"
"33341","646",2023-08-14 07:00:00,-12757,1913,14670,907,FALSE,NA,"0.1.4"
"33342","646",2023-08-14 07:15:00,-12547,1913,14460,907,FALSE,NA,"0.1.4"
"33343","646",2023-08-14 07:30:00,-12611,1913,14524,907,FALSE,NA,"0.1.4"
"33344","646",2023-08-14 07:45:00,-12664,1913,14577,907,FALSE,NA,"0.1.4"
"33345","646",2023-08-14 08:00:00,-12431,1913,14344,907,FALSE,NA,"0.1.4"
"33346","646",2023-08-14 08:15:00,-12292,1913,14205,907,FALSE,NA,"0.1.4"
"33347","646",2023-08-14 08:30:00,-12568,1913,14481,907,FALSE,NA,"0.1.4"
"33348","646",2023-08-14 08:45:00,-12647,1913,14560,907,FALSE,NA,"0.1.4"
"33349","646",2023-08-14 09:00:00,-12580,1913,14493,907,FALSE,NA,"0.1.4"
"33350","646",2023-08-14 09:15:00,-12709,1913,14622,907,FALSE,NA,"0.1.4"
"33351","646",2023-08-14 09:30:00,-12775,1913,14688,907,FALSE,NA,"0.1.4"
"33352","646",2023-08-14 09:45:00,-12804,1913,14717,907,FALSE,NA,"0.1.4"
"33353","646",2023-08-14 10:00:00,-12538,1913,14451,907,FALSE,NA,"0.1.4"
"33354","646",2023-08-14 10:15:00,-12233,1913,14146,907,FALSE,NA,"0.1.4"
"33355","646",2023-08-14 10:30:00,-12311,1913,14224,907,FALSE,NA,"0.1.4"
"33356","646",2023-08-14 10:45:00,-12803,1913,14716,907,FALSE,NA,"0.1.4"
"33357","646",2023-08-14 11:00:00,-12712,1913,14625,907,FALSE,NA,"0.1.4"
"33358","646",2023-08-14 11:15:00,-12557,1913,14470,907,FALSE,NA,"0.1.4"
"33359","646",2023-08-14 11:30:00,-12812,1913,14725,907,FALSE,NA,"0.1.4"
"33360","646",2023-08-14 11:45:00,-12690,1913,14603,907,FALSE,NA,"0.1.4"
"33361","646",2023-08-14 12:00:00,-12603,1913,14516,907,FALSE,NA,"0.1.4"
"33362","646",2023-08-14 12:15:00,-12608,1913,14521,907,FALSE,NA,"0.1.4"
"33363","646",2023-08-14 12:30:00,-12683,1913,14596,907,FALSE,NA,"0.1.4"
"33364","646",2023-08-14 12:45:00,-12729,1913,14642,907,FALSE,NA,"0.1.4"
"33365","646",2023-08-14 13:00:00,-12759,1913,14672,907,FALSE,NA,"0.1.4"
"33366","646",2023-08-14 13:15:00,-12754,1913,14667,907,FALSE,NA,"0.1.4"
"33367","646",2023-08-14 13:30:00,-12608,1913,14521,907,FALSE,NA,"0.1.4"
"33368","646",2023-08-14 13:45:00,-12685,1913,14598,907,FALSE,NA,"0.1.4"
"33369","646",2023-08-14 14:00:00,-12738,1913,14651,907,FALSE,NA,"0.1.4"
"33370","646",2023-08-14 14:15:00,-12869,1913,14782,907,FALSE,NA,"0.1.4"
"33371","646",2023-08-14 14:30:00,-12735,1913,14648,907,FALSE,NA,"0.1.4"
"33372","646",2023-08-14 14:45:00,-12330,1913,14243,907,FALSE,NA,"0.1.4"
"33373","646",2023-08-14 15:00:00,-12483,1913,14396,907,FALSE,NA,"0.1.4"
"33374","646",2023-08-14 15:15:00,-12207,1913,14120,907,FALSE,NA,"0.1.4"
"33375","646",2023-08-14 15:30:00,-12246,1913,14159,907,FALSE,NA,"0.1.4"
"33376","646",2023-08-14 15:45:00,-12421,1913,14334,907,FALSE,NA,"0.1.4"
"33377","646",2023-08-14 16:00:00,-12487.3333333333,1913,14400.3333333333,907,FALSE,"out1, fill","0.1.4"
"33378","646",2023-08-14 16:15:00,-12553.6666666667,1913,14466.6666666667,907,FALSE,"out1, fill","0.1.4"
"33379","646",2023-08-14 16:30:00,-12620,1913,14533,907,FALSE,NA,"0.1.4"
"33380","646",2023-08-14 16:45:00,-12244,1913,14157,907,FALSE,NA,"0.1.4"
"33381","646",2023-08-14 17:00:00,-12174,1913,14087,907,FALSE,NA,"0.1.4"
"33382","646",2023-08-14 17:15:00,-12184,1913,14097,907,FALSE,NA,"0.1.4"
"33383","646",2023-08-14 17:30:00,-12334,1913,14247,907,FALSE,NA,"0.1.4"
"33384","646",2023-08-14 17:45:00,-12115,1913,14028,907,FALSE,NA,"0.1.4"
"33385","646",2023-08-14 18:00:00,-12205,1913,14118,907,FALSE,NA,"0.1.4"
"33386","646",2023-08-14 18:15:00,-11925,1913,13838,907,FALSE,NA,"0.1.4"
"33387","646",2023-08-14 18:30:00,-11786,1913,13699,907,FALSE,NA,"0.1.4"
"33388","646",2023-08-14 18:45:00,-11786,1913,13699,907,FALSE,"jump1","0.1.4"
"33389","646",2023-08-14 19:00:00,-11589,1913,13502,907,FALSE,NA,"0.1.4"
"33390","646",2023-08-14 19:15:00,-11698,1913,13611,907,FALSE,NA,"0.1.4"
"33391","646",2023-08-14 19:30:00,-11837,1913,13750,907,FALSE,NA,"0.1.4"
"33392","646",2023-08-14 19:45:00,-11436,1913,13349,907,FALSE,NA,"0.1.4"
"33393","646",2023-08-14 20:00:00,-11338.6,1913,13251.6,907,FALSE,"out1, fill","0.1.4"
"33394","646",2023-08-14 20:15:00,-11241.2,1913,13154.2,907,FALSE,"out1, fill","0.1.4"
"33395","646",2023-08-14 20:30:00,-11143.8,1913,13056.8,907,FALSE,"out1, fill","0.1.4"
"33396","646",2023-08-14 20:45:00,-11046.4,1913,12959.4,907,FALSE,"out1, fill","0.1.4"
"33397","646",2023-08-14 21:00:00,-10949,1913,12862,907,FALSE,"out1, fill","0.1.4"
"33398","646",2023-08-14 21:15:00,-10851.6,1913,12764.6,907,FALSE,"out1, fill","0.1.4"
"33399","646",2023-08-14 21:30:00,-10754.2,1913,12667.2,907,FALSE,"out1, fill","0.1.4"
"33400","646",2023-08-14 21:45:00,-10656.8,1913,12569.8,907,FALSE,"out1, fill","0.1.4"
"33401","646",2023-08-14 22:00:00,-10559.4,1913,12472.4,907,FALSE,"out1, fill","0.1.4"
"33402","646",2023-08-14 22:15:00,-10462,1913,12375,907,FALSE,NA,"0.1.4"
"33403","646",2023-08-14 22:30:00,-10470,1913,12383,907,FALSE,NA,"0.1.4"
"33404","646",2023-08-14 22:45:00,-10465,1913,12378,907,FALSE,NA,"0.1.4"
"33405","646",2023-08-14 23:00:00,-10685,1913,12598,907,FALSE,NA,"0.1.4"
"33406","646",2023-08-14 23:15:00,-11145,1913,13058,907,FALSE,NA,"0.1.4"
"33407","646",2023-08-14 23:30:00,-11247,1913,13160,907,FALSE,"out1, fill","0.1.4"
"33408","646",2023-08-14 23:45:00,-11349,1913,13262,907,FALSE,"out1, fill","0.1.4"
"33409","646",2023-08-15,-11451,1913,13364,907,FALSE,NA,"0.1.4"
"33410","646",2023-08-15 00:15:00,-11160,1913,13073,907,FALSE,NA,"0.1.4"
"33411","646",2023-08-15 00:30:00,-11160,1913,13073,907,FALSE,"jump1","0.1.4"
"33412","646",2023-08-15 00:45:00,-11161,1913,13074,907,FALSE,NA,"0.1.4"
"33413","646",2023-08-15 01:00:00,-11045,1913,12958,907,FALSE,NA,"0.1.4"
"33414","646",2023-08-15 01:15:00,-11005,1913,12918,907,FALSE,NA,"0.1.4"
"33415","646",2023-08-15 01:30:00,-11111,1913,13024,907,FALSE,NA,"0.1.4"
"33416","646",2023-08-15 01:45:00,-11395,1913,13308,907,FALSE,"out1, fill","0.1.4"
"33417","646",2023-08-15 02:00:00,-11679,1913,13592,907,FALSE,NA,"0.1.4"
"33418","646",2023-08-15 02:15:00,-12179,1913,14092,907,FALSE,NA,"0.1.4"
"33419","646",2023-08-15 02:30:00,-12346,1913,14259,907,FALSE,NA,"0.1.4"
"33420","646",2023-08-15 02:45:00,-12353,1913,14266,907,FALSE,NA,"0.1.4"
"33421","646",2023-08-15 03:00:00,-12175.25,1913,14088.25,907,FALSE,"out1, fill","0.1.4"
"33422","646",2023-08-15 03:15:00,-11997.5,1913,13910.5,907,FALSE,"out1, fill","0.1.4"
"33423","646",2023-08-15 03:30:00,-11819.75,1913,13732.75,907,FALSE,"out1, fill","0.1.4"
"33424","646",2023-08-15 03:45:00,-11642,1913,13555,907,FALSE,NA,"0.1.4"
"33425","646",2023-08-15 04:00:00,-12089,1913,14002,907,FALSE,NA,"0.1.4"
"33426","646",2023-08-15 04:15:00,-12201,1913,14114,907,FALSE,NA,"0.1.4"
"33427","646",2023-08-15 04:30:00,-12302,1913,14215,907,FALSE,NA,"0.1.4"
"33428","646",2023-08-15 04:45:00,-11959,1913,13872,907,FALSE,NA,"0.1.4"
"33429","646",2023-08-15 05:00:00,-12246,1913,14159,907,FALSE,NA,"0.1.4"
"33430","646",2023-08-15 05:15:00,-12317,1913,14230,907,FALSE,NA,"0.1.4"
"33431","646",2023-08-15 05:30:00,-12275,1913,14188,907,FALSE,"out1, fill","0.1.4"
"33432","646",2023-08-15 05:45:00,-12233,1913,14146,907,FALSE,"out1, fill","0.1.4"
"33433","646",2023-08-15 06:00:00,-12191,1913,14104,907,FALSE,"out1, fill","0.1.4"
"33434","646",2023-08-15 06:15:00,-12149,1913,14062,907,FALSE,"out1, fill","0.1.4"
"33435","646",2023-08-15 06:30:00,-12107,1913,14020,907,FALSE,"out1, fill","0.1.4"
"33436","646",2023-08-15 06:45:00,-12065,1913,13978,907,FALSE,NA,"0.1.4"
"33437","646",2023-08-15 07:00:00,-12018,1913,13931,907,FALSE,NA,"0.1.4"
"33438","646",2023-08-15 07:15:00,-12428,1913,14341,907,FALSE,NA,"0.1.4"
"33439","646",2023-08-15 07:30:00,-12355,1913,14268,907,FALSE,"out1, fill","0.1.4"
"33440","646",2023-08-15 07:45:00,-12282,1913,14195,907,FALSE,NA,"0.1.4"
"33441","646",2023-08-15 08:00:00,-12333,1913,14246,907,FALSE,NA,"0.1.4"
"33442","646",2023-08-15 08:15:00,-12226,1913,14139,907,FALSE,NA,"0.1.4"
"33443","646",2023-08-15 08:30:00,-12233,1913,14146,907,FALSE,"out1, fill","0.1.4"
"33444","646",2023-08-15 08:45:00,-12240,1913,14153,907,FALSE,"out1, fill","0.1.4"
"33445","646",2023-08-15 09:00:00,-12247,1913,14160,907,FALSE,NA,"0.1.4"
"33446","646",2023-08-15 09:15:00,-12323,1913,14236,907,FALSE,NA,"0.1.4"
"33447","646",2023-08-15 09:30:00,-12251,1913,14164,907,FALSE,NA,"0.1.4"
"33448","646",2023-08-15 09:45:00,-12236,1913,14149,907,FALSE,NA,"0.1.4"
"33449","646",2023-08-15 10:00:00,-12257,1913,14170,907,FALSE,NA,"0.1.4"
"33450","646",2023-08-15 10:15:00,-12261,1913,14174,907,FALSE,NA,"0.1.4"
"33451","646",2023-08-15 10:30:00,-12374,1913,14287,907,FALSE,NA,"0.1.4"
"33452","646",2023-08-15 10:45:00,-12307,1913,14220,907,FALSE,NA,"0.1.4"
"33453","646",2023-08-15 11:00:00,-12560,1913,14473,907,FALSE,NA,"0.1.4"
"33454","646",2023-08-15 11:15:00,-12500,1913,14413,907,FALSE,NA,"0.1.4"
"33455","646",2023-08-15 11:30:00,-12643,1913,14556,907,FALSE,NA,"0.1.4"
"33456","646",2023-08-15 11:45:00,-12643,1913,14556,907,FALSE,"out1, fill","0.1.4"
"33457","646",2023-08-15 12:00:00,-12643,1913,14556,907,FALSE,"jump1","0.1.4"
"33458","646",2023-08-15 12:15:00,-12655,1913,14568,907,FALSE,NA,"0.1.4"
"33459","646",2023-08-15 12:30:00,-12655,1913,14568,907,FALSE,NA,"0.1.4"
"33460","646",2023-08-15 12:45:00,-12655,1913,14568,907,FALSE,"out1, fill","0.1.4"
"33461","646",2023-08-15 13:00:00,-12655,1913,14568,907,FALSE,"jump1","0.1.4"
"33462","646",2023-08-15 13:15:00,-12606,1913,14519,907,FALSE,NA,"0.1.4"
"33463","646",2023-08-15 13:30:00,-12738,1913,14651,907,FALSE,NA,"0.1.4"
"33464","646",2023-08-15 13:45:00,-12408,1913,14321,907,FALSE,NA,"0.1.4"
"33465","646",2023-08-15 14:00:00,-12569,1913,14482,907,FALSE,NA,"0.1.4"
"33466","646",2023-08-15 14:15:00,-12570,1913,14483,907,FALSE,NA,"0.1.4"
"33467","646",2023-08-15 14:30:00,-12110,1913,14023,907,FALSE,NA,"0.1.4"
"33468","646",2023-08-15 14:45:00,-12285,1913,14198,907,FALSE,NA,"0.1.4"
"33469","646",2023-08-15 15:00:00,-12233,1913,14146,907,FALSE,NA,"0.1.4"
"33470","646",2023-08-15 15:15:00,-12174,1913,14087,907,FALSE,NA,"0.1.4"
"33471","646",2023-08-15 15:30:00,-12194,1913,14107,907,FALSE,NA,"0.1.4"
"33472","646",2023-08-15 15:45:00,-12194,1913,14107,907,FALSE,"jump1","0.1.4"
"33473","646",2023-08-15 16:00:00,-11902,1913,13815,907,FALSE,NA,"0.1.4"
"33474","646",2023-08-15 16:15:00,-11904,1913,13817,907,FALSE,NA,"0.1.4"
"33475","646",2023-08-15 16:30:00,-11906,1913,13819,907,FALSE,NA,"0.1.4"
"33476","646",2023-08-15 16:45:00,-11906,1913,13819,907,FALSE,"jump1","0.1.4"
"33477","646",2023-08-15 17:00:00,-12152,1913,14065,907,FALSE,NA,"0.1.4"
"33478","646",2023-08-15 17:15:00,-11735,1913,13648,907,FALSE,"out1, fill","0.1.4"
"33479","646",2023-08-15 17:30:00,-11318,1913,13231,907,FALSE,NA,"0.1.4"
"33480","646",2023-08-15 17:45:00,-11318,1913,13231,907,FALSE,"jump1","0.1.4"
"33481","646",2023-08-15 18:00:00,-11318,1913,13231,907,FALSE,"jump1","0.1.4"
"33482","646",2023-08-15 18:15:00,-11320,1913,13233,907,FALSE,NA,"0.1.4"
"33483","646",2023-08-15 18:30:00,-11320,1913,13233,907,FALSE,"jump1","0.1.4"
"33484","646",2023-08-15 18:45:00,-11559,1913,13472,907,FALSE,NA,"0.1.4"
"33485","646",2023-08-15 19:00:00,-11547,1913,13460,907,FALSE,"out1, fill","0.1.4"
"33486","646",2023-08-15 19:15:00,-11535,1913,13448,907,FALSE,"out1, fill","0.1.4"
"33487","646",2023-08-15 19:30:00,-11523,1913,13436,907,FALSE,"out1, fill","0.1.4"
"33488","646",2023-08-15 19:45:00,-11511,1913,13424,907,FALSE,NA,"0.1.4"
"33489","646",2023-08-15 20:00:00,-11780,1913,13693,907,FALSE,NA,"0.1.4"
"33490","646",2023-08-15 20:15:00,-11780,1913,13693,907,FALSE,"jump1","0.1.4"
"33491","646",2023-08-15 20:30:00,-11513,1913,13426,907,FALSE,NA,"0.1.4"
"33492","646",2023-08-15 20:45:00,-11531.4,1913,13444.4,907,FALSE,"out1, fill","0.1.4"
"33493","646",2023-08-15 21:00:00,-11549.8,1913,13462.8,907,FALSE,"out1, fill","0.1.4"
"33494","646",2023-08-15 21:15:00,-11568.2,1913,13481.2,907,FALSE,"out1, fill","0.1.4"
"33495","646",2023-08-15 21:30:00,-11586.6,1913,13499.6,907,FALSE,"out1, fill","0.1.4"
"33496","646",2023-08-15 21:45:00,-11605,1913,13518,907,FALSE,NA,"0.1.4"
"33497","646",2023-08-15 22:00:00,-11534,1913,13447,907,FALSE,NA,"0.1.4"
"33498","646",2023-08-15 22:15:00,-11534,1913,13447,907,FALSE,"jump1","0.1.4"
"33499","646",2023-08-15 22:30:00,-11821,1913,13734,907,FALSE,NA,"0.1.4"
"33500","646",2023-08-15 22:45:00,-11866,1913,13779,907,FALSE,NA,"0.1.4"
"33501","646",2023-08-15 23:00:00,-11753,1913,13666,907,FALSE,NA,"0.1.4"
"33502","646",2023-08-15 23:15:00,-11454,1913,13367,907,FALSE,NA,"0.1.4"
"33503","646",2023-08-15 23:30:00,-11754,1913,13667,907,FALSE,NA,"0.1.4"
"33504","646",2023-08-15 23:45:00,-11754,1913,13667,907,FALSE,"jump1","0.1.4"
"33505","646",2023-08-16,-11668,1913,13581,907,FALSE,NA,"0.1.4"
"33506","646",2023-08-16 00:15:00,-11527,1913,13440,907,FALSE,NA,"0.1.4"
"33507","646",2023-08-16 00:30:00,-11527,1913,13440,907,FALSE,"jump1","0.1.4"
"33508","646",2023-08-16 00:45:00,-11520.0909090909,1913,13433.0909090909,907,FALSE,"out1, fill","0.1.4"
"33509","646",2023-08-16 01:00:00,-11513.1818181818,1913,13426.1818181818,907,FALSE,"out1, fill","0.1.4"
"33510","646",2023-08-16 01:15:00,-11506.2727272727,1913,13419.2727272727,907,FALSE,"out1, fill","0.1.4"
"33511","646",2023-08-16 01:30:00,-11499.3636363636,1913,13412.3636363636,907,FALSE,"out1, fill","0.1.4"
"33512","646",2023-08-16 01:45:00,-11492.4545454545,1913,13405.4545454545,907,FALSE,"out1, fill","0.1.4"
"33513","646",2023-08-16 02:00:00,-11485.5454545455,1913,13398.5454545455,907,FALSE,"out1, fill","0.1.4"
"33514","646",2023-08-16 02:15:00,-11478.6363636364,1913,13391.6363636364,907,FALSE,"out1, fill","0.1.4"
"33515","646",2023-08-16 02:30:00,-11471.7272727273,1913,13384.7272727273,907,FALSE,"out1, fill","0.1.4"
"33516","646",2023-08-16 02:45:00,-11464.8181818182,1913,13377.8181818182,907,FALSE,"out1, fill","0.1.4"
"33517","646",2023-08-16 03:00:00,-11457.9090909091,1913,13370.9090909091,907,FALSE,"out1, fill","0.1.4"
"33518","646",2023-08-16 03:15:00,-11451,1913,13364,907,FALSE,NA,"0.1.4"
"33519","646",2023-08-16 03:30:00,-11451,1913,13364,907,FALSE,"jump1","0.1.4"
"33520","646",2023-08-16 03:45:00,-11231,1913,13144,907,FALSE,NA,"0.1.4"
"33521","646",2023-08-16 04:00:00,-11318,1913,13231,907,FALSE,NA,"0.1.4"
"33522","646",2023-08-16 04:15:00,-10913,1913,12826,907,FALSE,NA,"0.1.4"
"33523","646",2023-08-16 04:30:00,-11120.5,1913,13033.5,907,FALSE,"out1, fill","0.1.4"
"33524","646",2023-08-16 04:45:00,-11328,1913,13241,907,FALSE,NA,"0.1.4"
"33525","646",2023-08-16 05:00:00,-11104,1913,13017,907,FALSE,NA,"0.1.4"
"33526","646",2023-08-16 05:15:00,-11365,1913,13278,907,FALSE,NA,"0.1.4"
"33527","646",2023-08-16 05:30:00,-11413,1913,13326,907,FALSE,NA,"0.1.4"
"33528","646",2023-08-16 05:45:00,-11303,1913,13216,907,FALSE,NA,"0.1.4"
"33529","646",2023-08-16 06:00:00,-11460,1913,13373,907,FALSE,NA,"0.1.4"
"33530","646",2023-08-16 06:15:00,-11542,1913,13455,907,FALSE,NA,"0.1.4"
"33531","646",2023-08-16 06:30:00,-11161,1913,13074,907,FALSE,NA,"0.1.4"
"33532","646",2023-08-16 06:45:00,-11480,1913,13393,907,FALSE,NA,"0.1.4"
"33533","646",2023-08-16 07:00:00,-11352,1913,13265,907,FALSE,NA,"0.1.4"
"33534","646",2023-08-16 07:15:00,-11352,1913,13265,907,FALSE,"out1, fill","0.1.4"
"33535","646",2023-08-16 07:30:00,-11352,1913,13265,907,FALSE,"jump1","0.1.4"
"33536","646",2023-08-16 07:45:00,-11353,1913,13266,907,FALSE,NA,"0.1.4"
"33537","646",2023-08-16 08:00:00,-11409,1913,13322,907,FALSE,NA,"0.1.4"
"33538","646",2023-08-16 08:15:00,-11673,1913,13586,907,FALSE,NA,"0.1.4"
"33539","646",2023-08-16 08:30:00,-11673,1913,13586,907,FALSE,"jump1","0.1.4"
"33540","646",2023-08-16 08:45:00,-12031,1913,13944,907,FALSE,NA,"0.1.4"
"33541","646",2023-08-16 09:00:00,-11821,1913,13734,907,FALSE,NA,"0.1.4"
"33542","646",2023-08-16 09:15:00,-11861,1913,13774,907,FALSE,NA,"0.1.4"
"33543","646",2023-08-16 09:30:00,-11861,1913,13774,907,FALSE,"jump1","0.1.4"
"33544","646",2023-08-16 09:45:00,-11932,1913,13845,907,FALSE,NA,"0.1.4"
"33545","646",2023-08-16 10:00:00,-11876,1913,13789,907,FALSE,NA,"0.1.4"
"33546","646",2023-08-16 10:15:00,-12241,1913,14154,907,FALSE,NA,"0.1.4"
"33547","646",2023-08-16 10:30:00,-11843,1913,13756,907,FALSE,NA,"0.1.4"
"33548","646",2023-08-16 10:45:00,-11883.25,1913,13796.25,907,FALSE,"out1, fill","0.1.4"
"33549","646",2023-08-16 11:00:00,-11923.5,1913,13836.5,907,FALSE,"out1, fill","0.1.4"
"33550","646",2023-08-16 11:15:00,-11963.75,1913,13876.75,907,FALSE,"out1, fill","0.1.4"
"33551","646",2023-08-16 11:30:00,-12004,1913,13917,907,FALSE,NA,"0.1.4"
"33552","646",2023-08-16 11:45:00,-11905,1913,13818,907,FALSE,NA,"0.1.4"
"33553","646",2023-08-16 12:00:00,-12391,1913,14304,907,FALSE,NA,"0.1.4"
"33554","646",2023-08-16 12:15:00,-12384,1913,14297,907,FALSE,"out1, fill","0.1.4"
"33555","646",2023-08-16 12:30:00,-12377,1913,14290,907,FALSE,"out1, fill","0.1.4"
"33556","646",2023-08-16 12:45:00,-12370,1913,14283,907,FALSE,"out1, fill","0.1.4"
"33557","646",2023-08-16 13:00:00,-12363,1913,14276,907,FALSE,"out1, fill","0.1.4"
"33558","646",2023-08-16 13:15:00,-12356,1913,14269,907,FALSE,"out1, fill","0.1.4"
"33559","646",2023-08-16 13:30:00,-12349,1913,14262,907,FALSE,"out1, fill","0.1.4"
"33560","646",2023-08-16 13:45:00,-12342,1913,14255,907,FALSE,NA,"0.1.4"
"33561","646",2023-08-16 14:00:00,-12130,1913,14043,907,FALSE,NA,"0.1.4"
"33562","646",2023-08-16 14:15:00,-12230,1913,14143,907,FALSE,NA,"0.1.4"
"33563","646",2023-08-16 14:30:00,-12125,1913,14038,907,FALSE,NA,"0.1.4"
"33564","646",2023-08-16 14:45:00,-12583,1913,14496,907,FALSE,NA,"0.1.4"
"33565","646",2023-08-16 15:00:00,-12535,1913,14448,907,FALSE,NA,"0.1.4"
"33566","646",2023-08-16 15:15:00,-12575,1913,14488,907,FALSE,NA,"0.1.4"
"33567","646",2023-08-16 15:30:00,-12522,1913,14435,907,FALSE,NA,"0.1.4"
"33568","646",2023-08-16 15:45:00,-12457,1913,14370,907,FALSE,NA,"0.1.4"
"33569","646",2023-08-16 16:00:00,-12457,1913,14370,907,FALSE,"jump1","0.1.4"
"33570","646",2023-08-16 16:15:00,-12291,1913,14204,907,FALSE,NA,"0.1.4"
"33571","646",2023-08-16 16:30:00,-12030,1913,13943,907,FALSE,NA,"0.1.4"
"33572","646",2023-08-16 16:45:00,-12013,1913,13926,907,FALSE,NA,"0.1.4"
"33573","646",2023-08-16 17:00:00,-12013,1913,13926,907,FALSE,"jump1","0.1.4"
"33574","646",2023-08-16 17:15:00,-12232,1913,14145,907,FALSE,NA,"0.1.4"
"33575","646",2023-08-16 17:30:00,-11792,1913,13705,907,FALSE,"out1, fill","0.1.4"
"33576","646",2023-08-16 17:45:00,-11352,1913,13265,907,FALSE,NA,"0.1.4"
"33577","646",2023-08-16 18:00:00,-11352,1913,13265,907,FALSE,NA,"0.1.4"
"33578","646",2023-08-16 18:15:00,-11347,1913,13260,907,FALSE,NA,"0.1.4"
"33579","646",2023-08-16 18:30:00,-11422,1913,13335,907,FALSE,NA,"0.1.4"
"33580","646",2023-08-16 18:45:00,-11422,1913,13335,907,FALSE,"out1, fill","0.1.4"
"33581","646",2023-08-16 19:00:00,-11422,1913,13335,907,FALSE,"jump1","0.1.4"
"33582","646",2023-08-16 19:15:00,-11422,1913,13335,907,FALSE,"jump1","0.1.4"
"33583","646",2023-08-16 19:30:00,-11661,1913,13574,907,FALSE,NA,"0.1.4"
"33584","646",2023-08-16 19:45:00,-11877,1913,13790,907,FALSE,NA,"0.1.4"
"33585","646",2023-08-16 20:00:00,-11746,1913,13659,907,FALSE,NA,"0.1.4"
"33586","646",2023-08-16 20:15:00,-12043,1913,13956,907,FALSE,NA,"0.1.4"
"33587","646",2023-08-16 20:30:00,-11868,1913,13781,907,FALSE,NA,"0.1.4"
"33588","646",2023-08-16 20:45:00,-11958,1913,13871,907,FALSE,NA,"0.1.4"
"33589","646",2023-08-16 21:00:00,-11958,1913,13871,907,FALSE,"jump1","0.1.4"
"33590","646",2023-08-16 21:15:00,-11958,1913,13871,907,FALSE,"jump1","0.1.4"
"33591","646",2023-08-16 21:30:00,-11754,1913,13667,907,FALSE,"out1, fill","0.1.4"
"33592","646",2023-08-16 21:45:00,-11550,1913,13463,907,FALSE,"out1, fill","0.1.4"
"33593","646",2023-08-16 22:00:00,-11346,1913,13259,907,FALSE,NA,"0.1.4"
"33594","646",2023-08-16 22:15:00,-11287,1913,13200,907,FALSE,NA,"0.1.4"
"33595","646",2023-08-16 22:30:00,-11287,1913,13200,907,FALSE,"jump1","0.1.4"
"33596","646",2023-08-16 22:45:00,-11233,1913,13146,907,FALSE,NA,"0.1.4"
"33597","646",2023-08-16 23:00:00,-11231,1913,13144,907,FALSE,NA,"0.1.4"
"33598","646",2023-08-16 23:15:00,-11071,1913,12984,907,FALSE,NA,"0.1.4"
"33599","646",2023-08-16 23:30:00,-10855.6666666667,1913,12768.6666666667,907,FALSE,"out1, fill","0.1.4"
"33600","646",2023-08-16 23:45:00,-10640.3333333333,1913,12553.3333333333,907,FALSE,"out1, fill","0.1.4"
"33601","646",2023-08-17,-10425,1913,12338,907,FALSE,NA,"0.1.4"
"33602","646",2023-08-17 00:15:00,-10461,1913,12374,907,FALSE,NA,"0.1.4"
"33603","646",2023-08-17 00:30:00,-10439,1913,12352,907,FALSE,NA,"0.1.4"
"33604","646",2023-08-17 00:45:00,-10411,1913,12324,907,FALSE,NA,"0.1.4"
"33605","646",2023-08-17 01:00:00,-10692.5,1913,12605.5,907,FALSE,"out1, fill","0.1.4"
"33606","646",2023-08-17 01:15:00,-10974,1913,12887,907,FALSE,NA,"0.1.4"
"33607","646",2023-08-17 01:30:00,-10811,1913,12724,907,FALSE,NA,"0.1.4"
"33608","646",2023-08-17 01:45:00,-11179,1913,13092,907,FALSE,NA,"0.1.4"
"33609","646",2023-08-17 02:00:00,-11179,1913,13092,907,FALSE,"jump1","0.1.4"
"33610","646",2023-08-17 02:15:00,-11043,1913,12956,907,FALSE,NA,"0.1.4"
"33611","646",2023-08-17 02:30:00,-11115,1913,13028,907,FALSE,NA,"0.1.4"
"33612","646",2023-08-17 02:45:00,-11570.5,1913,13483.5,907,FALSE,"out1, fill","0.1.4"
"33613","646",2023-08-17 03:00:00,-12026,1913,13939,907,FALSE,NA,"0.1.4"
"33614","646",2023-08-17 03:15:00,-11770,1913,13683,907,FALSE,NA,"0.1.4"
"33615","646",2023-08-17 03:30:00,-12072,1913,13985,907,FALSE,NA,"0.1.4"
"33616","646",2023-08-17 03:45:00,-12068,1913,13981,907,FALSE,NA,"0.1.4"
"33617","646",2023-08-17 04:00:00,-11818,1913,13731,907,FALSE,NA,"0.1.4"
"33618","646",2023-08-17 04:15:00,-11811,1913,13724,907,FALSE,NA,"0.1.4"
"33619","646",2023-08-17 04:30:00,-11426,1913,13339,907,FALSE,NA,"0.1.4"
"33620","646",2023-08-17 04:45:00,-11423,1913,13336,907,FALSE,NA,"0.1.4"
"33621","646",2023-08-17 05:00:00,-11698,1913,13611,907,FALSE,NA,"0.1.4"
"33622","646",2023-08-17 05:15:00,-12070,1913,13983,907,FALSE,NA,"0.1.4"
"33623","646",2023-08-17 05:30:00,-12070,1913,13983,907,FALSE,"out1, fill","0.1.4"
"33624","646",2023-08-17 05:45:00,-12070,1913,13983,907,FALSE,"jump1","0.1.4"
"33625","646",2023-08-17 06:00:00,-12070,1913,13983,907,FALSE,NA,"0.1.4"
"33626","646",2023-08-17 06:15:00,-12070,1913,13983,907,FALSE,NA,"0.1.4"
"33627","646",2023-08-17 06:30:00,-12070,1913,13983,907,FALSE,NA,"0.1.4"
"33628","646",2023-08-17 06:45:00,-12079,1913,13992,907,FALSE,NA,"0.1.4"
"33629","646",2023-08-17 07:00:00,-12567.5,1913,14480.5,907,FALSE,"out1, fill","0.1.4"
"33630","646",2023-08-17 07:15:00,-13056,1913,14969,907,FALSE,NA,"0.1.4"
"33631","646",2023-08-17 07:30:00,-13179,1913,15092,907,FALSE,NA,"0.1.4"
"33632","646",2023-08-17 07:45:00,-12911,1913,14824,907,FALSE,NA,"0.1.4"
"33633","646",2023-08-17 08:00:00,-13064,1913,14977,907,FALSE,NA,"0.1.4"
"33634","646",2023-08-17 08:15:00,-12853,1913,14766,907,FALSE,NA,"0.1.4"
"33635","646",2023-08-17 08:30:00,-12929,1913,14842,907,FALSE,NA,"0.1.4"
"33636","646",2023-08-17 08:45:00,-13034,1913,14947,907,FALSE,NA,"0.1.4"
"33637","646",2023-08-17 09:00:00,-13034,1913,14947,907,FALSE,"jump1","0.1.4"
"33638","646",2023-08-17 09:15:00,-13034,1913,14947,907,FALSE,"jump1","0.1.4"
"33639","646",2023-08-17 09:30:00,-13092,1913,15005,907,FALSE,NA,"0.1.4"
"33640","646",2023-08-17 09:45:00,-13167,1913,15080,907,FALSE,NA,"0.1.4"
"33641","646",2023-08-17 10:00:00,-13153,1913,15066,907,FALSE,NA,"0.1.4"
"33642","646",2023-08-17 10:15:00,-13254,1913,15167,907,FALSE,NA,"0.1.4"
"33643","646",2023-08-17 10:30:00,-13124,1913,15037,907,FALSE,NA,"0.1.4"
"33644","646",2023-08-17 10:45:00,-13162,1913,15075,907,FALSE,NA,"0.1.4"
"33645","646",2023-08-17 11:00:00,-13166,1913,15079,907,FALSE,NA,"0.1.4"
"33646","646",2023-08-17 11:15:00,-12836,1913,14749,907,FALSE,NA,"0.1.4"
"33647","646",2023-08-17 11:30:00,-12982,1913,14895,907,FALSE,NA,"0.1.4"
"33648","646",2023-08-17 11:45:00,-13122,1913,15035,907,FALSE,NA,"0.1.4"
"33649","646",2023-08-17 12:00:00,-13246,1913,15159,907,FALSE,NA,"0.1.4"
"33650","646",2023-08-17 12:15:00,-13246,1913,15159,907,FALSE,"jump1","0.1.4"
"33651","646",2023-08-17 12:30:00,-13669,1913,15582,907,FALSE,NA,"0.1.4"
"33652","646",2023-08-17 12:45:00,-13564,1913,15477,907,FALSE,NA,"0.1.4"
"33653","646",2023-08-17 13:00:00,-13535,1913,15448,907,FALSE,"out1, fill","0.1.4"
"33654","646",2023-08-17 13:15:00,-13506,1913,15419,907,FALSE,"out1, fill","0.1.4"
"33655","646",2023-08-17 13:30:00,-13477,1913,15390,907,FALSE,NA,"0.1.4"
"33656","646",2023-08-17 13:45:00,-13411,1913,15324,907,FALSE,NA,"0.1.4"
"33657","646",2023-08-17 14:00:00,-13622,1913,15535,907,FALSE,NA,"0.1.4"
"33658","646",2023-08-17 14:15:00,-13423,1913,15336,907,FALSE,NA,"0.1.4"
"33659","646",2023-08-17 14:30:00,-13383,1913,15296,907,FALSE,NA,"0.1.4"
"33660","646",2023-08-17 14:45:00,-13386,1913,15299,907,FALSE,NA,"0.1.4"
"33661","646",2023-08-17 15:00:00,-13408,1913,15321,907,FALSE,NA,"0.1.4"
"33662","646",2023-08-17 15:15:00,-13624,1913,15537,907,FALSE,NA,"0.1.4"
"33663","646",2023-08-17 15:30:00,-13502,1913,15415,907,FALSE,NA,"0.1.4"
"33664","646",2023-08-17 15:45:00,-13455.3333333333,1913,15368.3333333333,907,FALSE,"out1, fill","0.1.4"
"33665","646",2023-08-17 16:00:00,-13408.6666666667,1913,15321.6666666667,907,FALSE,"out1, fill","0.1.4"
"33666","646",2023-08-17 16:15:00,-13362,1913,15275,907,FALSE,NA,"0.1.4"
"33667","646",2023-08-17 16:30:00,-13391,1913,15304,907,FALSE,NA,"0.1.4"
"33668","646",2023-08-17 16:45:00,-13367,1913,15280,907,FALSE,NA,"0.1.4"
"33669","646",2023-08-17 17:00:00,-13335,1913,15248,907,FALSE,NA,"0.1.4"
"33670","646",2023-08-17 17:15:00,-13318,1913,15231,907,FALSE,NA,"0.1.4"
"33671","646",2023-08-17 17:30:00,-13318,1913,15231,907,FALSE,"jump1","0.1.4"
"33672","646",2023-08-17 17:45:00,-13711,1913,15624,907,FALSE,NA,"0.1.4"
"33673","646",2023-08-17 18:00:00,-13559,1913,15472,907,FALSE,NA,"0.1.4"
"33674","646",2023-08-17 18:15:00,-13559,1913,15472,907,FALSE,"jump1","0.1.4"
"33675","646",2023-08-17 18:30:00,-13145,1913,15058,907,FALSE,NA,"0.1.4"
"33676","646",2023-08-17 18:45:00,-13145,1913,15058,907,FALSE,"jump1","0.1.4"
"33677","646",2023-08-17 19:00:00,-13167,1913,15080,907,FALSE,NA,"0.1.4"
"33678","646",2023-08-17 19:15:00,-13524,1913,15437,907,FALSE,NA,"0.1.4"
"33679","646",2023-08-17 19:30:00,-13252,1913,15165,907,FALSE,NA,"0.1.4"
"33680","646",2023-08-17 19:45:00,-13723,1913,15636,907,FALSE,NA,"0.1.4"
"33681","646",2023-08-17 20:00:00,-13723,1913,15636,907,FALSE,"jump1","0.1.4"
"33682","646",2023-08-17 20:15:00,-13684,1913,15597,907,FALSE,NA,"0.1.4"
"33683","646",2023-08-17 20:30:00,-13682,1913,15595,907,FALSE,NA,"0.1.4"
"33684","646",2023-08-17 20:45:00,-13683,1913,15596,907,FALSE,NA,"0.1.4"
"33685","646",2023-08-17 21:00:00,-13683,1913,15596,907,FALSE,NA,"0.1.4"
"33686","646",2023-08-17 21:15:00,-13683,1913,15596,907,FALSE,NA,"0.1.4"
"33687","646",2023-08-17 21:30:00,-13682,1913,15595,907,FALSE,NA,"0.1.4"
"33688","646",2023-08-17 21:45:00,-13684,1913,15597,907,FALSE,NA,"0.1.4"
"33689","646",2023-08-17 22:00:00,-13682,1913,15595,907,FALSE,NA,"0.1.4"
"33690","646",2023-08-17 22:15:00,-13683,1913,15596,907,FALSE,NA,"0.1.4"
"33691","646",2023-08-17 22:30:00,-13683,1913,15596,907,FALSE,NA,"0.1.4"
"33692","646",2023-08-17 22:45:00,-13687,1913,15600,907,FALSE,NA,"0.1.4"
"33693","646",2023-08-17 23:00:00,-13681,1913,15594,907,FALSE,NA,"0.1.4"
"33694","646",2023-08-17 23:15:00,-13681,1913,15594,907,FALSE,NA,"0.1.4"
"33695","646",2023-08-17 23:30:00,-13681,1913,15594,907,FALSE,NA,"0.1.4"
"33696","646",2023-08-17 23:45:00,-13681,1913,15594,907,FALSE,NA,"0.1.4"
"33697","646",2023-08-18,-13682,1913,15595,907,FALSE,NA,"0.1.4"
"33698","646",2023-08-18 00:15:00,-13681,1913,15594,907,FALSE,NA,"0.1.4"
"33699","646",2023-08-18 00:30:00,-13681,1913,15594,907,FALSE,NA,"0.1.4"
"33700","646",2023-08-18 00:45:00,-13681,1913,15594,907,FALSE,NA,"0.1.4"
"33701","646",2023-08-18 01:00:00,-13681,1913,15594,907,FALSE,NA,"0.1.4"
"33702","646",2023-08-18 01:15:00,-13681,1913,15594,907,FALSE,NA,"0.1.4"
"33703","646",2023-08-18 01:30:00,-13681,1913,15594,907,FALSE,NA,"0.1.4"
"33704","646",2023-08-18 01:45:00,-13681,1913,15594,907,FALSE,NA,"0.1.4"
"33705","646",2023-08-18 02:00:00,-13682,1913,15595,907,FALSE,NA,"0.1.4"
"33706","646",2023-08-18 02:15:00,-13715,1913,15628,907,FALSE,NA,"0.1.4"
"33707","646",2023-08-18 02:30:00,-13991,1913,15904,907,FALSE,NA,"0.1.4"
"33708","646",2023-08-18 02:45:00,-13914,1913,15827,907,FALSE,NA,"0.1.4"
"33709","646",2023-08-18 03:00:00,-13713,1913,15626,907,FALSE,NA,"0.1.4"
"33710","646",2023-08-18 03:15:00,-13681,1913,15594,907,FALSE,NA,"0.1.4"
"33711","646",2023-08-18 03:30:00,-13684,1913,15597,907,FALSE,NA,"0.1.4"
"33712","646",2023-08-18 03:45:00,-13686,1913,15599,907,FALSE,NA,"0.1.4"
"33713","646",2023-08-18 04:00:00,-13682,1913,15595,907,FALSE,NA,"0.1.4"
"33714","646",2023-08-18 04:15:00,-13703,1913,15616,907,FALSE,NA,"0.1.4"
"33715","646",2023-08-18 04:30:00,-13682,1913,15595,907,FALSE,NA,"0.1.4"
"33716","646",2023-08-18 04:45:00,-13681,1913,15594,907,FALSE,NA,"0.1.4"
"33717","646",2023-08-18 05:00:00,-13681,1913,15594,907,FALSE,NA,"0.1.4"
"33718","646",2023-08-18 05:15:00,-13681,1913,15594,907,FALSE,NA,"0.1.4"
"33719","646",2023-08-18 05:30:00,-13682,1913,15595,907,FALSE,NA,"0.1.4"
"33720","646",2023-08-18 05:45:00,-13682,1913,15595,907,FALSE,NA,"0.1.4"
"33721","646",2023-08-18 06:00:00,-13682,1913,15595,907,FALSE,NA,"0.1.4"
"33722","646",2023-08-18 06:15:00,-13681,1913,15594,907,FALSE,NA,"0.1.4"
"33723","646",2023-08-18 06:30:00,-13685,1913,15598,907,FALSE,NA,"0.1.4"
"33724","646",2023-08-18 06:45:00,-13686,1913,15599,907,FALSE,NA,"0.1.4"
"33725","646",2023-08-18 07:00:00,-13693,1913,15606,907,FALSE,NA,"0.1.4"
"33726","646",2023-08-18 07:15:00,-13711,1913,15624,907,FALSE,NA,"0.1.4"
"33727","646",2023-08-18 07:30:00,-13709.6666666667,1913,15622.6666666667,907,FALSE,"out1, fill","0.1.4"
"33728","646",2023-08-18 07:45:00,-13708.3333333333,1913,15621.3333333333,907,FALSE,"out1, fill","0.1.4"
"33729","646",2023-08-18 08:00:00,-13707,1913,15620,907,FALSE,NA,"0.1.4"
"33730","646",2023-08-18 08:15:00,-14096,1913,16009,907,FALSE,NA,"0.1.4"
"33731","646",2023-08-18 08:30:00,-13751,1913,15664,907,FALSE,NA,"0.1.4"
"33732","646",2023-08-18 08:45:00,-13751,1913,15664,907,FALSE,"jump1","0.1.4"
"33733","646",2023-08-18 09:00:00,-14013,1913,15926,907,FALSE,NA,"0.1.4"
"33734","646",2023-08-18 09:15:00,-14013,1913,15926,907,FALSE,"jump1","0.1.4"
"33735","646",2023-08-18 09:30:00,-13666,1913,15579,907,FALSE,NA,"0.1.4"
"33736","646",2023-08-18 09:45:00,-13703,1913,15616,907,FALSE,NA,"0.1.4"
"33737","646",2023-08-18 10:00:00,-13757,1913,15670,907,FALSE,NA,"0.1.4"
"33738","646",2023-08-18 10:15:00,-13765,1913,15678,907,FALSE,NA,"0.1.4"
"33739","646",2023-08-18 10:30:00,-13804,1913,15717,907,FALSE,"out1, fill","0.1.4"
"33740","646",2023-08-18 10:45:00,-13843,1913,15756,907,FALSE,"out1, fill","0.1.4"
"33741","646",2023-08-18 11:00:00,-13882,1913,15795,907,FALSE,NA,"0.1.4"
"33742","646",2023-08-18 11:15:00,-13882,1913,15795,907,FALSE,"jump1","0.1.4"
"33743","646",2023-08-18 11:30:00,-13803,1913,15716,907,FALSE,NA,"0.1.4"
"33744","646",2023-08-18 11:45:00,-14016,1913,15929,907,FALSE,NA,"0.1.4"
"33745","646",2023-08-18 12:00:00,-13896.875,1913,15809.875,907,FALSE,"out1, fill","0.1.4"
"33746","646",2023-08-18 12:15:00,-13777.75,1913,15690.75,907,FALSE,"out1, fill","0.1.4"
"33747","646",2023-08-18 12:30:00,-13658.625,1913,15571.625,907,FALSE,"out1, fill","0.1.4"
"33748","646",2023-08-18 12:45:00,-13539.5,1913,15452.5,907,FALSE,"out1, fill","0.1.4"
"33749","646",2023-08-18 13:00:00,-13420.375,1913,15333.375,907,FALSE,"out1, fill","0.1.4"
"33750","646",2023-08-18 13:15:00,-13301.25,1913,15214.25,907,FALSE,"out1, fill","0.1.4"
"33751","646",2023-08-18 13:30:00,-13182.125,1913,15095.125,907,FALSE,"out1, fill","0.1.4"
"33752","646",2023-08-18 13:45:00,-13063,1913,14976,907,FALSE,NA,"0.1.4"
"33753","646",2023-08-18 14:00:00,-13063,1913,14976,907,FALSE,"jump1","0.1.4"
"33754","646",2023-08-18 14:15:00,-13063,1913,14976,907,FALSE,"jump1","0.1.4"
"33755","646",2023-08-18 14:30:00,-13055,1913,14968,907,FALSE,NA,"0.1.4"
"33756","646",2023-08-18 14:45:00,-13055,1913,14968,907,FALSE,"out1, fill","0.1.4"
"33757","646",2023-08-18 15:00:00,-13055,1913,14968,907,FALSE,"out1, fill","0.1.4"
"33758","646",2023-08-18 15:15:00,-13055,1913,14968,907,FALSE,NA,"0.1.4"
"33759","646",2023-08-18 15:30:00,-13055,1913,14968,907,FALSE,"jump1","0.1.4"
"33760","646",2023-08-18 15:45:00,-12636,1913,14549,907,FALSE,NA,"0.1.4"
"33761","646",2023-08-18 16:00:00,-12586,1913,14499,907,FALSE,NA,"0.1.4"
"33762","646",2023-08-18 16:15:00,-12597,1913,14510,907,FALSE,NA,"0.1.4"
"33763","646",2023-08-18 16:30:00,-12581,1913,14494,907,FALSE,NA,"0.1.4"
"33764","646",2023-08-18 16:45:00,-12525,1913,14438,907,FALSE,NA,"0.1.4"
"33765","646",2023-08-18 17:00:00,-12503,1913,14416,907,FALSE,NA,"0.1.4"
"33766","646",2023-08-18 17:15:00,-12485,1913,14398,907,FALSE,NA,"0.1.4"
"33767","646",2023-08-18 17:30:00,-12503,1913,14416,907,FALSE,NA,"0.1.4"
"33768","646",2023-08-18 17:45:00,-12515,1913,14428,907,FALSE,NA,"0.1.4"
"33769","646",2023-08-18 18:00:00,-12498,1913,14411,907,FALSE,NA,"0.1.4"
"33770","646",2023-08-18 18:15:00,-12497,1913,14410,907,FALSE,NA,"0.1.4"
"33771","646",2023-08-18 18:30:00,-12473,1913,14386,907,FALSE,NA,"0.1.4"
"33772","646",2023-08-18 18:45:00,-12468,1913,14381,907,FALSE,NA,"0.1.4"
"33773","646",2023-08-18 19:00:00,-12498,1913,14411,907,FALSE,NA,"0.1.4"
"33774","646",2023-08-18 19:15:00,-12503,1913,14416,907,FALSE,NA,"0.1.4"
"33775","646",2023-08-18 19:30:00,-12504,1913,14417,907,FALSE,NA,"0.1.4"
"33776","646",2023-08-18 19:45:00,-12504,1913,14417,907,FALSE,NA,"0.1.4"
"33777","646",2023-08-18 20:00:00,-12507,1913,14420,907,FALSE,NA,"0.1.4"
"33778","646",2023-08-18 20:15:00,-12497,1913,14410,907,FALSE,NA,"0.1.4"
"33779","646",2023-08-18 20:30:00,-12548,1913,14461,907,FALSE,NA,"0.1.4"
"33780","646",2023-08-18 20:45:00,-12489,1913,14402,907,FALSE,NA,"0.1.4"
"33781","646",2023-08-18 21:00:00,-12498,1913,14411,907,FALSE,NA,"0.1.4"
"33782","646",2023-08-18 21:15:00,-12486,1913,14399,907,FALSE,NA,"0.1.4"
"33783","646",2023-08-18 21:30:00,-12472,1913,14385,907,FALSE,NA,"0.1.4"
"33784","646",2023-08-18 21:45:00,-12518,1913,14431,907,FALSE,NA,"0.1.4"
"33785","646",2023-08-18 22:00:00,-12518,1913,14431,907,FALSE,"jump1","0.1.4"
"33786","646",2023-08-18 22:15:00,-12518,1913,14431,907,FALSE,"jump1","0.1.4"
"33787","646",2023-08-18 22:30:00,-12514,1913,14427,907,FALSE,NA,"0.1.4"
"33788","646",2023-08-18 22:45:00,-12515,1913,14428,907,FALSE,NA,"0.1.4"
"33789","646",2023-08-18 23:00:00,-12575,1913,14488,907,FALSE,NA,"0.1.4"
"33790","646",2023-08-18 23:15:00,-12514,1913,14427,907,FALSE,NA,"0.1.4"
"33791","646",2023-08-18 23:30:00,-12528,1913,14441,907,FALSE,NA,"0.1.4"
"33792","646",2023-08-18 23:45:00,-12527,1913,14440,907,FALSE,NA,"0.1.4"
"33793","646",2023-08-19,-12527,1913,14440,907,FALSE,NA,"0.1.4"
"33794","646",2023-08-19 00:15:00,-12514,1913,14427,907,FALSE,NA,"0.1.4"
"33795","646",2023-08-19 00:30:00,-12599,1913,14512,907,FALSE,NA,"0.1.4"
"33796","646",2023-08-19 00:45:00,-12532,1913,14445,907,FALSE,NA,"0.1.4"
"33797","646",2023-08-19 01:00:00,-12895.5,1913,14808.5,907,FALSE,"out1, fill","0.1.4"
"33798","646",2023-08-19 01:15:00,-13259,1913,15172,907,FALSE,NA,"0.1.4"
"33799","646",2023-08-19 01:30:00,-13349,1913,15262,907,FALSE,NA,"0.1.4"
"33800","646",2023-08-19 01:45:00,-13545,1913,15458,907,FALSE,NA,"0.1.4"
"33801","646",2023-08-19 02:00:00,-13098,1913,15011,907,FALSE,NA,"0.1.4"
"33802","646",2023-08-19 02:15:00,-13453,1913,15366,907,FALSE,NA,"0.1.4"
"33803","646",2023-08-19 02:30:00,-13464,1913,15377,907,FALSE,NA,"0.1.4"
"33804","646",2023-08-19 02:45:00,-13462,1913,15375,907,FALSE,NA,"0.1.4"
"33805","646",2023-08-19 03:00:00,-13387,1913,15300,907,FALSE,NA,"0.1.4"
"33806","646",2023-08-19 03:15:00,-13387,1913,15300,907,FALSE,"jump1","0.1.4"
"33807","646",2023-08-19 03:30:00,-13681,1913,15594,907,FALSE,"out1, fill","0.1.4"
"33808","646",2023-08-19 03:45:00,-13975,1913,15888,907,FALSE,NA,"0.1.4"
"33809","646",2023-08-19 04:00:00,-14201,1913,16114,907,FALSE,NA,"0.1.4"
"33810","646",2023-08-19 04:15:00,-13882,1913,15795,907,FALSE,NA,"0.1.4"
"33811","646",2023-08-19 04:30:00,-14283,1913,16196,907,FALSE,NA,"0.1.4"
"33812","646",2023-08-19 04:45:00,-14128.3333333333,1913,16041.3333333333,907,FALSE,"out1, fill","0.1.4"
"33813","646",2023-08-19 05:00:00,-13973.6666666667,1913,15886.6666666667,907,FALSE,"out1, fill","0.1.4"
"33814","646",2023-08-19 05:15:00,-13819,1913,15732,907,FALSE,NA,"0.1.4"
"33815","646",2023-08-19 05:30:00,-13819,1913,15732,907,FALSE,"jump1","0.1.4"
"33816","646",2023-08-19 05:45:00,-13899,1913,15812,907,FALSE,NA,"0.1.4"
"33817","646",2023-08-19 06:00:00,-14350,1913,16263,907,FALSE,"out1, fill","0.1.4"
"33818","646",2023-08-19 06:15:00,-14801,1913,16714,907,FALSE,NA,"0.1.4"
"33819","646",2023-08-19 06:30:00,-14923,1913,16836,907,FALSE,NA,"0.1.4"
"33820","646",2023-08-19 06:45:00,-14994,1913,16907,907,FALSE,NA,"0.1.4"
"33821","646",2023-08-19 07:00:00,-14819,1913,16732,907,FALSE,NA,"0.1.4"
"33822","646",2023-08-19 07:15:00,-14505,1913,16418,907,FALSE,NA,"0.1.4"
"33823","646",2023-08-19 07:30:00,-14818,1913,16731,907,FALSE,NA,"0.1.4"
"33824","646",2023-08-19 07:45:00,-14765,1913,16678,907,FALSE,NA,"0.1.4"
"33825","646",2023-08-19 08:00:00,-14785,1913,16698,907,FALSE,NA,"0.1.4"
"33826","646",2023-08-19 08:15:00,-14828.3333333333,1913,16741.3333333333,907,FALSE,"out1, fill","0.1.4"
"33827","646",2023-08-19 08:30:00,-14871.6666666667,1913,16784.6666666667,907,FALSE,"out1, fill","0.1.4"
"33828","646",2023-08-19 08:45:00,-14915,1913,16828,907,FALSE,NA,"0.1.4"
"33829","646",2023-08-19 09:00:00,-14838,1913,16751,907,FALSE,NA,"0.1.4"
"33830","646",2023-08-19 09:15:00,-14856,1913,16769,907,FALSE,NA,"0.1.4"
"33831","646",2023-08-19 09:30:00,-14856,1913,16769,907,FALSE,"jump1","0.1.4"
"33832","646",2023-08-19 09:45:00,-14706,1913,16619,907,FALSE,NA,"0.1.4"
"33833","646",2023-08-19 10:00:00,-14379,1913,16292,907,FALSE,NA,"0.1.4"
"33834","646",2023-08-19 10:15:00,-13982,1913,15895,907,FALSE,NA,"0.1.4"
"33835","646",2023-08-19 10:30:00,-14004,1913,15917,907,FALSE,NA,"0.1.4"
"33836","646",2023-08-19 10:45:00,-14057,1913,15970,907,FALSE,NA,"0.1.4"
"33837","646",2023-08-19 11:00:00,-13907,1913,15820,907,FALSE,NA,"0.1.4"
"33838","646",2023-08-19 11:15:00,-13907,1913,15820,907,FALSE,"jump1","0.1.4"
"33839","646",2023-08-19 11:30:00,-13792.4,1913,15705.4,907,FALSE,"out1, fill","0.1.4"
"33840","646",2023-08-19 11:45:00,-13677.8,1913,15590.8,907,FALSE,"out1, fill","0.1.4"
"33841","646",2023-08-19 12:00:00,-13563.2,1913,15476.2,907,FALSE,"out1, fill","0.1.4"
"33842","646",2023-08-19 12:15:00,-13448.6,1913,15361.6,907,FALSE,"out1, fill","0.1.4"
"33843","646",2023-08-19 12:30:00,-13334,1913,15247,907,FALSE,NA,"0.1.4"
"33844","646",2023-08-19 12:45:00,-13696,1913,15609,907,FALSE,NA,"0.1.4"
"33845","646",2023-08-19 13:00:00,-13534,1913,15447,907,FALSE,NA,"0.1.4"
"33846","646",2023-08-19 13:15:00,-13157,1913,15070,907,FALSE,"out1, fill","0.1.4"
"33847","646",2023-08-19 13:30:00,-12780,1913,14693,907,FALSE,NA,"0.1.4"
"33848","646",2023-08-19 13:45:00,-12616,1913,14529,907,FALSE,NA,"0.1.4"
"33849","646",2023-08-19 14:00:00,-12694,1913,14607,907,FALSE,NA,"0.1.4"
"33850","646",2023-08-19 14:15:00,-12808,1913,14721,907,FALSE,NA,"0.1.4"
"33851","646",2023-08-19 14:30:00,-12845,1913,14758,907,FALSE,NA,"0.1.4"
"33852","646",2023-08-19 14:45:00,-12816,1913,14729,907,FALSE,NA,"0.1.4"
"33853","646",2023-08-19 15:00:00,-12825,1913,14738,907,FALSE,NA,"0.1.4"
"33854","646",2023-08-19 15:15:00,-12832,1913,14745,907,FALSE,NA,"0.1.4"
"33855","646",2023-08-19 15:30:00,-12823,1913,14736,907,FALSE,NA,"0.1.4"
"33856","646",2023-08-19 15:45:00,-12823,1913,14736,907,FALSE,"jump1","0.1.4"
"33857","646",2023-08-19 16:00:00,-12823,1913,14736,907,FALSE,"jump1","0.1.4"
"33858","646",2023-08-19 16:15:00,-12811,1913,14724,907,FALSE,NA,"0.1.4"
"33859","646",2023-08-19 16:30:00,-12702,1913,14615,907,FALSE,NA,"0.1.4"
"33860","646",2023-08-19 16:45:00,-12710,1913,14623,907,FALSE,NA,"0.1.4"
"33861","646",2023-08-19 17:00:00,-12581,1913,14494,907,FALSE,NA,"0.1.4"
"33862","646",2023-08-19 17:15:00,-12566,1913,14479,907,FALSE,NA,"0.1.4"
"33863","646",2023-08-19 17:30:00,-12567.2,1913,14480.2,907,FALSE,"out1, fill","0.1.4"
"33864","646",2023-08-19 17:45:00,-12568.4,1913,14481.4,907,FALSE,"out1, fill","0.1.4"
"33865","646",2023-08-19 18:00:00,-12569.6,1913,14482.6,907,FALSE,"out1, fill","0.1.4"
"33866","646",2023-08-19 18:15:00,-12570.8,1913,14483.8,907,FALSE,"out1, fill","0.1.4"
"33867","646",2023-08-19 18:30:00,-12572,1913,14485,907,FALSE,NA,"0.1.4"
"33868","646",2023-08-19 18:45:00,-12597,1913,14510,907,FALSE,NA,"0.1.4"
"33869","646",2023-08-19 19:00:00,-12570,1913,14483,907,FALSE,NA,"0.1.4"
"33870","646",2023-08-19 19:15:00,-13010,1913,14923,907,FALSE,NA,"0.1.4"
"33871","646",2023-08-19 19:30:00,-12558,1913,14471,907,FALSE,NA,"0.1.4"
"33872","646",2023-08-19 19:45:00,-12564,1913,14477,907,FALSE,NA,"0.1.4"
"33873","646",2023-08-19 20:00:00,-13003,1913,14916,907,FALSE,NA,"0.1.4"
"33874","646",2023-08-19 20:15:00,-12560,1913,14473,907,FALSE,NA,"0.1.4"
"33875","646",2023-08-19 20:30:00,-12813,1913,14726,907,FALSE,"out1, fill","0.1.4"
"33876","646",2023-08-19 20:45:00,-13066,1913,14979,907,FALSE,"out1, fill","0.1.4"
"33877","646",2023-08-19 21:00:00,-13319,1913,15232,907,FALSE,NA,"0.1.4"
"33878","646",2023-08-19 21:15:00,-13155,1913,15068,907,FALSE,NA,"0.1.4"
"33879","646",2023-08-19 21:30:00,-13552,1913,15465,907,FALSE,NA,"0.1.4"
"33880","646",2023-08-19 21:45:00,-13192,1913,15105,907,FALSE,NA,"0.1.4"
"33881","646",2023-08-19 22:00:00,-13022,1913,14935,907,FALSE,NA,"0.1.4"
"33882","646",2023-08-19 22:15:00,-12559,1913,14472,907,FALSE,NA,"0.1.4"
"33883","646",2023-08-19 22:30:00,-12575,1913,14488,907,FALSE,NA,"0.1.4"
"33884","646",2023-08-19 22:45:00,-12685,1913,14598,907,FALSE,NA,"0.1.4"
"33885","646",2023-08-19 23:00:00,-12600,1913,14513,907,FALSE,NA,"0.1.4"
"33886","646",2023-08-19 23:15:00,-12559,1913,14472,907,FALSE,NA,"0.1.4"
"33887","646",2023-08-19 23:30:00,-12559,1913,14472,907,FALSE,NA,"0.1.4"
"33888","646",2023-08-19 23:45:00,-12576,1913,14489,907,FALSE,NA,"0.1.4"
"33889","646",2023-08-20,-12558,1913,14471,907,FALSE,NA,"0.1.4"
"33890","646",2023-08-20 00:15:00,-12558,1913,14471,907,FALSE,NA,"0.1.4"
"33891","646",2023-08-20 00:30:00,-12560,1913,14473,907,FALSE,NA,"0.1.4"
"33892","646",2023-08-20 00:45:00,-12557,1913,14470,907,FALSE,NA,"0.1.4"
"33893","646",2023-08-20 01:00:00,-13057,1913,14970,907,FALSE,NA,"0.1.4"
"33894","646",2023-08-20 01:15:00,-13070,1913,14983,907,FALSE,NA,"0.1.4"
"33895","646",2023-08-20 01:30:00,-13520,1913,15433,907,FALSE,NA,"0.1.4"
"33896","646",2023-08-20 01:45:00,-13611,1913,15524,907,FALSE,NA,"0.1.4"
"33897","646",2023-08-20 02:00:00,-13739,1913,15652,907,FALSE,NA,"0.1.4"
"33898","646",2023-08-20 02:15:00,-13493,1913,15406,907,FALSE,NA,"0.1.4"
"33899","646",2023-08-20 02:30:00,-13210,1913,15123,907,FALSE,NA,"0.1.4"
"33900","646",2023-08-20 02:45:00,-13432,1913,15345,907,FALSE,NA,"0.1.4"
"33901","646",2023-08-20 03:00:00,-13356,1913,15269,907,FALSE,NA,"0.1.4"
"33902","646",2023-08-20 03:15:00,-13527,1913,15440,907,FALSE,NA,"0.1.4"
"33903","646",2023-08-20 03:30:00,-13111,1913,15024,907,FALSE,NA,"0.1.4"
"33904","646",2023-08-20 03:45:00,-13508,1913,15421,907,FALSE,NA,"0.1.4"
"33905","646",2023-08-20 04:00:00,-13394,1913,15307,907,FALSE,NA,"0.1.4"
"33906","646",2023-08-20 04:15:00,-13641,1913,15554,907,FALSE,NA,"0.1.4"
"33907","646",2023-08-20 04:30:00,-13167,1913,15080,907,FALSE,NA,"0.1.4"
"33908","646",2023-08-20 04:45:00,-12997,1913,14910,907,FALSE,NA,"0.1.4"
"33909","646",2023-08-20 05:00:00,-12997,1913,14910,907,FALSE,"jump1","0.1.4"
"33910","646",2023-08-20 05:15:00,-12997,1913,14910,907,FALSE,"jump1","0.1.4"
"33911","646",2023-08-20 05:30:00,-12997,1913,14910,907,FALSE,"jump1","0.1.4"
"33912","646",2023-08-20 05:45:00,-13256,1913,15169,907,FALSE,NA,"0.1.4"
"33913","646",2023-08-20 06:00:00,-12888,1913,14801,907,FALSE,NA,"0.1.4"
"33914","646",2023-08-20 06:15:00,-13009,1913,14922,907,FALSE,NA,"0.1.4"
"33915","646",2023-08-20 06:30:00,-13042,1913,14955,907,FALSE,NA,"0.1.4"
"33916","646",2023-08-20 06:45:00,-13036,1913,14949,907,FALSE,NA,"0.1.4"
"33917","646",2023-08-20 07:00:00,-12958,1913,14871,907,FALSE,NA,"0.1.4"
"33918","646",2023-08-20 07:15:00,-13389,1913,15302,907,FALSE,NA,"0.1.4"
"33919","646",2023-08-20 07:30:00,-13315,1913,15228,907,FALSE,NA,"0.1.4"
"33920","646",2023-08-20 07:45:00,-13264,1913,15177,907,FALSE,NA,"0.1.4"
"33921","646",2023-08-20 08:00:00,-13091,1913,15004,907,FALSE,NA,"0.1.4"
"33922","646",2023-08-20 08:15:00,-12902,1913,14815,907,FALSE,"out1, fill","0.1.4"
"33923","646",2023-08-20 08:30:00,-12713,1913,14626,907,FALSE,"out1, fill","0.1.4"
"33924","646",2023-08-20 08:45:00,-12524,1913,14437,907,FALSE,"out1, fill","0.1.4"
"33925","646",2023-08-20 09:00:00,-12335,1913,14248,907,FALSE,"out1, fill","0.1.4"
"33926","646",2023-08-20 09:15:00,-12146,1913,14059,907,FALSE,NA,"0.1.4"
"33927","646",2023-08-20 09:30:00,-12115,1913,14028,907,FALSE,NA,"0.1.4"
"33928","646",2023-08-20 09:45:00,-12300,1913,14213,907,FALSE,NA,"0.1.4"
"33929","646",2023-08-20 10:00:00,-12300,1913,14213,907,FALSE,"jump1","0.1.4"
"33930","646",2023-08-20 10:15:00,-12278,1913,14191,907,FALSE,NA,"0.1.4"
"33931","646",2023-08-20 10:30:00,-12034,1913,13947,907,FALSE,NA,"0.1.4"
"33932","646",2023-08-20 10:45:00,-11846,1913,13759,907,FALSE,NA,"0.1.4"
"33933","646",2023-08-20 11:00:00,-11445,1913,13358,907,FALSE,NA,"0.1.4"
"33934","646",2023-08-20 11:15:00,-11546.3333333333,1913,13459.3333333333,907,FALSE,"out1, fill","0.1.4"
"33935","646",2023-08-20 11:30:00,-11647.6666666667,1913,13560.6666666667,907,FALSE,"out1, fill","0.1.4"
"33936","646",2023-08-20 11:45:00,-11749,1913,13662,907,FALSE,NA,"0.1.4"
"33937","646",2023-08-20 12:00:00,-11512,1913,13425,907,FALSE,NA,"0.1.4"
"33938","646",2023-08-20 12:15:00,-11512,1913,13425,907,FALSE,"jump1","0.1.4"
"33939","646",2023-08-20 12:30:00,-11512,1913,13425,907,FALSE,"jump1","0.1.4"
"33940","646",2023-08-20 12:45:00,-11512,1913,13425,907,FALSE,"jump1","0.1.4"
"33941","646",2023-08-20 13:00:00,-11646,1913,13559,907,FALSE,NA,"0.1.4"
"33942","646",2023-08-20 13:15:00,-11646,1913,13559,907,FALSE,"jump1","0.1.4"
"33943","646",2023-08-20 13:30:00,-12033,1913,13946,907,FALSE,NA,"0.1.4"
"33944","646",2023-08-20 13:45:00,-11633,1913,13546,907,FALSE,NA,"0.1.4"
"33945","646",2023-08-20 14:00:00,-11695,1913,13608,907,FALSE,NA,"0.1.4"
"33946","646",2023-08-20 14:15:00,-11623,1913,13536,907,FALSE,NA,"0.1.4"
"33947","646",2023-08-20 14:30:00,-11612,1913,13525,907,FALSE,NA,"0.1.4"
"33948","646",2023-08-20 14:45:00,-11646,1913,13559,907,FALSE,NA,"0.1.4"
"33949","646",2023-08-20 15:00:00,-11618,1913,13531,907,FALSE,NA,"0.1.4"
"33950","646",2023-08-20 15:15:00,-11609,1913,13522,907,FALSE,NA,"0.1.4"
"33951","646",2023-08-20 15:30:00,-11609,1913,13522,907,FALSE,NA,"0.1.4"
"33952","646",2023-08-20 15:45:00,-11608,1913,13521,907,FALSE,NA,"0.1.4"
"33953","646",2023-08-20 16:00:00,-11608,1913,13521,907,FALSE,NA,"0.1.4"
"33954","646",2023-08-20 16:15:00,-11608,1913,13521,907,FALSE,NA,"0.1.4"
"33955","646",2023-08-20 16:30:00,-11610,1913,13523,907,FALSE,NA,"0.1.4"
"33956","646",2023-08-20 16:45:00,-11611,1913,13524,907,FALSE,NA,"0.1.4"
"33957","646",2023-08-20 17:00:00,-11655,1913,13568,907,FALSE,NA,"0.1.4"
"33958","646",2023-08-20 17:15:00,-11613,1913,13526,907,FALSE,NA,"0.1.4"
"33959","646",2023-08-20 17:30:00,-11611,1913,13524,907,FALSE,NA,"0.1.4"
"33960","646",2023-08-20 17:45:00,-11611,1913,13524,907,FALSE,"jump1","0.1.4"
"33961","646",2023-08-20 18:00:00,-11810,1913,13723,907,FALSE,NA,"0.1.4"
"33962","646",2023-08-20 18:15:00,-11810,1913,13723,907,FALSE,"jump1","0.1.4"
"33963","646",2023-08-20 18:30:00,-11790,1913,13703,907,FALSE,NA,"0.1.4"
"33964","646",2023-08-20 18:45:00,-11695,1913,13608,907,FALSE,NA,"0.1.4"
"33965","646",2023-08-20 19:00:00,-12184,1913,14097,907,FALSE,NA,"0.1.4"
"33966","646",2023-08-20 19:15:00,-12284,1913,14197,907,FALSE,NA,"0.1.4"
"33967","646",2023-08-20 19:30:00,-11865,1913,13778,907,FALSE,NA,"0.1.4"
"33968","646",2023-08-20 19:45:00,-12013,1913,13926,907,FALSE,NA,"0.1.4"
"33969","646",2023-08-20 20:00:00,-12430,1913,14343,907,FALSE,NA,"0.1.4"
"33970","646",2023-08-20 20:15:00,-12293,1913,14206,907,FALSE,"out1, fill","0.1.4"
"33971","646",2023-08-20 20:30:00,-12156,1913,14069,907,FALSE,NA,"0.1.4"
"33972","646",2023-08-20 20:45:00,-11762,1913,13675,907,FALSE,NA,"0.1.4"
"33973","646",2023-08-20 21:00:00,-11720,1913,13633,907,FALSE,NA,"0.1.4"
"33974","646",2023-08-20 21:15:00,-11753,1913,13666,907,FALSE,NA,"0.1.4"
"33975","646",2023-08-20 21:30:00,-11753,1913,13666,907,FALSE,"jump1","0.1.4"
"33976","646",2023-08-20 21:45:00,-11849,1913,13762,907,FALSE,NA,"0.1.4"
"33977","646",2023-08-20 22:00:00,-11683,1913,13596,907,FALSE,NA,"0.1.4"
"33978","646",2023-08-20 22:15:00,-11484,1913,13397,907,FALSE,NA,"0.1.4"
"33979","646",2023-08-20 22:30:00,-11031,1913,12944,907,FALSE,NA,"0.1.4"
"33980","646",2023-08-20 22:45:00,-11039,1913,12952,907,FALSE,NA,"0.1.4"
"33981","646",2023-08-20 23:00:00,-11039,1913,12952,907,FALSE,NA,"0.1.4"
"33982","646",2023-08-20 23:15:00,-11032,1913,12945,907,FALSE,NA,"0.1.4"
"33983","646",2023-08-20 23:30:00,-11316,1913,13229,907,FALSE,NA,"0.1.4"
"33984","646",2023-08-20 23:45:00,-11195,1913,13108,907,FALSE,NA,"0.1.4"
"33985","646",2023-08-21,-11245,1913,13158,907,FALSE,NA,"0.1.4"
"33986","646",2023-08-21 00:15:00,-11350,1913,13263,907,FALSE,NA,"0.1.4"
"33987","646",2023-08-21 00:30:00,-11423,1913,13336,907,FALSE,NA,"0.1.4"
"33988","646",2023-08-21 00:45:00,-11078,1913,12991,907,FALSE,NA,"0.1.4"
"33989","646",2023-08-21 01:00:00,-11196,1913,13109,907,FALSE,NA,"0.1.4"
"33990","646",2023-08-21 01:15:00,-11159,1913,13072,907,FALSE,NA,"0.1.4"
"33991","646",2023-08-21 01:30:00,-11207,1913,13120,907,FALSE,NA,"0.1.4"
"33992","646",2023-08-21 01:45:00,-11227,1913,13140,907,FALSE,NA,"0.1.4"
"33993","646",2023-08-21 02:00:00,-11532.5,1913,13445.5,907,FALSE,"out1, fill","0.1.4"
"33994","646",2023-08-21 02:15:00,-11838,1913,13751,907,FALSE,NA,"0.1.4"
"33995","646",2023-08-21 02:30:00,-12011,1913,13924,907,FALSE,NA,"0.1.4"
"33996","646",2023-08-21 02:45:00,-12011,1913,13924,907,FALSE,"jump1","0.1.4"
"33997","646",2023-08-21 03:00:00,-12002,1913,13915,907,FALSE,NA,"0.1.4"
"33998","646",2023-08-21 03:15:00,-11973,1913,13886,907,FALSE,NA,"0.1.4"
"33999","646",2023-08-21 03:30:00,-11677,1913,13590,907,FALSE,NA,"0.1.4"
"34000","646",2023-08-21 03:45:00,-11708,1913,13621,907,FALSE,NA,"0.1.4"
"34001","646",2023-08-21 04:00:00,-12052,1913,13965,907,FALSE,NA,"0.1.4"
"34002","646",2023-08-21 04:15:00,-11577,1913,13490,907,FALSE,NA,"0.1.4"
"34003","646",2023-08-21 04:30:00,-11681,1913,13594,907,FALSE,NA,"0.1.4"
"34004","646",2023-08-21 04:45:00,-11584,1913,13497,907,FALSE,NA,"0.1.4"
"34005","646",2023-08-21 05:00:00,-11575,1913,13488,907,FALSE,NA,"0.1.4"
"34006","646",2023-08-21 05:15:00,-11585,1913,13498,907,FALSE,NA,"0.1.4"
"34007","646",2023-08-21 05:30:00,-11677,1913,13590,907,FALSE,NA,"0.1.4"
"34008","646",2023-08-21 05:45:00,-11758,1913,13671,907,FALSE,NA,"0.1.4"
"34009","646",2023-08-21 06:00:00,-11544,1913,13457,907,FALSE,NA,"0.1.4"
"34010","646",2023-08-21 06:15:00,-11541,1913,13454,907,FALSE,NA,"0.1.4"
"34011","646",2023-08-21 06:30:00,-11558,1913,13471,907,FALSE,NA,"0.1.4"
"34012","646",2023-08-21 06:45:00,-11559,1913,13472,907,FALSE,NA,"0.1.4"
"34013","646",2023-08-21 07:00:00,-11597,1913,13510,907,FALSE,NA,"0.1.4"
"34014","646",2023-08-21 07:15:00,-11562,1913,13475,907,FALSE,NA,"0.1.4"
"34015","646",2023-08-21 07:30:00,-11542,1913,13455,907,FALSE,NA,"0.1.4"
"34016","646",2023-08-21 07:45:00,-11611,1913,13524,907,FALSE,NA,"0.1.4"
"34017","646",2023-08-21 08:00:00,-11820,1913,13733,907,FALSE,NA,"0.1.4"
"34018","646",2023-08-21 08:15:00,-11984,1913,13897,907,FALSE,NA,"0.1.4"
"34019","646",2023-08-21 08:30:00,-11553,1913,13466,907,FALSE,NA,"0.1.4"
"34020","646",2023-08-21 08:45:00,-11553,1913,13466,907,FALSE,"jump1","0.1.4"
"34021","646",2023-08-21 09:00:00,-11553,1913,13466,907,FALSE,"jump1","0.1.4"
"34022","646",2023-08-21 09:15:00,-11595,1913,13508,907,FALSE,NA,"0.1.4"
"34023","646",2023-08-21 09:30:00,-11595,1913,13508,907,FALSE,"jump1","0.1.4"
"34024","646",2023-08-21 09:45:00,-11595,1913,13508,907,FALSE,"jump1","0.1.4"
"34025","646",2023-08-21 10:00:00,-11609.3333333333,1913,13522.3333333333,907,FALSE,"out1, fill","0.1.4"
"34026","646",2023-08-21 10:15:00,-11623.6666666667,1913,13536.6666666667,907,FALSE,"out1, fill","0.1.4"
"34027","646",2023-08-21 10:30:00,-11638,1913,13551,907,FALSE,NA,"0.1.4"
"34028","646",2023-08-21 10:45:00,-11621,1913,13534,907,FALSE,NA,"0.1.4"
"34029","646",2023-08-21 11:00:00,-11650,1913,13563,907,FALSE,NA,"0.1.4"
"34030","646",2023-08-21 11:15:00,-12140,1913,14053,907,FALSE,NA,"0.1.4"
"34031","646",2023-08-21 11:30:00,-11963,1913,13876,907,FALSE,NA,"0.1.4"
"34032","646",2023-08-21 11:45:00,-12333,1913,14246,907,FALSE,NA,"0.1.4"
"34033","646",2023-08-21 12:00:00,-12250,1913,14163,907,FALSE,NA,"0.1.4"
"34034","646",2023-08-21 12:15:00,-12281,1913,14194,907,FALSE,NA,"0.1.4"
"34035","646",2023-08-21 12:30:00,-12281,1913,14194,907,FALSE,"jump1","0.1.4"
"34036","646",2023-08-21 12:45:00,-12241,1913,14154,907,FALSE,NA,"0.1.4"
"34037","646",2023-08-21 13:00:00,-12248,1913,14161,907,FALSE,NA,"0.1.4"
"34038","646",2023-08-21 13:15:00,-12284,1913,14197,907,FALSE,"out1, fill","0.1.4"
"34039","646",2023-08-21 13:30:00,-12320,1913,14233,907,FALSE,NA,"0.1.4"
"34040","646",2023-08-21 13:45:00,-12207,1913,14120,907,FALSE,NA,"0.1.4"
"34041","646",2023-08-21 14:00:00,-12224,1913,14137,907,FALSE,NA,"0.1.4"
"34042","646",2023-08-21 14:15:00,-12221,1913,14134,907,FALSE,NA,"0.1.4"
"34043","646",2023-08-21 14:30:00,-12241,1913,14154,907,FALSE,NA,"0.1.4"
"34044","646",2023-08-21 14:45:00,-12277,1913,14190,907,FALSE,NA,"0.1.4"
"34045","646",2023-08-21 15:00:00,-12284,1913,14197,907,FALSE,NA,"0.1.4"
"34046","646",2023-08-21 15:15:00,-12282,1913,14195,907,FALSE,NA,"0.1.4"
"34047","646",2023-08-21 15:30:00,-12315,1913,14228,907,FALSE,NA,"0.1.4"
"34048","646",2023-08-21 15:45:00,-12309,1913,14222,907,FALSE,NA,"0.1.4"
"34049","646",2023-08-21 16:00:00,-12296,1913,14209,907,FALSE,NA,"0.1.4"
"34050","646",2023-08-21 16:15:00,-12243,1913,14156,907,FALSE,NA,"0.1.4"
"34051","646",2023-08-21 16:30:00,-12186,1913,14099,907,FALSE,NA,"0.1.4"
"34052","646",2023-08-21 16:45:00,-12195,1913,14108,907,FALSE,NA,"0.1.4"
"34053","646",2023-08-21 17:00:00,-12190,1913,14103,907,FALSE,NA,"0.1.4"
"34054","646",2023-08-21 17:15:00,-12247,1913,14160,907,FALSE,NA,"0.1.4"
"34055","646",2023-08-21 17:30:00,-12221,1913,14134,907,FALSE,NA,"0.1.4"
"34056","646",2023-08-21 17:45:00,-12189,1913,14102,907,FALSE,NA,"0.1.4"
"34057","646",2023-08-21 18:00:00,-12196,1913,14109,907,FALSE,NA,"0.1.4"
"34058","646",2023-08-21 18:15:00,-12474,1913,14387,907,FALSE,NA,"0.1.4"
"34059","646",2023-08-21 18:30:00,-12199,1913,14112,907,FALSE,NA,"0.1.4"
"34060","646",2023-08-21 18:45:00,-12175,1913,14088,907,FALSE,NA,"0.1.4"
"34061","646",2023-08-21 19:00:00,-12475,1913,14388,907,FALSE,NA,"0.1.4"
"34062","646",2023-08-21 19:15:00,-12189,1913,14102,907,FALSE,NA,"0.1.4"
"34063","646",2023-08-21 19:30:00,-12614,1913,14527,907,FALSE,NA,"0.1.4"
"34064","646",2023-08-21 19:45:00,-12201,1913,14114,907,FALSE,NA,"0.1.4"
"34065","646",2023-08-21 20:00:00,-12203,1913,14116,907,FALSE,NA,"0.1.4"
"34066","646",2023-08-21 20:15:00,-12196,1913,14109,907,FALSE,NA,"0.1.4"
"34067","646",2023-08-21 20:30:00,-12198,1913,14111,907,FALSE,NA,"0.1.4"
"34068","646",2023-08-21 20:45:00,-12196,1913,14109,907,FALSE,NA,"0.1.4"
"34069","646",2023-08-21 21:00:00,-12198,1913,14111,907,FALSE,NA,"0.1.4"
"34070","646",2023-08-21 21:15:00,-12217,1913,14130,907,FALSE,NA,"0.1.4"
"34071","646",2023-08-21 21:30:00,-12249,1913,14162,907,FALSE,NA,"0.1.4"
"34072","646",2023-08-21 21:45:00,-12201,1913,14114,907,FALSE,NA,"0.1.4"
"34073","646",2023-08-21 22:00:00,-12202,1913,14115,907,FALSE,NA,"0.1.4"
"34074","646",2023-08-21 22:15:00,-12200,1913,14113,907,FALSE,NA,"0.1.4"
"34075","646",2023-08-21 22:30:00,-12202,1913,14115,907,FALSE,NA,"0.1.4"
"34076","646",2023-08-21 22:45:00,-12681,1913,14594,907,FALSE,NA,"0.1.4"
"34077","646",2023-08-21 23:00:00,-12200,1913,14113,907,FALSE,NA,"0.1.4"
"34078","646",2023-08-21 23:15:00,-12200,1913,14113,907,FALSE,"jump1","0.1.4"
"34079","646",2023-08-21 23:30:00,-12200,1913,14113,907,FALSE,"jump1","0.1.4"
"34080","646",2023-08-21 23:45:00,-12197,1913,14110,907,FALSE,NA,"0.1.4"
"34081","646",2023-08-22,-12114,1913,14027,907,FALSE,NA,"0.1.4"
"34082","646",2023-08-22 00:15:00,-12614,1913,14527,907,FALSE,NA,"0.1.4"
"34083","646",2023-08-22 00:30:00,-12402,1913,14315,907,FALSE,NA,"0.1.4"
"34084","646",2023-08-22 00:45:00,-12128,1913,14041,907,FALSE,NA,"0.1.4"
"34085","646",2023-08-22 01:00:00,-12125,1913,14038,907,FALSE,NA,"0.1.4"
"34086","646",2023-08-22 01:15:00,-12256,1913,14169,907,FALSE,NA,"0.1.4"
"34087","646",2023-08-22 01:30:00,-12167,1913,14080,907,FALSE,NA,"0.1.4"
"34088","646",2023-08-22 01:45:00,-12167,1913,14080,907,FALSE,"out1, fill","0.1.4"
"34089","646",2023-08-22 02:00:00,-12167,1913,14080,907,FALSE,"jump1","0.1.4"
"34090","646",2023-08-22 02:15:00,-12195,1913,14108,907,FALSE,NA,"0.1.4"
"34091","646",2023-08-22 02:30:00,-11972,1913,13885,907,FALSE,NA,"0.1.4"
"34092","646",2023-08-22 02:45:00,-11880,1913,13793,907,FALSE,NA,"0.1.4"
"34093","646",2023-08-22 03:00:00,-11965,1913,13878,907,FALSE,NA,"0.1.4"
"34094","646",2023-08-22 03:15:00,-12416,1913,14329,907,FALSE,NA,"0.1.4"
"34095","646",2023-08-22 03:30:00,-12416,1913,14329,907,FALSE,"jump1","0.1.4"
"34096","646",2023-08-22 03:45:00,-12590,1913,14503,907,FALSE,NA,"0.1.4"
"34097","646",2023-08-22 04:00:00,-12835,1913,14748,907,FALSE,NA,"0.1.4"
"34098","646",2023-08-22 04:15:00,-12691,1913,14604,907,FALSE,NA,"0.1.4"
"34099","646",2023-08-22 04:30:00,-12510,1913,14423,907,FALSE,NA,"0.1.4"
"34100","646",2023-08-22 04:45:00,-12554,1913,14467,907,FALSE,NA,"0.1.4"
"34101","646",2023-08-22 05:00:00,-12157,1913,14070,907,FALSE,NA,"0.1.4"
"34102","646",2023-08-22 05:15:00,-12391,1913,14304,907,FALSE,NA,"0.1.4"
"34103","646",2023-08-22 05:30:00,-12391,1913,14304,907,FALSE,"jump1","0.1.4"
"34104","646",2023-08-22 05:45:00,-12291.6666666667,1913,14204.6666666667,907,FALSE,"out1, fill","0.1.4"
"34105","646",2023-08-22 06:00:00,-12192.3333333333,1913,14105.3333333333,907,FALSE,"out1, fill","0.1.4"
"34106","646",2023-08-22 06:15:00,-12093,1913,14006,907,FALSE,NA,"0.1.4"
"34107","646",2023-08-22 06:30:00,-11612,1913,13525,907,FALSE,NA,"0.1.4"
"34108","646",2023-08-22 06:45:00,-11135,1913,13048,907,FALSE,NA,"0.1.4"
"34109","646",2023-08-22 07:00:00,-11135,1913,13048,907,FALSE,"jump1","0.1.4"
"34110","646",2023-08-22 07:15:00,-11135,1913,13048,907,FALSE,"jump1","0.1.4"
"34111","646",2023-08-22 07:30:00,-11080,1913,12993,907,FALSE,NA,"0.1.4"
"34112","646",2023-08-22 07:45:00,-11083,1913,12996,907,FALSE,NA,"0.1.4"
"34113","646",2023-08-22 08:00:00,-11082,1913,12995,907,FALSE,NA,"0.1.4"
"34114","646",2023-08-22 08:15:00,-11070,1913,12983,907,FALSE,NA,"0.1.4"
"34115","646",2023-08-22 08:30:00,-11070,1913,12983,907,FALSE,NA,"0.1.4"
"34116","646",2023-08-22 08:45:00,-11070,1913,12983,907,FALSE,NA,"0.1.4"
"34117","646",2023-08-22 09:00:00,-11070,1913,12983,907,FALSE,NA,"0.1.4"
"34118","646",2023-08-22 09:15:00,-11070,1913,12983,907,FALSE,NA,"0.1.4"
"34119","646",2023-08-22 09:30:00,-11070,1913,12983,907,FALSE,NA,"0.1.4"
"34120","646",2023-08-22 09:45:00,-11070,1913,12983,907,FALSE,NA,"0.1.4"
"34121","646",2023-08-22 10:00:00,-11070,1913,12983,907,FALSE,NA,"0.1.4"
"34122","646",2023-08-22 10:15:00,-11070,1913,12983,907,FALSE,NA,"0.1.4"
"34123","646",2023-08-22 10:30:00,-11070,1913,12983,907,FALSE,NA,"0.1.4"
"34124","646",2023-08-22 10:45:00,-11070,1913,12983,907,FALSE,NA,"0.1.4"
"34125","646",2023-08-22 11:00:00,-11070,1913,12983,907,FALSE,NA,"0.1.4"
"34126","646",2023-08-22 11:15:00,-11070,1913,12983,907,FALSE,NA,"0.1.4"
"34127","646",2023-08-22 11:30:00,-11070,1913,12983,907,FALSE,NA,"0.1.4"
"34128","646",2023-08-22 11:45:00,-11349,1913,13262,907,FALSE,"out1, fill","0.1.4"
"34129","646",2023-08-22 12:00:00,-11628,1913,13541,907,FALSE,NA,"0.1.4"
"34130","646",2023-08-22 12:15:00,-11753,1913,13666,907,FALSE,NA,"0.1.4"
"34131","646",2023-08-22 12:30:00,-11878,1913,13791,907,FALSE,NA,"0.1.4"
"34132","646",2023-08-22 12:45:00,-11863,1913,13776,907,FALSE,NA,"0.1.4"
"34133","646",2023-08-22 13:00:00,-11863,1913,13776,907,FALSE,"jump1","0.1.4"
"34134","646",2023-08-22 13:15:00,-12072.3333333333,1913,13985.3333333333,907,FALSE,"out1, fill","0.1.4"
"34135","646",2023-08-22 13:30:00,-12281.6666666667,1913,14194.6666666667,907,FALSE,"out1, fill","0.1.4"
"34136","646",2023-08-22 13:45:00,-12491,1913,14404,907,FALSE,NA,"0.1.4"
"34137","646",2023-08-22 14:00:00,-12153,1913,14066,907,FALSE,NA,"0.1.4"
"34138","646",2023-08-22 14:15:00,-12181,1913,14094,907,FALSE,NA,"0.1.4"
"34139","646",2023-08-22 14:30:00,-12225,1913,14138,907,FALSE,NA,"0.1.4"
"34140","646",2023-08-22 14:45:00,-12028,1913,13941,907,FALSE,NA,"0.1.4"
"34141","646",2023-08-22 15:00:00,-12017,1913,13930,907,FALSE,NA,"0.1.4"
"34142","646",2023-08-22 15:15:00,-12031,1913,13944,907,FALSE,NA,"0.1.4"
"34143","646",2023-08-22 15:30:00,-12041,1913,13954,907,FALSE,NA,"0.1.4"
"34144","646",2023-08-22 15:45:00,-11931,1913,13844,907,FALSE,NA,"0.1.4"
"34145","646",2023-08-22 16:00:00,-11970,1913,13883,907,FALSE,NA,"0.1.4"
"34146","646",2023-08-22 16:15:00,-12338,1913,14251,907,FALSE,NA,"0.1.4"
"34147","646",2023-08-22 16:30:00,-12005,1913,13918,907,FALSE,NA,"0.1.4"
"34148","646",2023-08-22 16:45:00,-11894,1913,13807,907,FALSE,NA,"0.1.4"
"34149","646",2023-08-22 17:00:00,-11706,1913,13619,907,FALSE,NA,"0.1.4"
"34150","646",2023-08-22 17:15:00,-11721,1913,13634,907,FALSE,NA,"0.1.4"
"34151","646",2023-08-22 17:30:00,-11766,1913,13679,907,FALSE,NA,"0.1.4"
"34152","646",2023-08-22 17:45:00,-11739,1913,13652,907,FALSE,NA,"0.1.4"
"34153","646",2023-08-22 18:00:00,-11777,1913,13690,907,FALSE,NA,"0.1.4"
"34154","646",2023-08-22 18:15:00,-12103,1913,14016,907,FALSE,NA,"0.1.4"
"34155","646",2023-08-22 18:30:00,-12283,1913,14196,907,FALSE,NA,"0.1.4"
"34156","646",2023-08-22 18:45:00,-12532,1913,14445,907,FALSE,NA,"0.1.4"
"34157","646",2023-08-22 19:00:00,-12598,1913,14511,907,FALSE,NA,"0.1.4"
"34158","646",2023-08-22 19:15:00,-12627,1913,14540,907,FALSE,NA,"0.1.4"
"34159","646",2023-08-22 19:30:00,-12496.4,1913,14409.4,907,FALSE,"out1, fill","0.1.4"
"34160","646",2023-08-22 19:45:00,-12365.8,1913,14278.8,907,FALSE,"out1, fill","0.1.4"
"34161","646",2023-08-22 20:00:00,-12235.2,1913,14148.2,907,FALSE,"out1, fill","0.1.4"
"34162","646",2023-08-22 20:15:00,-12104.6,1913,14017.6,907,FALSE,"out1, fill","0.1.4"
"34163","646",2023-08-22 20:30:00,-11974,1913,13887,907,FALSE,NA,"0.1.4"
"34164","646",2023-08-22 20:45:00,-12050,1913,13963,907,FALSE,NA,"0.1.4"
"34165","646",2023-08-22 21:00:00,-12548,1913,14461,907,FALSE,NA,"0.1.4"
"34166","646",2023-08-22 21:15:00,-12357,1913,14270,907,FALSE,NA,"0.1.4"
"34167","646",2023-08-22 21:30:00,-12590,1913,14503,907,FALSE,NA,"0.1.4"
"34168","646",2023-08-22 21:45:00,-12864,1913,14777,907,FALSE,NA,"0.1.4"
"34169","646",2023-08-22 22:00:00,-12671,1913,14584,907,FALSE,NA,"0.1.4"
"34170","646",2023-08-22 22:15:00,-12777,1913,14690,907,FALSE,NA,"0.1.4"
"34171","646",2023-08-22 22:30:00,-12802,1913,14715,907,FALSE,NA,"0.1.4"
"34172","646",2023-08-22 22:45:00,-12939,1913,14852,907,FALSE,NA,"0.1.4"
"34173","646",2023-08-22 23:00:00,-12939,1913,14852,907,FALSE,"jump1","0.1.4"
"34174","646",2023-08-22 23:15:00,-13303,1913,15216,907,FALSE,NA,"0.1.4"
"34175","646",2023-08-22 23:30:00,-13303,1913,15216,907,FALSE,"jump1","0.1.4"
"34176","646",2023-08-22 23:45:00,-13609,1913,15522,907,FALSE,"out1, fill","0.1.4"
"34177","646",2023-08-23,-13915,1913,15828,907,FALSE,NA,"0.1.4"
"34178","646",2023-08-23 00:15:00,-14130,1913,16043,907,FALSE,NA,"0.1.4"
"34179","646",2023-08-23 00:30:00,-13987,1913,15900,907,FALSE,NA,"0.1.4"
"34180","646",2023-08-23 00:45:00,-13987,1913,15900,907,FALSE,"jump1","0.1.4"
"34181","646",2023-08-23 01:00:00,-13509,1913,15422,907,FALSE,NA,"0.1.4"
"34182","646",2023-08-23 01:15:00,-13509,1913,15422,907,FALSE,"out1, fill","0.1.4"
"34183","646",2023-08-23 01:30:00,-13509,1913,15422,907,FALSE,"jump1","0.1.4"
"34184","646",2023-08-23 01:45:00,-13670,1913,15583,907,FALSE,NA,"0.1.4"
"34185","646",2023-08-23 02:00:00,-13427,1913,15340,907,FALSE,NA,"0.1.4"
"34186","646",2023-08-23 02:15:00,-13598,1913,15511,907,FALSE,NA,"0.1.4"
"34187","646",2023-08-23 02:30:00,-13589,1913,15502,907,FALSE,NA,"0.1.4"
"34188","646",2023-08-23 02:45:00,-13770,1913,15683,907,FALSE,NA,"0.1.4"
"34189","646",2023-08-23 03:00:00,-13766,1913,15679,907,FALSE,NA,"0.1.4"
"34190","646",2023-08-23 03:15:00,-13590,1913,15503,907,FALSE,NA,"0.1.4"
"34191","646",2023-08-23 03:30:00,-13536,1913,15449,907,FALSE,NA,"0.1.4"
"34192","646",2023-08-23 03:45:00,-13801,1913,15714,907,FALSE,NA,"0.1.4"
"34193","646",2023-08-23 04:00:00,-14129,1913,16042,907,FALSE,NA,"0.1.4"
"34194","646",2023-08-23 04:15:00,-13831,1913,15744,907,FALSE,NA,"0.1.4"
"34195","646",2023-08-23 04:30:00,-13407,1913,15320,907,FALSE,NA,"0.1.4"
"34196","646",2023-08-23 04:45:00,-13606,1913,15519,907,FALSE,NA,"0.1.4"
"34197","646",2023-08-23 05:00:00,-13734,1913,15647,907,FALSE,NA,"0.1.4"
"34198","646",2023-08-23 05:15:00,-13672.75,1913,15585.75,907,FALSE,"out1, fill","0.1.4"
"34199","646",2023-08-23 05:30:00,-13611.5,1913,15524.5,907,FALSE,"out1, fill","0.1.4"
"34200","646",2023-08-23 05:45:00,-13550.25,1913,15463.25,907,FALSE,"out1, fill","0.1.4"
"34201","646",2023-08-23 06:00:00,-13489,1913,15402,907,FALSE,"out1, fill","0.1.4"
"34202","646",2023-08-23 06:15:00,-13427.75,1913,15340.75,907,FALSE,"out1, fill","0.1.4"
"34203","646",2023-08-23 06:30:00,-13366.5,1913,15279.5,907,FALSE,"out1, fill","0.1.4"
"34204","646",2023-08-23 06:45:00,-13305.25,1913,15218.25,907,FALSE,"out1, fill","0.1.4"
"34205","646",2023-08-23 07:00:00,-13244,1913,15157,907,FALSE,"out1, fill","0.1.4"
"34206","646",2023-08-23 07:15:00,-13182.75,1913,15095.75,907,FALSE,"out1, fill","0.1.4"
"34207","646",2023-08-23 07:30:00,-13121.5,1913,15034.5,907,FALSE,"out1, fill","0.1.4"
"34208","646",2023-08-23 07:45:00,-13060.25,1913,14973.25,907,FALSE,"out1, fill","0.1.4"
"34209","646",2023-08-23 08:00:00,-12999,1913,14912,907,FALSE,NA,"0.1.4"
"34210","646",2023-08-23 08:15:00,-12817,1913,14730,907,FALSE,NA,"0.1.4"
"34211","646",2023-08-23 08:30:00,-12815,1913,14728,907,FALSE,NA,"0.1.4"
"34212","646",2023-08-23 08:45:00,-12382,1913,14295,907,FALSE,NA,"0.1.4"
"34213","646",2023-08-23 09:00:00,-12323,1913,14236,907,FALSE,NA,"0.1.4"
"34214","646",2023-08-23 09:15:00,-12572,1913,14485,907,FALSE,NA,"0.1.4"
"34215","646",2023-08-23 09:30:00,-12708.5,1913,14621.5,907,FALSE,"out1, fill","0.1.4"
"34216","646",2023-08-23 09:45:00,-12845,1913,14758,907,FALSE,NA,"0.1.4"
"34217","646",2023-08-23 10:00:00,-12819,1913,14732,907,FALSE,NA,"0.1.4"
"34218","646",2023-08-23 10:15:00,-12485,1913,14398,907,FALSE,NA,"0.1.4"
"34219","646",2023-08-23 10:30:00,-12431,1913,14344,907,FALSE,NA,"0.1.4"
"34220","646",2023-08-23 10:45:00,-12845,1913,14758,907,FALSE,NA,"0.1.4"
"34221","646",2023-08-23 11:00:00,-13175,1913,15088,907,FALSE,NA,"0.1.4"
"34222","646",2023-08-23 11:15:00,-12748.5,1913,14661.5,907,FALSE,"out1, fill","0.1.4"
"34223","646",2023-08-23 11:30:00,-12322,1913,14235,907,FALSE,NA,"0.1.4"
"34224","646",2023-08-23 11:45:00,-12323,1913,14236,907,FALSE,NA,"0.1.4"
"34225","646",2023-08-23 12:00:00,-12474,1913,14387,907,FALSE,NA,"0.1.4"
"34226","646",2023-08-23 12:15:00,-12753.6666666667,1913,14666.6666666667,907,FALSE,"out1, fill","0.1.4"
"34227","646",2023-08-23 12:30:00,-13033.3333333333,1913,14946.3333333333,907,FALSE,"out1, fill","0.1.4"
"34228","646",2023-08-23 12:45:00,-13313,1913,15226,907,FALSE,NA,"0.1.4"
"34229","646",2023-08-23 13:00:00,-13484,1913,15397,907,FALSE,NA,"0.1.4"
"34230","646",2023-08-23 13:15:00,-13248,1913,15161,907,FALSE,NA,"0.1.4"
"34231","646",2023-08-23 13:30:00,-13626,1913,15539,907,FALSE,"out1, fill","0.1.4"
"34232","646",2023-08-23 13:45:00,-14004,1913,15917,907,FALSE,"out1, fill","0.1.4"
"34233","646",2023-08-23 14:00:00,-14382,1913,16295,907,FALSE,NA,"0.1.4"
"34234","646",2023-08-23 14:15:00,-14228,1913,16141,907,FALSE,NA,"0.1.4"
"34235","646",2023-08-23 14:30:00,-14230,1913,16143,907,FALSE,NA,"0.1.4"
"34236","646",2023-08-23 14:45:00,-14154,1913,16067,907,FALSE,NA,"0.1.4"
"34237","646",2023-08-23 15:00:00,-14154,1913,16067,907,FALSE,"out1, fill","0.1.4"
"34238","646",2023-08-23 15:15:00,-14154,1913,16067,907,FALSE,"jump1","0.1.4"
"34239","646",2023-08-23 15:30:00,-14126,1913,16039,907,FALSE,NA,"0.1.4"
"34240","646",2023-08-23 15:45:00,-14129,1913,16042,907,FALSE,NA,"0.1.4"
"34241","646",2023-08-23 16:00:00,-14575.5,1913,16488.5,907,FALSE,"out1, fill","0.1.4"
"34242","646",2023-08-23 16:15:00,-15022,1913,16935,907,FALSE,NA,"0.1.4"
"34243","646",2023-08-23 16:30:00,-14868,1913,16781,907,FALSE,NA,"0.1.4"
"34244","646",2023-08-23 16:45:00,-14868,1913,16781,907,FALSE,"jump1","0.1.4"
"34245","646",2023-08-23 17:00:00,-15165,1913,17078,907,FALSE,NA,"0.1.4"
"34246","646",2023-08-23 17:15:00,-14989,1913,16902,907,FALSE,NA,"0.1.4"
"34247","646",2023-08-23 17:30:00,-14709,1913,16622,907,FALSE,NA,"0.1.4"
"34248","646",2023-08-23 17:45:00,-14709,1913,16622,907,FALSE,"jump1","0.1.4"
"34249","646",2023-08-23 18:00:00,-14709,1913,16622,907,FALSE,"jump1","0.1.4"
"34250","646",2023-08-23 18:15:00,-14823,1913,16736,907,FALSE,NA,"0.1.4"
"34251","646",2023-08-23 18:30:00,-14823,1913,16736,907,FALSE,"jump1","0.1.4"
"34252","646",2023-08-23 18:45:00,-14823,1913,16736,907,FALSE,"jump1","0.1.4"
"34253","646",2023-08-23 19:00:00,-15157,1913,17070,907,FALSE,"out1, fill","0.1.4"
"34254","646",2023-08-23 19:15:00,-15491,1913,17404,907,FALSE,NA,"0.1.4"
"34255","646",2023-08-23 19:30:00,-15641,1913,17554,907,FALSE,NA,"0.1.4"
"34256","646",2023-08-23 19:45:00,-15955,1913,17868,907,FALSE,NA,"0.1.4"
"34257","646",2023-08-23 20:00:00,-15740,1913,17653,907,FALSE,NA,"0.1.4"
"34258","646",2023-08-23 20:15:00,-15758.3333333333,1913,17671.3333333333,907,FALSE,"out1, fill","0.1.4"
"34259","646",2023-08-23 20:30:00,-15776.6666666667,1913,17689.6666666667,907,FALSE,"out1, fill","0.1.4"
"34260","646",2023-08-23 20:45:00,-15795,1913,17708,907,FALSE,NA,"0.1.4"
"34261","646",2023-08-23 21:00:00,-15788,1913,17701,907,FALSE,NA,"0.1.4"
"34262","646",2023-08-23 21:15:00,-15651,1913,17564,907,FALSE,NA,"0.1.4"
"34263","646",2023-08-23 21:30:00,-15651,1913,17564,907,FALSE,"jump1","0.1.4"
"34264","646",2023-08-23 21:45:00,-15648,1913,17561,907,FALSE,NA,"0.1.4"
"34265","646",2023-08-23 22:00:00,-15691,1913,17604,907,FALSE,"out1, fill","0.1.4"
"34266","646",2023-08-23 22:15:00,-15734,1913,17647,907,FALSE,NA,"0.1.4"
"34267","646",2023-08-23 22:30:00,-15402,1913,17315,907,FALSE,NA,"0.1.4"
"34268","646",2023-08-23 22:45:00,-15401,1913,17314,907,FALSE,NA,"0.1.4"
"34269","646",2023-08-23 23:00:00,-15484,1913,17397,907,FALSE,"out1, fill","0.1.4"
"34270","646",2023-08-23 23:15:00,-15567,1913,17480,907,FALSE,"out1, fill","0.1.4"
"34271","646",2023-08-23 23:30:00,-15650,1913,17563,907,FALSE,"out1, fill","0.1.4"
"34272","646",2023-08-23 23:45:00,-15733,1913,17646,907,FALSE,"out1, fill","0.1.4"
"34273","646",2023-08-24,-15816,1913,17729,907,FALSE,"out1, fill","0.1.4"
"34274","646",2023-08-24 00:15:00,-15899,1913,17812,907,FALSE,"out1, fill","0.1.4"
"34275","646",2023-08-24 00:30:00,-15982,1913,17895,907,FALSE,"out1, fill","0.1.4"
"34276","646",2023-08-24 00:45:00,-16065,1913,17978,907,FALSE,"out1, fill","0.1.4"
"34277","646",2023-08-24 01:00:00,-16148,1913,18061,907,FALSE,"out1, fill","0.1.4"
"34278","646",2023-08-24 01:15:00,-16231,1913,18144,907,FALSE,NA,"0.1.4"
"34279","646",2023-08-24 01:30:00,-16449,1913,18362,907,FALSE,NA,"0.1.4"
"34280","646",2023-08-24 01:45:00,-16542,1913,18455,907,FALSE,NA,"0.1.4"
"34281","646",2023-08-24 02:00:00,-16599,1913,18512,907,FALSE,NA,"0.1.4"
"34282","646",2023-08-24 02:15:00,-16500,1913,18413,907,FALSE,NA,"0.1.4"
"34283","646",2023-08-24 02:30:00,-16482.3333333333,1913,18395.3333333333,907,FALSE,"out1, fill","0.1.4"
"34284","646",2023-08-24 02:45:00,-16464.6666666667,1913,18377.6666666667,907,FALSE,"out1, fill","0.1.4"
"34285","646",2023-08-24 03:00:00,-16447,1913,18360,907,FALSE,NA,"0.1.4"
"34286","646",2023-08-24 03:15:00,-16826,1913,18739,907,FALSE,NA,"0.1.4"
"34287","646",2023-08-24 03:30:00,-16375,1913,18288,907,FALSE,NA,"0.1.4"
"34288","646",2023-08-24 03:45:00,-16411,1913,18324,907,FALSE,NA,"0.1.4"
"34289","646",2023-08-24 04:00:00,-16252,1913,18165,907,FALSE,NA,"0.1.4"
"34290","646",2023-08-24 04:15:00,-16252,1913,18165,907,FALSE,"jump1","0.1.4"
"34291","646",2023-08-24 04:30:00,-16252,1913,18165,907,FALSE,"jump1","0.1.4"
"34292","646",2023-08-24 04:45:00,-16398,1913,18311,907,FALSE,"out1, fill","0.1.4"
"34293","646",2023-08-24 05:00:00,-16544,1913,18457,907,FALSE,NA,"0.1.4"
"34294","646",2023-08-24 05:15:00,-16117,1913,18030,907,FALSE,NA,"0.1.4"
"34295","646",2023-08-24 05:30:00,-15710,1913,17623,907,FALSE,NA,"0.1.4"
"34296","646",2023-08-24 05:45:00,-15862,1913,17775,907,FALSE,"out1, fill","0.1.4"
"34297","646",2023-08-24 06:00:00,-16014,1913,17927,907,FALSE,"out1, fill","0.1.4"
"34298","646",2023-08-24 06:15:00,-16166,1913,18079,907,FALSE,"out1, fill","0.1.4"
"34299","646",2023-08-24 06:30:00,-16318,1913,18231,907,FALSE,"out1, fill","0.1.4"
"34300","646",2023-08-24 06:45:00,-16470,1913,18383,907,FALSE,"out1, fill","0.1.4"
"34301","646",2023-08-24 07:00:00,-16622,1913,18535,907,FALSE,NA,"0.1.4"
"34302","646",2023-08-24 07:15:00,-16622,1913,18535,907,FALSE,"jump1","0.1.4"
"34303","646",2023-08-24 07:30:00,-16648,1913,18561,907,FALSE,NA,"0.1.4"
"34304","646",2023-08-24 07:45:00,-16648,1913,18561,907,FALSE,"jump1","0.1.4"
"34305","646",2023-08-24 08:00:00,-16382,1913,18295,907,FALSE,NA,"0.1.4"
"34306","646",2023-08-24 08:15:00,-16655,1913,18568,907,FALSE,NA,"0.1.4"
"34307","646",2023-08-24 08:30:00,-16415,1913,18328,907,FALSE,NA,"0.1.4"
"34308","646",2023-08-24 08:45:00,-16382,1913,18295,907,FALSE,"out1, fill","0.1.4"
"34309","646",2023-08-24 09:00:00,-16349,1913,18262,907,FALSE,NA,"0.1.4"
"34310","646",2023-08-24 09:15:00,-15915,1913,17828,907,FALSE,NA,"0.1.4"
"34311","646",2023-08-24 09:30:00,-16228,1913,18141,907,FALSE,NA,"0.1.4"
"34312","646",2023-08-24 09:45:00,-16309,1913,18222,907,FALSE,NA,"0.1.4"
"34313","646",2023-08-24 10:00:00,-16279,1913,18192,907,FALSE,NA,"0.1.4"
"34314","646",2023-08-24 10:15:00,-16477,1913,18390,907,FALSE,NA,"0.1.4"
"34315","646",2023-08-24 10:30:00,-16507.6666666667,1913,18420.6666666667,907,FALSE,"out1, fill","0.1.4"
"34316","646",2023-08-24 10:45:00,-16538.3333333333,1913,18451.3333333333,907,FALSE,"out1, fill","0.1.4"
"34317","646",2023-08-24 11:00:00,-16569,1913,18482,907,FALSE,NA,"0.1.4"
"34318","646",2023-08-24 11:15:00,-16803,1913,18716,907,FALSE,NA,"0.1.4"
"34319","646",2023-08-24 11:30:00,-16424,1913,18337,907,FALSE,NA,"0.1.4"
"34320","646",2023-08-24 11:45:00,-15968.5,1913,17881.5,907,FALSE,"out1, fill","0.1.4"
"34321","646",2023-08-24 12:00:00,-15513,1913,17426,907,FALSE,NA,"0.1.4"
"34322","646",2023-08-24 12:15:00,-15469,1913,17382,907,FALSE,NA,"0.1.4"
"34323","646",2023-08-24 12:30:00,-15960,1913,17873,907,FALSE,NA,"0.1.4"
"34324","646",2023-08-24 12:45:00,-16387,1913,18300,907,FALSE,NA,"0.1.4"
"34325","646",2023-08-24 13:00:00,-16016.5,1913,17929.5,907,FALSE,"out1, fill","0.1.4"
"34326","646",2023-08-24 13:15:00,-15646,1913,17559,907,FALSE,NA,"0.1.4"
"34327","646",2023-08-24 13:30:00,-15977,1913,17890,907,FALSE,NA,"0.1.4"
"34328","646",2023-08-24 13:45:00,-15977,1913,17890,907,FALSE,"jump1","0.1.4"
"34329","646",2023-08-24 14:00:00,-16001,1913,17914,907,FALSE,NA,"0.1.4"
"34330","646",2023-08-24 14:15:00,-16093,1913,18006,907,FALSE,NA,"0.1.4"
"34331","646",2023-08-24 14:30:00,-16386,1913,18299,907,FALSE,NA,"0.1.4"
"34332","646",2023-08-24 14:45:00,-16426,1913,18339,907,FALSE,NA,"0.1.4"
"34333","646",2023-08-24 15:00:00,-16174,1913,18087,907,FALSE,NA,"0.1.4"
"34334","646",2023-08-24 15:15:00,-16098,1913,18011,907,FALSE,NA,"0.1.4"
"34335","646",2023-08-24 15:30:00,-16064,1913,17977,907,FALSE,NA,"0.1.4"
"34336","646",2023-08-24 15:45:00,-16334,1913,18247,907,FALSE,NA,"0.1.4"
"34337","646",2023-08-24 16:00:00,-16334,1913,18247,907,FALSE,"jump1","0.1.4"
"34338","646",2023-08-24 16:15:00,-16334,1913,18247,907,FALSE,"jump1","0.1.4"
"34339","646",2023-08-24 16:30:00,-16334,1913,18247,907,FALSE,"jump1","0.1.4"
"34340","646",2023-08-24 16:45:00,-16588,1913,18501,907,FALSE,NA,"0.1.4"
"34341","646",2023-08-24 17:00:00,-16700,1913,18613,907,FALSE,NA,"0.1.4"
"34342","646",2023-08-24 17:15:00,-16381.5,1913,18294.5,907,FALSE,"out1, fill","0.1.4"
"34343","646",2023-08-24 17:30:00,-16063,1913,17976,907,FALSE,"out1, fill","0.1.4"
"34344","646",2023-08-24 17:45:00,-15744.5,1913,17657.5,907,FALSE,"out1, fill","0.1.4"
"34345","646",2023-08-24 18:00:00,-15426,1913,17339,907,FALSE,NA,"0.1.4"
"34346","646",2023-08-24 18:15:00,-15652,1913,17565,907,FALSE,NA,"0.1.4"
"34347","646",2023-08-24 18:30:00,-15582,1913,17495,907,FALSE,NA,"0.1.4"
"34348","646",2023-08-24 18:45:00,-15582,1913,17495,907,FALSE,"jump1","0.1.4"
"34349","646",2023-08-24 19:00:00,-15480,1913,17393,907,FALSE,NA,"0.1.4"
"34350","646",2023-08-24 19:15:00,-15720,1913,17633,907,FALSE,NA,"0.1.4"
"34351","646",2023-08-24 19:30:00,-15720,1913,17633,907,FALSE,"jump1","0.1.4"
"34352","646",2023-08-24 19:45:00,-15720,1913,17633,907,FALSE,"jump1","0.1.4"
"34353","646",2023-08-24 20:00:00,-15720,1913,17633,907,FALSE,"jump1","0.1.4"
"34354","646",2023-08-24 20:15:00,-15961,1913,17874,907,FALSE,NA,"0.1.4"
"34355","646",2023-08-24 20:30:00,-15961,1913,17874,907,FALSE,"jump1","0.1.4"
"34356","646",2023-08-24 20:45:00,-15911,1913,17824,907,FALSE,NA,"0.1.4"
"34357","646",2023-08-24 21:00:00,-15878,1913,17791,907,FALSE,NA,"0.1.4"
"34358","646",2023-08-24 21:15:00,-15888,1913,17801,907,FALSE,NA,"0.1.4"
"34359","646",2023-08-24 21:30:00,-15869,1913,17782,907,FALSE,NA,"0.1.4"
"34360","646",2023-08-24 21:45:00,-15869,1913,17782,907,FALSE,NA,"0.1.4"
"34361","646",2023-08-24 22:00:00,-15870,1913,17783,907,FALSE,NA,"0.1.4"
"34362","646",2023-08-24 22:15:00,-15860,1913,17773,907,FALSE,NA,"0.1.4"
"34363","646",2023-08-24 22:30:00,-15862,1913,17775,907,FALSE,NA,"0.1.4"
"34364","646",2023-08-24 22:45:00,-15862,1913,17775,907,FALSE,"jump1","0.1.4"
"34365","646",2023-08-24 23:00:00,-15972,1913,17885,907,FALSE,NA,"0.1.4"
"34366","646",2023-08-24 23:15:00,-15931,1913,17844,907,FALSE,NA,"0.1.4"
"34367","646",2023-08-24 23:30:00,-15967,1913,17880,907,FALSE,NA,"0.1.4"
"34368","646",2023-08-24 23:45:00,-15903,1913,17816,907,FALSE,NA,"0.1.4"
"34369","646",2023-08-25,-15903,1913,17816,907,FALSE,"jump1","0.1.4"
"34370","646",2023-08-25 00:15:00,-15936,1913,17849,907,FALSE,NA,"0.1.4"
"34371","646",2023-08-25 00:30:00,-15936,1913,17849,907,FALSE,NA,"0.1.4"
"34372","646",2023-08-25 00:45:00,-16114.7142857143,1913,18027.7142857143,907,FALSE,"out1, fill","0.1.4"
"34373","646",2023-08-25 01:00:00,-16293.4285714286,1913,18206.4285714286,907,FALSE,"out1, fill","0.1.4"
"34374","646",2023-08-25 01:15:00,-16472.1428571429,1913,18385.1428571429,907,FALSE,"out1, fill","0.1.4"
"34375","646",2023-08-25 01:30:00,-16650.8571428571,1913,18563.8571428571,907,FALSE,"out1, fill","0.1.4"
"34376","646",2023-08-25 01:45:00,-16829.5714285714,1913,18742.5714285714,907,FALSE,"out1, fill","0.1.4"
"34377","646",2023-08-25 02:00:00,-17008.2857142857,1913,18921.2857142857,907,FALSE,"out1, fill","0.1.4"
"34378","646",2023-08-25 02:15:00,-17187,1913,19100,907,FALSE,NA,"0.1.4"
"34379","646",2023-08-25 02:30:00,-16826,1913,18739,907,FALSE,NA,"0.1.4"
"34380","646",2023-08-25 02:45:00,-16845,1913,18758,907,FALSE,NA,"0.1.4"
"34381","646",2023-08-25 03:00:00,-16845,1913,18758,907,FALSE,"jump1","0.1.4"
"34382","646",2023-08-25 03:15:00,-16507,1913,18420,907,FALSE,NA,"0.1.4"
"34383","646",2023-08-25 03:30:00,-16501,1913,18414,907,FALSE,NA,"0.1.4"
"34384","646",2023-08-25 03:45:00,-16495,1913,18408,907,FALSE,NA,"0.1.4"
"34385","646",2023-08-25 04:00:00,-16958.5,1913,18871.5,907,FALSE,"out1, fill","0.1.4"
"34386","646",2023-08-25 04:15:00,-17422,1913,19335,907,FALSE,NA,"0.1.4"
"34387","646",2023-08-25 04:30:00,-17363,1913,19276,907,FALSE,NA,"0.1.4"
"34388","646",2023-08-25 04:45:00,-17501,1913,19414,907,FALSE,NA,"0.1.4"
"34389","646",2023-08-25 05:00:00,-17373,1913,19286,907,FALSE,NA,"0.1.4"
"34390","646",2023-08-25 05:15:00,-17178,1913,19091,907,FALSE,NA,"0.1.4"
"34391","646",2023-08-25 05:30:00,-17612,1913,19525,907,FALSE,NA,"0.1.4"
"34392","646",2023-08-25 05:45:00,-17459,1913,19372,907,FALSE,NA,"0.1.4"
"34393","646",2023-08-25 06:00:00,-17651,1913,19564,907,FALSE,NA,"0.1.4"
"34394","646",2023-08-25 06:15:00,-17431,1913,19344,907,FALSE,NA,"0.1.4"
"34395","646",2023-08-25 06:30:00,-17015,1913,18928,907,FALSE,NA,"0.1.4"
"34396","646",2023-08-25 06:45:00,-16657,1913,18570,907,FALSE,NA,"0.1.4"
"34397","646",2023-08-25 07:00:00,-16936,1913,18849,907,FALSE,NA,"0.1.4"
"34398","646",2023-08-25 07:15:00,-16503,1913,18416,907,FALSE,NA,"0.1.4"
"34399","646",2023-08-25 07:30:00,-16514,1913,18427,907,FALSE,NA,"0.1.4"
"34400","646",2023-08-25 07:45:00,-16519,1913,18432,907,FALSE,NA,"0.1.4"
"34401","646",2023-08-25 08:00:00,-16513.6,1913,18426.6,907,FALSE,"out1, fill","0.1.4"
"34402","646",2023-08-25 08:15:00,-16508.2,1913,18421.2,907,FALSE,"out1, fill","0.1.4"
"34403","646",2023-08-25 08:30:00,-16502.8,1913,18415.8,907,FALSE,"out1, fill","0.1.4"
"34404","646",2023-08-25 08:45:00,-16497.4,1913,18410.4,907,FALSE,"out1, fill","0.1.4"
"34405","646",2023-08-25 09:00:00,-16492,1913,18405,907,FALSE,NA,"0.1.4"
"34406","646",2023-08-25 09:15:00,-16597,1913,18510,907,FALSE,NA,"0.1.4"
"34407","646",2023-08-25 09:30:00,-16610,1913,18523,907,FALSE,NA,"0.1.4"
"34408","646",2023-08-25 09:45:00,-16519,1913,18432,907,FALSE,NA,"0.1.4"
"34409","646",2023-08-25 10:00:00,-16916,1913,18829,907,FALSE,NA,"0.1.4"
"34410","646",2023-08-25 10:15:00,-16486,1913,18399,907,FALSE,NA,"0.1.4"
"34411","646",2023-08-25 10:30:00,-16973,1913,18886,907,FALSE,NA,"0.1.4"
"34412","646",2023-08-25 10:45:00,-17371,1913,19284,907,FALSE,NA,"0.1.4"
"34413","646",2023-08-25 11:00:00,-17684,1913,19597,907,FALSE,NA,"0.1.4"
"34414","646",2023-08-25 11:15:00,-17556,1913,19469,907,FALSE,NA,"0.1.4"
"34415","646",2023-08-25 11:30:00,-17453,1913,19366,907,FALSE,NA,"0.1.4"
"34416","646",2023-08-25 11:45:00,-17453,1913,19366,907,FALSE,"jump1","0.1.4"
"34417","646",2023-08-25 12:00:00,-17594,1913,19507,907,FALSE,NA,"0.1.4"
"34418","646",2023-08-25 12:15:00,-17326.5,1913,19239.5,907,FALSE,"out1, fill","0.1.4"
"34419","646",2023-08-25 12:30:00,-17059,1913,18972,907,FALSE,"out1, fill","0.1.4"
"34420","646",2023-08-25 12:45:00,-16791.5,1913,18704.5,907,FALSE,"out1, fill","0.1.4"
"34421","646",2023-08-25 13:00:00,-16524,1913,18437,907,FALSE,"out1, fill","0.1.4"
"34422","646",2023-08-25 13:15:00,-16256.5,1913,18169.5,907,FALSE,"out1, fill","0.1.4"
"34423","646",2023-08-25 13:30:00,-15989,1913,17902,907,FALSE,NA,"0.1.4"
"34424","646",2023-08-25 13:45:00,-16000,1913,17913,907,FALSE,NA,"0.1.4"
"34425","646",2023-08-25 14:00:00,-16009,1913,17922,907,FALSE,NA,"0.1.4"
"34426","646",2023-08-25 14:15:00,-16087,1913,18000,907,FALSE,NA,"0.1.4"
"34427","646",2023-08-25 14:30:00,-15994,1913,17907,907,FALSE,NA,"0.1.4"
"34428","646",2023-08-25 14:45:00,-15992,1913,17905,907,FALSE,NA,"0.1.4"
"34429","646",2023-08-25 15:00:00,-15991,1913,17904,907,FALSE,NA,"0.1.4"
"34430","646",2023-08-25 15:15:00,-15992,1913,17905,907,FALSE,NA,"0.1.4"
"34431","646",2023-08-25 15:30:00,-15989,1913,17902,907,FALSE,NA,"0.1.4"
"34432","646",2023-08-25 15:45:00,-15992,1913,17905,907,FALSE,NA,"0.1.4"
"34433","646",2023-08-25 16:00:00,-15995.6666666667,1913,17908.6666666667,907,FALSE,"out1, fill","0.1.4"
"34434","646",2023-08-25 16:15:00,-15999.3333333333,1913,17912.3333333333,907,FALSE,"out1, fill","0.1.4"
"34435","646",2023-08-25 16:30:00,-16003,1913,17916,907,FALSE,NA,"0.1.4"
"34436","646",2023-08-25 16:45:00,-15995,1913,17908,907,FALSE,NA,"0.1.4"
"34437","646",2023-08-25 17:00:00,-16290,1913,18203,907,FALSE,NA,"0.1.4"
"34438","646",2023-08-25 17:15:00,-16014,1913,17927,907,FALSE,NA,"0.1.4"
"34439","646",2023-08-25 17:30:00,-16223,1913,18136,907,FALSE,"out1, fill","0.1.4"
"34440","646",2023-08-25 17:45:00,-16432,1913,18345,907,FALSE,"out1, fill","0.1.4"
"34441","646",2023-08-25 18:00:00,-16641,1913,18554,907,FALSE,NA,"0.1.4"
"34442","646",2023-08-25 18:15:00,-16641,1913,18554,907,FALSE,"jump1","0.1.4"
"34443","646",2023-08-25 18:30:00,-16641,1913,18554,907,FALSE,"jump1","0.1.4"
"34444","646",2023-08-25 18:45:00,-16250.5,1913,18163.5,907,FALSE,"out1, fill","0.1.4"
"34445","646",2023-08-25 19:00:00,-15860,1913,17773,907,FALSE,NA,"0.1.4"
"34446","646",2023-08-25 19:15:00,-15865,1913,17778,907,FALSE,NA,"0.1.4"
"34447","646",2023-08-25 19:30:00,-15919,1913,17832,907,FALSE,NA,"0.1.4"
"34448","646",2023-08-25 19:45:00,-15903,1913,17816,907,FALSE,NA,"0.1.4"
"34449","646",2023-08-25 20:00:00,-15873,1913,17786,907,FALSE,NA,"0.1.4"
"34450","646",2023-08-25 20:15:00,-15903,1913,17816,907,FALSE,NA,"0.1.4"
"34451","646",2023-08-25 20:30:00,-16302,1913,18215,907,FALSE,NA,"0.1.4"
"34452","646",2023-08-25 20:45:00,-15890,1913,17803,907,FALSE,NA,"0.1.4"
"34453","646",2023-08-25 21:00:00,-15890.8333333333,1913,17803.8333333333,907,FALSE,"out1, fill","0.1.4"
"34454","646",2023-08-25 21:15:00,-15891.6666666667,1913,17804.6666666667,907,FALSE,"out1, fill","0.1.4"
"34455","646",2023-08-25 21:30:00,-15892.5,1913,17805.5,907,FALSE,"out1, fill","0.1.4"
"34456","646",2023-08-25 21:45:00,-15893.3333333333,1913,17806.3333333333,907,FALSE,"out1, fill","0.1.4"
"34457","646",2023-08-25 22:00:00,-15894.1666666667,1913,17807.1666666667,907,FALSE,"out1, fill","0.1.4"
"34458","646",2023-08-25 22:15:00,-15895,1913,17808,907,FALSE,NA,"0.1.4"
"34459","646",2023-08-25 22:30:00,-16162,1913,18075,907,FALSE,NA,"0.1.4"
"34460","646",2023-08-25 22:45:00,-16334,1913,18247,907,FALSE,NA,"0.1.4"
"34461","646",2023-08-25 23:00:00,-15990,1913,17903,907,FALSE,NA,"0.1.4"
"34462","646",2023-08-25 23:15:00,-15899,1913,17812,907,FALSE,NA,"0.1.4"
"34463","646",2023-08-25 23:30:00,-15889,1913,17802,907,FALSE,NA,"0.1.4"
"34464","646",2023-08-25 23:45:00,-15880,1913,17793,907,FALSE,NA,"0.1.4"
"34465","646",2023-08-26,-16380,1913,18293,907,FALSE,NA,"0.1.4"
"34466","646",2023-08-26 00:15:00,-15889,1913,17802,907,FALSE,NA,"0.1.4"
"34467","646",2023-08-26 00:30:00,-16338,1913,18251,907,FALSE,NA,"0.1.4"
"34468","646",2023-08-26 00:45:00,-16473,1913,18386,907,FALSE,NA,"0.1.4"
"34469","646",2023-08-26 01:00:00,-16864,1913,18777,907,FALSE,NA,"0.1.4"
"34470","646",2023-08-26 01:15:00,-16592,1913,18505,907,FALSE,NA,"0.1.4"
"34471","646",2023-08-26 01:30:00,-16801,1913,18714,907,FALSE,NA,"0.1.4"
"34472","646",2023-08-26 01:45:00,-16763,1913,18676,907,FALSE,NA,"0.1.4"
"34473","646",2023-08-26 02:00:00,-16714,1913,18627,907,FALSE,NA,"0.1.4"
"34474","646",2023-08-26 02:15:00,-16984,1913,18897,907,FALSE,NA,"0.1.4"
"34475","646",2023-08-26 02:30:00,-17056,1913,18969,907,FALSE,NA,"0.1.4"
"34476","646",2023-08-26 02:45:00,-17052,1913,18965,907,FALSE,NA,"0.1.4"
"34477","646",2023-08-26 03:00:00,-17061.8,1913,18974.8,907,FALSE,"out1, fill","0.1.4"
"34478","646",2023-08-26 03:15:00,-17071.6,1913,18984.6,907,FALSE,"out1, fill","0.1.4"
"34479","646",2023-08-26 03:30:00,-17081.4,1913,18994.4,907,FALSE,"out1, fill","0.1.4"
"34480","646",2023-08-26 03:45:00,-17091.2,1913,19004.2,907,FALSE,"out1, fill","0.1.4"
"34481","646",2023-08-26 04:00:00,-17101,1913,19014,907,FALSE,NA,"0.1.4"
"34482","646",2023-08-26 04:15:00,-16744,1913,18657,907,FALSE,NA,"0.1.4"
"34483","646",2023-08-26 04:30:00,-17147,1913,19060,907,FALSE,NA,"0.1.4"
"34484","646",2023-08-26 04:45:00,-17107,1913,19020,907,FALSE,NA,"0.1.4"
"34485","646",2023-08-26 05:00:00,-17157,1913,19070,907,FALSE,NA,"0.1.4"
"34486","646",2023-08-26 05:15:00,-17059,1913,18972,907,FALSE,NA,"0.1.4"
"34487","646",2023-08-26 05:30:00,-17230,1913,19143,907,FALSE,NA,"0.1.4"
"34488","646",2023-08-26 05:45:00,-17090,1913,19003,907,FALSE,NA,"0.1.4"
"34489","646",2023-08-26 06:00:00,-17228,1913,19141,907,FALSE,NA,"0.1.4"
"34490","646",2023-08-26 06:15:00,-16812,1913,18725,907,FALSE,NA,"0.1.4"
"34491","646",2023-08-26 06:30:00,-17230,1913,19143,907,FALSE,NA,"0.1.4"
"34492","646",2023-08-26 06:45:00,-17056,1913,18969,907,FALSE,NA,"0.1.4"
"34493","646",2023-08-26 07:00:00,-17299,1913,19212,907,FALSE,NA,"0.1.4"
"34494","646",2023-08-26 07:15:00,-17225,1913,19138,907,FALSE,NA,"0.1.4"
"34495","646",2023-08-26 07:30:00,-17305,1913,19218,907,FALSE,NA,"0.1.4"
"34496","646",2023-08-26 07:45:00,-17313,1913,19226,907,FALSE,"out1, fill","0.1.4"
"34497","646",2023-08-26 08:00:00,-17321,1913,19234,907,FALSE,"out1, fill","0.1.4"
"34498","646",2023-08-26 08:15:00,-17329,1913,19242,907,FALSE,NA,"0.1.4"
"34499","646",2023-08-26 08:30:00,-17402,1913,19315,907,FALSE,NA,"0.1.4"
"34500","646",2023-08-26 08:45:00,-17313,1913,19226,907,FALSE,NA,"0.1.4"
"34501","646",2023-08-26 09:00:00,-17311,1913,19224,907,FALSE,NA,"0.1.4"
"34502","646",2023-08-26 09:15:00,-17330,1913,19243,907,FALSE,NA,"0.1.4"
"34503","646",2023-08-26 09:30:00,-17660,1913,19573,907,FALSE,NA,"0.1.4"
"34504","646",2023-08-26 09:45:00,-17508,1913,19421,907,FALSE,NA,"0.1.4"
"34505","646",2023-08-26 10:00:00,-17476,1913,19389,907,FALSE,NA,"0.1.4"
"34506","646",2023-08-26 10:15:00,-17126,1913,19039,907,FALSE,NA,"0.1.4"
"34507","646",2023-08-26 10:30:00,-17126,1913,19039,907,FALSE,"jump1","0.1.4"
"34508","646",2023-08-26 10:45:00,-16935,1913,18848,907,FALSE,NA,"0.1.4"
"34509","646",2023-08-26 11:00:00,-16764.3333333333,1913,18677.3333333333,907,FALSE,"out1, fill","0.1.4"
"34510","646",2023-08-26 11:15:00,-16593.6666666667,1913,18506.6666666667,907,FALSE,"out1, fill","0.1.4"
"34511","646",2023-08-26 11:30:00,-16423,1913,18336,907,FALSE,NA,"0.1.4"
"34512","646",2023-08-26 11:45:00,-15947,1913,17860,907,FALSE,NA,"0.1.4"
"34513","646",2023-08-26 12:00:00,-16403,1913,18316,907,FALSE,NA,"0.1.4"
"34514","646",2023-08-26 12:15:00,-16710,1913,18623,907,FALSE,NA,"0.1.4"
"34515","646",2023-08-26 12:30:00,-16429,1913,18342,907,FALSE,NA,"0.1.4"
"34516","646",2023-08-26 12:45:00,-16297,1913,18210,907,FALSE,NA,"0.1.4"
"34517","646",2023-08-26 13:00:00,-16196.3333333333,1913,18109.3333333333,907,FALSE,"out1, fill","0.1.4"
"34518","646",2023-08-26 13:15:00,-16095.6666666667,1913,18008.6666666667,907,FALSE,"out1, fill","0.1.4"
"34519","646",2023-08-26 13:30:00,-15995,1913,17908,907,FALSE,NA,"0.1.4"
"34520","646",2023-08-26 13:45:00,-16219,1913,18132,907,FALSE,NA,"0.1.4"
"34521","646",2023-08-26 14:00:00,-15997,1913,17910,907,FALSE,NA,"0.1.4"
"34522","646",2023-08-26 14:15:00,-15997,1913,17910,907,FALSE,"jump1","0.1.4"
"34523","646",2023-08-26 14:30:00,-15997,1913,17910,907,FALSE,"jump1","0.1.4"
"34524","646",2023-08-26 14:45:00,-16108,1913,18021,907,FALSE,NA,"0.1.4"
"34525","646",2023-08-26 15:00:00,-16229,1913,18142,907,FALSE,NA,"0.1.4"
"34526","646",2023-08-26 15:15:00,-15948,1913,17861,907,FALSE,NA,"0.1.4"
"34527","646",2023-08-26 15:30:00,-16083,1913,17996,907,FALSE,NA,"0.1.4"
"34528","646",2023-08-26 15:45:00,-16171,1913,18084,907,FALSE,NA,"0.1.4"
"34529","646",2023-08-26 16:00:00,-15818,1913,17731,907,FALSE,NA,"0.1.4"
"34530","646",2023-08-26 16:15:00,-15392,1913,17305,907,FALSE,NA,"0.1.4"
"34531","646",2023-08-26 16:30:00,-15130,1913,17043,907,FALSE,NA,"0.1.4"
"34532","646",2023-08-26 16:45:00,-15303.3333333333,1913,17216.3333333333,907,FALSE,"out1, fill","0.1.4"
"34533","646",2023-08-26 17:00:00,-15476.6666666667,1913,17389.6666666667,907,FALSE,"out1, fill","0.1.4"
"34534","646",2023-08-26 17:15:00,-15650,1913,17563,907,FALSE,NA,"0.1.4"
"34535","646",2023-08-26 17:30:00,-15650,1913,17563,907,FALSE,"jump1","0.1.4"
"34536","646",2023-08-26 17:45:00,-15364,1913,17277,907,FALSE,NA,"0.1.4"
"34537","646",2023-08-26 18:00:00,-15632,1913,17545,907,FALSE,NA,"0.1.4"
"34538","646",2023-08-26 18:15:00,-15205.5,1913,17118.5,907,FALSE,"out1, fill","0.1.4"
"34539","646",2023-08-26 18:30:00,-14779,1913,16692,907,FALSE,NA,"0.1.4"
"34540","646",2023-08-26 18:45:00,-14835,1913,16748,907,FALSE,NA,"0.1.4"
"34541","646",2023-08-26 19:00:00,-14739,1913,16652,907,FALSE,NA,"0.1.4"
"34542","646",2023-08-26 19:15:00,-14765,1913,16678,907,FALSE,NA,"0.1.4"
"34543","646",2023-08-26 19:30:00,-14752,1913,16665,907,FALSE,NA,"0.1.4"
"34544","646",2023-08-26 19:45:00,-14709,1913,16622,907,FALSE,NA,"0.1.4"
"34545","646",2023-08-26 20:00:00,-14697,1913,16610,907,FALSE,NA,"0.1.4"
"34546","646",2023-08-26 20:15:00,-14743,1913,16656,907,FALSE,NA,"0.1.4"
"34547","646",2023-08-26 20:30:00,-14553,1913,16466,907,FALSE,NA,"0.1.4"
"34548","646",2023-08-26 20:45:00,-14691,1913,16604,907,FALSE,NA,"0.1.4"
"34549","646",2023-08-26 21:00:00,-14933.25,1913,16846.25,907,FALSE,"out1, fill","0.1.4"
"34550","646",2023-08-26 21:15:00,-15175.5,1913,17088.5,907,FALSE,"out1, fill","0.1.4"
"34551","646",2023-08-26 21:30:00,-15417.75,1913,17330.75,907,FALSE,"out1, fill","0.1.4"
"34552","646",2023-08-26 21:45:00,-15660,1913,17573,907,FALSE,NA,"0.1.4"
"34553","646",2023-08-26 22:00:00,-15469,1913,17382,907,FALSE,NA,"0.1.4"
"34554","646",2023-08-26 22:15:00,-15153,1913,17066,907,FALSE,NA,"0.1.4"
"34555","646",2023-08-26 22:30:00,-15261,1913,17174,907,FALSE,NA,"0.1.4"
"34556","646",2023-08-26 22:45:00,-15261,1913,17174,907,FALSE,"jump1","0.1.4"
"34557","646",2023-08-26 23:00:00,-15252,1913,17165,907,FALSE,NA,"0.1.4"
"34558","646",2023-08-26 23:15:00,-15330,1913,17243,907,FALSE,NA,"0.1.4"
"34559","646",2023-08-26 23:30:00,-15604.5,1913,17517.5,907,FALSE,"out1, fill","0.1.4"
"34560","646",2023-08-26 23:45:00,-15879,1913,17792,907,FALSE,NA,"0.1.4"
"34561","646",2023-08-27,-15779,1913,17692,907,FALSE,NA,"0.1.4"
"34562","646",2023-08-27 00:15:00,-15476,1913,17389,907,FALSE,NA,"0.1.4"
"34563","646",2023-08-27 00:30:00,-15278,1913,17191,907,FALSE,NA,"0.1.4"
"34564","646",2023-08-27 00:45:00,-15316,1913,17229,907,FALSE,NA,"0.1.4"
"34565","646",2023-08-27 01:00:00,-15444,1913,17357,907,FALSE,NA,"0.1.4"
"34566","646",2023-08-27 01:15:00,-15438,1913,17351,907,FALSE,NA,"0.1.4"
"34567","646",2023-08-27 01:30:00,-15447,1913,17360,907,FALSE,NA,"0.1.4"
"34568","646",2023-08-27 01:45:00,-15780,1913,17693,907,FALSE,"out1, fill","0.1.4"
"34569","646",2023-08-27 02:00:00,-16113,1913,18026,907,FALSE,NA,"0.1.4"
"34570","646",2023-08-27 02:15:00,-16497,1913,18410,907,FALSE,NA,"0.1.4"
"34571","646",2023-08-27 02:30:00,-16271,1913,18184,907,FALSE,NA,"0.1.4"
"34572","646",2023-08-27 02:45:00,-16501,1913,18414,907,FALSE,NA,"0.1.4"
"34573","646",2023-08-27 03:00:00,-16452,1913,18365,907,FALSE,NA,"0.1.4"
"34574","646",2023-08-27 03:15:00,-16690,1913,18603,907,FALSE,NA,"0.1.4"
"34575","646",2023-08-27 03:30:00,-16690,1913,18603,907,FALSE,"jump1","0.1.4"
"34576","646",2023-08-27 03:45:00,-16690,1913,18603,907,FALSE,"jump1","0.1.4"
"34577","646",2023-08-27 04:00:00,-16690,1913,18603,907,FALSE,"jump1","0.1.4"
"34578","646",2023-08-27 04:15:00,-16690,1913,18603,907,FALSE,"jump1","0.1.4"
"34579","646",2023-08-27 04:30:00,-16654,1913,18567,907,FALSE,NA,"0.1.4"
"34580","646",2023-08-27 04:45:00,-16633,1913,18546,907,FALSE,NA,"0.1.4"
"34581","646",2023-08-27 05:00:00,-16725,1913,18638,907,FALSE,NA,"0.1.4"
"34582","646",2023-08-27 05:15:00,-16528,1913,18441,907,FALSE,NA,"0.1.4"
"34583","646",2023-08-27 05:30:00,-16385,1913,18298,907,FALSE,NA,"0.1.4"
"34584","646",2023-08-27 05:45:00,-16751,1913,18664,907,FALSE,NA,"0.1.4"
"34585","646",2023-08-27 06:00:00,-16679,1913,18592,907,FALSE,NA,"0.1.4"
"34586","646",2023-08-27 06:15:00,-16236,1913,18149,907,FALSE,NA,"0.1.4"
"34587","646",2023-08-27 06:30:00,-16419,1913,18332,907,FALSE,"out1, fill","0.1.4"
"34588","646",2023-08-27 06:45:00,-16602,1913,18515,907,FALSE,NA,"0.1.4"
"34589","646",2023-08-27 07:00:00,-16751,1913,18664,907,FALSE,NA,"0.1.4"
"34590","646",2023-08-27 07:15:00,-16530,1913,18443,907,FALSE,NA,"0.1.4"
"34591","646",2023-08-27 07:30:00,-16735,1913,18648,907,FALSE,NA,"0.1.4"
"34592","646",2023-08-27 07:45:00,-16674,1913,18587,907,FALSE,NA,"0.1.4"
"34593","646",2023-08-27 08:00:00,-16661,1913,18574,907,FALSE,NA,"0.1.4"
"34594","646",2023-08-27 08:15:00,-16741,1913,18654,907,FALSE,NA,"0.1.4"
"34595","646",2023-08-27 08:30:00,-16854,1913,18767,907,FALSE,NA,"0.1.4"
"34596","646",2023-08-27 08:45:00,-16479,1913,18392,907,FALSE,"out1, fill","0.1.4"
"34597","646",2023-08-27 09:00:00,-16104,1913,18017,907,FALSE,NA,"0.1.4"
"34598","646",2023-08-27 09:15:00,-16467,1913,18380,907,FALSE,NA,"0.1.4"
"34599","646",2023-08-27 09:30:00,-16504,1913,18417,907,FALSE,NA,"0.1.4"
"34600","646",2023-08-27 09:45:00,-16233,1913,18146,907,FALSE,NA,"0.1.4"
"34601","646",2023-08-27 10:00:00,-16607,1913,18520,907,FALSE,NA,"0.1.4"
"34602","646",2023-08-27 10:15:00,-16445,1913,18358,907,FALSE,NA,"0.1.4"
"34603","646",2023-08-27 10:30:00,-16412,1913,18325,907,FALSE,NA,"0.1.4"
"34604","646",2023-08-27 10:45:00,-16412,1913,18325,907,FALSE,"out1, fill","0.1.4"
"34605","646",2023-08-27 11:00:00,-16412,1913,18325,907,FALSE,"jump1","0.1.4"
"34606","646",2023-08-27 11:15:00,-16369,1913,18282,907,FALSE,NA,"0.1.4"
"34607","646",2023-08-27 11:30:00,-16485,1913,18398,907,FALSE,NA,"0.1.4"
"34608","646",2023-08-27 11:45:00,-16485,1913,18398,907,FALSE,"jump1","0.1.4"
"34609","646",2023-08-27 12:00:00,-16902,1913,18815,907,FALSE,NA,"0.1.4"
"34610","646",2023-08-27 12:15:00,-16877.8181818182,1913,18790.8181818182,907,FALSE,"out1, fill","0.1.4"
"34611","646",2023-08-27 12:30:00,-16853.6363636364,1913,18766.6363636364,907,FALSE,"out1, fill","0.1.4"
"34612","646",2023-08-27 12:45:00,-16829.4545454545,1913,18742.4545454545,907,FALSE,"out1, fill","0.1.4"
"34613","646",2023-08-27 13:00:00,-16805.2727272727,1913,18718.2727272727,907,FALSE,"out1, fill","0.1.4"
"34614","646",2023-08-27 13:15:00,-16781.0909090909,1913,18694.0909090909,907,FALSE,"out1, fill","0.1.4"
"34615","646",2023-08-27 13:30:00,-16756.9090909091,1913,18669.9090909091,907,FALSE,"out1, fill","0.1.4"
"34616","646",2023-08-27 13:45:00,-16732.7272727273,1913,18645.7272727273,907,FALSE,"out1, fill","0.1.4"
"34617","646",2023-08-27 14:00:00,-16708.5454545455,1913,18621.5454545455,907,FALSE,"out1, fill","0.1.4"
"34618","646",2023-08-27 14:15:00,-16684.3636363636,1913,18597.3636363636,907,FALSE,"out1, fill","0.1.4"
"34619","646",2023-08-27 14:30:00,-16660.1818181818,1913,18573.1818181818,907,FALSE,"out1, fill","0.1.4"
"34620","646",2023-08-27 14:45:00,-16636,1913,18549,907,FALSE,NA,"0.1.4"
"34621","646",2023-08-27 15:00:00,-16661,1913,18574,907,FALSE,NA,"0.1.4"
"34622","646",2023-08-27 15:15:00,-16580,1913,18493,907,FALSE,NA,"0.1.4"
"34623","646",2023-08-27 15:30:00,-16425,1913,18338,907,FALSE,NA,"0.1.4"
"34624","646",2023-08-27 15:45:00,-16315,1913,18228,907,FALSE,NA,"0.1.4"
"34625","646",2023-08-27 16:00:00,-16314,1913,18227,907,FALSE,NA,"0.1.4"
"34626","646",2023-08-27 16:15:00,-16543,1913,18456,907,FALSE,NA,"0.1.4"
"34627","646",2023-08-27 16:30:00,-16524,1913,18437,907,FALSE,NA,"0.1.4"
"34628","646",2023-08-27 16:45:00,-16258,1913,18171,907,FALSE,"out1, fill","0.1.4"
"34629","646",2023-08-27 17:00:00,-15992,1913,17905,907,FALSE,NA,"0.1.4"
"34630","646",2023-08-27 17:15:00,-15986,1913,17899,907,FALSE,NA,"0.1.4"
"34631","646",2023-08-27 17:30:00,-16097,1913,18010,907,FALSE,NA,"0.1.4"
"34632","646",2023-08-27 17:45:00,-16097,1913,18010,907,FALSE,"jump1","0.1.4"
"34633","646",2023-08-27 18:00:00,-15779,1913,17692,907,FALSE,"out1, fill","0.1.4"
"34634","646",2023-08-27 18:15:00,-15461,1913,17374,907,FALSE,NA,"0.1.4"
"34635","646",2023-08-27 18:30:00,-15352,1913,17265,907,FALSE,NA,"0.1.4"
"34636","646",2023-08-27 18:45:00,-15078,1913,16991,907,FALSE,NA,"0.1.4"
"34637","646",2023-08-27 19:00:00,-15078,1913,16991,907,FALSE,"jump1","0.1.4"
"34638","646",2023-08-27 19:15:00,-14721,1913,16634,907,FALSE,NA,"0.1.4"
"34639","646",2023-08-27 19:30:00,-14721,1913,16634,907,FALSE,"jump1","0.1.4"
"34640","646",2023-08-27 19:45:00,-14377,1913,16290,907,FALSE,NA,"0.1.4"
"34641","646",2023-08-27 20:00:00,-14402,1913,16315,907,FALSE,NA,"0.1.4"
"34642","646",2023-08-27 20:15:00,-14402,1913,16315,907,FALSE,"jump1","0.1.4"
"34643","646",2023-08-27 20:30:00,-14732,1913,16645,907,FALSE,NA,"0.1.4"
"34644","646",2023-08-27 20:45:00,-14653,1913,16566,907,FALSE,NA,"0.1.4"
"34645","646",2023-08-27 21:00:00,-14628,1913,16541,907,FALSE,NA,"0.1.4"
"34646","646",2023-08-27 21:15:00,-15067,1913,16980,907,FALSE,NA,"0.1.4"
"34647","646",2023-08-27 21:30:00,-14891,1913,16804,907,FALSE,NA,"0.1.4"
"34648","646",2023-08-27 21:45:00,-14393,1913,16306,907,FALSE,NA,"0.1.4"
"34649","646",2023-08-27 22:00:00,-14704,1913,16617,907,FALSE,NA,"0.1.4"
"34650","646",2023-08-27 22:15:00,-14594,1913,16507,907,FALSE,NA,"0.1.4"
"34651","646",2023-08-27 22:30:00,-14974,1913,16887,907,FALSE,NA,"0.1.4"
"34652","646",2023-08-27 22:45:00,-14974,1913,16887,907,FALSE,"jump1","0.1.4"
"34653","646",2023-08-27 23:00:00,-14965,1913,16878,907,FALSE,NA,"0.1.4"
"34654","646",2023-08-27 23:15:00,-15416,1913,17329,907,FALSE,NA,"0.1.4"
"34655","646",2023-08-27 23:30:00,-15594,1913,17507,907,FALSE,NA,"0.1.4"
"34656","646",2023-08-27 23:45:00,-15594,1913,17507,907,FALSE,"jump1","0.1.4"
"34657","646",2023-08-28,-15612.1,1913,17525.1,907,FALSE,"out1, fill","0.1.4"
"34658","646",2023-08-28 00:15:00,-15630.2,1913,17543.2,907,FALSE,"out1, fill","0.1.4"
"34659","646",2023-08-28 00:30:00,-15648.3,1913,17561.3,907,FALSE,"out1, fill","0.1.4"
"34660","646",2023-08-28 00:45:00,-15666.4,1913,17579.4,907,FALSE,"out1, fill","0.1.4"
"34661","646",2023-08-28 01:00:00,-15684.5,1913,17597.5,907,FALSE,"out1, fill","0.1.4"
"34662","646",2023-08-28 01:15:00,-15702.6,1913,17615.6,907,FALSE,"out1, fill","0.1.4"
"34663","646",2023-08-28 01:30:00,-15720.7,1913,17633.7,907,FALSE,"out1, fill","0.1.4"
"34664","646",2023-08-28 01:45:00,-15738.8,1913,17651.8,907,FALSE,"out1, fill","0.1.4"
"34665","646",2023-08-28 02:00:00,-15756.9,1913,17669.9,907,FALSE,"out1, fill","0.1.4"
"34666","646",2023-08-28 02:15:00,-15775,1913,17688,907,FALSE,NA,"0.1.4"
"34667","646",2023-08-28 02:30:00,-15775,1913,17688,907,FALSE,"jump1","0.1.4"
"34668","646",2023-08-28 02:45:00,-15775,1913,17688,907,FALSE,"jump1","0.1.4"
"34669","646",2023-08-28 03:00:00,-15644,1913,17557,907,FALSE,NA,"0.1.4"
"34670","646",2023-08-28 03:15:00,-15705,1913,17618,907,FALSE,NA,"0.1.4"
"34671","646",2023-08-28 03:30:00,-15887,1913,17800,907,FALSE,NA,"0.1.4"
"34672","646",2023-08-28 03:45:00,-15848,1913,17761,907,FALSE,NA,"0.1.4"
"34673","646",2023-08-28 04:00:00,-15924,1913,17837,907,FALSE,NA,"0.1.4"
"34674","646",2023-08-28 04:15:00,-15678,1913,17591,907,FALSE,NA,"0.1.4"
"34675","646",2023-08-28 04:30:00,-15704,1913,17617,907,FALSE,NA,"0.1.4"
"34676","646",2023-08-28 04:45:00,-15856,1913,17769,907,FALSE,NA,"0.1.4"
"34677","646",2023-08-28 05:00:00,-15910,1913,17823,907,FALSE,NA,"0.1.4"
"34678","646",2023-08-28 05:15:00,-15883,1913,17796,907,FALSE,NA,"0.1.4"
"34679","646",2023-08-28 05:30:00,-16040,1913,17953,907,FALSE,NA,"0.1.4"
"34680","646",2023-08-28 05:45:00,-15896,1913,17809,907,FALSE,NA,"0.1.4"
"34681","646",2023-08-28 06:00:00,-15823,1913,17736,907,FALSE,NA,"0.1.4"
"34682","646",2023-08-28 06:15:00,-15697,1913,17610,907,FALSE,NA,"0.1.4"
"34683","646",2023-08-28 06:30:00,-15697,1913,17610,907,FALSE,"out1, fill","0.1.4"
"34684","646",2023-08-28 06:45:00,-15697,1913,17610,907,FALSE,"jump1","0.1.4"
"34685","646",2023-08-28 07:00:00,-15620,1913,17533,907,FALSE,NA,"0.1.4"
"34686","646",2023-08-28 07:15:00,-15603,1913,17516,907,FALSE,NA,"0.1.4"
"34687","646",2023-08-28 07:30:00,-15603,1913,17516,907,FALSE,NA,"0.1.4"
"34688","646",2023-08-28 07:45:00,-16031,1913,17944,907,FALSE,"out1, fill","0.1.4"
"34689","646",2023-08-28 08:00:00,-16459,1913,18372,907,FALSE,NA,"0.1.4"
"34690","646",2023-08-28 08:15:00,-16158,1913,18071,907,FALSE,NA,"0.1.4"
"34691","646",2023-08-28 08:30:00,-16158,1913,18071,907,FALSE,"jump1","0.1.4"
"34692","646",2023-08-28 08:45:00,-16372,1913,18285,907,FALSE,"out1, fill","0.1.4"
"34693","646",2023-08-28 09:00:00,-16586,1913,18499,907,FALSE,"out1, fill","0.1.4"
"34694","646",2023-08-28 09:15:00,-16800,1913,18713,907,FALSE,NA,"0.1.4"
"34695","646",2023-08-28 09:30:00,-16969,1913,18882,907,FALSE,NA,"0.1.4"
"34696","646",2023-08-28 09:45:00,-16791,1913,18704,907,FALSE,NA,"0.1.4"
"34697","646",2023-08-28 10:00:00,-16489,1913,18402,907,FALSE,NA,"0.1.4"
"34698","646",2023-08-28 10:15:00,-16308,1913,18221,907,FALSE,NA,"0.1.4"
"34699","646",2023-08-28 10:30:00,-16390,1913,18303,907,FALSE,NA,"0.1.4"
"34700","646",2023-08-28 10:45:00,-16360,1913,18273,907,FALSE,NA,"0.1.4"
"34701","646",2023-08-28 11:00:00,-16135,1913,18048,907,FALSE,NA,"0.1.4"
"34702","646",2023-08-28 11:15:00,-16264,1913,18177,907,FALSE,NA,"0.1.4"
"34703","646",2023-08-28 11:30:00,-16151,1913,18064,907,FALSE,NA,"0.1.4"
"34704","646",2023-08-28 11:45:00,-16330.3333333333,1913,18243.3333333333,907,FALSE,"out1, fill","0.1.4"
"34705","646",2023-08-28 12:00:00,-16509.6666666667,1913,18422.6666666667,907,FALSE,"out1, fill","0.1.4"
"34706","646",2023-08-28 12:15:00,-16689,1913,18602,907,FALSE,NA,"0.1.4"
"34707","646",2023-08-28 12:30:00,-16689,1913,18602,907,FALSE,"jump1","0.1.4"
"34708","646",2023-08-28 12:45:00,-16665,1913,18578,907,FALSE,NA,"0.1.4"
"34709","646",2023-08-28 13:00:00,-16664,1913,18577,907,FALSE,NA,"0.1.4"
"34710","646",2023-08-28 13:15:00,-16660,1913,18573,907,FALSE,NA,"0.1.4"
"34711","646",2023-08-28 13:30:00,-16658,1913,18571,907,FALSE,NA,"0.1.4"
"34712","646",2023-08-28 13:45:00,-16657,1913,18570,907,FALSE,NA,"0.1.4"
"34713","646",2023-08-28 14:00:00,-16658,1913,18571,907,FALSE,NA,"0.1.4"
"34714","646",2023-08-28 14:15:00,-16658,1913,18571,907,FALSE,NA,"0.1.4"
"34715","646",2023-08-28 14:30:00,-16659,1913,18572,907,FALSE,NA,"0.1.4"
"34716","646",2023-08-28 14:45:00,-16699,1913,18612,907,FALSE,NA,"0.1.4"
"34717","646",2023-08-28 15:00:00,-16708,1913,18621,907,FALSE,NA,"0.1.4"
"34718","646",2023-08-28 15:15:00,-16657,1913,18570,907,FALSE,NA,"0.1.4"
"34719","646",2023-08-28 15:30:00,-16752,1913,18665,907,FALSE,NA,"0.1.4"
"34720","646",2023-08-28 15:45:00,-16777,1913,18690,907,FALSE,NA,"0.1.4"
"34721","646",2023-08-28 16:00:00,-16792,1913,18705,907,FALSE,NA,"0.1.4"
"34722","646",2023-08-28 16:15:00,-16759,1913,18672,907,FALSE,NA,"0.1.4"
"34723","646",2023-08-28 16:30:00,-16798,1913,18711,907,FALSE,NA,"0.1.4"
"34724","646",2023-08-28 16:45:00,-16754,1913,18667,907,FALSE,NA,"0.1.4"
"34725","646",2023-08-28 17:00:00,-16999,1913,18912,907,FALSE,NA,"0.1.4"
"34726","646",2023-08-28 17:15:00,-16657,1913,18570,907,FALSE,NA,"0.1.4"
"34727","646",2023-08-28 17:30:00,-16902,1913,18815,907,FALSE,NA,"0.1.4"
"34728","646",2023-08-28 17:45:00,-17063,1913,18976,907,FALSE,NA,"0.1.4"
"34729","646",2023-08-28 18:00:00,-16796,1913,18709,907,FALSE,NA,"0.1.4"
"34730","646",2023-08-28 18:15:00,-16796,1913,18709,907,FALSE,"jump1","0.1.4"
"34731","646",2023-08-28 18:30:00,-16336,1913,18249,907,FALSE,NA,"0.1.4"
"34732","646",2023-08-28 18:45:00,-16336,1913,18249,907,FALSE,"jump1","0.1.4"
"34733","646",2023-08-28 19:00:00,-16336,1913,18249,907,FALSE,"jump1","0.1.4"
"34734","646",2023-08-28 19:15:00,-16827,1913,18740,907,FALSE,NA,"0.1.4"
"34735","646",2023-08-28 19:30:00,-16462,1913,18375,907,FALSE,NA,"0.1.4"
"34736","646",2023-08-28 19:45:00,-16660,1913,18573,907,FALSE,NA,"0.1.4"
"34737","646",2023-08-28 20:00:00,-16644,1913,18557,907,FALSE,NA,"0.1.4"
"34738","646",2023-08-28 20:15:00,-16644,1913,18557,907,FALSE,"jump1","0.1.4"
"34739","646",2023-08-28 20:30:00,-16793,1913,18706,907,FALSE,NA,"0.1.4"
"34740","646",2023-08-28 20:45:00,-16793,1913,18706,907,FALSE,"jump1","0.1.4"
"34741","646",2023-08-28 21:00:00,-16793,1913,18706,907,FALSE,"jump1","0.1.4"
"34742","646",2023-08-28 21:15:00,-16744,1913,18657,907,FALSE,NA,"0.1.4"
"34743","646",2023-08-28 21:30:00,-16841,1913,18754,907,FALSE,NA,"0.1.4"
"34744","646",2023-08-28 21:45:00,-16755,1913,18668,907,FALSE,NA,"0.1.4"
"34745","646",2023-08-28 22:00:00,-16807,1913,18720,907,FALSE,NA,"0.1.4"
"34746","646",2023-08-28 22:15:00,-16756,1913,18669,907,FALSE,NA,"0.1.4"
"34747","646",2023-08-28 22:30:00,-16760,1913,18673,907,FALSE,NA,"0.1.4"
"34748","646",2023-08-28 22:45:00,-16995,1913,18908,907,FALSE,NA,"0.1.4"
"34749","646",2023-08-28 23:00:00,-16756,1913,18669,907,FALSE,NA,"0.1.4"
"34750","646",2023-08-28 23:15:00,-16756,1913,18669,907,FALSE,"jump1","0.1.4"
"34751","646",2023-08-28 23:30:00,-16952,1913,18865,907,FALSE,NA,"0.1.4"
"34752","646",2023-08-28 23:45:00,-17010,1913,18923,907,FALSE,NA,"0.1.4"
"34753","646",2023-08-29,-17010,1913,18923,907,FALSE,"jump1","0.1.4"
"34754","646",2023-08-29 00:15:00,-17284.5,1913,19197.5,907,FALSE,"out1, fill","0.1.4"
"34755","646",2023-08-29 00:30:00,-17559,1913,19472,907,FALSE,NA,"0.1.4"
"34756","646",2023-08-29 00:45:00,-17523,1913,19436,907,FALSE,NA,"0.1.4"
"34757","646",2023-08-29 01:00:00,-17852,1913,19765,907,FALSE,NA,"0.1.4"
"34758","646",2023-08-29 01:15:00,-17870,1913,19783,907,FALSE,NA,"0.1.4"
"34759","646",2023-08-29 01:30:00,-17938,1913,19851,907,FALSE,NA,"0.1.4"
"34760","646",2023-08-29 01:45:00,-17740,1913,19653,907,FALSE,NA,"0.1.4"
"34761","646",2023-08-29 02:00:00,-17579,1913,19492,907,FALSE,NA,"0.1.4"
"34762","646",2023-08-29 02:15:00,-17655,1913,19568,907,FALSE,"out1, fill","0.1.4"
"34763","646",2023-08-29 02:30:00,-17731,1913,19644,907,FALSE,"out1, fill","0.1.4"
"34764","646",2023-08-29 02:45:00,-17807,1913,19720,907,FALSE,"out1, fill","0.1.4"
"34765","646",2023-08-29 03:00:00,-17883,1913,19796,907,FALSE,NA,"0.1.4"
"34766","646",2023-08-29 03:15:00,-17412,1913,19325,907,FALSE,NA,"0.1.4"
"34767","646",2023-08-29 03:30:00,-17529,1913,19442,907,FALSE,NA,"0.1.4"
"34768","646",2023-08-29 03:45:00,-17529,1913,19442,907,FALSE,"jump1","0.1.4"
"34769","646",2023-08-29 04:00:00,-17563,1913,19476,907,FALSE,NA,"0.1.4"
"34770","646",2023-08-29 04:15:00,-17918,1913,19831,907,FALSE,NA,"0.1.4"
"34771","646",2023-08-29 04:30:00,-18272,1913,20185,907,FALSE,NA,"0.1.4"
"34772","646",2023-08-29 04:45:00,-18297,1913,20210,907,FALSE,NA,"0.1.4"
"34773","646",2023-08-29 05:00:00,-18273,1913,20186,907,FALSE,NA,"0.1.4"
"34774","646",2023-08-29 05:15:00,-18525,1913,20438,907,FALSE,NA,"0.1.4"
"34775","646",2023-08-29 05:30:00,-18593,1913,20506,907,FALSE,NA,"0.1.4"
"34776","646",2023-08-29 05:45:00,-18211,1913,20124,907,FALSE,NA,"0.1.4"
"34777","646",2023-08-29 06:00:00,-18533,1913,20446,907,FALSE,NA,"0.1.4"
"34778","646",2023-08-29 06:15:00,-18300,1913,20213,907,FALSE,NA,"0.1.4"
"34779","646",2023-08-29 06:30:00,-18647,1913,20560,907,FALSE,NA,"0.1.4"
"34780","646",2023-08-29 06:45:00,-18647,1913,20560,907,FALSE,"jump1","0.1.4"
"34781","646",2023-08-29 07:00:00,-18647,1913,20560,907,FALSE,"jump1","0.1.4"
"34782","646",2023-08-29 07:15:00,-18712,1913,20625,907,FALSE,"out1, fill","0.1.4"
"34783","646",2023-08-29 07:30:00,-18777,1913,20690,907,FALSE,"out1, fill","0.1.4"
"34784","646",2023-08-29 07:45:00,-18842,1913,20755,907,FALSE,NA,"0.1.4"
"34785","646",2023-08-29 08:00:00,-18839,1913,20752,907,FALSE,NA,"0.1.4"
"34786","646",2023-08-29 08:15:00,-18827,1913,20740,907,FALSE,NA,"0.1.4"
"34787","646",2023-08-29 08:30:00,-18837,1913,20750,907,FALSE,NA,"0.1.4"
"34788","646",2023-08-29 08:45:00,-18761,1913,20674,907,FALSE,NA,"0.1.4"
"34789","646",2023-08-29 09:00:00,-18876,1913,20789,907,FALSE,NA,"0.1.4"
"34790","646",2023-08-29 09:15:00,-19185,1913,21098,907,FALSE,NA,"0.1.4"
"34791","646",2023-08-29 09:30:00,-19185,1913,21098,907,FALSE,"jump1","0.1.4"
"34792","646",2023-08-29 09:45:00,-19177,1913,21090,907,FALSE,NA,"0.1.4"
"34793","646",2023-08-29 10:00:00,-19182,1913,21095,907,FALSE,NA,"0.1.4"
"34794","646",2023-08-29 10:15:00,-19156,1913,21069,907,FALSE,NA,"0.1.4"
"34795","646",2023-08-29 10:30:00,-19048,1913,20961,907,FALSE,NA,"0.1.4"
"34796","646",2023-08-29 10:45:00,-19234,1913,21147,907,FALSE,NA,"0.1.4"
"34797","646",2023-08-29 11:00:00,-19282,1913,21195,907,FALSE,NA,"0.1.4"
"34798","646",2023-08-29 11:15:00,-19282,1913,21195,907,FALSE,"out1, fill","0.1.4"
"34799","646",2023-08-29 11:30:00,-19282,1913,21195,907,FALSE,"jump1","0.1.4"
"34800","646",2023-08-29 11:45:00,-19282,1913,21195,907,FALSE,NA,"0.1.4"
"34801","646",2023-08-29 12:00:00,-19282,1913,21195,907,FALSE,NA,"0.1.4"
"34802","646",2023-08-29 12:15:00,-19283,1913,21196,907,FALSE,NA,"0.1.4"
"34803","646",2023-08-29 12:30:00,-19281,1913,21194,907,FALSE,NA,"0.1.4"
"34804","646",2023-08-29 12:45:00,-19281,1913,21194,907,FALSE,NA,"0.1.4"
"34805","646",2023-08-29 13:00:00,-19281,1913,21194,907,FALSE,NA,"0.1.4"
"34806","646",2023-08-29 13:15:00,-19280,1913,21193,907,FALSE,NA,"0.1.4"
"34807","646",2023-08-29 13:30:00,-19280,1913,21193,907,FALSE,NA,"0.1.4"
"34808","646",2023-08-29 13:45:00,-19281,1913,21194,907,FALSE,NA,"0.1.4"
"34809","646",2023-08-29 14:00:00,-19682.5,1913,21595.5,907,FALSE,"out1, fill","0.1.4"
"34810","646",2023-08-29 14:15:00,-20084,1913,21997,907,FALSE,NA,"0.1.4"
"34811","646",2023-08-29 14:30:00,-20062,1913,21975,907,FALSE,NA,"0.1.4"
"34812","646",2023-08-29 14:45:00,-20146,1913,22059,907,FALSE,NA,"0.1.4"
"34813","646",2023-08-29 15:00:00,-19786,1913,21699,907,FALSE,NA,"0.1.4"
"34814","646",2023-08-29 15:15:00,-19334,1913,21247,907,FALSE,NA,"0.1.4"
"34815","646",2023-08-29 15:30:00,-19328.75,1913,21241.75,907,FALSE,"out1, fill","0.1.4"
"34816","646",2023-08-29 15:45:00,-19323.5,1913,21236.5,907,FALSE,"out1, fill","0.1.4"
"34817","646",2023-08-29 16:00:00,-19318.25,1913,21231.25,907,FALSE,"out1, fill","0.1.4"
"34818","646",2023-08-29 16:15:00,-19313,1913,21226,907,FALSE,NA,"0.1.4"
"34819","646",2023-08-29 16:30:00,-19258,1913,21171,907,FALSE,NA,"0.1.4"
"34820","646",2023-08-29 16:45:00,-19248,1913,21161,907,FALSE,NA,"0.1.4"
"34821","646",2023-08-29 17:00:00,-19241,1913,21154,907,FALSE,NA,"0.1.4"
"34822","646",2023-08-29 17:15:00,-19282,1913,21195,907,FALSE,NA,"0.1.4"
"34823","646",2023-08-29 17:30:00,-19247,1913,21160,907,FALSE,NA,"0.1.4"
"34824","646",2023-08-29 17:45:00,-19241,1913,21154,907,FALSE,NA,"0.1.4"
"34825","646",2023-08-29 18:00:00,-19244,1913,21157,907,FALSE,NA,"0.1.4"
"34826","646",2023-08-29 18:15:00,-19242,1913,21155,907,FALSE,NA,"0.1.4"
"34827","646",2023-08-29 18:30:00,-19242,1913,21155,907,FALSE,NA,"0.1.4"
"34828","646",2023-08-29 18:45:00,-19246,1913,21159,907,FALSE,NA,"0.1.4"
"34829","646",2023-08-29 19:00:00,-19241,1913,21154,907,FALSE,NA,"0.1.4"
"34830","646",2023-08-29 19:15:00,-19242,1913,21155,907,FALSE,NA,"0.1.4"
"34831","646",2023-08-29 19:30:00,-19263,1913,21176,907,FALSE,NA,"0.1.4"
"34832","646",2023-08-29 19:45:00,-19538,1913,21451,907,FALSE,"out1, fill","0.1.4"
"34833","646",2023-08-29 20:00:00,-19813,1913,21726,907,FALSE,NA,"0.1.4"
"34834","646",2023-08-29 20:15:00,-20102,1913,22015,907,FALSE,NA,"0.1.4"
"34835","646",2023-08-29 20:30:00,-20124,1913,22037,907,FALSE,NA,"0.1.4"
"34836","646",2023-08-29 20:45:00,-20124,1913,22037,907,FALSE,"jump1","0.1.4"
"34837","646",2023-08-29 21:00:00,-20191,1913,22104,907,FALSE,NA,"0.1.4"
"34838","646",2023-08-29 21:15:00,-19822,1913,21735,907,FALSE,NA,"0.1.4"
"34839","646",2023-08-29 21:30:00,-19965,1913,21878,907,FALSE,NA,"0.1.4"
"34840","646",2023-08-29 21:45:00,-20174,1913,22087,907,FALSE,NA,"0.1.4"
"34841","646",2023-08-29 22:00:00,-19818,1913,21731,907,FALSE,NA,"0.1.4"
"34842","646",2023-08-29 22:15:00,-19818,1913,21731,907,FALSE,"jump1","0.1.4"
"34843","646",2023-08-29 22:30:00,-20214,1913,22127,907,FALSE,NA,"0.1.4"
"34844","646",2023-08-29 22:45:00,-20182,1913,22095,907,FALSE,NA,"0.1.4"
"34845","646",2023-08-29 23:00:00,-20281,1913,22194,907,FALSE,NA,"0.1.4"
"34846","646",2023-08-29 23:15:00,-19990,1913,21903,907,FALSE,NA,"0.1.4"
"34847","646",2023-08-29 23:30:00,-20097,1913,22010,907,FALSE,NA,"0.1.4"
"34848","646",2023-08-29 23:45:00,-20135.2,1913,22048.2,907,FALSE,"out1, fill","0.1.4"
"34849","646",2023-08-30,-20173.4,1913,22086.4,907,FALSE,"out1, fill","0.1.4"
"34850","646",2023-08-30 00:15:00,-20211.6,1913,22124.6,907,FALSE,"out1, fill","0.1.4"
"34851","646",2023-08-30 00:30:00,-20249.8,1913,22162.8,907,FALSE,"out1, fill","0.1.4"
"34852","646",2023-08-30 00:45:00,-20288,1913,22201,907,FALSE,NA,"0.1.4"
"34853","646",2023-08-30 01:00:00,-20288,1913,22201,907,FALSE,"jump1","0.1.4"
"34854","646",2023-08-30 01:15:00,-20288,1913,22201,907,FALSE,"jump1","0.1.4"
"34855","646",2023-08-30 01:30:00,-20288,1913,22201,907,FALSE,"jump1","0.1.4"
"34856","646",2023-08-30 01:45:00,-20288,1913,22201,907,FALSE,"jump1","0.1.4"
"34857","646",2023-08-30 02:00:00,-20135,1913,22048,907,FALSE,NA,"0.1.4"
"34858","646",2023-08-30 02:15:00,-20135,1913,22048,907,FALSE,"jump1","0.1.4"
"34859","646",2023-08-30 02:30:00,-20425.6,1913,22338.6,907,FALSE,"out1, fill","0.1.4"
"34860","646",2023-08-30 02:45:00,-20716.2,1913,22629.2,907,FALSE,"out1, fill","0.1.4"
"34861","646",2023-08-30 03:00:00,-21006.8,1913,22919.8,907,FALSE,"out1, fill","0.1.4"
"34862","646",2023-08-30 03:15:00,-21297.4,1913,23210.4,907,FALSE,"out1, fill","0.1.4"
"34863","646",2023-08-30 03:30:00,-21588,1913,23501,907,FALSE,NA,"0.1.4"
"34864","646",2023-08-30 03:45:00,-21588,1913,23501,907,FALSE,"jump1","0.1.4"
"34865","646",2023-08-30 04:00:00,-21588,1913,23501,907,FALSE,"jump1","0.1.4"
"34866","646",2023-08-30 04:15:00,-21214,1913,23127,907,FALSE,NA,"0.1.4"
"34867","646",2023-08-30 04:30:00,-21378,1913,23291,907,FALSE,NA,"0.1.4"
"34868","646",2023-08-30 04:45:00,-21715,1913,23628,907,FALSE,NA,"0.1.4"
"34869","646",2023-08-30 05:00:00,-21599,1913,23512,907,FALSE,NA,"0.1.4"
"34870","646",2023-08-30 05:15:00,-21869,1913,23782,907,FALSE,NA,"0.1.4"
"34871","646",2023-08-30 05:30:00,-21472,1913,23385,907,FALSE,"out1, fill","0.1.4"
"34872","646",2023-08-30 05:45:00,-21075,1913,22988,907,FALSE,NA,"0.1.4"
"34873","646",2023-08-30 06:00:00,-21043,1913,22956,907,FALSE,NA,"0.1.4"
"34874","646",2023-08-30 06:15:00,-21074,1913,22987,907,FALSE,NA,"0.1.4"
"34875","646",2023-08-30 06:30:00,-21099,1913,23012,907,FALSE,NA,"0.1.4"
"34876","646",2023-08-30 06:45:00,-21180,1913,23093,907,FALSE,NA,"0.1.4"
"34877","646",2023-08-30 07:00:00,-21073,1913,22986,907,FALSE,NA,"0.1.4"
"34878","646",2023-08-30 07:15:00,-21086,1913,22999,907,FALSE,NA,"0.1.4"
"34879","646",2023-08-30 07:30:00,-21057,1913,22970,907,FALSE,NA,"0.1.4"
"34880","646",2023-08-30 07:45:00,-21072,1913,22985,907,FALSE,NA,"0.1.4"
"34881","646",2023-08-30 08:00:00,-21074,1913,22987,907,FALSE,NA,"0.1.4"
"34882","646",2023-08-30 08:15:00,-21097,1913,23010,907,FALSE,NA,"0.1.4"
"34883","646",2023-08-30 08:30:00,-21035,1913,22948,907,FALSE,NA,"0.1.4"
"34884","646",2023-08-30 08:45:00,-21138,1913,23051,907,FALSE,"out1, fill","0.1.4"
"34885","646",2023-08-30 09:00:00,-21241,1913,23154,907,FALSE,NA,"0.1.4"
"34886","646",2023-08-30 09:15:00,-21561,1913,23474,907,FALSE,NA,"0.1.4"
"34887","646",2023-08-30 09:30:00,-21898,1913,23811,907,FALSE,NA,"0.1.4"
"34888","646",2023-08-30 09:45:00,-21890,1913,23803,907,FALSE,NA,"0.1.4"
"34889","646",2023-08-30 10:00:00,-21862,1913,23775,907,FALSE,NA,"0.1.4"
"34890","646",2023-08-30 10:15:00,-21899,1913,23812,907,FALSE,NA,"0.1.4"
"34891","646",2023-08-30 10:30:00,-21814,1913,23727,907,FALSE,NA,"0.1.4"
"34892","646",2023-08-30 10:45:00,-21910,1913,23823,907,FALSE,NA,"0.1.4"
"34893","646",2023-08-30 11:00:00,-21986,1913,23899,907,FALSE,NA,"0.1.4"
"34894","646",2023-08-30 11:15:00,-21535,1913,23448,907,FALSE,NA,"0.1.4"
"34895","646",2023-08-30 11:30:00,-21535,1913,23448,907,FALSE,"jump1","0.1.4"
"34896","646",2023-08-30 11:45:00,-21535,1913,23448,907,FALSE,"jump1","0.1.4"
"34897","646",2023-08-30 12:00:00,-21768,1913,23681,907,FALSE,NA,"0.1.4"
"34898","646",2023-08-30 12:15:00,-21331.5,1913,23244.5,907,FALSE,"out1, fill","0.1.4"
"34899","646",2023-08-30 12:30:00,-20895,1913,22808,907,FALSE,NA,"0.1.4"
"34900","646",2023-08-30 12:45:00,-20939,1913,22852,907,FALSE,NA,"0.1.4"
"34901","646",2023-08-30 13:00:00,-20916,1913,22829,907,FALSE,NA,"0.1.4"
"34902","646",2023-08-30 13:15:00,-21119,1913,23032,907,FALSE,NA,"0.1.4"
"34903","646",2023-08-30 13:30:00,-21119,1913,23032,907,FALSE,"out1, fill","0.1.4"
"34904","646",2023-08-30 13:45:00,-21119,1913,23032,907,FALSE,"jump1","0.1.4"
"34905","646",2023-08-30 14:00:00,-21074,1913,22987,907,FALSE,NA,"0.1.4"
"34906","646",2023-08-30 14:15:00,-21000,1913,22913,907,FALSE,NA,"0.1.4"
"34907","646",2023-08-30 14:30:00,-20826,1913,22739,907,FALSE,NA,"0.1.4"
"34908","646",2023-08-30 14:45:00,-20869,1913,22782,907,FALSE,NA,"0.1.4"
"34909","646",2023-08-30 15:00:00,-20969,1913,22882,907,FALSE,NA,"0.1.4"
"34910","646",2023-08-30 15:15:00,-20958,1913,22871,907,FALSE,NA,"0.1.4"
"34911","646",2023-08-30 15:30:00,-20745,1913,22658,907,FALSE,NA,"0.1.4"
"34912","646",2023-08-30 15:45:00,-20600,1913,22513,907,FALSE,NA,"0.1.4"
"34913","646",2023-08-30 16:00:00,-20600,1913,22513,907,FALSE,"out1, fill","0.1.4"
"34914","646",2023-08-30 16:15:00,-20600,1913,22513,907,FALSE,"jump1","0.1.4"
"34915","646",2023-08-30 16:30:00,-20651,1913,22564,907,FALSE,NA,"0.1.4"
"34916","646",2023-08-30 16:45:00,-20794,1913,22707,907,FALSE,NA,"0.1.4"
"34917","646",2023-08-30 17:00:00,-20798,1913,22711,907,FALSE,NA,"0.1.4"
"34918","646",2023-08-30 17:15:00,-20812,1913,22725,907,FALSE,NA,"0.1.4"
"34919","646",2023-08-30 17:30:00,-20630,1913,22543,907,FALSE,NA,"0.1.4"
"34920","646",2023-08-30 17:45:00,-20599,1913,22512,907,FALSE,NA,"0.1.4"
"34921","646",2023-08-30 18:00:00,-20611,1913,22524,907,FALSE,NA,"0.1.4"
"34922","646",2023-08-30 18:15:00,-20601,1913,22514,907,FALSE,NA,"0.1.4"
"34923","646",2023-08-30 18:30:00,-20613,1913,22526,907,FALSE,NA,"0.1.4"
"34924","646",2023-08-30 18:45:00,-20617.3333333333,1913,22530.3333333333,907,FALSE,"out1, fill","0.1.4"
"34925","646",2023-08-30 19:00:00,-20621.6666666667,1913,22534.6666666667,907,FALSE,"out1, fill","0.1.4"
"34926","646",2023-08-30 19:15:00,-20626,1913,22539,907,FALSE,NA,"0.1.4"
"34927","646",2023-08-30 19:30:00,-20627,1913,22540,907,FALSE,NA,"0.1.4"
"34928","646",2023-08-30 19:45:00,-20725,1913,22638,907,FALSE,NA,"0.1.4"
"34929","646",2023-08-30 20:00:00,-20725,1913,22638,907,FALSE,"jump1","0.1.4"
"34930","646",2023-08-30 20:15:00,-20725,1913,22638,907,FALSE,"jump1","0.1.4"
"34931","646",2023-08-30 20:30:00,-20725,1913,22638,907,FALSE,"jump1","0.1.4"
"34932","646",2023-08-30 20:45:00,-20254,1913,22167,907,FALSE,NA,"0.1.4"
"34933","646",2023-08-30 21:00:00,-20233,1913,22146,907,FALSE,NA,"0.1.4"
"34934","646",2023-08-30 21:15:00,-20560,1913,22473,907,FALSE,NA,"0.1.4"
"34935","646",2023-08-30 21:30:00,-20560,1913,22473,907,FALSE,NA,"0.1.4"
"34936","646",2023-08-30 21:45:00,-20206,1913,22119,907,FALSE,NA,"0.1.4"
"34937","646",2023-08-30 22:00:00,-20183,1913,22096,907,FALSE,NA,"0.1.4"
"34938","646",2023-08-30 22:15:00,-20183,1913,22096,907,FALSE,"out1, fill","0.1.4"
"34939","646",2023-08-30 22:30:00,-20183,1913,22096,907,FALSE,"jump1","0.1.4"
"34940","646",2023-08-30 22:45:00,-20334,1913,22247,907,FALSE,NA,"0.1.4"
"34941","646",2023-08-30 23:00:00,-20418,1913,22331,907,FALSE,NA,"0.1.4"
"34942","646",2023-08-30 23:15:00,-20426,1913,22339,907,FALSE,NA,"0.1.4"
"34943","646",2023-08-30 23:30:00,-20327,1913,22240,907,FALSE,NA,"0.1.4"
"34944","646",2023-08-30 23:45:00,-20572,1913,22485,907,FALSE,NA,"0.1.4"
"34945","646",2023-08-31,-20639,1913,22552,907,FALSE,NA,"0.1.4"
"34946","646",2023-08-31 00:15:00,-20643,1913,22556,907,FALSE,NA,"0.1.4"
"34947","646",2023-08-31 00:30:00,-20755,1913,22668,907,FALSE,NA,"0.1.4"
"34948","646",2023-08-31 00:45:00,-20628,1913,22541,907,FALSE,NA,"0.1.4"
"34949","646",2023-08-31 01:00:00,-20487,1913,22400,907,FALSE,NA,"0.1.4"
"34950","646",2023-08-31 01:15:00,-20397,1913,22310,907,FALSE,NA,"0.1.4"
"34951","646",2023-08-31 01:30:00,-20685,1913,22598,907,FALSE,NA,"0.1.4"
"34952","646",2023-08-31 01:45:00,-20247,1913,22160,907,FALSE,NA,"0.1.4"
"34953","646",2023-08-31 02:00:00,-20634,1913,22547,907,FALSE,NA,"0.1.4"
"34954","646",2023-08-31 02:15:00,-20726,1913,22639,907,FALSE,NA,"0.1.4"
"34955","646",2023-08-31 02:30:00,-21048,1913,22961,907,FALSE,NA,"0.1.4"
"34956","646",2023-08-31 02:45:00,-21018,1913,22931,907,FALSE,NA,"0.1.4"
"34957","646",2023-08-31 03:00:00,-21070,1913,22983,907,FALSE,NA,"0.1.4"
"34958","646",2023-08-31 03:15:00,-20865,1913,22778,907,FALSE,NA,"0.1.4"
"34959","646",2023-08-31 03:30:00,-20821.5,1913,22734.5,907,FALSE,"out1, fill","0.1.4"
"34960","646",2023-08-31 03:45:00,-20778,1913,22691,907,FALSE,"out1, fill","0.1.4"
"34961","646",2023-08-31 04:00:00,-20734.5,1913,22647.5,907,FALSE,"out1, fill","0.1.4"
"34962","646",2023-08-31 04:15:00,-20691,1913,22604,907,FALSE,"out1, fill","0.1.4"
"34963","646",2023-08-31 04:30:00,-20647.5,1913,22560.5,907,FALSE,"out1, fill","0.1.4"
"34964","646",2023-08-31 04:45:00,-20604,1913,22517,907,FALSE,NA,"0.1.4"
"34965","646",2023-08-31 05:00:00,-20688,1913,22601,907,FALSE,NA,"0.1.4"
"34966","646",2023-08-31 05:15:00,-20481,1913,22394,907,FALSE,NA,"0.1.4"
"34967","646",2023-08-31 05:30:00,-20699,1913,22612,907,FALSE,NA,"0.1.4"
"34968","646",2023-08-31 05:45:00,-20506,1913,22419,907,FALSE,NA,"0.1.4"
"34969","646",2023-08-31 06:00:00,-20696,1913,22609,907,FALSE,NA,"0.1.4"
"34970","646",2023-08-31 06:15:00,-20614,1913,22527,907,FALSE,NA,"0.1.4"
"34971","646",2023-08-31 06:30:00,-20606,1913,22519,907,FALSE,NA,"0.1.4"
"34972","646",2023-08-31 06:45:00,-20253,1913,22166,907,FALSE,NA,"0.1.4"
"34973","646",2023-08-31 07:00:00,-19951.5,1913,21864.5,907,FALSE,"out1, fill","0.1.4"
"34974","646",2023-08-31 07:15:00,-19650,1913,21563,907,FALSE,NA,"0.1.4"
"34975","646",2023-08-31 07:30:00,-19650,1913,21563,907,FALSE,"jump1","0.1.4"
"34976","646",2023-08-31 07:45:00,-19626,1913,21539,907,FALSE,NA,"0.1.4"
"34977","646",2023-08-31 08:00:00,-19630,1913,21543,907,FALSE,NA,"0.1.4"
"34978","646",2023-08-31 08:15:00,-19531,1913,21444,907,FALSE,NA,"0.1.4"
"34979","646",2023-08-31 08:30:00,-19518,1913,21431,907,FALSE,"out1, fill","0.1.4"
"34980","646",2023-08-31 08:45:00,-19505,1913,21418,907,FALSE,"out1, fill","0.1.4"
"34981","646",2023-08-31 09:00:00,-19492,1913,21405,907,FALSE,"out1, fill","0.1.4"
"34982","646",2023-08-31 09:15:00,-19479,1913,21392,907,FALSE,NA,"0.1.4"
"34983","646",2023-08-31 09:30:00,-19708,1913,21621,907,FALSE,NA,"0.1.4"
"34984","646",2023-08-31 09:45:00,-19774,1913,21687,907,FALSE,NA,"0.1.4"
"34985","646",2023-08-31 10:00:00,-19767,1913,21680,907,FALSE,NA,"0.1.4"
"34986","646",2023-08-31 10:15:00,-19523,1913,21436,907,FALSE,NA,"0.1.4"
"34987","646",2023-08-31 10:30:00,-19548,1913,21461,907,FALSE,NA,"0.1.4"
"34988","646",2023-08-31 10:45:00,-19623,1913,21536,907,FALSE,NA,"0.1.4"
"34989","646",2023-08-31 11:00:00,-19541,1913,21454,907,FALSE,NA,"0.1.4"
"34990","646",2023-08-31 11:15:00,-19635,1913,21548,907,FALSE,NA,"0.1.4"
"34991","646",2023-08-31 11:30:00,-19607,1913,21520,907,FALSE,NA,"0.1.4"
"34992","646",2023-08-31 11:45:00,-19397,1913,21310,907,FALSE,NA,"0.1.4"
"34993","646",2023-08-31 12:00:00,-19568,1913,21481,907,FALSE,NA,"0.1.4"
"34994","646",2023-08-31 12:15:00,-19483,1913,21396,907,FALSE,NA,"0.1.4"
"34995","646",2023-08-31 12:30:00,-19576,1913,21489,907,FALSE,NA,"0.1.4"
"34996","646",2023-08-31 12:45:00,-19410,1913,21323,907,FALSE,NA,"0.1.4"
"34997","646",2023-08-31 13:00:00,-19186,1913,21099,907,FALSE,NA,"0.1.4"
"34998","646",2023-08-31 13:15:00,-19539,1913,21452,907,FALSE,NA,"0.1.4"
"34999","646",2023-08-31 13:30:00,-19539,1913,21452,907,FALSE,"out1, fill","0.1.4"
"35000","646",2023-08-31 13:45:00,-19539,1913,21452,907,FALSE,"jump1","0.1.4"
"35001","646",2023-08-31 14:00:00,-19539,1913,21452,907,FALSE,NA,"0.1.4"
"35002","646",2023-08-31 14:15:00,-19539,1913,21452,907,FALSE,NA,"0.1.4"
"35003","646",2023-08-31 14:30:00,-20004,1913,21917,907,FALSE,"out1, fill","0.1.4"
"35004","646",2023-08-31 14:45:00,-20469,1913,22382,907,FALSE,NA,"0.1.4"
"35005","646",2023-08-31 15:00:00,-20337,1913,22250,907,FALSE,NA,"0.1.4"
"35006","646",2023-08-31 15:15:00,-20337,1913,22250,907,FALSE,"jump1","0.1.4"
"35007","646",2023-08-31 15:30:00,-20337,1913,22250,907,FALSE,"jump1","0.1.4"
"35008","646",2023-08-31 15:45:00,-19928.5,1913,21841.5,907,FALSE,"out1, fill","0.1.4"
"35009","646",2023-08-31 16:00:00,-19520,1913,21433,907,FALSE,NA,"0.1.4"
"35010","646",2023-08-31 16:15:00,-19976,1913,21889,907,FALSE,NA,"0.1.4"
"35011","646",2023-08-31 16:30:00,-19976,1913,21889,907,FALSE,"jump1","0.1.4"
"35012","646",2023-08-31 16:45:00,-20016.375,1913,21929.375,907,FALSE,"out1, fill","0.1.4"
"35013","646",2023-08-31 17:00:00,-20056.75,1913,21969.75,907,FALSE,"out1, fill","0.1.4"
"35014","646",2023-08-31 17:15:00,-20097.125,1913,22010.125,907,FALSE,"out1, fill","0.1.4"
"35015","646",2023-08-31 17:30:00,-20137.5,1913,22050.5,907,FALSE,"out1, fill","0.1.4"
"35016","646",2023-08-31 17:45:00,-20177.875,1913,22090.875,907,FALSE,"out1, fill","0.1.4"
"35017","646",2023-08-31 18:00:00,-20218.25,1913,22131.25,907,FALSE,"out1, fill","0.1.4"
"35018","646",2023-08-31 18:15:00,-20258.625,1913,22171.625,907,FALSE,"out1, fill","0.1.4"
"35019","646",2023-08-31 18:30:00,-20299,1913,22212,907,FALSE,NA,"0.1.4"
"35020","646",2023-08-31 18:45:00,-20299,1913,22212,907,FALSE,"jump1","0.1.4"
"35021","646",2023-08-31 19:00:00,-20456,1913,22369,907,FALSE,NA,"0.1.4"
"35022","646",2023-08-31 19:15:00,-20456,1913,22369,907,FALSE,"jump1","0.1.4"
"35023","646",2023-08-31 19:30:00,-20013,1913,21926,907,FALSE,NA,"0.1.4"
"35024","646",2023-08-31 19:45:00,-20050,1913,21963,907,FALSE,NA,"0.1.4"
"35025","646",2023-08-31 20:00:00,-20028,1913,21941,907,FALSE,NA,"0.1.4"
"35026","646",2023-08-31 20:15:00,-20013,1913,21926,907,FALSE,NA,"0.1.4"
"35027","646",2023-08-31 20:30:00,-20044,1913,21957,907,FALSE,NA,"0.1.4"
"35028","646",2023-08-31 20:45:00,-20026,1913,21939,907,FALSE,NA,"0.1.4"
"35029","646",2023-08-31 21:00:00,-20041,1913,21954,907,FALSE,NA,"0.1.4"
"35030","646",2023-08-31 21:15:00,-20030,1913,21943,907,FALSE,NA,"0.1.4"
"35031","646",2023-08-31 21:30:00,-20045,1913,21958,907,FALSE,NA,"0.1.4"
"35032","646",2023-08-31 21:45:00,-20103,1913,22016,907,FALSE,"out1, fill","0.1.4"
"35033","646",2023-08-31 22:00:00,-20161,1913,22074,907,FALSE,NA,"0.1.4"
"35034","646",2023-08-31 22:15:00,-20654,1913,22567,907,FALSE,NA,"0.1.4"
"35035","646",2023-08-31 22:30:00,-20654,1913,22567,907,FALSE,"jump1","0.1.4"
"35036","646",2023-08-31 22:45:00,-20651,1913,22564,907,FALSE,NA,"0.1.4"
"35037","646",2023-08-31 23:00:00,-20955,1913,22868,907,FALSE,NA,"0.1.4"
"35038","646",2023-08-31 23:15:00,-20684,1913,22597,907,FALSE,NA,"0.1.4"
"35039","646",2023-08-31 23:30:00,-20792.8888888889,1913,22705.8888888889,907,FALSE,"out1, fill","0.1.4"
"35040","646",2023-08-31 23:45:00,-20901.7777777778,1913,22814.7777777778,907,FALSE,"out1, fill","0.1.4"
"35041","646",2023-09-01,-21010.6666666667,1913,22923.6666666667,907,FALSE,"out1, fill","0.1.4"
"35042","646",2023-09-01 00:15:00,-21119.5555555556,1913,23032.5555555556,907,FALSE,"out1, fill","0.1.4"
"35043","646",2023-09-01 00:30:00,-21228.4444444444,1913,23141.4444444444,907,FALSE,"out1, fill","0.1.4"
"35044","646",2023-09-01 00:45:00,-21337.3333333333,1913,23250.3333333333,907,FALSE,"out1, fill","0.1.4"
"35045","646",2023-09-01 01:00:00,-21446.2222222222,1913,23359.2222222222,907,FALSE,"out1, fill","0.1.4"
"35046","646",2023-09-01 01:15:00,-21555.1111111111,1913,23468.1111111111,907,FALSE,"out1, fill","0.1.4"
"35047","646",2023-09-01 01:30:00,-21664,1913,23577,907,FALSE,NA,"0.1.4"
"35048","646",2023-09-01 01:45:00,-21280,1913,23193,907,FALSE,NA,"0.1.4"
"35049","646",2023-09-01 02:00:00,-20994,1913,22907,907,FALSE,NA,"0.1.4"
"35050","646",2023-09-01 02:15:00,-20845,1913,22758,907,FALSE,NA,"0.1.4"
"35051","646",2023-09-01 02:30:00,-20779,1913,22692,907,FALSE,NA,"0.1.4"
"35052","646",2023-09-01 02:45:00,-20779,1913,22692,907,FALSE,"jump1","0.1.4"
"35053","646",2023-09-01 03:00:00,-20932,1913,22845,907,FALSE,NA,"0.1.4"
"35054","646",2023-09-01 03:15:00,-20873,1913,22786,907,FALSE,NA,"0.1.4"
"35055","646",2023-09-01 03:30:00,-20930.5,1913,22843.5,907,FALSE,"out1, fill","0.1.4"
"35056","646",2023-09-01 03:45:00,-20988,1913,22901,907,FALSE,"out1, fill","0.1.4"
"35057","646",2023-09-01 04:00:00,-21045.5,1913,22958.5,907,FALSE,"out1, fill","0.1.4"
"35058","646",2023-09-01 04:15:00,-21103,1913,23016,907,FALSE,"out1, fill","0.1.4"
"35059","646",2023-09-01 04:30:00,-21160.5,1913,23073.5,907,FALSE,"out1, fill","0.1.4"
"35060","646",2023-09-01 04:45:00,-21218,1913,23131,907,FALSE,"out1, fill","0.1.4"
"35061","646",2023-09-01 05:00:00,-21275.5,1913,23188.5,907,FALSE,"out1, fill","0.1.4"
"35062","646",2023-09-01 05:15:00,-21333,1913,23246,907,FALSE,"out1, fill","0.1.4"
"35063","646",2023-09-01 05:30:00,-21390.5,1913,23303.5,907,FALSE,"out1, fill","0.1.4"
"35064","646",2023-09-01 05:45:00,-21448,1913,23361,907,FALSE,"out1, fill","0.1.4"
"35065","646",2023-09-01 06:00:00,-21505.5,1913,23418.5,907,FALSE,"out1, fill","0.1.4"
"35066","646",2023-09-01 06:15:00,-21563,1913,23476,907,FALSE,NA,"0.1.4"
"35067","646",2023-09-01 06:30:00,-22018,1913,23931,907,FALSE,NA,"0.1.4"
"35068","646",2023-09-01 06:45:00,-22018,1913,23931,907,FALSE,"jump1","0.1.4"
"35069","646",2023-09-01 07:00:00,-21751.5,1913,23664.5,907,FALSE,"out1, fill","0.1.4"
"35070","646",2023-09-01 07:15:00,-21485,1913,23398,907,FALSE,"out1, fill","0.1.4"
"35071","646",2023-09-01 07:30:00,-21218.5,1913,23131.5,907,FALSE,"out1, fill","0.1.4"
"35072","646",2023-09-01 07:45:00,-20952,1913,22865,907,FALSE,NA,"0.1.4"
"35073","646",2023-09-01 08:00:00,-20805,1913,22718,907,FALSE,NA,"0.1.4"
"35074","646",2023-09-01 08:15:00,-20803,1913,22716,907,FALSE,NA,"0.1.4"
"35075","646",2023-09-01 08:30:00,-20998,1913,22911,907,FALSE,"out1, fill","0.1.4"
"35076","646",2023-09-01 08:45:00,-21193,1913,23106,907,FALSE,NA,"0.1.4"
"35077","646",2023-09-01 09:00:00,-21193,1913,23106,907,FALSE,"jump1","0.1.4"
"35078","646",2023-09-01 09:15:00,-21193,1913,23106,907,FALSE,"jump1","0.1.4"
"35079","646",2023-09-01 09:30:00,-21148.2,1913,23061.2,907,FALSE,"out1, fill","0.1.4"
"35080","646",2023-09-01 09:45:00,-21103.4,1913,23016.4,907,FALSE,"out1, fill","0.1.4"
"35081","646",2023-09-01 10:00:00,-21058.6,1913,22971.6,907,FALSE,"out1, fill","0.1.4"
"35082","646",2023-09-01 10:15:00,-21013.8,1913,22926.8,907,FALSE,"out1, fill","0.1.4"
"35083","646",2023-09-01 10:30:00,-20969,1913,22882,907,FALSE,NA,"0.1.4"
"35084","646",2023-09-01 10:45:00,-20672,1913,22585,907,FALSE,NA,"0.1.4"
"35085","646",2023-09-01 11:00:00,-20981,1913,22894,907,FALSE,NA,"0.1.4"
"35086","646",2023-09-01 11:15:00,-20670,1913,22583,907,FALSE,NA,"0.1.4"
"35087","646",2023-09-01 11:30:00,-21020,1913,22933,907,FALSE,"out1, fill","0.1.4"
"35088","646",2023-09-01 11:45:00,-21370,1913,23283,907,FALSE,"out1, fill","0.1.4"
"35089","646",2023-09-01 12:00:00,-21720,1913,23633,907,FALSE,"out1, fill","0.1.4"
"35090","646",2023-09-01 12:15:00,-22070,1913,23983,907,FALSE,"out1, fill","0.1.4"
"35091","646",2023-09-01 12:30:00,-22420,1913,24333,907,FALSE,NA,"0.1.4"
"35092","646",2023-09-01 12:45:00,-22529,1913,24442,907,FALSE,NA,"0.1.4"
"35093","646",2023-09-01 13:00:00,-22571,1913,24484,907,FALSE,NA,"0.1.4"
"35094","646",2023-09-01 13:15:00,-22551.2,1913,24464.2,907,FALSE,"out1, fill","0.1.4"
"35095","646",2023-09-01 13:30:00,-22531.4,1913,24444.4,907,FALSE,"out1, fill","0.1.4"
"35096","646",2023-09-01 13:45:00,-22511.6,1913,24424.6,907,FALSE,"out1, fill","0.1.4"
"35097","646",2023-09-01 14:00:00,-22491.8,1913,24404.8,907,FALSE,"out1, fill","0.1.4"
"35098","646",2023-09-01 14:15:00,-22472,1913,24385,907,FALSE,NA,"0.1.4"
"35099","646",2023-09-01 14:30:00,-22540,1913,24453,907,FALSE,NA,"0.1.4"
"35100","646",2023-09-01 14:45:00,-22610,1913,24523,907,FALSE,NA,"0.1.4"
"35101","646",2023-09-01 15:00:00,-22498,1913,24411,907,FALSE,NA,"0.1.4"
"35102","646",2023-09-01 15:15:00,-22674,1913,24587,907,FALSE,NA,"0.1.4"
"35103","646",2023-09-01 15:30:00,-22674,1913,24587,907,FALSE,"jump1","0.1.4"
"35104","646",2023-09-01 15:45:00,-22492.875,1913,24405.875,907,FALSE,"out1, fill","0.1.4"
"35105","646",2023-09-01 16:00:00,-22311.75,1913,24224.75,907,FALSE,"out1, fill","0.1.4"
"35106","646",2023-09-01 16:15:00,-22130.625,1913,24043.625,907,FALSE,"out1, fill","0.1.4"
"35107","646",2023-09-01 16:30:00,-21949.5,1913,23862.5,907,FALSE,"out1, fill","0.1.4"
"35108","646",2023-09-01 16:45:00,-21768.375,1913,23681.375,907,FALSE,"out1, fill","0.1.4"
"35109","646",2023-09-01 17:00:00,-21587.25,1913,23500.25,907,FALSE,"out1, fill","0.1.4"
"35110","646",2023-09-01 17:15:00,-21406.125,1913,23319.125,907,FALSE,"out1, fill","0.1.4"
"35111","646",2023-09-01 17:30:00,-21225,1913,23138,907,FALSE,NA,"0.1.4"
"35112","646",2023-09-01 17:45:00,-21283,1913,23196,907,FALSE,NA,"0.1.4"
"35113","646",2023-09-01 18:00:00,-21688,1913,23601,907,FALSE,NA,"0.1.4"
"35114","646",2023-09-01 18:15:00,-21370,1913,23283,907,FALSE,NA,"0.1.4"
"35115","646",2023-09-01 18:30:00,-21212,1913,23125,907,FALSE,NA,"0.1.4"
"35116","646",2023-09-01 18:45:00,-21215,1913,23128,907,FALSE,NA,"0.1.4"
"35117","646",2023-09-01 19:00:00,-21253,1913,23166,907,FALSE,NA,"0.1.4"
"35118","646",2023-09-01 19:15:00,-21243,1913,23156,907,FALSE,NA,"0.1.4"
"35119","646",2023-09-01 19:30:00,-21222,1913,23135,907,FALSE,NA,"0.1.4"
"35120","646",2023-09-01 19:45:00,-21281,1913,23194,907,FALSE,NA,"0.1.4"
"35121","646",2023-09-01 20:00:00,-21234,1913,23147,907,FALSE,NA,"0.1.4"
"35122","646",2023-09-01 20:15:00,-21216,1913,23129,907,FALSE,NA,"0.1.4"
"35123","646",2023-09-01 20:30:00,-21215,1913,23128,907,FALSE,NA,"0.1.4"
"35124","646",2023-09-01 20:45:00,-21218,1913,23131,907,FALSE,NA,"0.1.4"
"35125","646",2023-09-01 21:00:00,-21219,1913,23132,907,FALSE,NA,"0.1.4"
"35126","646",2023-09-01 21:15:00,-21219,1913,23132,907,FALSE,NA,"0.1.4"
"35127","646",2023-09-01 21:30:00,-21219,1913,23132,907,FALSE,NA,"0.1.4"
"35128","646",2023-09-01 21:45:00,-21219,1913,23132,907,FALSE,NA,"0.1.4"
"35129","646",2023-09-01 22:00:00,-21220,1913,23133,907,FALSE,NA,"0.1.4"
"35130","646",2023-09-01 22:15:00,-21221,1913,23134,907,FALSE,NA,"0.1.4"
"35131","646",2023-09-01 22:30:00,-21219,1913,23132,907,FALSE,NA,"0.1.4"
"35132","646",2023-09-01 22:45:00,-21401,1913,23314,907,FALSE,NA,"0.1.4"
"35133","646",2023-09-01 23:00:00,-21329,1913,23242,907,FALSE,NA,"0.1.4"
"35134","646",2023-09-01 23:15:00,-21228,1913,23141,907,FALSE,NA,"0.1.4"
"35135","646",2023-09-01 23:30:00,-21225,1913,23138,907,FALSE,NA,"0.1.4"
"35136","646",2023-09-01 23:45:00,-21304,1913,23217,907,FALSE,NA,"0.1.4"
"35137","646",2023-09-02,-21242,1913,23155,907,FALSE,NA,"0.1.4"
"35138","646",2023-09-02 00:15:00,-21303,1913,23216,907,FALSE,NA,"0.1.4"
"35139","646",2023-09-02 00:30:00,-21234,1913,23147,907,FALSE,NA,"0.1.4"
"35140","646",2023-09-02 00:45:00,-21218,1913,23131,907,FALSE,NA,"0.1.4"
"35141","646",2023-09-02 01:00:00,-21217,1913,23130,907,FALSE,NA,"0.1.4"
"35142","646",2023-09-02 01:15:00,-21217,1913,23130,907,FALSE,NA,"0.1.4"
"35143","646",2023-09-02 01:30:00,-21218,1913,23131,907,FALSE,NA,"0.1.4"
"35144","646",2023-09-02 01:45:00,-21219,1913,23132,907,FALSE,NA,"0.1.4"
"35145","646",2023-09-02 02:00:00,-21219,1913,23132,907,FALSE,NA,"0.1.4"
"35146","646",2023-09-02 02:15:00,-21221,1913,23134,907,FALSE,NA,"0.1.4"
"35147","646",2023-09-02 02:30:00,-21221,1913,23134,907,FALSE,NA,"0.1.4"
"35148","646",2023-09-02 02:45:00,-21221,1913,23134,907,FALSE,NA,"0.1.4"
"35149","646",2023-09-02 03:00:00,-21231,1913,23144,907,FALSE,NA,"0.1.4"
"35150","646",2023-09-02 03:15:00,-21227,1913,23140,907,FALSE,NA,"0.1.4"
"35151","646",2023-09-02 03:30:00,-21214,1913,23127,907,FALSE,NA,"0.1.4"
"35152","646",2023-09-02 03:45:00,-21252,1913,23165,907,FALSE,NA,"0.1.4"
"35153","646",2023-09-02 04:00:00,-21271,1913,23184,907,FALSE,NA,"0.1.4"
"35154","646",2023-09-02 04:15:00,-21271,1913,23184,907,FALSE,"jump1","0.1.4"
"35155","646",2023-09-02 04:30:00,-21271,1913,23184,907,FALSE,"jump1","0.1.4"
"35156","646",2023-09-02 04:45:00,-21574,1913,23487,907,FALSE,NA,"0.1.4"
"35157","646",2023-09-02 05:00:00,-21188,1913,23101,907,FALSE,NA,"0.1.4"
"35158","646",2023-09-02 05:15:00,-21185,1913,23098,907,FALSE,NA,"0.1.4"
"35159","646",2023-09-02 05:30:00,-21188,1913,23101,907,FALSE,NA,"0.1.4"
"35160","646",2023-09-02 05:45:00,-21193,1913,23106,907,FALSE,NA,"0.1.4"
"35161","646",2023-09-02 06:00:00,-21192,1913,23105,907,FALSE,NA,"0.1.4"
"35162","646",2023-09-02 06:15:00,-21521,1913,23434,907,FALSE,NA,"0.1.4"
"35163","646",2023-09-02 06:30:00,-21197,1913,23110,907,FALSE,NA,"0.1.4"
"35164","646",2023-09-02 06:45:00,-21207,1913,23120,907,FALSE,NA,"0.1.4"
"35165","646",2023-09-02 07:00:00,-21201,1913,23114,907,FALSE,NA,"0.1.4"
"35166","646",2023-09-02 07:15:00,-21192,1913,23105,907,FALSE,NA,"0.1.4"
"35167","646",2023-09-02 07:30:00,-21190,1913,23103,907,FALSE,NA,"0.1.4"
"35168","646",2023-09-02 07:45:00,-21181,1913,23094,907,FALSE,NA,"0.1.4"
"35169","646",2023-09-02 08:00:00,-21183,1913,23096,907,FALSE,NA,"0.1.4"
"35170","646",2023-09-02 08:15:00,-21180,1913,23093,907,FALSE,NA,"0.1.4"
"35171","646",2023-09-02 08:30:00,-21180,1913,23093,907,FALSE,NA,"0.1.4"
"35172","646",2023-09-02 08:45:00,-21181,1913,23094,907,FALSE,NA,"0.1.4"
"35173","646",2023-09-02 09:00:00,-21646,1913,23559,907,FALSE,NA,"0.1.4"
"35174","646",2023-09-02 09:15:00,-21187,1913,23100,907,FALSE,NA,"0.1.4"
"35175","646",2023-09-02 09:30:00,-21183,1913,23096,907,FALSE,NA,"0.1.4"
"35176","646",2023-09-02 09:45:00,-21182,1913,23095,907,FALSE,NA,"0.1.4"
"35177","646",2023-09-02 10:00:00,-21182,1913,23095,907,FALSE,NA,"0.1.4"
"35178","646",2023-09-02 10:15:00,-21184,1913,23097,907,FALSE,NA,"0.1.4"
"35179","646",2023-09-02 10:30:00,-21187,1913,23100,907,FALSE,NA,"0.1.4"
"35180","646",2023-09-02 10:45:00,-21180,1913,23093,907,FALSE,NA,"0.1.4"
"35181","646",2023-09-02 11:00:00,-21181,1913,23094,907,FALSE,NA,"0.1.4"
"35182","646",2023-09-02 11:15:00,-21181,1913,23094,907,FALSE,"out1, fill","0.1.4"
"35183","646",2023-09-02 11:30:00,-21181,1913,23094,907,FALSE,"out1, fill","0.1.4"
"35184","646",2023-09-02 11:45:00,-21181,1913,23094,907,FALSE,"out1, fill","0.1.4"
"35185","646",2023-09-02 12:00:00,-21181,1913,23094,907,FALSE,"out1, fill","0.1.4"
"35186","646",2023-09-02 12:15:00,-21181,1913,23094,907,FALSE,NA,"0.1.4"
"35187","646",2023-09-02 12:30:00,-21181,1913,23094,907,FALSE,NA,"0.1.4"
"35188","646",2023-09-02 12:45:00,-21181,1913,23094,907,FALSE,NA,"0.1.4"
"35189","646",2023-09-02 13:00:00,-21180,1913,23093,907,FALSE,NA,"0.1.4"
"35190","646",2023-09-02 13:15:00,-21180,1913,23093,907,FALSE,NA,"0.1.4"
"35191","646",2023-09-02 13:30:00,-21180,1913,23093,907,FALSE,NA,"0.1.4"
"35192","646",2023-09-02 13:45:00,-21180,1913,23093,907,FALSE,NA,"0.1.4"
"35193","646",2023-09-02 14:00:00,-21180,1913,23093,907,FALSE,NA,"0.1.4"
"35194","646",2023-09-02 14:15:00,-21180,1913,23093,907,FALSE,NA,"0.1.4"
"35195","646",2023-09-02 14:30:00,-21180,1913,23093,907,FALSE,NA,"0.1.4"
"35196","646",2023-09-02 14:45:00,-21180,1913,23093,907,FALSE,NA,"0.1.4"
"35197","646",2023-09-02 15:00:00,-21180,1913,23093,907,FALSE,NA,"0.1.4"
"35198","646",2023-09-02 15:15:00,-21180,1913,23093,907,FALSE,NA,"0.1.4"
"35199","646",2023-09-02 15:30:00,-21180,1913,23093,907,FALSE,NA,"0.1.4"
"35200","646",2023-09-02 15:45:00,-21180,1913,23093,907,FALSE,NA,"0.1.4"
"35201","646",2023-09-02 16:00:00,-21180,1913,23093,907,FALSE,NA,"0.1.4"
"35202","646",2023-09-02 16:15:00,-21180,1913,23093,907,FALSE,NA,"0.1.4"
"35203","646",2023-09-02 16:30:00,-21180,1913,23093,907,FALSE,NA,"0.1.4"
"35204","646",2023-09-02 16:45:00,-21181,1913,23094,907,FALSE,NA,"0.1.4"
"35205","646",2023-09-02 17:00:00,-21181,1913,23094,907,FALSE,NA,"0.1.4"
"35206","646",2023-09-02 17:15:00,-21183,1913,23096,907,FALSE,NA,"0.1.4"
"35207","646",2023-09-02 17:30:00,-21186,1913,23099,907,FALSE,NA,"0.1.4"
"35208","646",2023-09-02 17:45:00,-21188,1913,23101,907,FALSE,NA,"0.1.4"
"35209","646",2023-09-02 18:00:00,-21187,1913,23100,907,FALSE,NA,"0.1.4"
"35210","646",2023-09-02 18:15:00,-21187,1913,23100,907,FALSE,NA,"0.1.4"
"35211","646",2023-09-02 18:30:00,-21184,1913,23097,907,FALSE,NA,"0.1.4"
"35212","646",2023-09-02 18:45:00,-21184,1913,23097,907,FALSE,NA,"0.1.4"
"35213","646",2023-09-02 19:00:00,-21190,1913,23103,907,FALSE,NA,"0.1.4"
"35214","646",2023-09-02 19:15:00,-21194,1913,23107,907,FALSE,NA,"0.1.4"
"35215","646",2023-09-02 19:30:00,-21195,1913,23108,907,FALSE,NA,"0.1.4"
"35216","646",2023-09-02 19:45:00,-21192,1913,23105,907,FALSE,NA,"0.1.4"
"35217","646",2023-09-02 20:00:00,-21205,1913,23118,907,FALSE,NA,"0.1.4"
"35218","646",2023-09-02 20:15:00,-21237,1913,23150,907,FALSE,NA,"0.1.4"
"35219","646",2023-09-02 20:30:00,-21196,1913,23109,907,FALSE,NA,"0.1.4"
"35220","646",2023-09-02 20:45:00,-21192,1913,23105,907,FALSE,NA,"0.1.4"
"35221","646",2023-09-02 21:00:00,-21195,1913,23108,907,FALSE,NA,"0.1.4"
"35222","646",2023-09-02 21:15:00,-21195,1913,23108,907,FALSE,NA,"0.1.4"
"35223","646",2023-09-02 21:30:00,-21192,1913,23105,907,FALSE,NA,"0.1.4"
"35224","646",2023-09-02 21:45:00,-21186,1913,23099,907,FALSE,NA,"0.1.4"
"35225","646",2023-09-02 22:00:00,-21180,1913,23093,907,FALSE,NA,"0.1.4"
"35226","646",2023-09-02 22:15:00,-21170,1913,23083,907,FALSE,NA,"0.1.4"
"35227","646",2023-09-02 22:30:00,-21176,1913,23089,907,FALSE,NA,"0.1.4"
"35228","646",2023-09-02 22:45:00,-21176,1913,23089,907,FALSE,NA,"0.1.4"
"35229","646",2023-09-02 23:00:00,-21177,1913,23090,907,FALSE,NA,"0.1.4"
"35230","646",2023-09-02 23:15:00,-21187,1913,23100,907,FALSE,NA,"0.1.4"
"35231","646",2023-09-02 23:30:00,-21194,1913,23107,907,FALSE,NA,"0.1.4"
"35232","646",2023-09-02 23:45:00,-21194,1913,23107,907,FALSE,NA,"0.1.4"
"35233","646",2023-09-03,-21183,1913,23096,907,FALSE,NA,"0.1.4"
"35234","646",2023-09-03 00:15:00,-21183,1913,23096,907,FALSE,NA,"0.1.4"
"35235","646",2023-09-03 00:30:00,-21184,1913,23097,907,FALSE,NA,"0.1.4"
"35236","646",2023-09-03 00:45:00,-21187,1913,23100,907,FALSE,NA,"0.1.4"
"35237","646",2023-09-03 01:00:00,-21187,1913,23100,907,FALSE,NA,"0.1.4"
"35238","646",2023-09-03 01:15:00,-21190,1913,23103,907,FALSE,NA,"0.1.4"
"35239","646",2023-09-03 01:30:00,-21190,1913,23103,907,FALSE,NA,"0.1.4"
"35240","646",2023-09-03 01:45:00,-21190,1913,23103,907,FALSE,NA,"0.1.4"
"35241","646",2023-09-03 02:00:00,-21196,1913,23109,907,FALSE,NA,"0.1.4"
"35242","646",2023-09-03 02:15:00,-21186,1913,23099,907,FALSE,NA,"0.1.4"
"35243","646",2023-09-03 02:30:00,-21294,1913,23207,907,FALSE,NA,"0.1.4"
"35244","646",2023-09-03 02:45:00,-21183,1913,23096,907,FALSE,NA,"0.1.4"
"35245","646",2023-09-03 03:00:00,-21501,1913,23414,907,FALSE,NA,"0.1.4"
"35246","646",2023-09-03 03:15:00,-21501,1913,23414,907,FALSE,"jump1","0.1.4"
"35247","646",2023-09-03 03:30:00,-21139.5,1913,23052.5,907,FALSE,"out1, fill","0.1.4"
"35248","646",2023-09-03 03:45:00,-20778,1913,22691,907,FALSE,NA,"0.1.4"
"35249","646",2023-09-03 04:00:00,-20530,1913,22443,907,FALSE,NA,"0.1.4"
"35250","646",2023-09-03 04:15:00,-20480,1913,22393,907,FALSE,NA,"0.1.4"
"35251","646",2023-09-03 04:30:00,-20583.75,1913,22496.75,907,FALSE,"out1, fill","0.1.4"
"35252","646",2023-09-03 04:45:00,-20687.5,1913,22600.5,907,FALSE,"out1, fill","0.1.4"
"35253","646",2023-09-03 05:00:00,-20791.25,1913,22704.25,907,FALSE,"out1, fill","0.1.4"
"35254","646",2023-09-03 05:15:00,-20895,1913,22808,907,FALSE,"out1, fill","0.1.4"
"35255","646",2023-09-03 05:30:00,-20998.75,1913,22911.75,907,FALSE,"out1, fill","0.1.4"
"35256","646",2023-09-03 05:45:00,-21102.5,1913,23015.5,907,FALSE,"out1, fill","0.1.4"
"35257","646",2023-09-03 06:00:00,-21206.25,1913,23119.25,907,FALSE,"out1, fill","0.1.4"
"35258","646",2023-09-03 06:15:00,-21310,1913,23223,907,FALSE,NA,"0.1.4"
"35259","646",2023-09-03 06:30:00,-21437,1913,23350,907,FALSE,NA,"0.1.4"
"35260","646",2023-09-03 06:45:00,-21771,1913,23684,907,FALSE,NA,"0.1.4"
"35261","646",2023-09-03 07:00:00,-21771,1913,23684,907,FALSE,"jump1","0.1.4"
"35262","646",2023-09-03 07:15:00,-21771,1913,23684,907,FALSE,"jump1","0.1.4"
"35263","646",2023-09-03 07:30:00,-21522,1913,23435,907,FALSE,NA,"0.1.4"
"35264","646",2023-09-03 07:45:00,-21668,1913,23581,907,FALSE,NA,"0.1.4"
"35265","646",2023-09-03 08:00:00,-21680,1913,23593,907,FALSE,NA,"0.1.4"
"35266","646",2023-09-03 08:15:00,-21584,1913,23497,907,FALSE,NA,"0.1.4"
"35267","646",2023-09-03 08:30:00,-21538,1913,23451,907,FALSE,NA,"0.1.4"
"35268","646",2023-09-03 08:45:00,-21461,1913,23374,907,FALSE,NA,"0.1.4"
"35269","646",2023-09-03 09:00:00,-21452,1913,23365,907,FALSE,NA,"0.1.4"
"35270","646",2023-09-03 09:15:00,-21480,1913,23393,907,FALSE,NA,"0.1.4"
"35271","646",2023-09-03 09:30:00,-21336,1913,23249,907,FALSE,NA,"0.1.4"
"35272","646",2023-09-03 09:45:00,-21450,1913,23363,907,FALSE,NA,"0.1.4"
"35273","646",2023-09-03 10:00:00,-21537,1913,23450,907,FALSE,NA,"0.1.4"
"35274","646",2023-09-03 10:15:00,-21459,1913,23372,907,FALSE,NA,"0.1.4"
"35275","646",2023-09-03 10:30:00,-21590,1913,23503,907,FALSE,NA,"0.1.4"
"35276","646",2023-09-03 10:45:00,-21536,1913,23449,907,FALSE,NA,"0.1.4"
"35277","646",2023-09-03 11:00:00,-21505,1913,23418,907,FALSE,NA,"0.1.4"
"35278","646",2023-09-03 11:15:00,-21520,1913,23433,907,FALSE,NA,"0.1.4"
"35279","646",2023-09-03 11:30:00,-21499,1913,23412,907,FALSE,NA,"0.1.4"
"35280","646",2023-09-03 11:45:00,-21548,1913,23461,907,FALSE,NA,"0.1.4"
"35281","646",2023-09-03 12:00:00,-21512,1913,23425,907,FALSE,NA,"0.1.4"
"35282","646",2023-09-03 12:15:00,-21482,1913,23395,907,FALSE,NA,"0.1.4"
"35283","646",2023-09-03 12:30:00,-21473,1913,23386,907,FALSE,NA,"0.1.4"
"35284","646",2023-09-03 12:45:00,-21392,1913,23305,907,FALSE,NA,"0.1.4"
"35285","646",2023-09-03 13:00:00,-21491,1913,23404,907,FALSE,NA,"0.1.4"
"35286","646",2023-09-03 13:15:00,-21494,1913,23407,907,FALSE,NA,"0.1.4"
"35287","646",2023-09-03 13:30:00,-21339,1913,23252,907,FALSE,NA,"0.1.4"
"35288","646",2023-09-03 13:45:00,-21326,1913,23239,907,FALSE,NA,"0.1.4"
"35289","646",2023-09-03 14:00:00,-21193,1913,23106,907,FALSE,NA,"0.1.4"
"35290","646",2023-09-03 14:15:00,-21309,1913,23222,907,FALSE,NA,"0.1.4"
"35291","646",2023-09-03 14:30:00,-21535,1913,23448,907,FALSE,NA,"0.1.4"
"35292","646",2023-09-03 14:45:00,-21593,1913,23506,907,FALSE,NA,"0.1.4"
"35293","646",2023-09-03 15:00:00,-21429,1913,23342,907,FALSE,NA,"0.1.4"
"35294","646",2023-09-03 15:15:00,-21394,1913,23307,907,FALSE,NA,"0.1.4"
"35295","646",2023-09-03 15:30:00,-21142,1913,23055,907,FALSE,NA,"0.1.4"
"35296","646",2023-09-03 15:45:00,-21202,1913,23115,907,FALSE,NA,"0.1.4"
"35297","646",2023-09-03 16:00:00,-21186,1913,23099,907,FALSE,NA,"0.1.4"
"35298","646",2023-09-03 16:15:00,-21377,1913,23290,907,FALSE,NA,"0.1.4"
"35299","646",2023-09-03 16:30:00,-21161,1913,23074,907,FALSE,NA,"0.1.4"
"35300","646",2023-09-03 16:45:00,-20974,1913,22887,907,FALSE,NA,"0.1.4"
"35301","646",2023-09-03 17:00:00,-21090,1913,23003,907,FALSE,NA,"0.1.4"
"35302","646",2023-09-03 17:15:00,-21113,1913,23026,907,FALSE,NA,"0.1.4"
"35303","646",2023-09-03 17:30:00,-21394,1913,23307,907,FALSE,NA,"0.1.4"
"35304","646",2023-09-03 17:45:00,-21377,1913,23290,907,FALSE,NA,"0.1.4"
"35305","646",2023-09-03 18:00:00,-21377,1913,23290,907,FALSE,"jump1","0.1.4"
"35306","646",2023-09-03 18:15:00,-20962,1913,22875,907,FALSE,NA,"0.1.4"
"35307","646",2023-09-03 18:30:00,-20931,1913,22844,907,FALSE,NA,"0.1.4"
"35308","646",2023-09-03 18:45:00,-21185,1913,23098,907,FALSE,"out1, fill","0.1.4"
"35309","646",2023-09-03 19:00:00,-21439,1913,23352,907,FALSE,NA,"0.1.4"
"35310","646",2023-09-03 19:15:00,-21439,1913,23352,907,FALSE,"jump1","0.1.4"
"35311","646",2023-09-03 19:30:00,-21438,1913,23351,907,FALSE,NA,"0.1.4"
"35312","646",2023-09-03 19:45:00,-21445,1913,23358,907,FALSE,NA,"0.1.4"
"35313","646",2023-09-03 20:00:00,-21484,1913,23397,907,FALSE,NA,"0.1.4"
"35314","646",2023-09-03 20:15:00,-21443,1913,23356,907,FALSE,NA,"0.1.4"
"35315","646",2023-09-03 20:30:00,-21447,1913,23360,907,FALSE,NA,"0.1.4"
"35316","646",2023-09-03 20:45:00,-21420,1913,23333,907,FALSE,NA,"0.1.4"
"35317","646",2023-09-03 21:00:00,-21444,1913,23357,907,FALSE,NA,"0.1.4"
"35318","646",2023-09-03 21:15:00,-21425,1913,23338,907,FALSE,NA,"0.1.4"
"35319","646",2023-09-03 21:30:00,-21459,1913,23372,907,FALSE,NA,"0.1.4"
"35320","646",2023-09-03 21:45:00,-21416,1913,23329,907,FALSE,NA,"0.1.4"
"35321","646",2023-09-03 22:00:00,-21437,1913,23350,907,FALSE,NA,"0.1.4"
"35322","646",2023-09-03 22:15:00,-21441,1913,23354,907,FALSE,NA,"0.1.4"
"35323","646",2023-09-03 22:30:00,-21446,1913,23359,907,FALSE,NA,"0.1.4"
"35324","646",2023-09-03 22:45:00,-21446,1913,23359,907,FALSE,NA,"0.1.4"
"35325","646",2023-09-03 23:00:00,-21475,1913,23388,907,FALSE,NA,"0.1.4"
"35326","646",2023-09-03 23:15:00,-21429,1913,23342,907,FALSE,NA,"0.1.4"
"35327","646",2023-09-03 23:30:00,-21430,1913,23343,907,FALSE,NA,"0.1.4"
"35328","646",2023-09-03 23:45:00,-21446,1913,23359,907,FALSE,NA,"0.1.4"
"35329","646",2023-09-04,-21445,1913,23358,907,FALSE,NA,"0.1.4"
"35330","646",2023-09-04 00:15:00,-21446,1913,23359,907,FALSE,NA,"0.1.4"
"35331","646",2023-09-04 00:30:00,-21429,1913,23342,907,FALSE,NA,"0.1.4"
"35332","646",2023-09-04 00:45:00,-21469,1913,23382,907,FALSE,NA,"0.1.4"
"35333","646",2023-09-04 01:00:00,-21443,1913,23356,907,FALSE,NA,"0.1.4"
"35334","646",2023-09-04 01:15:00,-21481,1913,23394,907,FALSE,NA,"0.1.4"
"35335","646",2023-09-04 01:30:00,-21481,1913,23394,907,FALSE,NA,"0.1.4"
"35336","646",2023-09-04 01:45:00,-21618,1913,23531,907,FALSE,NA,"0.1.4"
"35337","646",2023-09-04 02:00:00,-21428,1913,23341,907,FALSE,NA,"0.1.4"
"35338","646",2023-09-04 02:15:00,-21447,1913,23360,907,FALSE,NA,"0.1.4"
"35339","646",2023-09-04 02:30:00,-21558,1913,23471,907,FALSE,NA,"0.1.4"
"35340","646",2023-09-04 02:45:00,-21963,1913,23876,907,FALSE,NA,"0.1.4"
"35341","646",2023-09-04 03:00:00,-21476,1913,23389,907,FALSE,NA,"0.1.4"
"35342","646",2023-09-04 03:15:00,-21459.6666666667,1913,23372.6666666667,907,FALSE,"out1, fill","0.1.4"
"35343","646",2023-09-04 03:30:00,-21443.3333333333,1913,23356.3333333333,907,FALSE,"out1, fill","0.1.4"
"35344","646",2023-09-04 03:45:00,-21427,1913,23340,907,FALSE,NA,"0.1.4"
"35345","646",2023-09-04 04:00:00,-21465,1913,23378,907,FALSE,NA,"0.1.4"
"35346","646",2023-09-04 04:15:00,-21494,1913,23407,907,FALSE,NA,"0.1.4"
"35347","646",2023-09-04 04:30:00,-21466.3333333333,1913,23379.3333333333,907,FALSE,"out1, fill","0.1.4"
"35348","646",2023-09-04 04:45:00,-21438.6666666667,1913,23351.6666666667,907,FALSE,"out1, fill","0.1.4"
"35349","646",2023-09-04 05:00:00,-21411,1913,23324,907,FALSE,NA,"0.1.4"
"35350","646",2023-09-04 05:15:00,-21396,1913,23309,907,FALSE,NA,"0.1.4"
"35351","646",2023-09-04 05:30:00,-21396,1913,23309,907,FALSE,"jump1","0.1.4"
"35352","646",2023-09-04 05:45:00,-21349,1913,23262,907,FALSE,NA,"0.1.4"
"35353","646",2023-09-04 06:00:00,-20928,1913,22841,907,FALSE,NA,"0.1.4"
"35354","646",2023-09-04 06:15:00,-21399,1913,23312,907,FALSE,NA,"0.1.4"
"35355","646",2023-09-04 06:30:00,-21399,1913,23312,907,FALSE,"jump1","0.1.4"
"35356","646",2023-09-04 06:45:00,-21399,1913,23312,907,FALSE,"out1, fill","0.1.4"
"35357","646",2023-09-04 07:00:00,-21399,1913,23312,907,FALSE,"jump1","0.1.4"
"35358","646",2023-09-04 07:15:00,-21389,1913,23302,907,FALSE,NA,"0.1.4"
"35359","646",2023-09-04 07:30:00,-21393,1913,23306,907,FALSE,NA,"0.1.4"
"35360","646",2023-09-04 07:45:00,-21368,1913,23281,907,FALSE,NA,"0.1.4"
"35361","646",2023-09-04 08:00:00,-21376,1913,23289,907,FALSE,NA,"0.1.4"
"35362","646",2023-09-04 08:15:00,-21376,1913,23289,907,FALSE,NA,"0.1.4"
"35363","646",2023-09-04 08:30:00,-21384,1913,23297,907,FALSE,NA,"0.1.4"
"35364","646",2023-09-04 08:45:00,-21381,1913,23294,907,FALSE,NA,"0.1.4"
"35365","646",2023-09-04 09:00:00,-21420,1913,23333,907,FALSE,NA,"0.1.4"
"35366","646",2023-09-04 09:15:00,-21410,1913,23323,907,FALSE,NA,"0.1.4"
"35367","646",2023-09-04 09:30:00,-21786,1913,23699,907,FALSE,NA,"0.1.4"
"35368","646",2023-09-04 09:45:00,-21763,1913,23676,907,FALSE,"out1, fill","0.1.4"
"35369","646",2023-09-04 10:00:00,-21740,1913,23653,907,FALSE,"out1, fill","0.1.4"
"35370","646",2023-09-04 10:15:00,-21717,1913,23630,907,FALSE,"out1, fill","0.1.4"
"35371","646",2023-09-04 10:30:00,-21694,1913,23607,907,FALSE,"out1, fill","0.1.4"
"35372","646",2023-09-04 10:45:00,-21671,1913,23584,907,FALSE,NA,"0.1.4"
"35373","646",2023-09-04 11:00:00,-21365,1913,23278,907,FALSE,NA,"0.1.4"
"35374","646",2023-09-04 11:15:00,-21348,1913,23261,907,FALSE,NA,"0.1.4"
"35375","646",2023-09-04 11:30:00,-21380,1913,23293,907,FALSE,NA,"0.1.4"
"35376","646",2023-09-04 11:45:00,-21352,1913,23265,907,FALSE,NA,"0.1.4"
"35377","646",2023-09-04 12:00:00,-21351,1913,23264,907,FALSE,NA,"0.1.4"
"35378","646",2023-09-04 12:15:00,-21349,1913,23262,907,FALSE,NA,"0.1.4"
"35379","646",2023-09-04 12:30:00,-21355,1913,23268,907,FALSE,NA,"0.1.4"
"35380","646",2023-09-04 12:45:00,-21351,1913,23264,907,FALSE,NA,"0.1.4"
"35381","646",2023-09-04 13:00:00,-21359,1913,23272,907,FALSE,NA,"0.1.4"
"35382","646",2023-09-04 13:15:00,-21348,1913,23261,907,FALSE,NA,"0.1.4"
"35383","646",2023-09-04 13:30:00,-21349,1913,23262,907,FALSE,NA,"0.1.4"
"35384","646",2023-09-04 13:45:00,-21365,1913,23278,907,FALSE,NA,"0.1.4"
"35385","646",2023-09-04 14:00:00,-21395,1913,23308,907,FALSE,NA,"0.1.4"
"35386","646",2023-09-04 14:15:00,-21372,1913,23285,907,FALSE,NA,"0.1.4"
"35387","646",2023-09-04 14:30:00,-21775,1913,23688,907,FALSE,NA,"0.1.4"
"35388","646",2023-09-04 14:45:00,-21727,1913,23640,907,FALSE,NA,"0.1.4"
"35389","646",2023-09-04 15:00:00,-21415,1913,23328,907,FALSE,NA,"0.1.4"
"35390","646",2023-09-04 15:15:00,-21363,1913,23276,907,FALSE,NA,"0.1.4"
"35391","646",2023-09-04 15:30:00,-21362,1913,23275,907,FALSE,NA,"0.1.4"
"35392","646",2023-09-04 15:45:00,-21363,1913,23276,907,FALSE,NA,"0.1.4"
"35393","646",2023-09-04 16:00:00,-21352,1913,23265,907,FALSE,NA,"0.1.4"
"35394","646",2023-09-04 16:15:00,-21358,1913,23271,907,FALSE,NA,"0.1.4"
"35395","646",2023-09-04 16:30:00,-21351,1913,23264,907,FALSE,NA,"0.1.4"
"35396","646",2023-09-04 16:45:00,-21349,1913,23262,907,FALSE,NA,"0.1.4"
"35397","646",2023-09-04 17:00:00,-21356,1913,23269,907,FALSE,NA,"0.1.4"
"35398","646",2023-09-04 17:15:00,-21346,1913,23259,907,FALSE,NA,"0.1.4"
"35399","646",2023-09-04 17:30:00,-21348,1913,23261,907,FALSE,NA,"0.1.4"
"35400","646",2023-09-04 17:45:00,-21353,1913,23266,907,FALSE,NA,"0.1.4"
"35401","646",2023-09-04 18:00:00,-21348,1913,23261,907,FALSE,NA,"0.1.4"
"35402","646",2023-09-04 18:15:00,-21354,1913,23267,907,FALSE,NA,"0.1.4"
"35403","646",2023-09-04 18:30:00,-21334,1913,23247,907,FALSE,NA,"0.1.4"
"35404","646",2023-09-04 18:45:00,-21334,1913,23247,907,FALSE,NA,"0.1.4"
"35405","646",2023-09-04 19:00:00,-21343,1913,23256,907,FALSE,NA,"0.1.4"
"35406","646",2023-09-04 19:15:00,-21583,1913,23496,907,FALSE,NA,"0.1.4"
"35407","646",2023-09-04 19:30:00,-21603.5,1913,23516.5,907,FALSE,"out1, fill","0.1.4"
"35408","646",2023-09-04 19:45:00,-21624,1913,23537,907,FALSE,"out1, fill","0.1.4"
"35409","646",2023-09-04 20:00:00,-21644.5,1913,23557.5,907,FALSE,"out1, fill","0.1.4"
"35410","646",2023-09-04 20:15:00,-21665,1913,23578,907,FALSE,NA,"0.1.4"
"35411","646",2023-09-04 20:30:00,-21374,1913,23287,907,FALSE,NA,"0.1.4"
"35412","646",2023-09-04 20:45:00,-21358,1913,23271,907,FALSE,NA,"0.1.4"
"35413","646",2023-09-04 21:00:00,-21357,1913,23270,907,FALSE,NA,"0.1.4"
"35414","646",2023-09-04 21:15:00,-21368,1913,23281,907,FALSE,NA,"0.1.4"
"35415","646",2023-09-04 21:30:00,-21363,1913,23276,907,FALSE,NA,"0.1.4"
"35416","646",2023-09-04 21:45:00,-21355,1913,23268,907,FALSE,NA,"0.1.4"
"35417","646",2023-09-04 22:00:00,-21356,1913,23269,907,FALSE,NA,"0.1.4"
"35418","646",2023-09-04 22:15:00,-21352,1913,23265,907,FALSE,NA,"0.1.4"
"35419","646",2023-09-04 22:30:00,-21356,1913,23269,907,FALSE,NA,"0.1.4"
"35420","646",2023-09-04 22:45:00,-21355,1913,23268,907,FALSE,NA,"0.1.4"
"35421","646",2023-09-04 23:00:00,-21361,1913,23274,907,FALSE,NA,"0.1.4"
"35422","646",2023-09-04 23:15:00,-21384,1913,23297,907,FALSE,NA,"0.1.4"
"35423","646",2023-09-04 23:30:00,-21358,1913,23271,907,FALSE,NA,"0.1.4"
"35424","646",2023-09-04 23:45:00,-21365,1913,23278,907,FALSE,NA,"0.1.4"
"35425","646",2023-09-05,-21365,1913,23278,907,FALSE,NA,"0.1.4"
"35426","646",2023-09-05 00:15:00,-21363,1913,23276,907,FALSE,NA,"0.1.4"
"35427","646",2023-09-05 00:30:00,-21358,1913,23271,907,FALSE,NA,"0.1.4"
"35428","646",2023-09-05 00:45:00,-21355,1913,23268,907,FALSE,NA,"0.1.4"
"35429","646",2023-09-05 01:00:00,-21357,1913,23270,907,FALSE,NA,"0.1.4"
"35430","646",2023-09-05 01:15:00,-21352,1913,23265,907,FALSE,NA,"0.1.4"
"35431","646",2023-09-05 01:30:00,-21342,1913,23255,907,FALSE,NA,"0.1.4"
"35432","646",2023-09-05 01:45:00,-21336,1913,23249,907,FALSE,NA,"0.1.4"
"35433","646",2023-09-05 02:00:00,-21351,1913,23264,907,FALSE,NA,"0.1.4"
"35434","646",2023-09-05 02:15:00,-21796,1913,23709,907,FALSE,NA,"0.1.4"
"35435","646",2023-09-05 02:30:00,-21360,1913,23273,907,FALSE,NA,"0.1.4"
"35436","646",2023-09-05 02:45:00,-21414.5,1913,23327.5,907,FALSE,"out1, fill","0.1.4"
"35437","646",2023-09-05 03:00:00,-21469,1913,23382,907,FALSE,"out1, fill","0.1.4"
"35438","646",2023-09-05 03:15:00,-21523.5,1913,23436.5,907,FALSE,"out1, fill","0.1.4"
"35439","646",2023-09-05 03:30:00,-21578,1913,23491,907,FALSE,NA,"0.1.4"
"35440","646",2023-09-05 03:45:00,-21971,1913,23884,907,FALSE,NA,"0.1.4"
"35441","646",2023-09-05 04:00:00,-21970,1913,23883,907,FALSE,NA,"0.1.4"
"35442","646",2023-09-05 04:15:00,-21970,1913,23883,907,FALSE,"jump1","0.1.4"
"35443","646",2023-09-05 04:30:00,-22163.3333333333,1913,24076.3333333333,907,FALSE,"out1, fill","0.1.4"
"35444","646",2023-09-05 04:45:00,-22356.6666666667,1913,24269.6666666667,907,FALSE,"out1, fill","0.1.4"
"35445","646",2023-09-05 05:00:00,-22550,1913,24463,907,FALSE,NA,"0.1.4"
"35446","646",2023-09-05 05:15:00,-22550,1913,24463,907,FALSE,"jump1","0.1.4"
"35447","646",2023-09-05 05:30:00,-22665,1913,24578,907,FALSE,NA,"0.1.4"
"35448","646",2023-09-05 05:45:00,-22508,1913,24421,907,FALSE,NA,"0.1.4"
"35449","646",2023-09-05 06:00:00,-22561,1913,24474,907,FALSE,NA,"0.1.4"
"35450","646",2023-09-05 06:15:00,-22504,1913,24417,907,FALSE,NA,"0.1.4"
"35451","646",2023-09-05 06:30:00,-22510,1913,24423,907,FALSE,NA,"0.1.4"
"35452","646",2023-09-05 06:45:00,-22498,1913,24411,907,FALSE,NA,"0.1.4"
"35453","646",2023-09-05 07:00:00,-22494,1913,24407,907,FALSE,NA,"0.1.4"
"35454","646",2023-09-05 07:15:00,-22484,1913,24397,907,FALSE,NA,"0.1.4"
"35455","646",2023-09-05 07:30:00,-22913,1913,24826,907,FALSE,NA,"0.1.4"
"35456","646",2023-09-05 07:45:00,-22892,1913,24805,907,FALSE,NA,"0.1.4"
"35457","646",2023-09-05 08:00:00,-22572,1913,24485,907,FALSE,NA,"0.1.4"
"35458","646",2023-09-05 08:15:00,-22519,1913,24432,907,FALSE,NA,"0.1.4"
"35459","646",2023-09-05 08:30:00,-22504,1913,24417,907,FALSE,NA,"0.1.4"
"35460","646",2023-09-05 08:45:00,-22483,1913,24396,907,FALSE,NA,"0.1.4"
"35461","646",2023-09-05 09:00:00,-22481,1913,24394,907,FALSE,NA,"0.1.4"
"35462","646",2023-09-05 09:15:00,-22482,1913,24395,907,FALSE,NA,"0.1.4"
"35463","646",2023-09-05 09:30:00,-22476,1913,24389,907,FALSE,NA,"0.1.4"
"35464","646",2023-09-05 09:45:00,-22481,1913,24394,907,FALSE,NA,"0.1.4"
"35465","646",2023-09-05 10:00:00,-22470,1913,24383,907,FALSE,NA,"0.1.4"
"35466","646",2023-09-05 10:15:00,-22470,1913,24383,907,FALSE,NA,"0.1.4"
"35467","646",2023-09-05 10:30:00,-22465,1913,24378,907,FALSE,NA,"0.1.4"
"35468","646",2023-09-05 10:45:00,-22476,1913,24389,907,FALSE,NA,"0.1.4"
"35469","646",2023-09-05 11:00:00,-22471,1913,24384,907,FALSE,NA,"0.1.4"
"35470","646",2023-09-05 11:15:00,-22473,1913,24386,907,FALSE,NA,"0.1.4"
"35471","646",2023-09-05 11:30:00,-22472,1913,24385,907,FALSE,NA,"0.1.4"
"35472","646",2023-09-05 11:45:00,-22479,1913,24392,907,FALSE,NA,"0.1.4"
"35473","646",2023-09-05 12:00:00,-22481,1913,24394,907,FALSE,NA,"0.1.4"
"35474","646",2023-09-05 12:15:00,-22523,1913,24436,907,FALSE,NA,"0.1.4"
"35475","646",2023-09-05 12:30:00,-22555,1913,24468,907,FALSE,NA,"0.1.4"
"35476","646",2023-09-05 12:45:00,-22548,1913,24461,907,FALSE,NA,"0.1.4"
"35477","646",2023-09-05 13:00:00,-22559,1913,24472,907,FALSE,NA,"0.1.4"
"35478","646",2023-09-05 13:15:00,-22514,1913,24427,907,FALSE,NA,"0.1.4"
"35479","646",2023-09-05 13:30:00,-22522,1913,24435,907,FALSE,NA,"0.1.4"
"35480","646",2023-09-05 13:45:00,-22513,1913,24426,907,FALSE,NA,"0.1.4"
"35481","646",2023-09-05 14:00:00,-22504,1913,24417,907,FALSE,NA,"0.1.4"
"35482","646",2023-09-05 14:15:00,-22493,1913,24406,907,FALSE,NA,"0.1.4"
"35483","646",2023-09-05 14:30:00,-22593,1913,24506,907,FALSE,NA,"0.1.4"
"35484","646",2023-09-05 14:45:00,-22502,1913,24415,907,FALSE,NA,"0.1.4"
"35485","646",2023-09-05 15:00:00,-22492,1913,24405,907,FALSE,NA,"0.1.4"
"35486","646",2023-09-05 15:15:00,-22497,1913,24410,907,FALSE,NA,"0.1.4"
"35487","646",2023-09-05 15:30:00,-22498,1913,24411,907,FALSE,NA,"0.1.4"
"35488","646",2023-09-05 15:45:00,-22502,1913,24415,907,FALSE,NA,"0.1.4"
"35489","646",2023-09-05 16:00:00,-22496,1913,24409,907,FALSE,NA,"0.1.4"
"35490","646",2023-09-05 16:15:00,-22488,1913,24401,907,FALSE,NA,"0.1.4"
"35491","646",2023-09-05 16:30:00,-22498,1913,24411,907,FALSE,NA,"0.1.4"
"35492","646",2023-09-05 16:45:00,-22488,1913,24401,907,FALSE,NA,"0.1.4"
"35493","646",2023-09-05 17:00:00,-22498,1913,24411,907,FALSE,NA,"0.1.4"
"35494","646",2023-09-05 17:15:00,-22497,1913,24410,907,FALSE,NA,"0.1.4"
"35495","646",2023-09-05 17:30:00,-22491,1913,24404,907,FALSE,NA,"0.1.4"
"35496","646",2023-09-05 17:45:00,-22543,1913,24456,907,FALSE,NA,"0.1.4"
"35497","646",2023-09-05 18:00:00,-22488,1913,24401,907,FALSE,NA,"0.1.4"
"35498","646",2023-09-05 18:15:00,-22493,1913,24406,907,FALSE,NA,"0.1.4"
"35499","646",2023-09-05 18:30:00,-22493,1913,24406,907,FALSE,NA,"0.1.4"
"35500","646",2023-09-05 18:45:00,-22490,1913,24403,907,FALSE,NA,"0.1.4"
"35501","646",2023-09-05 19:00:00,-22492.1111111111,1913,24405.1111111111,907,FALSE,"out1, fill","0.1.4"
"35502","646",2023-09-05 19:15:00,-22494.2222222222,1913,24407.2222222222,907,FALSE,"out1, fill","0.1.4"
"35503","646",2023-09-05 19:30:00,-22496.3333333333,1913,24409.3333333333,907,FALSE,"out1, fill","0.1.4"
"35504","646",2023-09-05 19:45:00,-22498.4444444444,1913,24411.4444444444,907,FALSE,"out1, fill","0.1.4"
"35505","646",2023-09-05 20:00:00,-22500.5555555556,1913,24413.5555555556,907,FALSE,"out1, fill","0.1.4"
"35506","646",2023-09-05 20:15:00,-22502.6666666667,1913,24415.6666666667,907,FALSE,"out1, fill","0.1.4"
"35507","646",2023-09-05 20:30:00,-22504.7777777778,1913,24417.7777777778,907,FALSE,"out1, fill","0.1.4"
"35508","646",2023-09-05 20:45:00,-22506.8888888889,1913,24419.8888888889,907,FALSE,"out1, fill","0.1.4"
"35509","646",2023-09-05 21:00:00,-22509,1913,24422,907,FALSE,NA,"0.1.4"
"35510","646",2023-09-05 21:15:00,-22502,1913,24415,907,FALSE,NA,"0.1.4"
"35511","646",2023-09-05 21:30:00,-22691,1913,24604,907,FALSE,NA,"0.1.4"
"35512","646",2023-09-05 21:45:00,-22508,1913,24421,907,FALSE,NA,"0.1.4"
"35513","646",2023-09-05 22:00:00,-22509,1913,24422,907,FALSE,"out1, fill","0.1.4"
"35514","646",2023-09-05 22:15:00,-22510,1913,24423,907,FALSE,"out1, fill","0.1.4"
"35515","646",2023-09-05 22:30:00,-22511,1913,24424,907,FALSE,NA,"0.1.4"
"35516","646",2023-09-05 22:45:00,-22513,1913,24426,907,FALSE,NA,"0.1.4"
"35517","646",2023-09-05 23:00:00,-22556,1913,24469,907,FALSE,NA,"0.1.4"
"35518","646",2023-09-05 23:15:00,-22551,1913,24464,907,FALSE,"out1, fill","0.1.4"
"35519","646",2023-09-05 23:30:00,-22546,1913,24459,907,FALSE,"out1, fill","0.1.4"
"35520","646",2023-09-05 23:45:00,-22541,1913,24454,907,FALSE,"out1, fill","0.1.4"
"35521","646",2023-09-06,-22536,1913,24449,907,FALSE,"out1, fill","0.1.4"
"35522","646",2023-09-06 00:15:00,-22531,1913,24444,907,FALSE,"out1, fill","0.1.4"
"35523","646",2023-09-06 00:30:00,-22526,1913,24439,907,FALSE,"out1, fill","0.1.4"
"35524","646",2023-09-06 00:45:00,-22521,1913,24434,907,FALSE,NA,"0.1.4"
"35525","646",2023-09-06 01:00:00,-22981,1913,24894,907,FALSE,NA,"0.1.4"
"35526","646",2023-09-06 01:15:00,-22919,1913,24832,907,FALSE,NA,"0.1.4"
"35527","646",2023-09-06 01:30:00,-22509,1913,24422,907,FALSE,NA,"0.1.4"
"35528","646",2023-09-06 01:45:00,-22509,1913,24422,907,FALSE,NA,"0.1.4"
"35529","646",2023-09-06 02:00:00,-22844,1913,24757,907,FALSE,NA,"0.1.4"
"35530","646",2023-09-06 02:15:00,-23318,1913,25231,907,FALSE,NA,"0.1.4"
"35531","646",2023-09-06 02:30:00,-23237,1913,25150,907,FALSE,"out1, fill","0.1.4"
"35532","646",2023-09-06 02:45:00,-23156,1913,25069,907,FALSE,"out1, fill","0.1.4"
"35533","646",2023-09-06 03:00:00,-23075,1913,24988,907,FALSE,"out1, fill","0.1.4"
"35534","646",2023-09-06 03:15:00,-22994,1913,24907,907,FALSE,"out1, fill","0.1.4"
"35535","646",2023-09-06 03:30:00,-22913,1913,24826,907,FALSE,"out1, fill","0.1.4"
"35536","646",2023-09-06 03:45:00,-22832,1913,24745,907,FALSE,NA,"0.1.4"
"35537","646",2023-09-06 04:00:00,-23187,1913,25100,907,FALSE,NA,"0.1.4"
"35538","646",2023-09-06 04:15:00,-23154,1913,25067,907,FALSE,NA,"0.1.4"
"35539","646",2023-09-06 04:30:00,-22951,1913,24864,907,FALSE,NA,"0.1.4"
"35540","646",2023-09-06 04:45:00,-22987.3333333333,1913,24900.3333333333,907,FALSE,"out1, fill","0.1.4"
"35541","646",2023-09-06 05:00:00,-23023.6666666667,1913,24936.6666666667,907,FALSE,"out1, fill","0.1.4"
"35542","646",2023-09-06 05:15:00,-23060,1913,24973,907,FALSE,NA,"0.1.4"
"35543","646",2023-09-06 05:30:00,-22580,1913,24493,907,FALSE,NA,"0.1.4"
"35544","646",2023-09-06 05:45:00,-22580,1913,24493,907,FALSE,"jump1","0.1.4"
"35545","646",2023-09-06 06:00:00,-22421,1913,24334,907,FALSE,NA,"0.1.4"
"35546","646",2023-09-06 06:15:00,-22421,1913,24334,907,FALSE,"jump1","0.1.4"
"35547","646",2023-09-06 06:30:00,-22421,1913,24334,907,FALSE,"out1, fill","0.1.4"
"35548","646",2023-09-06 06:45:00,-22421,1913,24334,907,FALSE,"jump1","0.1.4"
"35549","646",2023-09-06 07:00:00,-22421,1913,24334,907,FALSE,"jump1","0.1.4"
"35550","646",2023-09-06 07:15:00,-22072,1913,23985,907,FALSE,NA,"0.1.4"
"35551","646",2023-09-06 07:30:00,-21743,1913,23656,907,FALSE,NA,"0.1.4"
"35552","646",2023-09-06 07:45:00,-22076,1913,23989,907,FALSE,NA,"0.1.4"
"35553","646",2023-09-06 08:00:00,-21790,1913,23703,907,FALSE,NA,"0.1.4"
"35554","646",2023-09-06 08:15:00,-21640,1913,23553,907,FALSE,NA,"0.1.4"
"35555","646",2023-09-06 08:30:00,-21634,1913,23547,907,FALSE,NA,"0.1.4"
"35556","646",2023-09-06 08:45:00,-21652,1913,23565,907,FALSE,NA,"0.1.4"
"35557","646",2023-09-06 09:00:00,-21702,1913,23615,907,FALSE,NA,"0.1.4"
"35558","646",2023-09-06 09:15:00,-22027,1913,23940,907,FALSE,NA,"0.1.4"
"35559","646",2023-09-06 09:30:00,-21908,1913,23821,907,FALSE,NA,"0.1.4"
"35560","646",2023-09-06 09:45:00,-21647,1913,23560,907,FALSE,NA,"0.1.4"
"35561","646",2023-09-06 10:00:00,-21900,1913,23813,907,FALSE,NA,"0.1.4"
"35562","646",2023-09-06 10:15:00,-21845,1913,23758,907,FALSE,NA,"0.1.4"
"35563","646",2023-09-06 10:30:00,-21661,1913,23574,907,FALSE,NA,"0.1.4"
"35564","646",2023-09-06 10:45:00,-21645,1913,23558,907,FALSE,NA,"0.1.4"
"35565","646",2023-09-06 11:00:00,-21778,1913,23691,907,FALSE,"out1, fill","0.1.4"
"35566","646",2023-09-06 11:15:00,-21911,1913,23824,907,FALSE,"out1, fill","0.1.4"
"35567","646",2023-09-06 11:30:00,-22044,1913,23957,907,FALSE,NA,"0.1.4"
"35568","646",2023-09-06 11:45:00,-21664,1913,23577,907,FALSE,NA,"0.1.4"
"35569","646",2023-09-06 12:00:00,-21640,1913,23553,907,FALSE,NA,"0.1.4"
"35570","646",2023-09-06 12:15:00,-21986,1913,23899,907,FALSE,NA,"0.1.4"
"35571","646",2023-09-06 12:30:00,-22212,1913,24125,907,FALSE,NA,"0.1.4"
"35572","646",2023-09-06 12:45:00,-22115,1913,24028,907,FALSE,NA,"0.1.4"
"35573","646",2023-09-06 13:00:00,-21732,1913,23645,907,FALSE,NA,"0.1.4"
"35574","646",2023-09-06 13:15:00,-21708,1913,23621,907,FALSE,NA,"0.1.4"
"35575","646",2023-09-06 13:30:00,-21708,1913,23621,907,FALSE,"jump1","0.1.4"
"35576","646",2023-09-06 13:45:00,-21583,1913,23496,907,FALSE,NA,"0.1.4"
"35577","646",2023-09-06 14:00:00,-21756,1913,23669,907,FALSE,NA,"0.1.4"
"35578","646",2023-09-06 14:15:00,-21756,1913,23669,907,FALSE,"jump1","0.1.4"
"35579","646",2023-09-06 14:30:00,-21534,1913,23447,907,FALSE,NA,"0.1.4"
"35580","646",2023-09-06 14:45:00,-21632,1913,23545,907,FALSE,NA,"0.1.4"
"35581","646",2023-09-06 15:00:00,-21572,1913,23485,907,FALSE,NA,"0.1.4"
"35582","646",2023-09-06 15:15:00,-21573,1913,23486,907,FALSE,NA,"0.1.4"
"35583","646",2023-09-06 15:30:00,-21794,1913,23707,907,FALSE,NA,"0.1.4"
"35584","646",2023-09-06 15:45:00,-21795,1913,23708,907,FALSE,NA,"0.1.4"
"35585","646",2023-09-06 16:00:00,-21474,1913,23387,907,FALSE,NA,"0.1.4"
"35586","646",2023-09-06 16:15:00,-21365,1913,23278,907,FALSE,NA,"0.1.4"
"35587","646",2023-09-06 16:30:00,-21164,1913,23077,907,FALSE,"out1, fill","0.1.4"
"35588","646",2023-09-06 16:45:00,-20963,1913,22876,907,FALSE,NA,"0.1.4"
"35589","646",2023-09-06 17:00:00,-20494,1913,22407,907,FALSE,NA,"0.1.4"
"35590","646",2023-09-06 17:15:00,-20884,1913,22797,907,FALSE,NA,"0.1.4"
"35591","646",2023-09-06 17:30:00,-20732,1913,22645,907,FALSE,NA,"0.1.4"
"35592","646",2023-09-06 17:45:00,-20519,1913,22432,907,FALSE,NA,"0.1.4"
"35593","646",2023-09-06 18:00:00,-20450,1913,22363,907,FALSE,NA,"0.1.4"
"35594","646",2023-09-06 18:15:00,-20494,1913,22407,907,FALSE,NA,"0.1.4"
"35595","646",2023-09-06 18:30:00,-20499.6666666667,1913,22412.6666666667,907,FALSE,"out1, fill","0.1.4"
"35596","646",2023-09-06 18:45:00,-20505.3333333333,1913,22418.3333333333,907,FALSE,"out1, fill","0.1.4"
"35597","646",2023-09-06 19:00:00,-20511,1913,22424,907,FALSE,NA,"0.1.4"
"35598","646",2023-09-06 19:15:00,-20572,1913,22485,907,FALSE,NA,"0.1.4"
"35599","646",2023-09-06 19:30:00,-20508,1913,22421,907,FALSE,NA,"0.1.4"
"35600","646",2023-09-06 19:45:00,-20507,1913,22420,907,FALSE,NA,"0.1.4"
"35601","646",2023-09-06 20:00:00,-20496,1913,22409,907,FALSE,NA,"0.1.4"
"35602","646",2023-09-06 20:15:00,-20505,1913,22418,907,FALSE,NA,"0.1.4"
"35603","646",2023-09-06 20:30:00,-20619,1913,22532,907,FALSE,NA,"0.1.4"
"35604","646",2023-09-06 20:45:00,-20601,1913,22514,907,FALSE,"out1, fill","0.1.4"
"35605","646",2023-09-06 21:00:00,-20583,1913,22496,907,FALSE,"out1, fill","0.1.4"
"35606","646",2023-09-06 21:15:00,-20565,1913,22478,907,FALSE,"out1, fill","0.1.4"
"35607","646",2023-09-06 21:30:00,-20547,1913,22460,907,FALSE,"out1, fill","0.1.4"
"35608","646",2023-09-06 21:45:00,-20529,1913,22442,907,FALSE,"out1, fill","0.1.4"
"35609","646",2023-09-06 22:00:00,-20511,1913,22424,907,FALSE,NA,"0.1.4"
"35610","646",2023-09-06 22:15:00,-20579,1913,22492,907,FALSE,NA,"0.1.4"
"35611","646",2023-09-06 22:30:00,-20502,1913,22415,907,FALSE,NA,"0.1.4"
"35612","646",2023-09-06 22:45:00,-20508,1913,22421,907,FALSE,NA,"0.1.4"
"35613","646",2023-09-06 23:00:00,-20508,1913,22421,907,FALSE,NA,"0.1.4"
"35614","646",2023-09-06 23:15:00,-20508,1913,22421,907,FALSE,NA,"0.1.4"
"35615","646",2023-09-06 23:30:00,-20508,1913,22421,907,FALSE,"out1, fill","0.1.4"
"35616","646",2023-09-06 23:45:00,-20508,1913,22421,907,FALSE,"out1, fill","0.1.4"
"35617","646",2023-09-07,-20508,1913,22421,907,FALSE,"out1, fill","0.1.4"
"35618","646",2023-09-07 00:15:00,-20508,1913,22421,907,FALSE,"out1, fill","0.1.4"
"35619","646",2023-09-07 00:30:00,-20508,1913,22421,907,FALSE,NA,"0.1.4"
"35620","646",2023-09-07 00:45:00,-20508,1913,22421,907,FALSE,NA,"0.1.4"
"35621","646",2023-09-07 01:00:00,-20783,1913,22696,907,FALSE,NA,"0.1.4"
"35622","646",2023-09-07 01:15:00,-20739,1913,22652,907,FALSE,NA,"0.1.4"
"35623","646",2023-09-07 01:30:00,-20507,1913,22420,907,FALSE,NA,"0.1.4"
"35624","646",2023-09-07 01:45:00,-20508,1913,22421,907,FALSE,NA,"0.1.4"
"35625","646",2023-09-07 02:00:00,-20509.5714285714,1913,22422.5714285714,907,FALSE,"out1, fill","0.1.4"
"35626","646",2023-09-07 02:15:00,-20511.1428571429,1913,22424.1428571429,907,FALSE,"out1, fill","0.1.4"
"35627","646",2023-09-07 02:30:00,-20512.7142857143,1913,22425.7142857143,907,FALSE,"out1, fill","0.1.4"
"35628","646",2023-09-07 02:45:00,-20514.2857142857,1913,22427.2857142857,907,FALSE,"out1, fill","0.1.4"
"35629","646",2023-09-07 03:00:00,-20515.8571428571,1913,22428.8571428571,907,FALSE,"out1, fill","0.1.4"
"35630","646",2023-09-07 03:15:00,-20517.4285714286,1913,22430.4285714286,907,FALSE,"out1, fill","0.1.4"
"35631","646",2023-09-07 03:30:00,-20519,1913,22432,907,FALSE,NA,"0.1.4"
"35632","646",2023-09-07 03:45:00,-20515,1913,22428,907,FALSE,NA,"0.1.4"
"35633","646",2023-09-07 04:00:00,-20524,1913,22437,907,FALSE,NA,"0.1.4"
"35634","646",2023-09-07 04:15:00,-20687,1913,22600,907,FALSE,NA,"0.1.4"
"35635","646",2023-09-07 04:30:00,-21129,1913,23042,907,FALSE,NA,"0.1.4"
"35636","646",2023-09-07 04:45:00,-21169,1913,23082,907,FALSE,NA,"0.1.4"
"35637","646",2023-09-07 05:00:00,-20948,1913,22861,907,FALSE,NA,"0.1.4"
"35638","646",2023-09-07 05:15:00,-20496,1913,22409,907,FALSE,NA,"0.1.4"
"35639","646",2023-09-07 05:30:00,-20663.6666666667,1913,22576.6666666667,907,FALSE,"out1, fill","0.1.4"
"35640","646",2023-09-07 05:45:00,-20831.3333333333,1913,22744.3333333333,907,FALSE,"out1, fill","0.1.4"
"35641","646",2023-09-07 06:00:00,-20999,1913,22912,907,FALSE,NA,"0.1.4"
"35642","646",2023-09-07 06:15:00,-21145,1913,23058,907,FALSE,NA,"0.1.4"
"35643","646",2023-09-07 06:30:00,-21145,1913,23058,907,FALSE,"jump1","0.1.4"
"35644","646",2023-09-07 06:45:00,-21077,1913,22990,907,FALSE,NA,"0.1.4"
"35645","646",2023-09-07 07:00:00,-21076.8,1913,22989.8,907,FALSE,"out1, fill","0.1.4"
"35646","646",2023-09-07 07:15:00,-21076.6,1913,22989.6,907,FALSE,"out1, fill","0.1.4"
"35647","646",2023-09-07 07:30:00,-21076.4,1913,22989.4,907,FALSE,"out1, fill","0.1.4"
"35648","646",2023-09-07 07:45:00,-21076.2,1913,22989.2,907,FALSE,"out1, fill","0.1.4"
"35649","646",2023-09-07 08:00:00,-21076,1913,22989,907,FALSE,NA,"0.1.4"
"35650","646",2023-09-07 08:15:00,-21076,1913,22989,907,FALSE,NA,"0.1.4"
"35651","646",2023-09-07 08:30:00,-21166,1913,23079,907,FALSE,NA,"0.1.4"
"35652","646",2023-09-07 08:45:00,-21166,1913,23079,907,FALSE,"jump1","0.1.4"
"35653","646",2023-09-07 09:00:00,-21166,1913,23079,907,FALSE,"jump1","0.1.4"
"35654","646",2023-09-07 09:15:00,-21353,1913,23266,907,FALSE,NA,"0.1.4"
"35655","646",2023-09-07 09:30:00,-21174,1913,23087,907,FALSE,NA,"0.1.4"
"35656","646",2023-09-07 09:45:00,-21171,1913,23084,907,FALSE,NA,"0.1.4"
"35657","646",2023-09-07 10:00:00,-21166,1913,23079,907,FALSE,NA,"0.1.4"
"35658","646",2023-09-07 10:15:00,-21166,1913,23079,907,FALSE,"jump1","0.1.4"
"35659","646",2023-09-07 10:30:00,-21166,1913,23079,907,FALSE,"jump1","0.1.4"
"35660","646",2023-09-07 10:45:00,-21460,1913,23373,907,FALSE,NA,"0.1.4"
"35661","646",2023-09-07 11:00:00,-21156,1913,23069,907,FALSE,NA,"0.1.4"
"35662","646",2023-09-07 11:15:00,-21135,1913,23048,907,FALSE,NA,"0.1.4"
"35663","646",2023-09-07 11:30:00,-21333,1913,23246,907,FALSE,NA,"0.1.4"
"35664","646",2023-09-07 11:45:00,-21279,1913,23192,907,FALSE,NA,"0.1.4"
"35665","646",2023-09-07 12:00:00,-21133,1913,23046,907,FALSE,NA,"0.1.4"
"35666","646",2023-09-07 12:15:00,-21136,1913,23049,907,FALSE,NA,"0.1.4"
"35667","646",2023-09-07 12:30:00,-21139.3333333333,1913,23052.3333333333,907,FALSE,"out1, fill","0.1.4"
"35668","646",2023-09-07 12:45:00,-21142.6666666667,1913,23055.6666666667,907,FALSE,"out1, fill","0.1.4"
"35669","646",2023-09-07 13:00:00,-21146,1913,23059,907,FALSE,NA,"0.1.4"
"35670","646",2023-09-07 13:15:00,-21134,1913,23047,907,FALSE,NA,"0.1.4"
"35671","646",2023-09-07 13:30:00,-21139,1913,23052,907,FALSE,NA,"0.1.4"
"35672","646",2023-09-07 13:45:00,-21178,1913,23091,907,FALSE,NA,"0.1.4"
"35673","646",2023-09-07 14:00:00,-21238,1913,23151,907,FALSE,NA,"0.1.4"
"35674","646",2023-09-07 14:15:00,-21328,1913,23241,907,FALSE,NA,"0.1.4"
"35675","646",2023-09-07 14:30:00,-21328,1913,23241,907,FALSE,"jump1","0.1.4"
"35676","646",2023-09-07 14:45:00,-21479,1913,23392,907,FALSE,NA,"0.1.4"
"35677","646",2023-09-07 15:00:00,-21487,1913,23400,907,FALSE,NA,"0.1.4"
"35678","646",2023-09-07 15:15:00,-21528,1913,23441,907,FALSE,NA,"0.1.4"
"35679","646",2023-09-07 15:30:00,-21523,1913,23436,907,FALSE,NA,"0.1.4"
"35680","646",2023-09-07 15:45:00,-21405,1913,23318,907,FALSE,NA,"0.1.4"
"35681","646",2023-09-07 16:00:00,-21273,1913,23186,907,FALSE,NA,"0.1.4"
"35682","646",2023-09-07 16:15:00,-21028,1913,22941,907,FALSE,NA,"0.1.4"
"35683","646",2023-09-07 16:30:00,-21065,1913,22978,907,FALSE,NA,"0.1.4"
"35684","646",2023-09-07 16:45:00,-21065,1913,22978,907,FALSE,"jump1","0.1.4"
"35685","646",2023-09-07 17:00:00,-21509,1913,23422,907,FALSE,NA,"0.1.4"
"35686","646",2023-09-07 17:15:00,-21163,1913,23076,907,FALSE,NA,"0.1.4"
"35687","646",2023-09-07 17:30:00,-21057,1913,22970,907,FALSE,NA,"0.1.4"
"35688","646",2023-09-07 17:45:00,-21068,1913,22981,907,FALSE,NA,"0.1.4"
"35689","646",2023-09-07 18:00:00,-21096,1913,23009,907,FALSE,NA,"0.1.4"
"35690","646",2023-09-07 18:15:00,-21189,1913,23102,907,FALSE,NA,"0.1.4"
"35691","646",2023-09-07 18:30:00,-21174.4285714286,1913,23087.4285714286,907,FALSE,"out1, fill","0.1.4"
"35692","646",2023-09-07 18:45:00,-21159.8571428571,1913,23072.8571428571,907,FALSE,"out1, fill","0.1.4"
"35693","646",2023-09-07 19:00:00,-21145.2857142857,1913,23058.2857142857,907,FALSE,"out1, fill","0.1.4"
"35694","646",2023-09-07 19:15:00,-21130.7142857143,1913,23043.7142857143,907,FALSE,"out1, fill","0.1.4"
"35695","646",2023-09-07 19:30:00,-21116.1428571429,1913,23029.1428571429,907,FALSE,"out1, fill","0.1.4"
"35696","646",2023-09-07 19:45:00,-21101.5714285714,1913,23014.5714285714,907,FALSE,"out1, fill","0.1.4"
"35697","646",2023-09-07 20:00:00,-21087,1913,23000,907,FALSE,NA,"0.1.4"
"35698","646",2023-09-07 20:15:00,-21084,1913,22997,907,FALSE,NA,"0.1.4"
"35699","646",2023-09-07 20:30:00,-21069,1913,22982,907,FALSE,NA,"0.1.4"
"35700","646",2023-09-07 20:45:00,-21061,1913,22974,907,FALSE,NA,"0.1.4"
"35701","646",2023-09-07 21:00:00,-21062,1913,22975,907,FALSE,NA,"0.1.4"
"35702","646",2023-09-07 21:15:00,-21067,1913,22980,907,FALSE,NA,"0.1.4"
"35703","646",2023-09-07 21:30:00,-21143,1913,23056,907,FALSE,NA,"0.1.4"
"35704","646",2023-09-07 21:45:00,-21066,1913,22979,907,FALSE,NA,"0.1.4"
"35705","646",2023-09-07 22:00:00,-21066,1913,22979,907,FALSE,NA,"0.1.4"
"35706","646",2023-09-07 22:15:00,-21066,1913,22979,907,FALSE,NA,"0.1.4"
"35707","646",2023-09-07 22:30:00,-21068,1913,22981,907,FALSE,NA,"0.1.4"
"35708","646",2023-09-07 22:45:00,-21066,1913,22979,907,FALSE,NA,"0.1.4"
"35709","646",2023-09-07 23:00:00,-21078,1913,22991,907,FALSE,NA,"0.1.4"
"35710","646",2023-09-07 23:15:00,-21058,1913,22971,907,FALSE,NA,"0.1.4"
"35711","646",2023-09-07 23:30:00,-21067,1913,22980,907,FALSE,NA,"0.1.4"
"35712","646",2023-09-07 23:45:00,-21068,1913,22981,907,FALSE,NA,"0.1.4"
"35713","646",2023-09-08,-21067,1913,22980,907,FALSE,NA,"0.1.4"
"35714","646",2023-09-08 00:15:00,-21068,1913,22981,907,FALSE,NA,"0.1.4"
"35715","646",2023-09-08 00:30:00,-21068,1913,22981,907,FALSE,"jump1","0.1.4"
"35716","646",2023-09-08 00:45:00,-21068,1913,22981,907,FALSE,"jump1","0.1.4"
"35717","646",2023-09-08 01:00:00,-21070,1913,22983,907,FALSE,NA,"0.1.4"
"35718","646",2023-09-08 01:15:00,-21072,1913,22985,907,FALSE,NA,"0.1.4"
"35719","646",2023-09-08 01:30:00,-21070,1913,22983,907,FALSE,NA,"0.1.4"
"35720","646",2023-09-08 01:45:00,-21071,1913,22984,907,FALSE,"out1, fill","0.1.4"
"35721","646",2023-09-08 02:00:00,-21072,1913,22985,907,FALSE,"out1, fill","0.1.4"
"35722","646",2023-09-08 02:15:00,-21073,1913,22986,907,FALSE,"out1, fill","0.1.4"
"35723","646",2023-09-08 02:30:00,-21074,1913,22987,907,FALSE,"out1, fill","0.1.4"
"35724","646",2023-09-08 02:45:00,-21075,1913,22988,907,FALSE,"out1, fill","0.1.4"
"35725","646",2023-09-08 03:00:00,-21076,1913,22989,907,FALSE,"out1, fill","0.1.4"
"35726","646",2023-09-08 03:15:00,-21077,1913,22990,907,FALSE,"out1, fill","0.1.4"
"35727","646",2023-09-08 03:30:00,-21078,1913,22991,907,FALSE,"out1, fill","0.1.4"
"35728","646",2023-09-08 03:45:00,-21079,1913,22992,907,FALSE,NA,"0.1.4"
"35729","646",2023-09-08 04:00:00,-21079,1913,22992,907,FALSE,"jump1","0.1.4"
"35730","646",2023-09-08 04:15:00,-21342,1913,23255,907,FALSE,NA,"0.1.4"
"35731","646",2023-09-08 04:30:00,-21283,1913,23196,907,FALSE,NA,"0.1.4"
"35732","646",2023-09-08 04:45:00,-21280.4,1913,23193.4,907,FALSE,"out1, fill","0.1.4"
"35733","646",2023-09-08 05:00:00,-21277.8,1913,23190.8,907,FALSE,"out1, fill","0.1.4"
"35734","646",2023-09-08 05:15:00,-21275.2,1913,23188.2,907,FALSE,"out1, fill","0.1.4"
"35735","646",2023-09-08 05:30:00,-21272.6,1913,23185.6,907,FALSE,"out1, fill","0.1.4"
"35736","646",2023-09-08 05:45:00,-21270,1913,23183,907,FALSE,NA,"0.1.4"
"35737","646",2023-09-08 06:00:00,-21166,1913,23079,907,FALSE,NA,"0.1.4"
"35738","646",2023-09-08 06:15:00,-20768,1913,22681,907,FALSE,NA,"0.1.4"
"35739","646",2023-09-08 06:30:00,-20768,1913,22681,907,FALSE,"jump1","0.1.4"
"35740","646",2023-09-08 06:45:00,-21187,1913,23100,907,FALSE,NA,"0.1.4"
"35741","646",2023-09-08 07:00:00,-21075.8888888889,1913,22988.8888888889,907,FALSE,"out1, fill","0.1.4"
"35742","646",2023-09-08 07:15:00,-20964.7777777778,1913,22877.7777777778,907,FALSE,"out1, fill","0.1.4"
"35743","646",2023-09-08 07:30:00,-20853.6666666667,1913,22766.6666666667,907,FALSE,"out1, fill","0.1.4"
"35744","646",2023-09-08 07:45:00,-20742.5555555556,1913,22655.5555555556,907,FALSE,"out1, fill","0.1.4"
"35745","646",2023-09-08 08:00:00,-20631.4444444444,1913,22544.4444444444,907,FALSE,"out1, fill","0.1.4"
"35746","646",2023-09-08 08:15:00,-20520.3333333333,1913,22433.3333333333,907,FALSE,"out1, fill","0.1.4"
"35747","646",2023-09-08 08:30:00,-20409.2222222222,1913,22322.2222222222,907,FALSE,"out1, fill","0.1.4"
"35748","646",2023-09-08 08:45:00,-20298.1111111111,1913,22211.1111111111,907,FALSE,"out1, fill","0.1.4"
"35749","646",2023-09-08 09:00:00,-20187,1913,22100,907,FALSE,NA,"0.1.4"
"35750","646",2023-09-08 09:15:00,-19827,1913,21740,907,FALSE,NA,"0.1.4"
"35751","646",2023-09-08 09:30:00,-19844,1913,21757,907,FALSE,NA,"0.1.4"
"35752","646",2023-09-08 09:45:00,-19840,1913,21753,907,FALSE,NA,"0.1.4"
"35753","646",2023-09-08 10:00:00,-20027,1913,21940,907,FALSE,NA,"0.1.4"
"35754","646",2023-09-08 10:15:00,-19978,1913,21891,907,FALSE,NA,"0.1.4"
"35755","646",2023-09-08 10:30:00,-19833,1913,21746,907,FALSE,NA,"0.1.4"
"35756","646",2023-09-08 10:45:00,-20294,1913,22207,907,FALSE,NA,"0.1.4"
"35757","646",2023-09-08 11:00:00,-19822,1913,21735,907,FALSE,NA,"0.1.4"
"35758","646",2023-09-08 11:15:00,-19831,1913,21744,907,FALSE,NA,"0.1.4"
"35759","646",2023-09-08 11:30:00,-19840,1913,21753,907,FALSE,NA,"0.1.4"
"35760","646",2023-09-08 11:45:00,-19839.6666666667,1913,21752.6666666667,907,FALSE,"out1, fill","0.1.4"
"35761","646",2023-09-08 12:00:00,-19839.3333333333,1913,21752.3333333333,907,FALSE,"out1, fill","0.1.4"
"35762","646",2023-09-08 12:15:00,-19839,1913,21752,907,FALSE,"out1, fill","0.1.4"
"35763","646",2023-09-08 12:30:00,-19838.6666666667,1913,21751.6666666667,907,FALSE,"out1, fill","0.1.4"
"35764","646",2023-09-08 12:45:00,-19838.3333333333,1913,21751.3333333333,907,FALSE,"out1, fill","0.1.4"
"35765","646",2023-09-08 13:00:00,-19838,1913,21751,907,FALSE,NA,"0.1.4"
"35766","646",2023-09-08 13:15:00,-20055,1913,21968,907,FALSE,NA,"0.1.4"
"35767","646",2023-09-08 13:30:00,-20435,1913,22348,907,FALSE,NA,"0.1.4"
"35768","646",2023-09-08 13:45:00,-19960,1913,21873,907,FALSE,NA,"0.1.4"
"35769","646",2023-09-08 14:00:00,-19927,1913,21840,907,FALSE,NA,"0.1.4"
"35770","646",2023-09-08 14:15:00,-19903,1913,21816,907,FALSE,"out1, fill","0.1.4"
"35771","646",2023-09-08 14:30:00,-19879,1913,21792,907,FALSE,"out1, fill","0.1.4"
"35772","646",2023-09-08 14:45:00,-19855,1913,21768,907,FALSE,NA,"0.1.4"
"35773","646",2023-09-08 15:00:00,-19851,1913,21764,907,FALSE,NA,"0.1.4"
"35774","646",2023-09-08 15:15:00,-19850,1913,21763,907,FALSE,NA,"0.1.4"
"35775","646",2023-09-08 15:30:00,-19842,1913,21755,907,FALSE,NA,"0.1.4"
"35776","646",2023-09-08 15:45:00,-19930,1913,21843,907,FALSE,NA,"0.1.4"
"35777","646",2023-09-08 16:00:00,-19862,1913,21775,907,FALSE,NA,"0.1.4"
"35778","646",2023-09-08 16:15:00,-19839,1913,21752,907,FALSE,NA,"0.1.4"
"35779","646",2023-09-08 16:30:00,-20060,1913,21973,907,FALSE,NA,"0.1.4"
"35780","646",2023-09-08 16:45:00,-19823,1913,21736,907,FALSE,NA,"0.1.4"
"35781","646",2023-09-08 17:00:00,-19824,1913,21737,907,FALSE,NA,"0.1.4"
"35782","646",2023-09-08 17:15:00,-19838,1913,21751,907,FALSE,NA,"0.1.4"
"35783","646",2023-09-08 17:30:00,-20108,1913,22021,907,FALSE,NA,"0.1.4"
"35784","646",2023-09-08 17:45:00,-19842,1913,21755,907,FALSE,NA,"0.1.4"
"35785","646",2023-09-08 18:00:00,-19976,1913,21889,907,FALSE,NA,"0.1.4"
"35786","646",2023-09-08 18:15:00,-19954.3333333333,1913,21867.3333333333,907,FALSE,"out1, fill","0.1.4"
"35787","646",2023-09-08 18:30:00,-19932.6666666667,1913,21845.6666666667,907,FALSE,"out1, fill","0.1.4"
"35788","646",2023-09-08 18:45:00,-19911,1913,21824,907,FALSE,"out1, fill","0.1.4"
"35789","646",2023-09-08 19:00:00,-19889.3333333333,1913,21802.3333333333,907,FALSE,"out1, fill","0.1.4"
"35790","646",2023-09-08 19:15:00,-19867.6666666667,1913,21780.6666666667,907,FALSE,"out1, fill","0.1.4"
"35791","646",2023-09-08 19:30:00,-19846,1913,21759,907,FALSE,NA,"0.1.4"
"35792","646",2023-09-08 19:45:00,-19846,1913,21759,907,FALSE,NA,"0.1.4"
"35793","646",2023-09-08 20:00:00,-19856,1913,21769,907,FALSE,NA,"0.1.4"
"35794","646",2023-09-08 20:15:00,-19846,1913,21759,907,FALSE,NA,"0.1.4"
"35795","646",2023-09-08 20:30:00,-19852,1913,21765,907,FALSE,NA,"0.1.4"
"35796","646",2023-09-08 20:45:00,-19857,1913,21770,907,FALSE,NA,"0.1.4"
"35797","646",2023-09-08 21:00:00,-19854,1913,21767,907,FALSE,NA,"0.1.4"
"35798","646",2023-09-08 21:15:00,-19903,1913,21816,907,FALSE,NA,"0.1.4"
"35799","646",2023-09-08 21:30:00,-19859,1913,21772,907,FALSE,NA,"0.1.4"
"35800","646",2023-09-08 21:45:00,-19879,1913,21792,907,FALSE,NA,"0.1.4"
"35801","646",2023-09-08 22:00:00,-19846,1913,21759,907,FALSE,NA,"0.1.4"
"35802","646",2023-09-08 22:15:00,-19848,1913,21761,907,FALSE,NA,"0.1.4"
"35803","646",2023-09-08 22:30:00,-19852,1913,21765,907,FALSE,NA,"0.1.4"
"35804","646",2023-09-08 22:45:00,-19876,1913,21789,907,FALSE,NA,"0.1.4"
"35805","646",2023-09-08 23:00:00,NA,NA,NA,NA,NA,"out1","0.1.4"
"35806","646",2023-09-08 23:15:00,NA,NA,NA,NA,NA,"out1","0.1.4"
"35807","646",2023-09-08 23:30:00,NA,NA,NA,NA,NA,"out1","0.1.4"
"35808","646",2023-09-08 23:45:00,NA,NA,NA,NA,NA,"out1","0.1.4"
"35809","646",2023-09-09,NA,NA,NA,NA,NA,"out1","0.1.4"
"35810","646",2023-09-09 00:15:00,NA,NA,NA,NA,NA,"out1","0.1.4"
"35811","646",2023-09-09 00:30:00,NA,NA,NA,NA,NA,"out1","0.1.4"
"35812","646",2023-09-09 00:45:00,NA,NA,NA,NA,NA,"out1","0.1.4"
"35813","646",2023-09-09 01:00:00,NA,NA,NA,NA,NA,"out1","0.1.4"
"35814","646",2023-09-09 01:15:00,NA,NA,NA,NA,NA,"out1","0.1.4"
"35815","646",2023-09-09 01:30:00,NA,NA,NA,NA,NA,"out1","0.1.4"
"35816","646",2023-09-09 01:45:00,NA,NA,NA,NA,NA,"out1","0.1.4"
"35817","646",2023-09-09 02:00:00,NA,NA,NA,NA,NA,"out1","0.1.4"
"35818","646",2023-09-09 02:15:00,NA,NA,NA,NA,NA,"out1","0.1.4"
"35819","646",2023-09-09 02:30:00,NA,NA,NA,NA,NA,"out1","0.1.4"
"35820","646",2023-09-09 02:45:00,NA,NA,NA,NA,NA,"out1","0.1.4"
"35821","646",2023-09-09 03:00:00,-19860,1913,21773,907,FALSE,NA,"0.1.4"
"35822","646",2023-09-09 03:15:00,-19850,1913,21763,907,FALSE,NA,"0.1.4"
"35823","646",2023-09-09 03:30:00,-19928,1913,21841,907,FALSE,NA,"0.1.4"
"35824","646",2023-09-09 03:45:00,-19863,1913,21776,907,FALSE,NA,"0.1.4"
"35825","646",2023-09-09 04:00:00,-19847,1913,21760,907,FALSE,NA,"0.1.4"
"35826","646",2023-09-09 04:15:00,-19863,1913,21776,907,FALSE,NA,"0.1.4"
"35827","646",2023-09-09 04:30:00,-19854,1913,21767,907,FALSE,NA,"0.1.4"
"35828","646",2023-09-09 04:45:00,-19897,1913,21810,907,FALSE,NA,"0.1.4"
"35829","646",2023-09-09 05:00:00,-19876,1913,21789,907,FALSE,NA,"0.1.4"
"35830","646",2023-09-09 05:15:00,-19837,1913,21750,907,FALSE,NA,"0.1.4"
"35831","646",2023-09-09 05:30:00,-19856,1913,21769,907,FALSE,NA,"0.1.4"
"35832","646",2023-09-09 05:45:00,-19850,1913,21763,907,FALSE,NA,"0.1.4"
"35833","646",2023-09-09 06:00:00,-19973,1913,21886,907,FALSE,NA,"0.1.4"
"35834","646",2023-09-09 06:15:00,-20410,1913,22323,907,FALSE,NA,"0.1.4"
"35835","646",2023-09-09 06:30:00,-20331.2857142857,1913,22244.2857142857,907,FALSE,"out1, fill","0.1.4"
"35836","646",2023-09-09 06:45:00,-20252.5714285714,1913,22165.5714285714,907,FALSE,"out1, fill","0.1.4"
"35837","646",2023-09-09 07:00:00,-20173.8571428571,1913,22086.8571428571,907,FALSE,"out1, fill","0.1.4"
"35838","646",2023-09-09 07:15:00,-20095.1428571429,1913,22008.1428571429,907,FALSE,"out1, fill","0.1.4"
"35839","646",2023-09-09 07:30:00,-20016.4285714286,1913,21929.4285714286,907,FALSE,"out1, fill","0.1.4"
"35840","646",2023-09-09 07:45:00,-19937.7142857143,1913,21850.7142857143,907,FALSE,"out1, fill","0.1.4"
"35841","646",2023-09-09 08:00:00,-19859,1913,21772,907,FALSE,NA,"0.1.4"
"35842","646",2023-09-09 08:15:00,-19841,1913,21754,907,FALSE,NA,"0.1.4"
"35843","646",2023-09-09 08:30:00,-19845,1913,21758,907,FALSE,NA,"0.1.4"
"35844","646",2023-09-09 08:45:00,-19845,1913,21758,907,FALSE,"jump1","0.1.4"
"35845","646",2023-09-09 09:00:00,-19845,1913,21758,907,FALSE,"jump1","0.1.4"
"35846","646",2023-09-09 09:15:00,-20292.5,1913,22205.5,907,FALSE,"out1, fill","0.1.4"
"35847","646",2023-09-09 09:30:00,-20740,1913,22653,907,FALSE,NA,"0.1.4"
"35848","646",2023-09-09 09:45:00,-20404,1913,22317,907,FALSE,NA,"0.1.4"
"35849","646",2023-09-09 10:00:00,-20130,1913,22043,907,FALSE,NA,"0.1.4"
"35850","646",2023-09-09 10:15:00,-20130,1913,22043,907,FALSE,"jump1","0.1.4"
"35851","646",2023-09-09 10:30:00,-20620,1913,22533,907,FALSE,"out1, fill","0.1.4"
"35852","646",2023-09-09 10:45:00,-21110,1913,23023,907,FALSE,NA,"0.1.4"
"35853","646",2023-09-09 11:00:00,-20669,1913,22582,907,FALSE,NA,"0.1.4"
"35854","646",2023-09-09 11:15:00,-20577,1913,22490,907,FALSE,NA,"0.1.4"
"35855","646",2023-09-09 11:30:00,-20445.5555555556,1913,22358.5555555556,907,FALSE,"out1, fill","0.1.4"
"35856","646",2023-09-09 11:45:00,-20314.1111111111,1913,22227.1111111111,907,FALSE,"out1, fill","0.1.4"
"35857","646",2023-09-09 12:00:00,-20182.6666666667,1913,22095.6666666667,907,FALSE,"out1, fill","0.1.4"
"35858","646",2023-09-09 12:15:00,-20051.2222222222,1913,21964.2222222222,907,FALSE,"out1, fill","0.1.4"
"35859","646",2023-09-09 12:30:00,-19919.7777777778,1913,21832.7777777778,907,FALSE,"out1, fill","0.1.4"
"35860","646",2023-09-09 12:45:00,-19788.3333333333,1913,21701.3333333333,907,FALSE,"out1, fill","0.1.4"
"35861","646",2023-09-09 13:00:00,-19656.8888888889,1913,21569.8888888889,907,FALSE,"out1, fill","0.1.4"
"35862","646",2023-09-09 13:15:00,-19525.4444444444,1913,21438.4444444444,907,FALSE,"out1, fill","0.1.4"
"35863","646",2023-09-09 13:30:00,-19394,1913,21307,907,FALSE,NA,"0.1.4"
"35864","646",2023-09-09 13:45:00,-19399,1913,21312,907,FALSE,NA,"0.1.4"
"35865","646",2023-09-09 14:00:00,-19318,1913,21231,907,FALSE,NA,"0.1.4"
"35866","646",2023-09-09 14:15:00,-19315,1913,21228,907,FALSE,NA,"0.1.4"
"35867","646",2023-09-09 14:30:00,-19316,1913,21229,907,FALSE,NA,"0.1.4"
"35868","646",2023-09-09 14:45:00,-19316,1913,21229,907,FALSE,NA,"0.1.4"
"35869","646",2023-09-09 15:00:00,-19316,1913,21229,907,FALSE,NA,"0.1.4"
"35870","646",2023-09-09 15:15:00,-19317,1913,21230,907,FALSE,NA,"0.1.4"
"35871","646",2023-09-09 15:30:00,-19314,1913,21227,907,FALSE,NA,"0.1.4"
"35872","646",2023-09-09 15:45:00,-19314,1913,21227,907,FALSE,NA,"0.1.4"
"35873","646",2023-09-09 16:00:00,-19368,1913,21281,907,FALSE,NA,"0.1.4"
"35874","646",2023-09-09 16:15:00,-19368,1913,21281,907,FALSE,"jump1","0.1.4"
"35875","646",2023-09-09 16:30:00,-19368,1913,21281,907,FALSE,"jump1","0.1.4"
"35876","646",2023-09-09 16:45:00,-19463,1913,21376,907,FALSE,NA,"0.1.4"
"35877","646",2023-09-09 17:00:00,-19569,1913,21482,907,FALSE,NA,"0.1.4"
"35878","646",2023-09-09 17:15:00,-19344,1913,21257,907,FALSE,NA,"0.1.4"
"35879","646",2023-09-09 17:30:00,-19341,1913,21254,907,FALSE,NA,"0.1.4"
"35880","646",2023-09-09 17:45:00,-19341,1913,21254,907,FALSE,"jump1","0.1.4"
"35881","646",2023-09-09 18:00:00,-19231.2,1913,21144.2,907,FALSE,"out1, fill","0.1.4"
"35882","646",2023-09-09 18:15:00,-19121.4,1913,21034.4,907,FALSE,"out1, fill","0.1.4"
"35883","646",2023-09-09 18:30:00,-19011.6,1913,20924.6,907,FALSE,"out1, fill","0.1.4"
"35884","646",2023-09-09 18:45:00,-18901.8,1913,20814.8,907,FALSE,"out1, fill","0.1.4"
"35885","646",2023-09-09 19:00:00,-18792,1913,20705,907,FALSE,NA,"0.1.4"
"35886","646",2023-09-09 19:15:00,-18702,1913,20615,907,FALSE,NA,"0.1.4"
"35887","646",2023-09-09 19:30:00,-18702,1913,20615,907,FALSE,NA,"0.1.4"
"35888","646",2023-09-09 19:45:00,-18706,1913,20619,907,FALSE,NA,"0.1.4"
"35889","646",2023-09-09 20:00:00,-18707,1913,20620,907,FALSE,NA,"0.1.4"
"35890","646",2023-09-09 20:15:00,-18781,1913,20694,907,FALSE,NA,"0.1.4"
"35891","646",2023-09-09 20:30:00,-18715,1913,20628,907,FALSE,NA,"0.1.4"
"35892","646",2023-09-09 20:45:00,-18703,1913,20616,907,FALSE,NA,"0.1.4"
"35893","646",2023-09-09 21:00:00,-18811,1913,20724,907,FALSE,NA,"0.1.4"
"35894","646",2023-09-09 21:15:00,-18703,1913,20616,907,FALSE,NA,"0.1.4"
"35895","646",2023-09-09 21:30:00,-18699,1913,20612,907,FALSE,"out1, fill","0.1.4"
"35896","646",2023-09-09 21:45:00,-18695,1913,20608,907,FALSE,"out1, fill","0.1.4"
"35897","646",2023-09-09 22:00:00,-18691,1913,20604,907,FALSE,"out1, fill","0.1.4"
"35898","646",2023-09-09 22:15:00,-18687,1913,20600,907,FALSE,"out1, fill","0.1.4"
"35899","646",2023-09-09 22:30:00,-18683,1913,20596,907,FALSE,"out1, fill","0.1.4"
"35900","646",2023-09-09 22:45:00,-18679,1913,20592,907,FALSE,NA,"0.1.4"
"35901","646",2023-09-09 23:00:00,-18770,1913,20683,907,FALSE,NA,"0.1.4"
"35902","646",2023-09-09 23:15:00,-18823,1913,20736,907,FALSE,NA,"0.1.4"
"35903","646",2023-09-09 23:30:00,-18786,1913,20699,907,FALSE,NA,"0.1.4"
"35904","646",2023-09-09 23:45:00,-18769.4,1913,20682.4,907,FALSE,"out1, fill","0.1.4"
"35905","646",2023-09-10,-18752.8,1913,20665.8,907,FALSE,"out1, fill","0.1.4"
"35906","646",2023-09-10 00:15:00,-18736.2,1913,20649.2,907,FALSE,"out1, fill","0.1.4"
"35907","646",2023-09-10 00:30:00,-18719.6,1913,20632.6,907,FALSE,"out1, fill","0.1.4"
"35908","646",2023-09-10 00:45:00,-18703,1913,20616,907,FALSE,NA,"0.1.4"
"35909","646",2023-09-10 01:00:00,-18703,1913,20616,907,FALSE,NA,"0.1.4"
"35910","646",2023-09-10 01:15:00,-18925,1913,20838,907,FALSE,NA,"0.1.4"
"35911","646",2023-09-10 01:30:00,-18704,1913,20617,907,FALSE,NA,"0.1.4"
"35912","646",2023-09-10 01:45:00,-18703,1913,20616,907,FALSE,NA,"0.1.4"
"35913","646",2023-09-10 02:00:00,-18703,1913,20616,907,FALSE,NA,"0.1.4"
"35914","646",2023-09-10 02:15:00,-18708,1913,20621,907,FALSE,NA,"0.1.4"
"35915","646",2023-09-10 02:30:00,-18787.6,1913,20700.6,907,FALSE,"out1, fill","0.1.4"
"35916","646",2023-09-10 02:45:00,-18867.2,1913,20780.2,907,FALSE,"out1, fill","0.1.4"
"35917","646",2023-09-10 03:00:00,-18946.8,1913,20859.8,907,FALSE,"out1, fill","0.1.4"
"35918","646",2023-09-10 03:15:00,-19026.4,1913,20939.4,907,FALSE,"out1, fill","0.1.4"
"35919","646",2023-09-10 03:30:00,-19106,1913,21019,907,FALSE,NA,"0.1.4"
"35920","646",2023-09-10 03:45:00,-18733,1913,20646,907,FALSE,NA,"0.1.4"
"35921","646",2023-09-10 04:00:00,-18807,1913,20720,907,FALSE,NA,"0.1.4"
"35922","646",2023-09-10 04:15:00,-18766,1913,20679,907,FALSE,NA,"0.1.4"
"35923","646",2023-09-10 04:30:00,-18771.6666666667,1913,20684.6666666667,907,FALSE,"out1, fill","0.1.4"
"35924","646",2023-09-10 04:45:00,-18777.3333333333,1913,20690.3333333333,907,FALSE,"out1, fill","0.1.4"
"35925","646",2023-09-10 05:00:00,-18783,1913,20696,907,FALSE,NA,"0.1.4"
"35926","646",2023-09-10 05:15:00,-18703,1913,20616,907,FALSE,NA,"0.1.4"
"35927","646",2023-09-10 05:30:00,-18692,1913,20605,907,FALSE,NA,"0.1.4"
"35928","646",2023-09-10 05:45:00,-18705,1913,20618,907,FALSE,NA,"0.1.4"
"35929","646",2023-09-10 06:00:00,-18737,1913,20650,907,FALSE,NA,"0.1.4"
"35930","646",2023-09-10 06:15:00,-18696,1913,20609,907,FALSE,NA,"0.1.4"
"35931","646",2023-09-10 06:30:00,-18697,1913,20610,907,FALSE,NA,"0.1.4"
"35932","646",2023-09-10 06:45:00,-18698,1913,20611,907,FALSE,NA,"0.1.4"
"35933","646",2023-09-10 07:00:00,-18708,1913,20621,907,FALSE,NA,"0.1.4"
"35934","646",2023-09-10 07:15:00,-18707,1913,20620,907,FALSE,NA,"0.1.4"
"35935","646",2023-09-10 07:30:00,-18721,1913,20634,907,FALSE,NA,"0.1.4"
"35936","646",2023-09-10 07:45:00,-19033,1913,20946,907,FALSE,"out1, fill","0.1.4"
"35937","646",2023-09-10 08:00:00,-19345,1913,21258,907,FALSE,"out1, fill","0.1.4"
"35938","646",2023-09-10 08:15:00,-19657,1913,21570,907,FALSE,"out1, fill","0.1.4"
"35939","646",2023-09-10 08:30:00,-19969,1913,21882,907,FALSE,"out1, fill","0.1.4"
"35940","646",2023-09-10 08:45:00,-20281,1913,22194,907,FALSE,NA,"0.1.4"
"35941","646",2023-09-10 09:00:00,-20281,1913,22194,907,FALSE,"jump1","0.1.4"
"35942","646",2023-09-10 09:15:00,-20281,1913,22194,907,FALSE,"jump1","0.1.4"
"35943","646",2023-09-10 09:30:00,-20311.8,1913,22224.8,907,FALSE,"out1, fill","0.1.4"
"35944","646",2023-09-10 09:45:00,-20342.6,1913,22255.6,907,FALSE,"out1, fill","0.1.4"
"35945","646",2023-09-10 10:00:00,-20373.4,1913,22286.4,907,FALSE,"out1, fill","0.1.4"
"35946","646",2023-09-10 10:15:00,-20404.2,1913,22317.2,907,FALSE,"out1, fill","0.1.4"
"35947","646",2023-09-10 10:30:00,-20435,1913,22348,907,FALSE,NA,"0.1.4"
"35948","646",2023-09-10 10:45:00,-20577,1913,22490,907,FALSE,NA,"0.1.4"
"35949","646",2023-09-10 11:00:00,-20463,1913,22376,907,FALSE,NA,"0.1.4"
"35950","646",2023-09-10 11:15:00,-20078.5,1913,21991.5,907,FALSE,"out1, fill","0.1.4"
"35951","646",2023-09-10 11:30:00,-19694,1913,21607,907,FALSE,NA,"0.1.4"
"35952","646",2023-09-10 11:45:00,-19562,1913,21475,907,FALSE,NA,"0.1.4"
"35953","646",2023-09-10 12:00:00,-19401,1913,21314,907,FALSE,NA,"0.1.4"
"35954","646",2023-09-10 12:15:00,-19232,1913,21145,907,FALSE,NA,"0.1.4"
"35955","646",2023-09-10 12:30:00,-19298,1913,21211,907,FALSE,NA,"0.1.4"
"35956","646",2023-09-10 12:45:00,-19011,1913,20924,907,FALSE,NA,"0.1.4"
"35957","646",2023-09-10 13:00:00,-19039.5,1913,20952.5,907,FALSE,"out1, fill","0.1.4"
"35958","646",2023-09-10 13:15:00,-19068,1913,20981,907,FALSE,"out1, fill","0.1.4"
"35959","646",2023-09-10 13:30:00,-19096.5,1913,21009.5,907,FALSE,"out1, fill","0.1.4"
"35960","646",2023-09-10 13:45:00,-19125,1913,21038,907,FALSE,NA,"0.1.4"
"35961","646",2023-09-10 14:00:00,-19334,1913,21247,907,FALSE,NA,"0.1.4"
"35962","646",2023-09-10 14:15:00,-19221,1913,21134,907,FALSE,NA,"0.1.4"
"35963","646",2023-09-10 14:30:00,-19557,1913,21470,907,FALSE,NA,"0.1.4"
"35964","646",2023-09-10 14:45:00,-19511,1913,21424,907,FALSE,NA,"0.1.4"
"35965","646",2023-09-10 15:00:00,-19502,1913,21415,907,FALSE,NA,"0.1.4"
"35966","646",2023-09-10 15:15:00,-19387,1913,21300,907,FALSE,NA,"0.1.4"
"35967","646",2023-09-10 15:30:00,-19557,1913,21470,907,FALSE,NA,"0.1.4"
"35968","646",2023-09-10 15:45:00,-19149,1913,21062,907,FALSE,NA,"0.1.4"
"35969","646",2023-09-10 16:00:00,-18817,1913,20730,907,FALSE,NA,"0.1.4"
"35970","646",2023-09-10 16:15:00,-18844,1913,20757,907,FALSE,NA,"0.1.4"
"35971","646",2023-09-10 16:30:00,-19299,1913,21212,907,FALSE,NA,"0.1.4"
"35972","646",2023-09-10 16:45:00,-19299,1913,21212,907,FALSE,"jump1","0.1.4"
"35973","646",2023-09-10 17:00:00,-19206,1913,21119,907,FALSE,NA,"0.1.4"
"35974","646",2023-09-10 17:15:00,-19206.25,1913,21119.25,907,FALSE,"out1, fill","0.1.4"
"35975","646",2023-09-10 17:30:00,-19206.5,1913,21119.5,907,FALSE,"out1, fill","0.1.4"
"35976","646",2023-09-10 17:45:00,-19206.75,1913,21119.75,907,FALSE,"out1, fill","0.1.4"
"35977","646",2023-09-10 18:00:00,-19207,1913,21120,907,FALSE,"out1, fill","0.1.4"
"35978","646",2023-09-10 18:15:00,-19207.25,1913,21120.25,907,FALSE,"out1, fill","0.1.4"
"35979","646",2023-09-10 18:30:00,-19207.5,1913,21120.5,907,FALSE,"out1, fill","0.1.4"
"35980","646",2023-09-10 18:45:00,-19207.75,1913,21120.75,907,FALSE,"out1, fill","0.1.4"
"35981","646",2023-09-10 19:00:00,-19208,1913,21121,907,FALSE,"out1, fill","0.1.4"
"35982","646",2023-09-10 19:15:00,-19208.25,1913,21121.25,907,FALSE,"out1, fill","0.1.4"
"35983","646",2023-09-10 19:30:00,-19208.5,1913,21121.5,907,FALSE,"out1, fill","0.1.4"
"35984","646",2023-09-10 19:45:00,-19208.75,1913,21121.75,907,FALSE,"out1, fill","0.1.4"
"35985","646",2023-09-10 20:00:00,-19209,1913,21122,907,FALSE,NA,"0.1.4"
"35986","646",2023-09-10 20:15:00,-19211,1913,21124,907,FALSE,NA,"0.1.4"
"35987","646",2023-09-10 20:30:00,-19205,1913,21118,907,FALSE,NA,"0.1.4"
"35988","646",2023-09-10 20:45:00,-19209,1913,21122,907,FALSE,NA,"0.1.4"
"35989","646",2023-09-10 21:00:00,-19206,1913,21119,907,FALSE,NA,"0.1.4"
"35990","646",2023-09-10 21:15:00,-19298,1913,21211,907,FALSE,NA,"0.1.4"
"35991","646",2023-09-10 21:30:00,-19213,1913,21126,907,FALSE,NA,"0.1.4"
"35992","646",2023-09-10 21:45:00,-19210,1913,21123,907,FALSE,NA,"0.1.4"
"35993","646",2023-09-10 22:00:00,-19209,1913,21122,907,FALSE,NA,"0.1.4"
"35994","646",2023-09-10 22:15:00,-19272,1913,21185,907,FALSE,NA,"0.1.4"
"35995","646",2023-09-10 22:30:00,-19626,1913,21539,907,FALSE,NA,"0.1.4"
"35996","646",2023-09-10 22:45:00,-19601.3333333333,1913,21514.3333333333,907,FALSE,"out1, fill","0.1.4"
"35997","646",2023-09-10 23:00:00,-19576.6666666667,1913,21489.6666666667,907,FALSE,"out1, fill","0.1.4"
"35998","646",2023-09-10 23:15:00,-19552,1913,21465,907,FALSE,"out1, fill","0.1.4"
"35999","646",2023-09-10 23:30:00,-19527.3333333333,1913,21440.3333333333,907,FALSE,"out1, fill","0.1.4"
"36000","646",2023-09-10 23:45:00,-19502.6666666667,1913,21415.6666666667,907,FALSE,"out1, fill","0.1.4"
"36001","646",2023-09-11,-19478,1913,21391,907,FALSE,"out1, fill","0.1.4"
"36002","646",2023-09-11 00:15:00,-19453.3333333333,1913,21366.3333333333,907,FALSE,"out1, fill","0.1.4"
"36003","646",2023-09-11 00:30:00,-19428.6666666667,1913,21341.6666666667,907,FALSE,"out1, fill","0.1.4"
"36004","646",2023-09-11 00:45:00,-19404,1913,21317,907,FALSE,"out1, fill","0.1.4"
"36005","646",2023-09-11 01:00:00,-19379.3333333333,1913,21292.3333333333,907,FALSE,"out1, fill","0.1.4"
"36006","646",2023-09-11 01:15:00,-19354.6666666667,1913,21267.6666666667,907,FALSE,"out1, fill","0.1.4"
"36007","646",2023-09-11 01:30:00,-19330,1913,21243,907,FALSE,NA,"0.1.4"
"36008","646",2023-09-11 01:45:00,-19205,1913,21118,907,FALSE,NA,"0.1.4"
"36009","646",2023-09-11 02:00:00,-19380,1913,21293,907,FALSE,NA,"0.1.4"
"36010","646",2023-09-11 02:15:00,-19228,1913,21141,907,FALSE,NA,"0.1.4"
"36011","646",2023-09-11 02:30:00,-19228,1913,21141,907,FALSE,"jump1","0.1.4"
"36012","646",2023-09-11 02:45:00,-19336,1913,21249,907,FALSE,NA,"0.1.4"
"36013","646",2023-09-11 03:00:00,-19295.5714285714,1913,21208.5714285714,907,FALSE,"out1, fill","0.1.4"
"36014","646",2023-09-11 03:15:00,-19255.1428571429,1913,21168.1428571429,907,FALSE,"out1, fill","0.1.4"
"36015","646",2023-09-11 03:30:00,-19214.7142857143,1913,21127.7142857143,907,FALSE,"out1, fill","0.1.4"
"36016","646",2023-09-11 03:45:00,-19174.2857142857,1913,21087.2857142857,907,FALSE,"out1, fill","0.1.4"
"36017","646",2023-09-11 04:00:00,-19133.8571428571,1913,21046.8571428571,907,FALSE,"out1, fill","0.1.4"
"36018","646",2023-09-11 04:15:00,-19093.4285714286,1913,21006.4285714286,907,FALSE,"out1, fill","0.1.4"
"36019","646",2023-09-11 04:30:00,-19053,1913,20966,907,FALSE,NA,"0.1.4"
"36020","646",2023-09-11 04:45:00,-19318,1913,21231,907,FALSE,NA,"0.1.4"
"36021","646",2023-09-11 05:00:00,-19321,1913,21234,907,FALSE,NA,"0.1.4"
"36022","646",2023-09-11 05:15:00,-19162.2,1913,21075.2,907,FALSE,"out1, fill","0.1.4"
"36023","646",2023-09-11 05:30:00,-19003.4,1913,20916.4,907,FALSE,"out1, fill","0.1.4"
"36024","646",2023-09-11 05:45:00,-18844.6,1913,20757.6,907,FALSE,"out1, fill","0.1.4"
"36025","646",2023-09-11 06:00:00,-18685.8,1913,20598.8,907,FALSE,"out1, fill","0.1.4"
"36026","646",2023-09-11 06:15:00,-18527,1913,20440,907,FALSE,NA,"0.1.4"
"36027","646",2023-09-11 06:30:00,-18556,1913,20469,907,FALSE,NA,"0.1.4"
"36028","646",2023-09-11 06:45:00,-18894,1913,20807,907,FALSE,NA,"0.1.4"
"36029","646",2023-09-11 07:00:00,-18986,1913,20899,907,FALSE,NA,"0.1.4"
"36030","646",2023-09-11 07:15:00,-18889.75,1913,20802.75,907,FALSE,"out1, fill","0.1.4"
"36031","646",2023-09-11 07:30:00,-18793.5,1913,20706.5,907,FALSE,"out1, fill","0.1.4"
"36032","646",2023-09-11 07:45:00,-18697.25,1913,20610.25,907,FALSE,"out1, fill","0.1.4"
"36033","646",2023-09-11 08:00:00,-18601,1913,20514,907,FALSE,NA,"0.1.4"
"36034","646",2023-09-11 08:15:00,-18548,1913,20461,907,FALSE,NA,"0.1.4"
"36035","646",2023-09-11 08:30:00,-18613,1913,20526,907,FALSE,NA,"0.1.4"
"36036","646",2023-09-11 08:45:00,-18660.2142857143,1913,20573.2142857143,907,FALSE,"out1, fill","0.1.4"
"36037","646",2023-09-11 09:00:00,-18707.4285714286,1913,20620.4285714286,907,FALSE,"out1, fill","0.1.4"
"36038","646",2023-09-11 09:15:00,-18754.6428571429,1913,20667.6428571429,907,FALSE,"out1, fill","0.1.4"
"36039","646",2023-09-11 09:30:00,-18801.8571428571,1913,20714.8571428571,907,FALSE,"out1, fill","0.1.4"
"36040","646",2023-09-11 09:45:00,-18849.0714285714,1913,20762.0714285714,907,FALSE,"out1, fill","0.1.4"
"36041","646",2023-09-11 10:00:00,-18896.2857142857,1913,20809.2857142857,907,FALSE,"out1, fill","0.1.4"
"36042","646",2023-09-11 10:15:00,-18943.5,1913,20856.5,907,FALSE,"out1, fill","0.1.4"
"36043","646",2023-09-11 10:30:00,-18990.7142857143,1913,20903.7142857143,907,FALSE,"out1, fill","0.1.4"
"36044","646",2023-09-11 10:45:00,-19037.9285714286,1913,20950.9285714286,907,FALSE,"out1, fill","0.1.4"
"36045","646",2023-09-11 11:00:00,-19085.1428571429,1913,20998.1428571429,907,FALSE,"out1, fill","0.1.4"
"36046","646",2023-09-11 11:15:00,-19132.3571428571,1913,21045.3571428571,907,FALSE,"out1, fill","0.1.4"
"36047","646",2023-09-11 11:30:00,-19179.5714285714,1913,21092.5714285714,907,FALSE,"out1, fill","0.1.4"
"36048","646",2023-09-11 11:45:00,-19226.7857142857,1913,21139.7857142857,907,FALSE,"out1, fill","0.1.4"
"36049","646",2023-09-11 12:00:00,-19274,1913,21187,907,FALSE,NA,"0.1.4"
"36050","646",2023-09-11 12:15:00,-19550,1913,21463,907,FALSE,NA,"0.1.4"
"36051","646",2023-09-11 12:30:00,-19390,1913,21303,907,FALSE,NA,"0.1.4"
"36052","646",2023-09-11 12:45:00,-19647,1913,21560,907,FALSE,NA,"0.1.4"
"36053","646",2023-09-11 13:00:00,-19463.5,1913,21376.5,907,FALSE,"out1, fill","0.1.4"
"36054","646",2023-09-11 13:15:00,-19280,1913,21193,907,FALSE,NA,"0.1.4"
"36055","646",2023-09-11 13:30:00,-19591,1913,21504,907,FALSE,NA,"0.1.4"
"36056","646",2023-09-11 13:45:00,-19603,1913,21516,907,FALSE,NA,"0.1.4"
"36057","646",2023-09-11 14:00:00,-19393,1913,21306,907,FALSE,NA,"0.1.4"
"36058","646",2023-09-11 14:15:00,-19008.5,1913,20921.5,907,FALSE,"out1, fill","0.1.4"
"36059","646",2023-09-11 14:30:00,-18624,1913,20537,907,FALSE,NA,"0.1.4"
"36060","646",2023-09-11 14:45:00,-18609,1913,20522,907,FALSE,NA,"0.1.4"
"36061","646",2023-09-11 15:00:00,-18648,1913,20561,907,FALSE,NA,"0.1.4"
"36062","646",2023-09-11 15:15:00,-18608,1913,20521,907,FALSE,NA,"0.1.4"
"36063","646",2023-09-11 15:30:00,-18552,1913,20465,907,FALSE,NA,"0.1.4"
"36064","646",2023-09-11 15:45:00,-18695,1913,20608,907,FALSE,NA,"0.1.4"
"36065","646",2023-09-11 16:00:00,-18567,1913,20480,907,FALSE,NA,"0.1.4"
"36066","646",2023-09-11 16:15:00,-18516,1913,20429,907,FALSE,NA,"0.1.4"
"36067","646",2023-09-11 16:30:00,-18524,1913,20437,907,FALSE,NA,"0.1.4"
"36068","646",2023-09-11 16:45:00,-18632,1913,20545,907,FALSE,"out1, fill","0.1.4"
"36069","646",2023-09-11 17:00:00,-18740,1913,20653,907,FALSE,NA,"0.1.4"
"36070","646",2023-09-11 17:15:00,-18780,1913,20693,907,FALSE,NA,"0.1.4"
"36071","646",2023-09-11 17:30:00,-18981,1913,20894,907,FALSE,NA,"0.1.4"
"36072","646",2023-09-11 17:45:00,-19003.2307692308,1913,20916.2307692308,907,FALSE,"out1, fill","0.1.4"
"36073","646",2023-09-11 18:00:00,-19025.4615384615,1913,20938.4615384615,907,FALSE,"out1, fill","0.1.4"
"36074","646",2023-09-11 18:15:00,-19047.6923076923,1913,20960.6923076923,907,FALSE,"out1, fill","0.1.4"
"36075","646",2023-09-11 18:30:00,-19069.9230769231,1913,20982.9230769231,907,FALSE,"out1, fill","0.1.4"
"36076","646",2023-09-11 18:45:00,-19092.1538461538,1913,21005.1538461538,907,FALSE,"out1, fill","0.1.4"
"36077","646",2023-09-11 19:00:00,-19114.3846153846,1913,21027.3846153846,907,FALSE,"out1, fill","0.1.4"
"36078","646",2023-09-11 19:15:00,-19136.6153846154,1913,21049.6153846154,907,FALSE,"out1, fill","0.1.4"
"36079","646",2023-09-11 19:30:00,-19158.8461538462,1913,21071.8461538462,907,FALSE,"out1, fill","0.1.4"
"36080","646",2023-09-11 19:45:00,-19181.0769230769,1913,21094.0769230769,907,FALSE,"out1, fill","0.1.4"
"36081","646",2023-09-11 20:00:00,-19203.3076923077,1913,21116.3076923077,907,FALSE,"out1, fill","0.1.4"
"36082","646",2023-09-11 20:15:00,-19225.5384615385,1913,21138.5384615385,907,FALSE,"out1, fill","0.1.4"
"36083","646",2023-09-11 20:30:00,-19247.7692307692,1913,21160.7692307692,907,FALSE,"out1, fill","0.1.4"
"36084","646",2023-09-11 20:45:00,-19270,1913,21183,907,FALSE,NA,"0.1.4"
"36085","646",2023-09-11 21:00:00,-19287,1913,21200,907,FALSE,NA,"0.1.4"
"36086","646",2023-09-11 21:15:00,-19287,1913,21200,907,FALSE,"jump1","0.1.4"
"36087","646",2023-09-11 21:30:00,-19161,1913,21074,907,FALSE,"out1, fill","0.1.4"
"36088","646",2023-09-11 21:45:00,-19035,1913,20948,907,FALSE,"out1, fill","0.1.4"
"36089","646",2023-09-11 22:00:00,-18909,1913,20822,907,FALSE,"out1, fill","0.1.4"
"36090","646",2023-09-11 22:15:00,-18783,1913,20696,907,FALSE,"out1, fill","0.1.4"
"36091","646",2023-09-11 22:30:00,-18657,1913,20570,907,FALSE,"out1, fill","0.1.4"
"36092","646",2023-09-11 22:45:00,-18531,1913,20444,907,FALSE,"out1, fill","0.1.4"
"36093","646",2023-09-11 23:00:00,-18405,1913,20318,907,FALSE,"out1, fill","0.1.4"
"36094","646",2023-09-11 23:15:00,-18279,1913,20192,907,FALSE,"out1, fill","0.1.4"
"36095","646",2023-09-11 23:30:00,-18153,1913,20066,907,FALSE,"out1, fill","0.1.4"
"36096","646",2023-09-11 23:45:00,-18027,1913,19940,907,FALSE,"out1, fill","0.1.4"
"36097","646",2023-09-12,-17901,1913,19814,907,FALSE,NA,"0.1.4"
"36098","646",2023-09-12 00:15:00,-17902,1913,19815,907,FALSE,NA,"0.1.4"
"36099","646",2023-09-12 00:30:00,-17901,1913,19814,907,FALSE,NA,"0.1.4"
"36100","646",2023-09-12 00:45:00,-17901,1913,19814,907,FALSE,NA,"0.1.4"
"36101","646",2023-09-12 01:00:00,-17924.6666666667,1913,19837.6666666667,907,FALSE,"out1, fill","0.1.4"
"36102","646",2023-09-12 01:15:00,-17948.3333333333,1913,19861.3333333333,907,FALSE,"out1, fill","0.1.4"
"36103","646",2023-09-12 01:30:00,-17972,1913,19885,907,FALSE,NA,"0.1.4"
"36104","646",2023-09-12 01:45:00,-18159,1913,20072,907,FALSE,NA,"0.1.4"
"36105","646",2023-09-12 02:00:00,-18203,1913,20116,907,FALSE,NA,"0.1.4"
"36106","646",2023-09-12 02:15:00,-18596,1913,20509,907,FALSE,NA,"0.1.4"
"36107","646",2023-09-12 02:30:00,-18596,1913,20509,907,FALSE,"jump1","0.1.4"
"36108","646",2023-09-12 02:45:00,-18907,1913,20820,907,FALSE,NA,"0.1.4"
"36109","646",2023-09-12 03:00:00,-18579,1913,20492,907,FALSE,NA,"0.1.4"
"36110","646",2023-09-12 03:15:00,-19013,1913,20926,907,FALSE,NA,"0.1.4"
"36111","646",2023-09-12 03:30:00,-18629,1913,20542,907,FALSE,NA,"0.1.4"
"36112","646",2023-09-12 03:45:00,-18905,1913,20818,907,FALSE,NA,"0.1.4"
"36113","646",2023-09-12 04:00:00,-18872.4285714286,1913,20785.4285714286,907,FALSE,"out1, fill","0.1.4"
"36114","646",2023-09-12 04:15:00,-18839.8571428571,1913,20752.8571428571,907,FALSE,"out1, fill","0.1.4"
"36115","646",2023-09-12 04:30:00,-18807.2857142857,1913,20720.2857142857,907,FALSE,"out1, fill","0.1.4"
"36116","646",2023-09-12 04:45:00,-18774.7142857143,1913,20687.7142857143,907,FALSE,"out1, fill","0.1.4"
"36117","646",2023-09-12 05:00:00,-18742.1428571429,1913,20655.1428571429,907,FALSE,"out1, fill","0.1.4"
"36118","646",2023-09-12 05:15:00,-18709.5714285714,1913,20622.5714285714,907,FALSE,"out1, fill","0.1.4"
"36119","646",2023-09-12 05:30:00,-18677,1913,20590,907,FALSE,NA,"0.1.4"
"36120","646",2023-09-12 05:45:00,-18677,1913,20590,907,FALSE,"jump1","0.1.4"
"36121","646",2023-09-12 06:00:00,-18651,1913,20564,907,FALSE,NA,"0.1.4"
"36122","646",2023-09-12 06:15:00,-18659,1913,20572,907,FALSE,NA,"0.1.4"
"36123","646",2023-09-12 06:30:00,-18521,1913,20434,907,FALSE,NA,"0.1.4"
"36124","646",2023-09-12 06:45:00,-18646,1913,20559,907,FALSE,NA,"0.1.4"
"36125","646",2023-09-12 07:00:00,-18486,1913,20399,907,FALSE,NA,"0.1.4"
"36126","646",2023-09-12 07:15:00,-18425,1913,20338,907,FALSE,NA,"0.1.4"
"36127","646",2023-09-12 07:30:00,-17969,1913,19882,907,FALSE,NA,"0.1.4"
"36128","646",2023-09-12 07:45:00,-18118.5,1913,20031.5,907,FALSE,"out1, fill","0.1.4"
"36129","646",2023-09-12 08:00:00,-18268,1913,20181,907,FALSE,NA,"0.1.4"
"36130","646",2023-09-12 08:15:00,-17942,1913,19855,907,FALSE,NA,"0.1.4"
"36131","646",2023-09-12 08:30:00,-17936,1913,19849,907,FALSE,NA,"0.1.4"
"36132","646",2023-09-12 08:45:00,-17903,1913,19816,907,FALSE,NA,"0.1.4"
"36133","646",2023-09-12 09:00:00,-18149.5,1913,20062.5,907,FALSE,"out1, fill","0.1.4"
"36134","646",2023-09-12 09:15:00,-18396,1913,20309,907,FALSE,NA,"0.1.4"
"36135","646",2023-09-12 09:30:00,-18326,1913,20239,907,FALSE,NA,"0.1.4"
"36136","646",2023-09-12 09:45:00,-18374,1913,20287,907,FALSE,NA,"0.1.4"
"36137","646",2023-09-12 10:00:00,-18177,1913,20090,907,FALSE,NA,"0.1.4"
"36138","646",2023-09-12 10:15:00,-18323,1913,20236,907,FALSE,NA,"0.1.4"
"36139","646",2023-09-12 10:30:00,-18263,1913,20176,907,FALSE,NA,"0.1.4"
"36140","646",2023-09-12 10:45:00,-18189,1913,20102,907,FALSE,"out1, fill","0.1.4"
"36141","646",2023-09-12 11:00:00,-18115,1913,20028,907,FALSE,"out1, fill","0.1.4"
"36142","646",2023-09-12 11:15:00,-18041,1913,19954,907,FALSE,NA,"0.1.4"
"36143","646",2023-09-12 11:30:00,-18237,1913,20150,907,FALSE,NA,"0.1.4"
"36144","646",2023-09-12 11:45:00,-17933,1913,19846,907,FALSE,NA,"0.1.4"
"36145","646",2023-09-12 12:00:00,-17932,1913,19845,907,FALSE,NA,"0.1.4"
"36146","646",2023-09-12 12:15:00,-17932,1913,19845,907,FALSE,NA,"0.1.4"
"36147","646",2023-09-12 12:30:00,-17937,1913,19850,907,FALSE,NA,"0.1.4"
"36148","646",2023-09-12 12:45:00,-17945,1913,19858,907,FALSE,NA,"0.1.4"
"36149","646",2023-09-12 13:00:00,-17945,1913,19858,907,FALSE,"jump1","0.1.4"
"36150","646",2023-09-12 13:15:00,-18132,1913,20045,907,FALSE,NA,"0.1.4"
"36151","646",2023-09-12 13:30:00,-18132,1913,20045,907,FALSE,"jump1","0.1.4"
"36152","646",2023-09-12 13:45:00,-18125.75,1913,20038.75,907,FALSE,"out1, fill","0.1.4"
"36153","646",2023-09-12 14:00:00,-18119.5,1913,20032.5,907,FALSE,"out1, fill","0.1.4"
"36154","646",2023-09-12 14:15:00,-18113.25,1913,20026.25,907,FALSE,"out1, fill","0.1.4"
"36155","646",2023-09-12 14:30:00,-18107,1913,20020,907,FALSE,NA,"0.1.4"
"36156","646",2023-09-12 14:45:00,-18100,1913,20013,907,FALSE,NA,"0.1.4"
"36157","646",2023-09-12 15:00:00,-18129,1913,20042,907,FALSE,NA,"0.1.4"
"36158","646",2023-09-12 15:15:00,-18107,1913,20020,907,FALSE,NA,"0.1.4"
"36159","646",2023-09-12 15:30:00,-18100,1913,20013,907,FALSE,NA,"0.1.4"
"36160","646",2023-09-12 15:45:00,-18099,1913,20012,907,FALSE,NA,"0.1.4"
"36161","646",2023-09-12 16:00:00,-18099,1913,20012,907,FALSE,NA,"0.1.4"
"36162","646",2023-09-12 16:15:00,-18096,1913,20009,907,FALSE,NA,"0.1.4"
"36163","646",2023-09-12 16:30:00,-18091,1913,20004,907,FALSE,NA,"0.1.4"
"36164","646",2023-09-12 16:45:00,-18091,1913,20004,907,FALSE,"jump1","0.1.4"
"36165","646",2023-09-12 17:00:00,-18033,1913,19946,907,FALSE,NA,"0.1.4"
"36166","646",2023-09-12 17:15:00,-18033,1913,19946,907,FALSE,"jump1","0.1.4"
"36167","646",2023-09-12 17:30:00,-18030,1913,19943,907,FALSE,NA,"0.1.4"
"36168","646",2023-09-12 17:45:00,-18051,1913,19964,907,FALSE,NA,"0.1.4"
"36169","646",2023-09-12 18:00:00,-18365,1913,20278,907,FALSE,NA,"0.1.4"
"36170","646",2023-09-12 18:15:00,-18380.8461538462,1913,20293.8461538462,907,FALSE,"out1, fill","0.1.4"
"36171","646",2023-09-12 18:30:00,-18396.6923076923,1913,20309.6923076923,907,FALSE,"out1, fill","0.1.4"
"36172","646",2023-09-12 18:45:00,-18412.5384615385,1913,20325.5384615385,907,FALSE,"out1, fill","0.1.4"
"36173","646",2023-09-12 19:00:00,-18428.3846153846,1913,20341.3846153846,907,FALSE,"out1, fill","0.1.4"
"36174","646",2023-09-12 19:15:00,-18444.2307692308,1913,20357.2307692308,907,FALSE,"out1, fill","0.1.4"
"36175","646",2023-09-12 19:30:00,-18460.0769230769,1913,20373.0769230769,907,FALSE,"out1, fill","0.1.4"
"36176","646",2023-09-12 19:45:00,-18475.9230769231,1913,20388.9230769231,907,FALSE,"out1, fill","0.1.4"
"36177","646",2023-09-12 20:00:00,-18491.7692307692,1913,20404.7692307692,907,FALSE,"out1, fill","0.1.4"
"36178","646",2023-09-12 20:15:00,-18507.6153846154,1913,20420.6153846154,907,FALSE,"out1, fill","0.1.4"
"36179","646",2023-09-12 20:30:00,-18523.4615384615,1913,20436.4615384615,907,FALSE,"out1, fill","0.1.4"
"36180","646",2023-09-12 20:45:00,-18539.3076923077,1913,20452.3076923077,907,FALSE,"out1, fill","0.1.4"
"36181","646",2023-09-12 21:00:00,-18555.1538461538,1913,20468.1538461538,907,FALSE,"out1, fill","0.1.4"
"36182","646",2023-09-12 21:15:00,-18571,1913,20484,907,FALSE,NA,"0.1.4"
"36183","646",2023-09-12 21:30:00,-18103,1913,20016,907,FALSE,NA,"0.1.4"
"36184","646",2023-09-12 21:45:00,-18071,1913,19984,907,FALSE,NA,"0.1.4"
"36185","646",2023-09-12 22:00:00,-18075,1913,19988,907,FALSE,"out1, fill","0.1.4"
"36186","646",2023-09-12 22:15:00,-18079,1913,19992,907,FALSE,"out1, fill","0.1.4"
"36187","646",2023-09-12 22:30:00,-18083,1913,19996,907,FALSE,NA,"0.1.4"
"36188","646",2023-09-12 22:45:00,-18075,1913,19988,907,FALSE,NA,"0.1.4"
"36189","646",2023-09-12 23:00:00,-18233,1913,20146,907,FALSE,NA,"0.1.4"
"36190","646",2023-09-12 23:15:00,-18385,1913,20298,907,FALSE,NA,"0.1.4"
"36191","646",2023-09-12 23:30:00,-18468,1913,20381,907,FALSE,NA,"0.1.4"
"36192","646",2023-09-12 23:45:00,-18356,1913,20269,907,FALSE,NA,"0.1.4"
"36193","646",2023-09-13,-18020,1913,19933,907,FALSE,NA,"0.1.4"
"36194","646",2023-09-13 00:15:00,-18037,1913,19950,907,FALSE,NA,"0.1.4"
"36195","646",2023-09-13 00:30:00,-18184,1913,20097,907,FALSE,NA,"0.1.4"
"36196","646",2023-09-13 00:45:00,-18092,1913,20005,907,FALSE,NA,"0.1.4"
"36197","646",2023-09-13 01:00:00,-18566,1913,20479,907,FALSE,NA,"0.1.4"
"36198","646",2023-09-13 01:15:00,-18554.4,1913,20467.4,907,FALSE,"out1, fill","0.1.4"
"36199","646",2023-09-13 01:30:00,-18542.8,1913,20455.8,907,FALSE,"out1, fill","0.1.4"
"36200","646",2023-09-13 01:45:00,-18531.2,1913,20444.2,907,FALSE,"out1, fill","0.1.4"
"36201","646",2023-09-13 02:00:00,-18519.6,1913,20432.6,907,FALSE,"out1, fill","0.1.4"
"36202","646",2023-09-13 02:15:00,-18508,1913,20421,907,FALSE,NA,"0.1.4"
"36203","646",2023-09-13 02:30:00,-18556,1913,20469,907,FALSE,NA,"0.1.4"
"36204","646",2023-09-13 02:45:00,-18532,1913,20445,907,FALSE,NA,"0.1.4"
"36205","646",2023-09-13 03:00:00,-18524.3333333333,1913,20437.3333333333,907,FALSE,"out1, fill","0.1.4"
"36206","646",2023-09-13 03:15:00,-18516.6666666667,1913,20429.6666666667,907,FALSE,"out1, fill","0.1.4"
"36207","646",2023-09-13 03:30:00,-18509,1913,20422,907,FALSE,"out1, fill","0.1.4"
"36208","646",2023-09-13 03:45:00,-18501.3333333333,1913,20414.3333333333,907,FALSE,"out1, fill","0.1.4"
"36209","646",2023-09-13 04:00:00,-18493.6666666667,1913,20406.6666666667,907,FALSE,"out1, fill","0.1.4"
"36210","646",2023-09-13 04:15:00,-18486,1913,20399,907,FALSE,NA,"0.1.4"
"36211","646",2023-09-13 04:30:00,-18621,1913,20534,907,FALSE,NA,"0.1.4"
"36212","646",2023-09-13 04:45:00,-18621,1913,20534,907,FALSE,"jump1","0.1.4"
"36213","646",2023-09-13 05:00:00,-18159,1913,20072,907,FALSE,NA,"0.1.4"
"36214","646",2023-09-13 05:15:00,-18322,1913,20235,907,FALSE,NA,"0.1.4"
"36215","646",2023-09-13 05:30:00,-18370,1913,20283,907,FALSE,NA,"0.1.4"
"36216","646",2023-09-13 05:45:00,-18371,1913,20284,907,FALSE,NA,"0.1.4"
"36217","646",2023-09-13 06:00:00,-18437,1913,20350,907,FALSE,NA,"0.1.4"
"36218","646",2023-09-13 06:15:00,-18263.5,1913,20176.5,907,FALSE,"out1, fill","0.1.4"
"36219","646",2023-09-13 06:30:00,-18090,1913,20003,907,FALSE,NA,"0.1.4"
"36220","646",2023-09-13 06:45:00,-18509,1913,20422,907,FALSE,NA,"0.1.4"
"36221","646",2023-09-13 07:00:00,-18237,1913,20150,907,FALSE,NA,"0.1.4"
"36222","646",2023-09-13 07:15:00,-18311,1913,20224,907,FALSE,NA,"0.1.4"
"36223","646",2023-09-13 07:30:00,-18256,1913,20169,907,FALSE,NA,"0.1.4"
"36224","646",2023-09-13 07:45:00,-18610,1913,20523,907,FALSE,NA,"0.1.4"
"36225","646",2023-09-13 08:00:00,-18320,1913,20233,907,FALSE,NA,"0.1.4"
"36226","646",2023-09-13 08:15:00,-18464,1913,20377,907,FALSE,NA,"0.1.4"
"36227","646",2023-09-13 08:30:00,-18464,1913,20377,907,FALSE,"jump1","0.1.4"
"36228","646",2023-09-13 08:45:00,-18576,1913,20489,907,FALSE,NA,"0.1.4"
"36229","646",2023-09-13 09:00:00,-18451.4,1913,20364.4,907,FALSE,"out1, fill","0.1.4"
"36230","646",2023-09-13 09:15:00,-18326.8,1913,20239.8,907,FALSE,"out1, fill","0.1.4"
"36231","646",2023-09-13 09:30:00,-18202.2,1913,20115.2,907,FALSE,"out1, fill","0.1.4"
"36232","646",2023-09-13 09:45:00,-18077.6,1913,19990.6,907,FALSE,"out1, fill","0.1.4"
"36233","646",2023-09-13 10:00:00,-17953,1913,19866,907,FALSE,NA,"0.1.4"
"36234","646",2023-09-13 10:15:00,-17991,1913,19904,907,FALSE,NA,"0.1.4"
"36235","646",2023-09-13 10:30:00,-18478,1913,20391,907,FALSE,NA,"0.1.4"
"36236","646",2023-09-13 10:45:00,-18478,1913,20391,907,FALSE,"jump1","0.1.4"
"36237","646",2023-09-13 11:00:00,-18498,1913,20411,907,FALSE,NA,"0.1.4"
"36238","646",2023-09-13 11:15:00,-18468,1913,20381,907,FALSE,NA,"0.1.4"
"36239","646",2023-09-13 11:30:00,-18435,1913,20348,907,FALSE,NA,"0.1.4"
"36240","646",2023-09-13 11:45:00,-18435,1913,20348,907,FALSE,"jump1","0.1.4"
"36241","646",2023-09-13 12:00:00,-18448,1913,20361,907,FALSE,NA,"0.1.4"
"36242","646",2023-09-13 12:15:00,-18197,1913,20110,907,FALSE,NA,"0.1.4"
"36243","646",2023-09-13 12:30:00,-18521,1913,20434,907,FALSE,NA,"0.1.4"
"36244","646",2023-09-13 12:45:00,-18664,1913,20577,907,FALSE,NA,"0.1.4"
"36245","646",2023-09-13 13:00:00,-18654,1913,20567,907,FALSE,NA,"0.1.4"
"36246","646",2023-09-13 13:15:00,-18686,1913,20599,907,FALSE,NA,"0.1.4"
"36247","646",2023-09-13 13:30:00,-19029,1913,20942,907,FALSE,NA,"0.1.4"
"36248","646",2023-09-13 13:45:00,-18719,1913,20632,907,FALSE,NA,"0.1.4"
"36249","646",2023-09-13 14:00:00,-18719,1913,20632,907,FALSE,"jump1","0.1.4"
"36250","646",2023-09-13 14:15:00,-18558,1913,20471,907,FALSE,NA,"0.1.4"
"36251","646",2023-09-13 14:30:00,-18558,1913,20471,907,FALSE,"out1, fill","0.1.4"
"36252","646",2023-09-13 14:45:00,-18558,1913,20471,907,FALSE,"jump1","0.1.4"
"36253","646",2023-09-13 15:00:00,-18750,1913,20663,907,FALSE,NA,"0.1.4"
"36254","646",2023-09-13 15:15:00,-18908,1913,20821,907,FALSE,NA,"0.1.4"
"36255","646",2023-09-13 15:30:00,-18968,1913,20881,907,FALSE,NA,"0.1.4"
"36256","646",2023-09-13 15:45:00,-18937,1913,20850,907,FALSE,NA,"0.1.4"
"36257","646",2023-09-13 16:00:00,-18864,1913,20777,907,FALSE,NA,"0.1.4"
"36258","646",2023-09-13 16:15:00,-18733,1913,20646,907,FALSE,NA,"0.1.4"
"36259","646",2023-09-13 16:30:00,-18798,1913,20711,907,FALSE,NA,"0.1.4"
"36260","646",2023-09-13 16:45:00,-18922,1913,20835,907,FALSE,NA,"0.1.4"
"36261","646",2023-09-13 17:00:00,-18564.5,1913,20477.5,907,FALSE,"out1, fill","0.1.4"
"36262","646",2023-09-13 17:15:00,-18207,1913,20120,907,FALSE,"out1, fill","0.1.4"
"36263","646",2023-09-13 17:30:00,-17849.5,1913,19762.5,907,FALSE,"out1, fill","0.1.4"
"36264","646",2023-09-13 17:45:00,-17492,1913,19405,907,FALSE,NA,"0.1.4"
"36265","646",2023-09-13 18:00:00,-17399,1913,19312,907,FALSE,NA,"0.1.4"
"36266","646",2023-09-13 18:15:00,-17209,1913,19122,907,FALSE,NA,"0.1.4"
"36267","646",2023-09-13 18:30:00,-17209,1913,19122,907,FALSE,"jump1","0.1.4"
"36268","646",2023-09-13 18:45:00,-17175,1913,19088,907,FALSE,NA,"0.1.4"
"36269","646",2023-09-13 19:00:00,-17015.5,1913,18928.5,907,FALSE,"out1, fill","0.1.4"
"36270","646",2023-09-13 19:15:00,-16856,1913,18769,907,FALSE,"out1, fill","0.1.4"
"36271","646",2023-09-13 19:30:00,-16696.5,1913,18609.5,907,FALSE,"out1, fill","0.1.4"
"36272","646",2023-09-13 19:45:00,-16537,1913,18450,907,FALSE,NA,"0.1.4"
"36273","646",2023-09-13 20:00:00,-16666,1913,18579,907,FALSE,NA,"0.1.4"
"36274","646",2023-09-13 20:15:00,-16835,1913,18748,907,FALSE,NA,"0.1.4"
"36275","646",2023-09-13 20:30:00,-16592,1913,18505,907,FALSE,NA,"0.1.4"
"36276","646",2023-09-13 20:45:00,-16472,1913,18385,907,FALSE,NA,"0.1.4"
"36277","646",2023-09-13 21:00:00,-16471,1913,18384,907,FALSE,NA,"0.1.4"
"36278","646",2023-09-13 21:15:00,-16471,1913,18384,907,FALSE,NA,"0.1.4"
"36279","646",2023-09-13 21:30:00,-16471,1913,18384,907,FALSE,NA,"0.1.4"
"36280","646",2023-09-13 21:45:00,-16628,1913,18541,907,FALSE,NA,"0.1.4"
"36281","646",2023-09-13 22:00:00,-16550,1913,18463,907,FALSE,NA,"0.1.4"
"36282","646",2023-09-13 22:15:00,-16481,1913,18394,907,FALSE,NA,"0.1.4"
"36283","646",2023-09-13 22:30:00,-16503.3333333333,1913,18416.3333333333,907,FALSE,"out1, fill","0.1.4"
"36284","646",2023-09-13 22:45:00,-16525.6666666667,1913,18438.6666666667,907,FALSE,"out1, fill","0.1.4"
"36285","646",2023-09-13 23:00:00,-16548,1913,18461,907,FALSE,NA,"0.1.4"
"36286","646",2023-09-13 23:15:00,-16528,1913,18441,907,FALSE,NA,"0.1.4"
"36287","646",2023-09-13 23:30:00,-16871,1913,18784,907,FALSE,NA,"0.1.4"
"36288","646",2023-09-13 23:45:00,-16766,1913,18679,907,FALSE,NA,"0.1.4"
"36289","646",2023-09-14,-16766,1913,18679,907,FALSE,"out1, fill","0.1.4"
"36290","646",2023-09-14 00:15:00,-16766,1913,18679,907,FALSE,"jump1","0.1.4"
"36291","646",2023-09-14 00:30:00,-17132,1913,19045,907,FALSE,NA,"0.1.4"
"36292","646",2023-09-14 00:45:00,-17132,1913,19045,907,FALSE,"jump1","0.1.4"
"36293","646",2023-09-14 01:00:00,-17126.6363636364,1913,19039.6363636364,907,FALSE,"out1, fill","0.1.4"
"36294","646",2023-09-14 01:15:00,-17121.2727272727,1913,19034.2727272727,907,FALSE,"out1, fill","0.1.4"
"36295","646",2023-09-14 01:30:00,-17115.9090909091,1913,19028.9090909091,907,FALSE,"out1, fill","0.1.4"
"36296","646",2023-09-14 01:45:00,-17110.5454545455,1913,19023.5454545455,907,FALSE,"out1, fill","0.1.4"
"36297","646",2023-09-14 02:00:00,-17105.1818181818,1913,19018.1818181818,907,FALSE,"out1, fill","0.1.4"
"36298","646",2023-09-14 02:15:00,-17099.8181818182,1913,19012.8181818182,907,FALSE,"out1, fill","0.1.4"
"36299","646",2023-09-14 02:30:00,-17094.4545454545,1913,19007.4545454545,907,FALSE,"out1, fill","0.1.4"
"36300","646",2023-09-14 02:45:00,-17089.0909090909,1913,19002.0909090909,907,FALSE,"out1, fill","0.1.4"
"36301","646",2023-09-14 03:00:00,-17083.7272727273,1913,18996.7272727273,907,FALSE,"out1, fill","0.1.4"
"36302","646",2023-09-14 03:15:00,-17078.3636363636,1913,18991.3636363636,907,FALSE,"out1, fill","0.1.4"
"36303","646",2023-09-14 03:30:00,-17073,1913,18986,907,FALSE,NA,"0.1.4"
"36304","646",2023-09-14 03:45:00,-16732,1913,18645,907,FALSE,NA,"0.1.4"
"36305","646",2023-09-14 04:00:00,-16561,1913,18474,907,FALSE,NA,"0.1.4"
"36306","646",2023-09-14 04:15:00,-16563,1913,18476,907,FALSE,"out1, fill","0.1.4"
"36307","646",2023-09-14 04:30:00,-16565,1913,18478,907,FALSE,"out1, fill","0.1.4"
"36308","646",2023-09-14 04:45:00,-16567,1913,18480,907,FALSE,NA,"0.1.4"
"36309","646",2023-09-14 05:00:00,-16778,1913,18691,907,FALSE,NA,"0.1.4"
"36310","646",2023-09-14 05:15:00,-16778,1913,18691,907,FALSE,"jump1","0.1.4"
"36311","646",2023-09-14 05:30:00,-16684.6666666667,1913,18597.6666666667,907,FALSE,"out1, fill","0.1.4"
"36312","646",2023-09-14 05:45:00,-16591.3333333333,1913,18504.3333333333,907,FALSE,"out1, fill","0.1.4"
"36313","646",2023-09-14 06:00:00,-16498,1913,18411,907,FALSE,NA,"0.1.4"
"36314","646",2023-09-14 06:15:00,-16498,1913,18411,907,FALSE,"jump1","0.1.4"
"36315","646",2023-09-14 06:30:00,-16498,1913,18411,907,FALSE,"jump1","0.1.4"
"36316","646",2023-09-14 06:45:00,-16957.5,1913,18870.5,907,FALSE,"out1, fill","0.1.4"
"36317","646",2023-09-14 07:00:00,-17417,1913,19330,907,FALSE,NA,"0.1.4"
"36318","646",2023-09-14 07:15:00,-17109,1913,19022,907,FALSE,NA,"0.1.4"
"36319","646",2023-09-14 07:30:00,-17093,1913,19006,907,FALSE,NA,"0.1.4"
"36320","646",2023-09-14 07:45:00,-16596,1913,18509,907,FALSE,NA,"0.1.4"
"36321","646",2023-09-14 08:00:00,-16352,1913,18265,907,FALSE,NA,"0.1.4"
"36322","646",2023-09-14 08:15:00,-16376,1913,18289,907,FALSE,NA,"0.1.4"
"36323","646",2023-09-14 08:30:00,-16848,1913,18761,907,FALSE,NA,"0.1.4"
"36324","646",2023-09-14 08:45:00,-16662,1913,18575,907,FALSE,NA,"0.1.4"
"36325","646",2023-09-14 09:00:00,-17113.25,1913,19026.25,907,FALSE,"out1, fill","0.1.4"
"36326","646",2023-09-14 09:15:00,-17564.5,1913,19477.5,907,FALSE,"out1, fill","0.1.4"
"36327","646",2023-09-14 09:30:00,-18015.75,1913,19928.75,907,FALSE,"out1, fill","0.1.4"
"36328","646",2023-09-14 09:45:00,-18467,1913,20380,907,FALSE,NA,"0.1.4"
"36329","646",2023-09-14 10:00:00,-18446,1913,20359,907,FALSE,NA,"0.1.4"
"36330","646",2023-09-14 10:15:00,-18430,1913,20343,907,FALSE,NA,"0.1.4"
"36331","646",2023-09-14 10:30:00,-18183.8,1913,20096.8,907,FALSE,"out1, fill","0.1.4"
"36332","646",2023-09-14 10:45:00,-17937.6,1913,19850.6,907,FALSE,"out1, fill","0.1.4"
"36333","646",2023-09-14 11:00:00,-17691.4,1913,19604.4,907,FALSE,"out1, fill","0.1.4"
"36334","646",2023-09-14 11:15:00,-17445.2,1913,19358.2,907,FALSE,"out1, fill","0.1.4"
"36335","646",2023-09-14 11:30:00,-17199,1913,19112,907,FALSE,NA,"0.1.4"
"36336","646",2023-09-14 11:45:00,-17571,1913,19484,907,FALSE,NA,"0.1.4"
"36337","646",2023-09-14 12:00:00,-17634,1913,19547,907,FALSE,NA,"0.1.4"
"36338","646",2023-09-14 12:15:00,-17867.5,1913,19780.5,907,FALSE,"out1, fill","0.1.4"
"36339","646",2023-09-14 12:30:00,-18101,1913,20014,907,FALSE,NA,"0.1.4"
"36340","646",2023-09-14 12:45:00,-18415,1913,20328,907,FALSE,NA,"0.1.4"
"36341","646",2023-09-14 13:00:00,-18231,1913,20144,907,FALSE,NA,"0.1.4"
"36342","646",2023-09-14 13:15:00,-17926,1913,19839,907,FALSE,NA,"0.1.4"
"36343","646",2023-09-14 13:30:00,-18218,1913,20131,907,FALSE,NA,"0.1.4"
"36344","646",2023-09-14 13:45:00,-17751,1913,19664,907,FALSE,"out1, fill","0.1.4"
"36345","646",2023-09-14 14:00:00,-17284,1913,19197,907,FALSE,NA,"0.1.4"
"36346","646",2023-09-14 14:15:00,-17427,1913,19340,907,FALSE,NA,"0.1.4"
"36347","646",2023-09-14 14:30:00,-17622,1913,19535,907,FALSE,NA,"0.1.4"
"36348","646",2023-09-14 14:45:00,-17136,1913,19049,907,FALSE,NA,"0.1.4"
"36349","646",2023-09-14 15:00:00,-17097,1913,19010,907,FALSE,NA,"0.1.4"
"36350","646",2023-09-14 15:15:00,-17226,1913,19139,907,FALSE,NA,"0.1.4"
"36351","646",2023-09-14 15:30:00,-17110,1913,19023,907,FALSE,NA,"0.1.4"
"36352","646",2023-09-14 15:45:00,-17317,1913,19230,907,FALSE,NA,"0.1.4"
"36353","646",2023-09-14 16:00:00,-17226,1913,19139,907,FALSE,NA,"0.1.4"
"36354","646",2023-09-14 16:15:00,-17288,1913,19201,907,FALSE,NA,"0.1.4"
"36355","646",2023-09-14 16:30:00,-17444,1913,19357,907,FALSE,NA,"0.1.4"
"36356","646",2023-09-14 16:45:00,-17026,1913,18939,907,FALSE,"out1, fill","0.1.4"
"36357","646",2023-09-14 17:00:00,-16608,1913,18521,907,FALSE,NA,"0.1.4"
"36358","646",2023-09-14 17:15:00,-16521,1913,18434,907,FALSE,NA,"0.1.4"
"36359","646",2023-09-14 17:30:00,-16559,1913,18472,907,FALSE,NA,"0.1.4"
"36360","646",2023-09-14 17:45:00,-16559,1913,18472,907,FALSE,"jump1","0.1.4"
"36361","646",2023-09-14 18:00:00,-16497.5,1913,18410.5,907,FALSE,"out1, fill","0.1.4"
"36362","646",2023-09-14 18:15:00,-16436,1913,18349,907,FALSE,"out1, fill","0.1.4"
"36363","646",2023-09-14 18:30:00,-16374.5,1913,18287.5,907,FALSE,"out1, fill","0.1.4"
"36364","646",2023-09-14 18:45:00,-16313,1913,18226,907,FALSE,"out1, fill","0.1.4"
"36365","646",2023-09-14 19:00:00,-16251.5,1913,18164.5,907,FALSE,"out1, fill","0.1.4"
"36366","646",2023-09-14 19:15:00,-16190,1913,18103,907,FALSE,"out1, fill","0.1.4"
"36367","646",2023-09-14 19:30:00,-16128.5,1913,18041.5,907,FALSE,"out1, fill","0.1.4"
"36368","646",2023-09-14 19:45:00,-16067,1913,17980,907,FALSE,"out1, fill","0.1.4"
"36369","646",2023-09-14 20:00:00,-16005.5,1913,17918.5,907,FALSE,"out1, fill","0.1.4"
"36370","646",2023-09-14 20:15:00,-15944,1913,17857,907,FALSE,"out1, fill","0.1.4"
"36371","646",2023-09-14 20:30:00,-15882.5,1913,17795.5,907,FALSE,"out1, fill","0.1.4"
"36372","646",2023-09-14 20:45:00,-15821,1913,17734,907,FALSE,NA,"0.1.4"
"36373","646",2023-09-14 21:00:00,-15830,1913,17743,907,FALSE,NA,"0.1.4"
"36374","646",2023-09-14 21:15:00,-15791,1913,17704,907,FALSE,NA,"0.1.4"
"36375","646",2023-09-14 21:30:00,-16109,1913,18022,907,FALSE,NA,"0.1.4"
"36376","646",2023-09-14 21:45:00,-16288,1913,18201,907,FALSE,"out1, fill","0.1.4"
"36377","646",2023-09-14 22:00:00,-16467,1913,18380,907,FALSE,NA,"0.1.4"
"36378","646",2023-09-14 22:15:00,-16467,1913,18380,907,FALSE,"jump1","0.1.4"
"36379","646",2023-09-14 22:30:00,-16467,1913,18380,907,FALSE,"jump1","0.1.4"
"36380","646",2023-09-14 22:45:00,-16459,1913,18372,907,FALSE,NA,"0.1.4"
"36381","646",2023-09-14 23:00:00,-16337,1913,18250,907,FALSE,NA,"0.1.4"
"36382","646",2023-09-14 23:15:00,-16342,1913,18255,907,FALSE,NA,"0.1.4"
"36383","646",2023-09-14 23:30:00,-16127,1913,18040,907,FALSE,NA,"0.1.4"
"36384","646",2023-09-14 23:45:00,-15865,1913,17778,907,FALSE,NA,"0.1.4"
"36385","646",2023-09-15,-15865,1913,17778,907,FALSE,"jump1","0.1.4"
"36386","646",2023-09-15 00:15:00,-15969,1913,17882,907,FALSE,NA,"0.1.4"
"36387","646",2023-09-15 00:30:00,-15928.3333333333,1913,17841.3333333333,907,FALSE,"out1, fill","0.1.4"
"36388","646",2023-09-15 00:45:00,-15887.6666666667,1913,17800.6666666667,907,FALSE,"out1, fill","0.1.4"
"36389","646",2023-09-15 01:00:00,-15847,1913,17760,907,FALSE,"out1, fill","0.1.4"
"36390","646",2023-09-15 01:15:00,-15806.3333333333,1913,17719.3333333333,907,FALSE,"out1, fill","0.1.4"
"36391","646",2023-09-15 01:30:00,-15765.6666666667,1913,17678.6666666667,907,FALSE,"out1, fill","0.1.4"
"36392","646",2023-09-15 01:45:00,-15725,1913,17638,907,FALSE,"out1, fill","0.1.4"
"36393","646",2023-09-15 02:00:00,-15684.3333333333,1913,17597.3333333333,907,FALSE,"out1, fill","0.1.4"
"36394","646",2023-09-15 02:15:00,-15643.6666666667,1913,17556.6666666667,907,FALSE,"out1, fill","0.1.4"
"36395","646",2023-09-15 02:30:00,-15603,1913,17516,907,FALSE,"out1, fill","0.1.4"
"36396","646",2023-09-15 02:45:00,-15562.3333333333,1913,17475.3333333333,907,FALSE,"out1, fill","0.1.4"
"36397","646",2023-09-15 03:00:00,-15521.6666666667,1913,17434.6666666667,907,FALSE,"out1, fill","0.1.4"
"36398","646",2023-09-15 03:15:00,-15481,1913,17394,907,FALSE,NA,"0.1.4"
"36399","646",2023-09-15 03:30:00,-15866,1913,17779,907,FALSE,NA,"0.1.4"
"36400","646",2023-09-15 03:45:00,-16088,1913,18001,907,FALSE,NA,"0.1.4"
"36401","646",2023-09-15 04:00:00,-15847,1913,17760,907,FALSE,NA,"0.1.4"
"36402","646",2023-09-15 04:15:00,-15981,1913,17894,907,FALSE,NA,"0.1.4"
"36403","646",2023-09-15 04:30:00,-16050,1913,17963,907,FALSE,NA,"0.1.4"
"36404","646",2023-09-15 04:45:00,-16438,1913,18351,907,FALSE,NA,"0.1.4"
"36405","646",2023-09-15 05:00:00,-16438,1913,18351,907,FALSE,"jump1","0.1.4"
"36406","646",2023-09-15 05:15:00,-16158,1913,18071,907,FALSE,NA,"0.1.4"
"36407","646",2023-09-15 05:30:00,-16380,1913,18293,907,FALSE,NA,"0.1.4"
"36408","646",2023-09-15 05:45:00,-16546,1913,18459,907,FALSE,NA,"0.1.4"
"36409","646",2023-09-15 06:00:00,-16546,1913,18459,907,FALSE,"jump1","0.1.4"
"36410","646",2023-09-15 06:15:00,-16482.625,1913,18395.625,907,FALSE,"out1, fill","0.1.4"
"36411","646",2023-09-15 06:30:00,-16419.25,1913,18332.25,907,FALSE,"out1, fill","0.1.4"
"36412","646",2023-09-15 06:45:00,-16355.875,1913,18268.875,907,FALSE,"out1, fill","0.1.4"
"36413","646",2023-09-15 07:00:00,-16292.5,1913,18205.5,907,FALSE,"out1, fill","0.1.4"
"36414","646",2023-09-15 07:15:00,-16229.125,1913,18142.125,907,FALSE,"out1, fill","0.1.4"
"36415","646",2023-09-15 07:30:00,-16165.75,1913,18078.75,907,FALSE,"out1, fill","0.1.4"
"36416","646",2023-09-15 07:45:00,-16102.375,1913,18015.375,907,FALSE,"out1, fill","0.1.4"
"36417","646",2023-09-15 08:00:00,-16039,1913,17952,907,FALSE,NA,"0.1.4"
"36418","646",2023-09-15 08:15:00,-16333,1913,18246,907,FALSE,NA,"0.1.4"
"36419","646",2023-09-15 08:30:00,-16333,1913,18246,907,FALSE,"jump1","0.1.4"
"36420","646",2023-09-15 08:45:00,-15891.5,1913,17804.5,907,FALSE,"out1, fill","0.1.4"
"36421","646",2023-09-15 09:00:00,-15450,1913,17363,907,FALSE,NA,"0.1.4"
"36422","646",2023-09-15 09:15:00,-15547,1913,17460,907,FALSE,NA,"0.1.4"
"36423","646",2023-09-15 09:30:00,-15547,1913,17460,907,FALSE,"jump1","0.1.4"
"36424","646",2023-09-15 09:45:00,-15547,1913,17460,907,FALSE,"jump1","0.1.4"
"36425","646",2023-09-15 10:00:00,-15547,1913,17460,907,FALSE,"jump1","0.1.4"
"36426","646",2023-09-15 10:15:00,-15668,1913,17581,907,FALSE,"out1, fill","0.1.4"
"36427","646",2023-09-15 10:30:00,-15789,1913,17702,907,FALSE,"out1, fill","0.1.4"
"36428","646",2023-09-15 10:45:00,-15910,1913,17823,907,FALSE,"out1, fill","0.1.4"
"36429","646",2023-09-15 11:00:00,-16031,1913,17944,907,FALSE,NA,"0.1.4"
"36430","646",2023-09-15 11:15:00,-16031,1913,17944,907,FALSE,"jump1","0.1.4"
"36431","646",2023-09-15 11:30:00,-15927,1913,17840,907,FALSE,NA,"0.1.4"
"36432","646",2023-09-15 11:45:00,-16354,1913,18267,907,FALSE,NA,"0.1.4"
"36433","646",2023-09-15 12:00:00,-16340.3333333333,1913,18253.3333333333,907,FALSE,"out1, fill","0.1.4"
"36434","646",2023-09-15 12:15:00,-16326.6666666667,1913,18239.6666666667,907,FALSE,"out1, fill","0.1.4"
"36435","646",2023-09-15 12:30:00,-16313,1913,18226,907,FALSE,NA,"0.1.4"
"36436","646",2023-09-15 12:45:00,-16283,1913,18196,907,FALSE,NA,"0.1.4"
"36437","646",2023-09-15 13:00:00,-15886,1913,17799,907,FALSE,NA,"0.1.4"
"36438","646",2023-09-15 13:15:00,-15900,1913,17813,907,FALSE,NA,"0.1.4"
"36439","646",2023-09-15 13:30:00,-15924,1913,17837,907,FALSE,NA,"0.1.4"
"36440","646",2023-09-15 13:45:00,-16031,1913,17944,907,FALSE,NA,"0.1.4"
"36441","646",2023-09-15 14:00:00,-15649,1913,17562,907,FALSE,NA,"0.1.4"
"36442","646",2023-09-15 14:15:00,-15573,1913,17486,907,FALSE,NA,"0.1.4"
"36443","646",2023-09-15 14:30:00,-15824,1913,17737,907,FALSE,NA,"0.1.4"
"36444","646",2023-09-15 14:45:00,-15491,1913,17404,907,FALSE,NA,"0.1.4"
"36445","646",2023-09-15 15:00:00,-15491,1913,17404,907,FALSE,"jump1","0.1.4"
"36446","646",2023-09-15 15:15:00,-15644,1913,17557,907,FALSE,NA,"0.1.4"
"36447","646",2023-09-15 15:30:00,-15672,1913,17585,907,FALSE,NA,"0.1.4"
"36448","646",2023-09-15 15:45:00,-15384,1913,17297,907,FALSE,NA,"0.1.4"
"36449","646",2023-09-15 16:00:00,-15266,1913,17179,907,FALSE,NA,"0.1.4"
"36450","646",2023-09-15 16:15:00,-15144,1913,17057,907,FALSE,NA,"0.1.4"
"36451","646",2023-09-15 16:30:00,-15233,1913,17146,907,FALSE,NA,"0.1.4"
"36452","646",2023-09-15 16:45:00,-15115,1913,17028,907,FALSE,NA,"0.1.4"
"36453","646",2023-09-15 17:00:00,-15033,1913,16946,907,FALSE,NA,"0.1.4"
"36454","646",2023-09-15 17:15:00,-15032,1913,16945,907,FALSE,NA,"0.1.4"
"36455","646",2023-09-15 17:30:00,-14911,1913,16824,907,FALSE,NA,"0.1.4"
"36456","646",2023-09-15 17:45:00,-14865,1913,16778,907,FALSE,NA,"0.1.4"
"36457","646",2023-09-15 18:00:00,-14865,1913,16778,907,FALSE,"jump1","0.1.4"
"36458","646",2023-09-15 18:15:00,-14415,1913,16328,907,FALSE,NA,"0.1.4"
"36459","646",2023-09-15 18:30:00,-14536,1913,16449,907,FALSE,NA,"0.1.4"
"36460","646",2023-09-15 18:45:00,-14991.6666666667,1913,16904.6666666667,907,FALSE,"out1, fill","0.1.4"
"36461","646",2023-09-15 19:00:00,-15447.3333333333,1913,17360.3333333333,907,FALSE,"out1, fill","0.1.4"
"36462","646",2023-09-15 19:15:00,-15903,1913,17816,907,FALSE,NA,"0.1.4"
"36463","646",2023-09-15 19:30:00,-15982,1913,17895,907,FALSE,NA,"0.1.4"
"36464","646",2023-09-15 19:45:00,-15982,1913,17895,907,FALSE,"jump1","0.1.4"
"36465","646",2023-09-15 20:00:00,-15561,1913,17474,907,FALSE,NA,"0.1.4"
"36466","646",2023-09-15 20:15:00,-15561,1913,17474,907,FALSE,"jump1","0.1.4"
"36467","646",2023-09-15 20:30:00,-15554.25,1913,17467.25,907,FALSE,"out1, fill","0.1.4"
"36468","646",2023-09-15 20:45:00,-15547.5,1913,17460.5,907,FALSE,"out1, fill","0.1.4"
"36469","646",2023-09-15 21:00:00,-15540.75,1913,17453.75,907,FALSE,"out1, fill","0.1.4"
"36470","646",2023-09-15 21:15:00,-15534,1913,17447,907,FALSE,"out1, fill","0.1.4"
"36471","646",2023-09-15 21:30:00,-15527.25,1913,17440.25,907,FALSE,"out1, fill","0.1.4"
"36472","646",2023-09-15 21:45:00,-15520.5,1913,17433.5,907,FALSE,"out1, fill","0.1.4"
"36473","646",2023-09-15 22:00:00,-15513.75,1913,17426.75,907,FALSE,"out1, fill","0.1.4"
"36474","646",2023-09-15 22:15:00,-15507,1913,17420,907,FALSE,NA,"0.1.4"
"36475","646",2023-09-15 22:30:00,-15565,1913,17478,907,FALSE,NA,"0.1.4"
"36476","646",2023-09-15 22:45:00,-15568,1913,17481,907,FALSE,NA,"0.1.4"
"36477","646",2023-09-15 23:00:00,-15567,1913,17480,907,FALSE,NA,"0.1.4"
"36478","646",2023-09-15 23:15:00,-15567,1913,17480,907,FALSE,NA,"0.1.4"
"36479","646",2023-09-15 23:30:00,-15571,1913,17484,907,FALSE,NA,"0.1.4"
"36480","646",2023-09-15 23:45:00,-15567,1913,17480,907,FALSE,NA,"0.1.4"
"36481","646",2023-09-16,-15761,1913,17674,907,FALSE,NA,"0.1.4"
"36482","646",2023-09-16 00:15:00,-15562,1913,17475,907,FALSE,NA,"0.1.4"
"36483","646",2023-09-16 00:30:00,-15776,1913,17689,907,FALSE,NA,"0.1.4"
"36484","646",2023-09-16 00:45:00,-15561,1913,17474,907,FALSE,NA,"0.1.4"
"36485","646",2023-09-16 01:00:00,-15861.3333333333,1913,17774.3333333333,907,FALSE,"out1, fill","0.1.4"
"36486","646",2023-09-16 01:15:00,-16161.6666666667,1913,18074.6666666667,907,FALSE,"out1, fill","0.1.4"
"36487","646",2023-09-16 01:30:00,-16462,1913,18375,907,FALSE,"out1, fill","0.1.4"
"36488","646",2023-09-16 01:45:00,-16762.3333333333,1913,18675.3333333333,907,FALSE,"out1, fill","0.1.4"
"36489","646",2023-09-16 02:00:00,-17062.6666666667,1913,18975.6666666667,907,FALSE,"out1, fill","0.1.4"
"36490","646",2023-09-16 02:15:00,-17363,1913,19276,907,FALSE,NA,"0.1.4"
"36491","646",2023-09-16 02:30:00,-17548,1913,19461,907,FALSE,NA,"0.1.4"
"36492","646",2023-09-16 02:45:00,-17277,1913,19190,907,FALSE,NA,"0.1.4"
"36493","646",2023-09-16 03:00:00,-17306.3333333333,1913,19219.3333333333,907,FALSE,"out1, fill","0.1.4"
"36494","646",2023-09-16 03:15:00,-17335.6666666667,1913,19248.6666666667,907,FALSE,"out1, fill","0.1.4"
"36495","646",2023-09-16 03:30:00,-17365,1913,19278,907,FALSE,NA,"0.1.4"
"36496","646",2023-09-16 03:45:00,-17482,1913,19395,907,FALSE,NA,"0.1.4"
"36497","646",2023-09-16 04:00:00,-17578,1913,19491,907,FALSE,NA,"0.1.4"
"36498","646",2023-09-16 04:15:00,-17415.1111111111,1913,19328.1111111111,907,FALSE,"out1, fill","0.1.4"
"36499","646",2023-09-16 04:30:00,-17252.2222222222,1913,19165.2222222222,907,FALSE,"out1, fill","0.1.4"
"36500","646",2023-09-16 04:45:00,-17089.3333333333,1913,19002.3333333333,907,FALSE,"out1, fill","0.1.4"
"36501","646",2023-09-16 05:00:00,-16926.4444444444,1913,18839.4444444444,907,FALSE,"out1, fill","0.1.4"
"36502","646",2023-09-16 05:15:00,-16763.5555555556,1913,18676.5555555556,907,FALSE,"out1, fill","0.1.4"
"36503","646",2023-09-16 05:30:00,-16600.6666666667,1913,18513.6666666667,907,FALSE,"out1, fill","0.1.4"
"36504","646",2023-09-16 05:45:00,-16437.7777777778,1913,18350.7777777778,907,FALSE,"out1, fill","0.1.4"
"36505","646",2023-09-16 06:00:00,-16274.8888888889,1913,18187.8888888889,907,FALSE,"out1, fill","0.1.4"
"36506","646",2023-09-16 06:15:00,-16112,1913,18025,907,FALSE,NA,"0.1.4"
"36507","646",2023-09-16 06:30:00,-16414,1913,18327,907,FALSE,NA,"0.1.4"
"36508","646",2023-09-16 06:45:00,-16323,1913,18236,907,FALSE,NA,"0.1.4"
"36509","646",2023-09-16 07:00:00,-16561,1913,18474,907,FALSE,NA,"0.1.4"
"36510","646",2023-09-16 07:15:00,-16158,1913,18071,907,FALSE,NA,"0.1.4"
"36511","646",2023-09-16 07:30:00,-16528,1913,18441,907,FALSE,NA,"0.1.4"
"36512","646",2023-09-16 07:45:00,-16194,1913,18107,907,FALSE,NA,"0.1.4"
"36513","646",2023-09-16 08:00:00,-16194,1913,18107,907,FALSE,"jump1","0.1.4"
"36514","646",2023-09-16 08:15:00,-16003,1913,17916,907,FALSE,NA,"0.1.4"
"36515","646",2023-09-16 08:30:00,-15964,1913,17877,907,FALSE,NA,"0.1.4"
"36516","646",2023-09-16 08:45:00,-15998,1913,17911,907,FALSE,NA,"0.1.4"
"36517","646",2023-09-16 09:00:00,-16187,1913,18100,907,FALSE,NA,"0.1.4"
"36518","646",2023-09-16 09:15:00,-16187,1913,18100,907,FALSE,"jump1","0.1.4"
"36519","646",2023-09-16 09:30:00,-16105,1913,18018,907,FALSE,NA,"0.1.4"
"36520","646",2023-09-16 09:45:00,-16381,1913,18294,907,FALSE,NA,"0.1.4"
"36521","646",2023-09-16 10:00:00,-16404,1913,18317,907,FALSE,NA,"0.1.4"
"36522","646",2023-09-16 10:15:00,-16358.25,1913,18271.25,907,FALSE,"out1, fill","0.1.4"
"36523","646",2023-09-16 10:30:00,-16312.5,1913,18225.5,907,FALSE,"out1, fill","0.1.4"
"36524","646",2023-09-16 10:45:00,-16266.75,1913,18179.75,907,FALSE,"out1, fill","0.1.4"
"36525","646",2023-09-16 11:00:00,-16221,1913,18134,907,FALSE,NA,"0.1.4"
"36526","646",2023-09-16 11:15:00,-16390,1913,18303,907,FALSE,NA,"0.1.4"
"36527","646",2023-09-16 11:30:00,-16126,1913,18039,907,FALSE,NA,"0.1.4"
"36528","646",2023-09-16 11:45:00,-15673,1913,17586,907,FALSE,NA,"0.1.4"
"36529","646",2023-09-16 12:00:00,-15673,1913,17586,907,FALSE,"jump1","0.1.4"
"36530","646",2023-09-16 12:15:00,-15673,1913,17586,907,FALSE,"out1, fill","0.1.4"
"36531","646",2023-09-16 12:30:00,-15673,1913,17586,907,FALSE,"jump1","0.1.4"
"36532","646",2023-09-16 12:45:00,-15607,1913,17520,907,FALSE,NA,"0.1.4"
"36533","646",2023-09-16 13:00:00,-15415,1913,17328,907,FALSE,NA,"0.1.4"
"36534","646",2023-09-16 13:15:00,-15415,1913,17328,907,FALSE,"jump1","0.1.4"
"36535","646",2023-09-16 13:30:00,-15247,1913,17160,907,FALSE,NA,"0.1.4"
"36536","646",2023-09-16 13:45:00,-14995,1913,16908,907,FALSE,NA,"0.1.4"
"36537","646",2023-09-16 14:00:00,-15208,1913,17121,907,FALSE,NA,"0.1.4"
"36538","646",2023-09-16 14:15:00,-14784,1913,16697,907,FALSE,NA,"0.1.4"
"36539","646",2023-09-16 14:30:00,-14784,1913,16697,907,FALSE,"jump1","0.1.4"
"36540","646",2023-09-16 14:45:00,-14884,1913,16797,907,FALSE,NA,"0.1.4"
"36541","646",2023-09-16 15:00:00,-14826,1913,16739,907,FALSE,NA,"0.1.4"
"36542","646",2023-09-16 15:15:00,-14762,1913,16675,907,FALSE,NA,"0.1.4"
"36543","646",2023-09-16 15:30:00,-14280,1913,16193,907,FALSE,"out1, fill","0.1.4"
"36544","646",2023-09-16 15:45:00,-13798,1913,15711,907,FALSE,NA,"0.1.4"
"36545","646",2023-09-16 16:00:00,-13797,1913,15710,907,FALSE,NA,"0.1.4"
"36546","646",2023-09-16 16:15:00,-13780,1913,15693,907,FALSE,NA,"0.1.4"
"36547","646",2023-09-16 16:30:00,-14162,1913,16075,907,FALSE,NA,"0.1.4"
"36548","646",2023-09-16 16:45:00,-13842,1913,15755,907,FALSE,NA,"0.1.4"
"36549","646",2023-09-16 17:00:00,NA,NA,NA,NA,NA,"out1","0.1.4"
"36550","646",2023-09-16 17:15:00,NA,NA,NA,NA,NA,"out1","0.1.4"
"36551","646",2023-09-16 17:30:00,NA,NA,NA,NA,NA,"out1","0.1.4"
"36552","646",2023-09-16 17:45:00,NA,NA,NA,NA,NA,"out1","0.1.4"
"36553","646",2023-09-16 18:00:00,NA,NA,NA,NA,NA,"out1","0.1.4"
"36554","646",2023-09-16 18:15:00,NA,NA,NA,NA,NA,"out1","0.1.4"
"36555","646",2023-09-16 18:30:00,NA,NA,NA,NA,NA,"out1","0.1.4"
"36556","646",2023-09-16 18:45:00,NA,NA,NA,NA,NA,"out1","0.1.4"
"36557","646",2023-09-16 19:00:00,NA,NA,NA,NA,NA,"out1","0.1.4"
"36558","646",2023-09-16 19:15:00,NA,NA,NA,NA,NA,"out1","0.1.4"
"36559","646",2023-09-16 19:30:00,NA,NA,NA,NA,NA,"out1","0.1.4"
"36560","646",2023-09-16 19:45:00,NA,NA,NA,NA,NA,"out1","0.1.4"
"36561","646",2023-09-16 20:00:00,NA,NA,NA,NA,NA,"out1","0.1.4"
"36562","646",2023-09-16 20:15:00,NA,NA,NA,NA,NA,"out1","0.1.4"
"36563","646",2023-09-16 20:30:00,NA,NA,NA,NA,NA,"out1","0.1.4"
"36564","646",2023-09-16 20:45:00,NA,NA,NA,NA,NA,"out1","0.1.4"
"36565","646",2023-09-16 21:00:00,NA,NA,NA,NA,NA,"out1","0.1.4"
"36566","646",2023-09-16 21:15:00,NA,NA,NA,NA,NA,"out1","0.1.4"
"36567","646",2023-09-16 21:30:00,NA,NA,NA,NA,NA,"out1","0.1.4"
"36568","646",2023-09-16 21:45:00,NA,NA,NA,NA,NA,"out1","0.1.4"
"36569","646",2023-09-16 22:00:00,NA,NA,NA,NA,NA,"out1","0.1.4"
"36570","646",2023-09-16 22:15:00,NA,NA,NA,NA,NA,"out1","0.1.4"
"36571","646",2023-09-16 22:30:00,NA,NA,NA,NA,NA,"out1","0.1.4"
"36572","646",2023-09-16 22:45:00,NA,NA,NA,NA,NA,"out1","0.1.4"
"36573","646",2023-09-16 23:00:00,NA,NA,NA,NA,NA,"out1","0.1.4"
"36574","646",2023-09-16 23:15:00,-15615,1913,17528,907,FALSE,NA,"0.1.4"
"36575","646",2023-09-16 23:30:00,-15650,1913,17563,907,FALSE,NA,"0.1.4"
"36576","646",2023-09-16 23:45:00,-15625,1913,17538,907,FALSE,NA,"0.1.4"
"36577","646",2023-09-17,-15722,1913,17635,907,FALSE,NA,"0.1.4"
"36578","646",2023-09-17 00:15:00,-15678,1913,17591,907,FALSE,"out1, fill","0.1.4"
"36579","646",2023-09-17 00:30:00,-15634,1913,17547,907,FALSE,"out1, fill","0.1.4"
"36580","646",2023-09-17 00:45:00,-15590,1913,17503,907,FALSE,"out1, fill","0.1.4"
"36581","646",2023-09-17 01:00:00,-15546,1913,17459,907,FALSE,NA,"0.1.4"
"36582","646",2023-09-17 01:15:00,-15728,1913,17641,907,FALSE,NA,"0.1.4"
"36583","646",2023-09-17 01:30:00,-15324,1913,17237,907,FALSE,NA,"0.1.4"
"36584","646",2023-09-17 01:45:00,-15745,1913,17658,907,FALSE,NA,"0.1.4"
"36585","646",2023-09-17 02:00:00,-15823,1913,17736,907,FALSE,NA,"0.1.4"
"36586","646",2023-09-17 02:15:00,-15628.8,1913,17541.8,907,FALSE,"out1, fill","0.1.4"
"36587","646",2023-09-17 02:30:00,-15434.6,1913,17347.6,907,FALSE,"out1, fill","0.1.4"
"36588","646",2023-09-17 02:45:00,-15240.4,1913,17153.4,907,FALSE,"out1, fill","0.1.4"
"36589","646",2023-09-17 03:00:00,-15046.2,1913,16959.2,907,FALSE,"out1, fill","0.1.4"
"36590","646",2023-09-17 03:15:00,-14852,1913,16765,907,FALSE,NA,"0.1.4"
"36591","646",2023-09-17 03:30:00,-14852,1913,16765,907,FALSE,"jump1","0.1.4"
"36592","646",2023-09-17 03:45:00,-14852,1913,16765,907,FALSE,"jump1","0.1.4"
"36593","646",2023-09-17 04:00:00,-15305.5,1913,17218.5,907,FALSE,"out1, fill","0.1.4"
"36594","646",2023-09-17 04:15:00,-15759,1913,17672,907,FALSE,NA,"0.1.4"
"36595","646",2023-09-17 04:30:00,-15529,1913,17442,907,FALSE,NA,"0.1.4"
"36596","646",2023-09-17 04:45:00,-15529,1913,17442,907,FALSE,"jump1","0.1.4"
"36597","646",2023-09-17 05:00:00,-15509,1913,17422,907,FALSE,NA,"0.1.4"
"36598","646",2023-09-17 05:15:00,-15509,1913,17422,907,FALSE,"jump1","0.1.4"
"36599","646",2023-09-17 05:30:00,-15509,1913,17422,907,FALSE,"out1, fill","0.1.4"
"36600","646",2023-09-17 05:45:00,-15509,1913,17422,907,FALSE,"jump1","0.1.4"
"36601","646",2023-09-17 06:00:00,-15773,1913,17686,907,FALSE,NA,"0.1.4"
"36602","646",2023-09-17 06:15:00,-15974,1913,17887,907,FALSE,NA,"0.1.4"
"36603","646",2023-09-17 06:30:00,-15887,1913,17800,907,FALSE,NA,"0.1.4"
"36604","646",2023-09-17 06:45:00,-15849.5,1913,17762.5,907,FALSE,"out1, fill","0.1.4"
"36605","646",2023-09-17 07:00:00,-15812,1913,17725,907,FALSE,NA,"0.1.4"
"36606","646",2023-09-17 07:15:00,-15357,1913,17270,907,FALSE,NA,"0.1.4"
"36607","646",2023-09-17 07:30:00,-15357,1913,17270,907,FALSE,"jump1","0.1.4"
"36608","646",2023-09-17 07:45:00,-15316,1913,17229,907,FALSE,NA,"0.1.4"
"36609","646",2023-09-17 08:00:00,-15235,1913,17148,907,FALSE,NA,"0.1.4"
"36610","646",2023-09-17 08:15:00,-15422.2,1913,17335.2,907,FALSE,"out1, fill","0.1.4"
"36611","646",2023-09-17 08:30:00,-15609.4,1913,17522.4,907,FALSE,"out1, fill","0.1.4"
"36612","646",2023-09-17 08:45:00,-15796.6,1913,17709.6,907,FALSE,"out1, fill","0.1.4"
"36613","646",2023-09-17 09:00:00,-15983.8,1913,17896.8,907,FALSE,"out1, fill","0.1.4"
"36614","646",2023-09-17 09:15:00,-16171,1913,18084,907,FALSE,NA,"0.1.4"
"36615","646",2023-09-17 09:30:00,-16207,1913,18120,907,FALSE,NA,"0.1.4"
"36616","646",2023-09-17 09:45:00,-16325,1913,18238,907,FALSE,NA,"0.1.4"
"36617","646",2023-09-17 10:00:00,-16331.4,1913,18244.4,907,FALSE,"out1, fill","0.1.4"
"36618","646",2023-09-17 10:15:00,-16337.8,1913,18250.8,907,FALSE,"out1, fill","0.1.4"
"36619","646",2023-09-17 10:30:00,-16344.2,1913,18257.2,907,FALSE,"out1, fill","0.1.4"
"36620","646",2023-09-17 10:45:00,-16350.6,1913,18263.6,907,FALSE,"out1, fill","0.1.4"
"36621","646",2023-09-17 11:00:00,-16357,1913,18270,907,FALSE,NA,"0.1.4"
"36622","646",2023-09-17 11:15:00,-16255,1913,18168,907,FALSE,NA,"0.1.4"
"36623","646",2023-09-17 11:30:00,-16098,1913,18011,907,FALSE,NA,"0.1.4"
"36624","646",2023-09-17 11:45:00,-15748,1913,17661,907,FALSE,NA,"0.1.4"
"36625","646",2023-09-17 12:00:00,-16056,1913,17969,907,FALSE,NA,"0.1.4"
"36626","646",2023-09-17 12:15:00,-16387,1913,18300,907,FALSE,NA,"0.1.4"
"36627","646",2023-09-17 12:30:00,-16158,1913,18071,907,FALSE,NA,"0.1.4"
"36628","646",2023-09-17 12:45:00,-16343,1913,18256,907,FALSE,NA,"0.1.4"
"36629","646",2023-09-17 13:00:00,-16089.5,1913,18002.5,907,FALSE,"out1, fill","0.1.4"
"36630","646",2023-09-17 13:15:00,-15836,1913,17749,907,FALSE,NA,"0.1.4"
"36631","646",2023-09-17 13:30:00,-15921,1913,17834,907,FALSE,NA,"0.1.4"
"36632","646",2023-09-17 13:45:00,-16116,1913,18029,907,FALSE,NA,"0.1.4"
"36633","646",2023-09-17 14:00:00,-16046,1913,17959,907,FALSE,NA,"0.1.4"
"36634","646",2023-09-17 14:15:00,-15955,1913,17868,907,FALSE,NA,"0.1.4"
"36635","646",2023-09-17 14:30:00,-15900,1913,17813,907,FALSE,NA,"0.1.4"
"36636","646",2023-09-17 14:45:00,-15906,1913,17819,907,FALSE,NA,"0.1.4"
"36637","646",2023-09-17 15:00:00,-15816,1913,17729,907,FALSE,NA,"0.1.4"
"36638","646",2023-09-17 15:15:00,-15814,1913,17727,907,FALSE,NA,"0.1.4"
"36639","646",2023-09-17 15:30:00,-15805,1913,17718,907,FALSE,NA,"0.1.4"
"36640","646",2023-09-17 15:45:00,-15399,1913,17312,907,FALSE,NA,"0.1.4"
"36641","646",2023-09-17 16:00:00,-15389,1913,17302,907,FALSE,NA,"0.1.4"
"36642","646",2023-09-17 16:15:00,-15417,1913,17330,907,FALSE,NA,"0.1.4"
"36643","646",2023-09-17 16:30:00,-15433,1913,17346,907,FALSE,NA,"0.1.4"
"36644","646",2023-09-17 16:45:00,-15806,1913,17719,907,FALSE,NA,"0.1.4"
"36645","646",2023-09-17 17:00:00,-15692,1913,17605,907,FALSE,NA,"0.1.4"
"36646","646",2023-09-17 17:15:00,-15615,1913,17528,907,FALSE,NA,"0.1.4"
"36647","646",2023-09-17 17:30:00,-15535,1913,17448,907,FALSE,NA,"0.1.4"
"36648","646",2023-09-17 17:45:00,-15916,1913,17829,907,FALSE,NA,"0.1.4"
"36649","646",2023-09-17 18:00:00,-15593,1913,17506,907,FALSE,NA,"0.1.4"
"36650","646",2023-09-17 18:15:00,-15127,1913,17040,907,FALSE,NA,"0.1.4"
"36651","646",2023-09-17 18:30:00,-15332,1913,17245,907,FALSE,NA,"0.1.4"
"36652","646",2023-09-17 18:45:00,-15314,1913,17227,907,FALSE,NA,"0.1.4"
"36653","646",2023-09-17 19:00:00,-14969,1913,16882,907,FALSE,NA,"0.1.4"
"36654","646",2023-09-17 19:15:00,-14902.5555555556,1913,16815.5555555556,907,FALSE,"out1, fill","0.1.4"
"36655","646",2023-09-17 19:30:00,-14836.1111111111,1913,16749.1111111111,907,FALSE,"out1, fill","0.1.4"
"36656","646",2023-09-17 19:45:00,-14769.6666666667,1913,16682.6666666667,907,FALSE,"out1, fill","0.1.4"
"36657","646",2023-09-17 20:00:00,-14703.2222222222,1913,16616.2222222222,907,FALSE,"out1, fill","0.1.4"
"36658","646",2023-09-17 20:15:00,-14636.7777777778,1913,16549.7777777778,907,FALSE,"out1, fill","0.1.4"
"36659","646",2023-09-17 20:30:00,-14570.3333333333,1913,16483.3333333333,907,FALSE,"out1, fill","0.1.4"
"36660","646",2023-09-17 20:45:00,-14503.8888888889,1913,16416.8888888889,907,FALSE,"out1, fill","0.1.4"
"36661","646",2023-09-17 21:00:00,-14437.4444444444,1913,16350.4444444444,907,FALSE,"out1, fill","0.1.4"
"36662","646",2023-09-17 21:15:00,-14371,1913,16284,907,FALSE,NA,"0.1.4"
"36663","646",2023-09-17 21:30:00,-14371,1913,16284,907,FALSE,"jump1","0.1.4"
"36664","646",2023-09-17 21:45:00,-14258,1913,16171,907,FALSE,NA,"0.1.4"
"36665","646",2023-09-17 22:00:00,-14306,1913,16219,907,FALSE,NA,"0.1.4"
"36666","646",2023-09-17 22:15:00,-14759,1913,16672,907,FALSE,NA,"0.1.4"
"36667","646",2023-09-17 22:30:00,-14562,1913,16475,907,FALSE,NA,"0.1.4"
"36668","646",2023-09-17 22:45:00,-14562,1913,16475,907,FALSE,"jump1","0.1.4"
"36669","646",2023-09-17 23:00:00,-14239,1913,16152,907,FALSE,NA,"0.1.4"
"36670","646",2023-09-17 23:15:00,-14584,1913,16497,907,FALSE,NA,"0.1.4"
"36671","646",2023-09-17 23:30:00,-14320,1913,16233,907,FALSE,NA,"0.1.4"
"36672","646",2023-09-17 23:45:00,-14804,1913,16717,907,FALSE,NA,"0.1.4"
"36673","646",2023-09-18,-14838,1913,16751,907,FALSE,NA,"0.1.4"
"36674","646",2023-09-18 00:15:00,-14741,1913,16654,907,FALSE,"out1, fill","0.1.4"
"36675","646",2023-09-18 00:30:00,-14644,1913,16557,907,FALSE,"out1, fill","0.1.4"
"36676","646",2023-09-18 00:45:00,-14547,1913,16460,907,FALSE,NA,"0.1.4"
"36677","646",2023-09-18 01:00:00,-14996,1913,16909,907,FALSE,NA,"0.1.4"
"36678","646",2023-09-18 01:15:00,-14729,1913,16642,907,FALSE,NA,"0.1.4"
"36679","646",2023-09-18 01:30:00,-14598.1666666667,1913,16511.1666666667,907,FALSE,"out1, fill","0.1.4"
"36680","646",2023-09-18 01:45:00,-14467.3333333333,1913,16380.3333333333,907,FALSE,"out1, fill","0.1.4"
"36681","646",2023-09-18 02:00:00,-14336.5,1913,16249.5,907,FALSE,"out1, fill","0.1.4"
"36682","646",2023-09-18 02:15:00,-14205.6666666667,1913,16118.6666666667,907,FALSE,"out1, fill","0.1.4"
"36683","646",2023-09-18 02:30:00,-14074.8333333333,1913,15987.8333333333,907,FALSE,"out1, fill","0.1.4"
"36684","646",2023-09-18 02:45:00,-13944,1913,15857,907,FALSE,NA,"0.1.4"
"36685","646",2023-09-18 03:00:00,-13911,1913,15824,907,FALSE,NA,"0.1.4"
"36686","646",2023-09-18 03:15:00,-13911,1913,15824,907,FALSE,"jump1","0.1.4"
"36687","646",2023-09-18 03:30:00,-13911,1913,15824,907,FALSE,"jump1","0.1.4"
"36688","646",2023-09-18 03:45:00,-13937,1913,15850,907,FALSE,"out1, fill","0.1.4"
"36689","646",2023-09-18 04:00:00,-13963,1913,15876,907,FALSE,"out1, fill","0.1.4"
"36690","646",2023-09-18 04:15:00,-13989,1913,15902,907,FALSE,"out1, fill","0.1.4"
"36691","646",2023-09-18 04:30:00,-14015,1913,15928,907,FALSE,"out1, fill","0.1.4"
"36692","646",2023-09-18 04:45:00,-14041,1913,15954,907,FALSE,"out1, fill","0.1.4"
"36693","646",2023-09-18 05:00:00,-14067,1913,15980,907,FALSE,"out1, fill","0.1.4"
"36694","646",2023-09-18 05:15:00,-14093,1913,16006,907,FALSE,NA,"0.1.4"
"36695","646",2023-09-18 05:30:00,-14093,1913,16006,907,FALSE,"jump1","0.1.4"
"36696","646",2023-09-18 05:45:00,-13878,1913,15791,907,FALSE,NA,"0.1.4"
"36697","646",2023-09-18 06:00:00,-13878,1913,15791,907,FALSE,"jump1","0.1.4"
"36698","646",2023-09-18 06:15:00,-13839.3333333333,1913,15752.3333333333,907,FALSE,"out1, fill","0.1.4"
"36699","646",2023-09-18 06:30:00,-13800.6666666667,1913,15713.6666666667,907,FALSE,"out1, fill","0.1.4"
"36700","646",2023-09-18 06:45:00,-13762,1913,15675,907,FALSE,NA,"0.1.4"
"36701","646",2023-09-18 07:00:00,-14180,1913,16093,907,FALSE,NA,"0.1.4"
"36702","646",2023-09-18 07:15:00,-14045,1913,15958,907,FALSE,NA,"0.1.4"
"36703","646",2023-09-18 07:30:00,-14163,1913,16076,907,FALSE,NA,"0.1.4"
"36704","646",2023-09-18 07:45:00,-14163,1913,16076,907,FALSE,"jump1","0.1.4"
"36705","646",2023-09-18 08:00:00,-13922.5,1913,15835.5,907,FALSE,"out1, fill","0.1.4"
"36706","646",2023-09-18 08:15:00,-13682,1913,15595,907,FALSE,NA,"0.1.4"
"36707","646",2023-09-18 08:30:00,-13682,1913,15595,907,FALSE,"jump1","0.1.4"
"36708","646",2023-09-18 08:45:00,-13926,1913,15839,907,FALSE,NA,"0.1.4"
"36709","646",2023-09-18 09:00:00,-13726.5,1913,15639.5,907,FALSE,"out1, fill","0.1.4"
"36710","646",2023-09-18 09:15:00,-13527,1913,15440,907,FALSE,NA,"0.1.4"
"36711","646",2023-09-18 09:30:00,-13527,1913,15440,907,FALSE,"jump1","0.1.4"
"36712","646",2023-09-18 09:45:00,-13949,1913,15862,907,FALSE,NA,"0.1.4"
"36713","646",2023-09-18 10:00:00,-13582,1913,15495,907,FALSE,NA,"0.1.4"
"36714","646",2023-09-18 10:15:00,-13579.3333333333,1913,15492.3333333333,907,FALSE,"out1, fill","0.1.4"
"36715","646",2023-09-18 10:30:00,-13576.6666666667,1913,15489.6666666667,907,FALSE,"out1, fill","0.1.4"
"36716","646",2023-09-18 10:45:00,-13574,1913,15487,907,FALSE,NA,"0.1.4"
"36717","646",2023-09-18 11:00:00,-13226,1913,15139,907,FALSE,NA,"0.1.4"
"36718","646",2023-09-18 11:15:00,-13226,1913,15139,907,FALSE,"jump1","0.1.4"
"36719","646",2023-09-18 11:30:00,-12838,1913,14751,907,FALSE,NA,"0.1.4"
"36720","646",2023-09-18 11:45:00,-12803,1913,14716,907,FALSE,NA,"0.1.4"
"36721","646",2023-09-18 12:00:00,-13022,1913,14935,907,FALSE,NA,"0.1.4"
"36722","646",2023-09-18 12:15:00,-12682,1913,14595,907,FALSE,NA,"0.1.4"
"36723","646",2023-09-18 12:30:00,-12381,1913,14294,907,FALSE,NA,"0.1.4"
"36724","646",2023-09-18 12:45:00,-12349,1913,14262,907,FALSE,NA,"0.1.4"
"36725","646",2023-09-18 13:00:00,-12480,1913,14393,907,FALSE,NA,"0.1.4"
"36726","646",2023-09-18 13:15:00,-12486,1913,14399,907,FALSE,NA,"0.1.4"
"36727","646",2023-09-18 13:30:00,-12463,1913,14376,907,FALSE,NA,"0.1.4"
"36728","646",2023-09-18 13:45:00,-12596.4,1913,14509.4,907,FALSE,"out1, fill","0.1.4"
"36729","646",2023-09-18 14:00:00,-12729.8,1913,14642.8,907,FALSE,"out1, fill","0.1.4"
"36730","646",2023-09-18 14:15:00,-12863.2,1913,14776.2,907,FALSE,"out1, fill","0.1.4"
"36731","646",2023-09-18 14:30:00,-12996.6,1913,14909.6,907,FALSE,"out1, fill","0.1.4"
"36732","646",2023-09-18 14:45:00,-13130,1913,15043,907,FALSE,"out1, fill","0.1.4"
"36733","646",2023-09-18 15:00:00,-13263.4,1913,15176.4,907,FALSE,"out1, fill","0.1.4"
"36734","646",2023-09-18 15:15:00,-13396.8,1913,15309.8,907,FALSE,"out1, fill","0.1.4"
"36735","646",2023-09-18 15:30:00,-13530.2,1913,15443.2,907,FALSE,"out1, fill","0.1.4"
"36736","646",2023-09-18 15:45:00,-13663.6,1913,15576.6,907,FALSE,"out1, fill","0.1.4"
"36737","646",2023-09-18 16:00:00,-13797,1913,15710,907,FALSE,NA,"0.1.4"
"36738","646",2023-09-18 16:15:00,-13826,1913,15739,907,FALSE,NA,"0.1.4"
"36739","646",2023-09-18 16:30:00,-13653,1913,15566,907,FALSE,NA,"0.1.4"
"36740","646",2023-09-18 16:45:00,-13486,1913,15399,907,FALSE,NA,"0.1.4"
"36741","646",2023-09-18 17:00:00,-13772,1913,15685,907,FALSE,NA,"0.1.4"
"36742","646",2023-09-18 17:15:00,-13838,1913,15751,907,FALSE,NA,"0.1.4"
"36743","646",2023-09-18 17:30:00,-13724,1913,15637,907,FALSE,NA,"0.1.4"
"36744","646",2023-09-18 17:45:00,-13736,1913,15649,907,FALSE,"out1, fill","0.1.4"
"36745","646",2023-09-18 18:00:00,-13748,1913,15661,907,FALSE,"out1, fill","0.1.4"
"36746","646",2023-09-18 18:15:00,-13760,1913,15673,907,FALSE,"out1, fill","0.1.4"
"36747","646",2023-09-18 18:30:00,-13772,1913,15685,907,FALSE,"out1, fill","0.1.4"
"36748","646",2023-09-18 18:45:00,-13784,1913,15697,907,FALSE,"out1, fill","0.1.4"
"36749","646",2023-09-18 19:00:00,-13796,1913,15709,907,FALSE,"out1, fill","0.1.4"
"36750","646",2023-09-18 19:15:00,-13808,1913,15721,907,FALSE,"out1, fill","0.1.4"
"36751","646",2023-09-18 19:30:00,-13820,1913,15733,907,FALSE,NA,"0.1.4"
"36752","646",2023-09-18 19:45:00,-13620,1913,15533,907,FALSE,NA,"0.1.4"
"36753","646",2023-09-18 20:00:00,-13838,1913,15751,907,FALSE,NA,"0.1.4"
"36754","646",2023-09-18 20:15:00,-13806.4,1913,15719.4,907,FALSE,"out1, fill","0.1.4"
"36755","646",2023-09-18 20:30:00,-13774.8,1913,15687.8,907,FALSE,"out1, fill","0.1.4"
"36756","646",2023-09-18 20:45:00,-13743.2,1913,15656.2,907,FALSE,"out1, fill","0.1.4"
"36757","646",2023-09-18 21:00:00,-13711.6,1913,15624.6,907,FALSE,"out1, fill","0.1.4"
"36758","646",2023-09-18 21:15:00,-13680,1913,15593,907,FALSE,NA,"0.1.4"
"36759","646",2023-09-18 21:30:00,-13440,1913,15353,907,FALSE,NA,"0.1.4"
"36760","646",2023-09-18 21:45:00,-13697,1913,15610,907,FALSE,NA,"0.1.4"
"36761","646",2023-09-18 22:00:00,-13534,1913,15447,907,FALSE,NA,"0.1.4"
"36762","646",2023-09-18 22:15:00,-13383,1913,15296,907,FALSE,NA,"0.1.4"
"36763","646",2023-09-18 22:30:00,-13480,1913,15393,907,FALSE,NA,"0.1.4"
"36764","646",2023-09-18 22:45:00,-13108,1913,15021,907,FALSE,NA,"0.1.4"
"36765","646",2023-09-18 23:00:00,-12880,1913,14793,907,FALSE,NA,"0.1.4"
"36766","646",2023-09-18 23:15:00,-12529,1913,14442,907,FALSE,NA,"0.1.4"
"36767","646",2023-09-18 23:30:00,-12758,1913,14671,907,FALSE,NA,"0.1.4"
"36768","646",2023-09-18 23:45:00,-12958,1913,14871,907,FALSE,NA,"0.1.4"
"36769","646",2023-09-19,-13131,1913,15044,907,FALSE,NA,"0.1.4"
"36770","646",2023-09-19 00:15:00,-13191,1913,15104,907,FALSE,NA,"0.1.4"
"36771","646",2023-09-19 00:30:00,-12809.5,1913,14722.5,907,FALSE,"out1, fill","0.1.4"
"36772","646",2023-09-19 00:45:00,-12428,1913,14341,907,FALSE,NA,"0.1.4"
"36773","646",2023-09-19 01:00:00,-12428,1913,14341,907,FALSE,"jump1","0.1.4"
"36774","646",2023-09-19 01:15:00,-12412,1913,14325,907,FALSE,NA,"0.1.4"
"36775","646",2023-09-19 01:30:00,-12481.8333333333,1913,14394.8333333333,907,FALSE,"out1, fill","0.1.4"
"36776","646",2023-09-19 01:45:00,-12551.6666666667,1913,14464.6666666667,907,FALSE,"out1, fill","0.1.4"
"36777","646",2023-09-19 02:00:00,-12621.5,1913,14534.5,907,FALSE,"out1, fill","0.1.4"
"36778","646",2023-09-19 02:15:00,-12691.3333333333,1913,14604.3333333333,907,FALSE,"out1, fill","0.1.4"
"36779","646",2023-09-19 02:30:00,-12761.1666666667,1913,14674.1666666667,907,FALSE,"out1, fill","0.1.4"
"36780","646",2023-09-19 02:45:00,-12831,1913,14744,907,FALSE,NA,"0.1.4"
"36781","646",2023-09-19 03:00:00,-12831,1913,14744,907,FALSE,"jump1","0.1.4"
"36782","646",2023-09-19 03:15:00,-12831,1913,14744,907,FALSE,"jump1","0.1.4"
"36783","646",2023-09-19 03:30:00,-12836.125,1913,14749.125,907,FALSE,"out1, fill","0.1.4"
"36784","646",2023-09-19 03:45:00,-12841.25,1913,14754.25,907,FALSE,"out1, fill","0.1.4"
"36785","646",2023-09-19 04:00:00,-12846.375,1913,14759.375,907,FALSE,"out1, fill","0.1.4"
"36786","646",2023-09-19 04:15:00,-12851.5,1913,14764.5,907,FALSE,"out1, fill","0.1.4"
"36787","646",2023-09-19 04:30:00,-12856.625,1913,14769.625,907,FALSE,"out1, fill","0.1.4"
"36788","646",2023-09-19 04:45:00,-12861.75,1913,14774.75,907,FALSE,"out1, fill","0.1.4"
"36789","646",2023-09-19 05:00:00,-12866.875,1913,14779.875,907,FALSE,"out1, fill","0.1.4"
"36790","646",2023-09-19 05:15:00,-12872,1913,14785,907,FALSE,NA,"0.1.4"
"36791","646",2023-09-19 05:30:00,-13160,1913,15073,907,FALSE,NA,"0.1.4"
"36792","646",2023-09-19 05:45:00,-13160,1913,15073,907,FALSE,"jump1","0.1.4"
"36793","646",2023-09-19 06:00:00,-12734,1913,14647,907,FALSE,NA,"0.1.4"
"36794","646",2023-09-19 06:15:00,-12685,1913,14598,907,FALSE,NA,"0.1.4"
"36795","646",2023-09-19 06:30:00,-12576,1913,14489,907,FALSE,NA,"0.1.4"
"36796","646",2023-09-19 06:45:00,-12619.6666666667,1913,14532.6666666667,907,FALSE,"out1, fill","0.1.4"
"36797","646",2023-09-19 07:00:00,-12663.3333333333,1913,14576.3333333333,907,FALSE,"out1, fill","0.1.4"
"36798","646",2023-09-19 07:15:00,-12707,1913,14620,907,FALSE,NA,"0.1.4"
"36799","646",2023-09-19 07:30:00,-12606,1913,14519,907,FALSE,NA,"0.1.4"
"36800","646",2023-09-19 07:45:00,-12606,1913,14519,907,FALSE,"jump1","0.1.4"
"36801","646",2023-09-19 08:00:00,-12566,1913,14479,907,FALSE,NA,"0.1.4"
"36802","646",2023-09-19 08:15:00,-13025,1913,14938,907,FALSE,NA,"0.1.4"
"36803","646",2023-09-19 08:30:00,-13025,1913,14938,907,FALSE,"jump1","0.1.4"
"36804","646",2023-09-19 08:45:00,-13025,1913,14938,907,FALSE,"jump1","0.1.4"
"36805","646",2023-09-19 09:00:00,-13306,1913,15219,907,FALSE,NA,"0.1.4"
"36806","646",2023-09-19 09:15:00,-13274,1913,15187,907,FALSE,NA,"0.1.4"
"36807","646",2023-09-19 09:30:00,-13127,1913,15040,907,FALSE,NA,"0.1.4"
"36808","646",2023-09-19 09:45:00,-13206,1913,15119,907,FALSE,NA,"0.1.4"
"36809","646",2023-09-19 10:00:00,-13170,1913,15083,907,FALSE,NA,"0.1.4"
"36810","646",2023-09-19 10:15:00,-13159,1913,15072,907,FALSE,NA,"0.1.4"
"36811","646",2023-09-19 10:30:00,-13205,1913,15118,907,FALSE,NA,"0.1.4"
"36812","646",2023-09-19 10:45:00,-13528,1913,15441,907,FALSE,NA,"0.1.4"
"36813","646",2023-09-19 11:00:00,-13787,1913,15700,907,FALSE,"out1, fill","0.1.4"
"36814","646",2023-09-19 11:15:00,-14046,1913,15959,907,FALSE,"out1, fill","0.1.4"
"36815","646",2023-09-19 11:30:00,-14305,1913,16218,907,FALSE,NA,"0.1.4"
"36816","646",2023-09-19 11:45:00,-14036,1913,15949,907,FALSE,NA,"0.1.4"
"36817","646",2023-09-19 12:00:00,-13980,1913,15893,907,FALSE,NA,"0.1.4"
"36818","646",2023-09-19 12:15:00,-13895,1913,15808,907,FALSE,NA,"0.1.4"
"36819","646",2023-09-19 12:30:00,-13832,1913,15745,907,FALSE,NA,"0.1.4"
"36820","646",2023-09-19 12:45:00,-13832,1913,15745,907,FALSE,"jump1","0.1.4"
"36821","646",2023-09-19 13:00:00,-14015,1913,15928,907,FALSE,NA,"0.1.4"
"36822","646",2023-09-19 13:15:00,-14081,1913,15994,907,FALSE,NA,"0.1.4"
"36823","646",2023-09-19 13:30:00,-14142,1913,16055,907,FALSE,NA,"0.1.4"
"36824","646",2023-09-19 13:45:00,-14058,1913,15971,907,FALSE,NA,"0.1.4"
"36825","646",2023-09-19 14:00:00,-14051,1913,15964,907,FALSE,NA,"0.1.4"
"36826","646",2023-09-19 14:15:00,-13962,1913,15875,907,FALSE,"out1, fill","0.1.4"
"36827","646",2023-09-19 14:30:00,-13873,1913,15786,907,FALSE,"out1, fill","0.1.4"
"36828","646",2023-09-19 14:45:00,-13784,1913,15697,907,FALSE,NA,"0.1.4"
"36829","646",2023-09-19 15:00:00,-13798,1913,15711,907,FALSE,NA,"0.1.4"
"36830","646",2023-09-19 15:15:00,-13506,1913,15419,907,FALSE,NA,"0.1.4"
"36831","646",2023-09-19 15:30:00,-13843,1913,15756,907,FALSE,NA,"0.1.4"
"36832","646",2023-09-19 15:45:00,-13803,1913,15716,907,FALSE,NA,"0.1.4"
"36833","646",2023-09-19 16:00:00,-13806,1913,15719,907,FALSE,NA,"0.1.4"
"36834","646",2023-09-19 16:15:00,-13419,1913,15332,907,FALSE,NA,"0.1.4"
"36835","646",2023-09-19 16:30:00,-13419,1913,15332,907,FALSE,"out1, fill","0.1.4"
"36836","646",2023-09-19 16:45:00,-13419,1913,15332,907,FALSE,"jump1","0.1.4"
"36837","646",2023-09-19 17:00:00,-13500,1913,15413,907,FALSE,NA,"0.1.4"
"36838","646",2023-09-19 17:15:00,-13500,1913,15413,907,FALSE,NA,"0.1.4"
"36839","646",2023-09-19 17:30:00,-13500,1913,15413,907,FALSE,"jump1","0.1.4"
"36840","646",2023-09-19 17:45:00,-13263,1913,15176,907,FALSE,NA,"0.1.4"
"36841","646",2023-09-19 18:00:00,-13210,1913,15123,907,FALSE,NA,"0.1.4"
"36842","646",2023-09-19 18:15:00,-13305,1913,15218,907,FALSE,NA,"0.1.4"
"36843","646",2023-09-19 18:30:00,-13305,1913,15218,907,FALSE,"jump1","0.1.4"
"36844","646",2023-09-19 18:45:00,NA,NA,NA,NA,NA,"out1","0.1.4"
"36845","646",2023-09-19 19:00:00,NA,NA,NA,NA,NA,"out1","0.1.4"
"36846","646",2023-09-19 19:15:00,NA,NA,NA,NA,NA,"out1","0.1.4"
"36847","646",2023-09-19 19:30:00,NA,NA,NA,NA,NA,"out1","0.1.4"
"36848","646",2023-09-19 19:45:00,NA,NA,NA,NA,NA,"out1","0.1.4"
"36849","646",2023-09-19 20:00:00,NA,NA,NA,NA,NA,"out1","0.1.4"
"36850","646",2023-09-19 20:15:00,NA,NA,NA,NA,NA,"out1","0.1.4"
"36851","646",2023-09-19 20:30:00,NA,NA,NA,NA,NA,"out1","0.1.4"
"36852","646",2023-09-19 20:45:00,NA,NA,NA,NA,NA,"out1","0.1.4"
"36853","646",2023-09-19 21:00:00,NA,NA,NA,NA,NA,"out1","0.1.4"
"36854","646",2023-09-19 21:15:00,NA,NA,NA,NA,NA,"out1","0.1.4"
"36855","646",2023-09-19 21:30:00,NA,NA,NA,NA,NA,"out1","0.1.4"
"36856","646",2023-09-19 21:45:00,NA,NA,NA,NA,NA,"out1","0.1.4"
"36857","646",2023-09-19 22:00:00,NA,NA,NA,NA,NA,"out1","0.1.4"
"36858","646",2023-09-19 22:15:00,NA,NA,NA,NA,NA,"out1","0.1.4"
"36859","646",2023-09-19 22:30:00,NA,NA,NA,NA,NA,"out1","0.1.4"
"36860","646",2023-09-19 22:45:00,NA,NA,NA,NA,NA,"out1","0.1.4"
"36861","646",2023-09-19 23:00:00,NA,NA,NA,NA,NA,"out1","0.1.4"
"36862","646",2023-09-19 23:15:00,NA,NA,NA,NA,NA,"out1","0.1.4"
"36863","646",2023-09-19 23:30:00,NA,NA,NA,NA,NA,"out1","0.1.4"
"36864","646",2023-09-19 23:45:00,NA,NA,NA,NA,NA,"out1","0.1.4"
"36865","646",2023-09-20,NA,NA,NA,NA,NA,"out1","0.1.4"
"36866","646",2023-09-20 00:15:00,NA,NA,NA,NA,NA,"out1","0.1.4"
"36867","646",2023-09-20 00:30:00,NA,NA,NA,NA,NA,"out1","0.1.4"
"36868","646",2023-09-20 00:45:00,NA,NA,NA,NA,NA,"out1","0.1.4"
"36869","646",2023-09-20 01:00:00,NA,NA,NA,NA,NA,"out1","0.1.4"
"36870","646",2023-09-20 01:15:00,NA,NA,NA,NA,NA,"out1","0.1.4"
"36871","646",2023-09-20 01:30:00,-14393,1913,16306,907,FALSE,NA,"0.1.4"
"36872","646",2023-09-20 01:45:00,-14393,1913,16306,907,FALSE,"jump1","0.1.4"
"36873","646",2023-09-20 02:00:00,-14822,1913,16735,907,FALSE,NA,"0.1.4"
"36874","646",2023-09-20 02:15:00,-14822,1913,16735,907,FALSE,"jump1","0.1.4"
"36875","646",2023-09-20 02:30:00,-14822,1913,16735,907,FALSE,"out1, fill","0.1.4"
"36876","646",2023-09-20 02:45:00,-14822,1913,16735,907,FALSE,"jump1","0.1.4"
"36877","646",2023-09-20 03:00:00,-14899,1913,16812,907,FALSE,NA,"0.1.4"
"36878","646",2023-09-20 03:15:00,-14751,1913,16664,907,FALSE,NA,"0.1.4"
"36879","646",2023-09-20 03:30:00,-14822,1913,16735,907,FALSE,NA,"0.1.4"
"36880","646",2023-09-20 03:45:00,-15039,1913,16952,907,FALSE,NA,"0.1.4"
"36881","646",2023-09-20 04:00:00,-14981.1111111111,1913,16894.1111111111,907,FALSE,"out1, fill","0.1.4"
"36882","646",2023-09-20 04:15:00,-14923.2222222222,1913,16836.2222222222,907,FALSE,"out1, fill","0.1.4"
"36883","646",2023-09-20 04:30:00,-14865.3333333333,1913,16778.3333333333,907,FALSE,"out1, fill","0.1.4"
"36884","646",2023-09-20 04:45:00,-14807.4444444444,1913,16720.4444444444,907,FALSE,"out1, fill","0.1.4"
"36885","646",2023-09-20 05:00:00,-14749.5555555556,1913,16662.5555555556,907,FALSE,"out1, fill","0.1.4"
"36886","646",2023-09-20 05:15:00,-14691.6666666667,1913,16604.6666666667,907,FALSE,"out1, fill","0.1.4"
"36887","646",2023-09-20 05:30:00,-14633.7777777778,1913,16546.7777777778,907,FALSE,"out1, fill","0.1.4"
"36888","646",2023-09-20 05:45:00,-14575.8888888889,1913,16488.8888888889,907,FALSE,"out1, fill","0.1.4"
"36889","646",2023-09-20 06:00:00,-14518,1913,16431,907,FALSE,NA,"0.1.4"
"36890","646",2023-09-20 06:15:00,-14456,1913,16369,907,FALSE,NA,"0.1.4"
"36891","646",2023-09-20 06:30:00,-14646,1913,16559,907,FALSE,NA,"0.1.4"
"36892","646",2023-09-20 06:45:00,-14646,1913,16559,907,FALSE,"jump1","0.1.4"
"36893","646",2023-09-20 07:00:00,-14746.5,1913,16659.5,907,FALSE,"out1, fill","0.1.4"
"36894","646",2023-09-20 07:15:00,-14847,1913,16760,907,FALSE,NA,"0.1.4"
"36895","646",2023-09-20 07:30:00,-15101,1913,17014,907,FALSE,NA,"0.1.4"
"36896","646",2023-09-20 07:45:00,-15262,1913,17175,907,FALSE,NA,"0.1.4"
"36897","646",2023-09-20 08:00:00,-15129,1913,17042,907,FALSE,NA,"0.1.4"
"36898","646",2023-09-20 08:15:00,-14831,1913,16744,907,FALSE,NA,"0.1.4"
"36899","646",2023-09-20 08:30:00,-14948,1913,16861,907,FALSE,NA,"0.1.4"
"36900","646",2023-09-20 08:45:00,-14948,1913,16861,907,FALSE,"jump1","0.1.4"
"36901","646",2023-09-20 09:00:00,-14948,1913,16861,907,FALSE,"jump1","0.1.4"
"36902","646",2023-09-20 09:15:00,-14835,1913,16748,907,FALSE,NA,"0.1.4"
"36903","646",2023-09-20 09:30:00,-14889,1913,16802,907,FALSE,NA,"0.1.4"
"36904","646",2023-09-20 09:45:00,-14664,1913,16577,907,FALSE,NA,"0.1.4"
"36905","646",2023-09-20 10:00:00,-14557,1913,16470,907,FALSE,NA,"0.1.4"
"36906","646",2023-09-20 10:15:00,-14607,1913,16520,907,FALSE,NA,"0.1.4"
"36907","646",2023-09-20 10:30:00,-14723,1913,16636,907,FALSE,NA,"0.1.4"
"36908","646",2023-09-20 10:45:00,-14723,1913,16636,907,FALSE,"jump1","0.1.4"
"36909","646",2023-09-20 11:00:00,-15108,1913,17021,907,FALSE,NA,"0.1.4"
"36910","646",2023-09-20 11:15:00,-14976,1913,16889,907,FALSE,NA,"0.1.4"
"36911","646",2023-09-20 11:30:00,-15357,1913,17270,907,FALSE,NA,"0.1.4"
"36912","646",2023-09-20 11:45:00,-15422,1913,17335,907,FALSE,NA,"0.1.4"
"36913","646",2023-09-20 12:00:00,-15511,1913,17424,907,FALSE,NA,"0.1.4"
"36914","646",2023-09-20 12:15:00,-15435,1913,17348,907,FALSE,NA,"0.1.4"
"36915","646",2023-09-20 12:30:00,-15465,1913,17378,907,FALSE,NA,"0.1.4"
"36916","646",2023-09-20 12:45:00,-15327,1913,17240,907,FALSE,NA,"0.1.4"
"36917","646",2023-09-20 13:00:00,-15431,1913,17344,907,FALSE,NA,"0.1.4"
"36918","646",2023-09-20 13:15:00,-15393,1913,17306,907,FALSE,NA,"0.1.4"
"36919","646",2023-09-20 13:30:00,-15303,1913,17216,907,FALSE,NA,"0.1.4"
"36920","646",2023-09-20 13:45:00,-15303,1913,17216,907,FALSE,"jump1","0.1.4"
"36921","646",2023-09-20 14:00:00,-15307,1913,17220,907,FALSE,NA,"0.1.4"
"36922","646",2023-09-20 14:15:00,-15251,1913,17164,907,FALSE,NA,"0.1.4"
"36923","646",2023-09-20 14:30:00,-15305,1913,17218,907,FALSE,NA,"0.1.4"
"36924","646",2023-09-20 14:45:00,-15409,1913,17322,907,FALSE,NA,"0.1.4"
"36925","646",2023-09-20 15:00:00,-15409,1913,17322,907,FALSE,"jump1","0.1.4"
"36926","646",2023-09-20 15:15:00,-15409,1913,17322,907,FALSE,"out1, fill","0.1.4"
"36927","646",2023-09-20 15:30:00,-15409,1913,17322,907,FALSE,"jump1","0.1.4"
"36928","646",2023-09-20 15:45:00,-15706,1913,17619,907,FALSE,NA,"0.1.4"
"36929","646",2023-09-20 16:00:00,-15508,1913,17421,907,FALSE,NA,"0.1.4"
"36930","646",2023-09-20 16:15:00,-15606.5,1913,17519.5,907,FALSE,"out1, fill","0.1.4"
"36931","646",2023-09-20 16:30:00,-15705,1913,17618,907,FALSE,"out1, fill","0.1.4"
"36932","646",2023-09-20 16:45:00,-15803.5,1913,17716.5,907,FALSE,"out1, fill","0.1.4"
"36933","646",2023-09-20 17:00:00,-15902,1913,17815,907,FALSE,NA,"0.1.4"
"36934","646",2023-09-20 17:15:00,-15945,1913,17858,907,FALSE,NA,"0.1.4"
"36935","646",2023-09-20 17:30:00,-15945,1913,17858,907,FALSE,"jump1","0.1.4"
"36936","646",2023-09-20 17:45:00,-15853,1913,17766,907,FALSE,NA,"0.1.4"
"36937","646",2023-09-20 18:00:00,-15679,1913,17592,907,FALSE,NA,"0.1.4"
"36938","646",2023-09-20 18:15:00,-15738,1913,17651,907,FALSE,NA,"0.1.4"
"36939","646",2023-09-20 18:30:00,-15861,1913,17774,907,FALSE,NA,"0.1.4"
"36940","646",2023-09-20 18:45:00,-15414,1913,17327,907,FALSE,NA,"0.1.4"
"36941","646",2023-09-20 19:00:00,-15414,1913,17327,907,FALSE,"jump1","0.1.4"
"36942","646",2023-09-20 19:15:00,-15276.5,1913,17189.5,907,FALSE,"out1, fill","0.1.4"
"36943","646",2023-09-20 19:30:00,-15139,1913,17052,907,FALSE,NA,"0.1.4"
"36944","646",2023-09-20 19:45:00,-15385,1913,17298,907,FALSE,NA,"0.1.4"
"36945","646",2023-09-20 20:00:00,-15216,1913,17129,907,FALSE,NA,"0.1.4"
"36946","646",2023-09-20 20:15:00,-15336,1913,17249,907,FALSE,NA,"0.1.4"
"36947","646",2023-09-20 20:30:00,-15359,1913,17272,907,FALSE,NA,"0.1.4"
"36948","646",2023-09-20 20:45:00,-15362,1913,17275,907,FALSE,NA,"0.1.4"
"36949","646",2023-09-20 21:00:00,-15358,1913,17271,907,FALSE,NA,"0.1.4"
"36950","646",2023-09-20 21:15:00,-15343,1913,17256,907,FALSE,NA,"0.1.4"
"36951","646",2023-09-20 21:30:00,-15184,1913,17097,907,FALSE,NA,"0.1.4"
"36952","646",2023-09-20 21:45:00,-15135.5,1913,17048.5,907,FALSE,"out1, fill","0.1.4"
"36953","646",2023-09-20 22:00:00,-15087,1913,17000,907,FALSE,"out1, fill","0.1.4"
"36954","646",2023-09-20 22:15:00,-15038.5,1913,16951.5,907,FALSE,"out1, fill","0.1.4"
"36955","646",2023-09-20 22:30:00,-14990,1913,16903,907,FALSE,NA,"0.1.4"
"36956","646",2023-09-20 22:45:00,-14993,1913,16906,907,FALSE,NA,"0.1.4"
"36957","646",2023-09-20 23:00:00,-14908,1913,16821,907,FALSE,NA,"0.1.4"
"36958","646",2023-09-20 23:15:00,-14962,1913,16875,907,FALSE,NA,"0.1.4"
"36959","646",2023-09-20 23:30:00,-15008,1913,16921,907,FALSE,NA,"0.1.4"
"36960","646",2023-09-20 23:45:00,-15097,1913,17010,907,FALSE,NA,"0.1.4"
"36961","646",2023-09-21,-15068,1913,16981,907,FALSE,NA,"0.1.4"
"36962","646",2023-09-21 00:15:00,-15090,1913,17003,907,FALSE,NA,"0.1.4"
"36963","646",2023-09-21 00:30:00,-15131,1913,17044,907,FALSE,NA,"0.1.4"
"36964","646",2023-09-21 00:45:00,-15133,1913,17046,907,FALSE,NA,"0.1.4"
"36965","646",2023-09-21 01:00:00,-15116,1913,17029,907,FALSE,NA,"0.1.4"
"36966","646",2023-09-21 01:15:00,-15160,1913,17073,907,FALSE,NA,"0.1.4"
"36967","646",2023-09-21 01:30:00,-15144,1913,17057,907,FALSE,NA,"0.1.4"
"36968","646",2023-09-21 01:45:00,-15028,1913,16941,907,FALSE,NA,"0.1.4"
"36969","646",2023-09-21 02:00:00,-15273,1913,17186,907,FALSE,NA,"0.1.4"
"36970","646",2023-09-21 02:15:00,-15355,1913,17268,907,FALSE,NA,"0.1.4"
"36971","646",2023-09-21 02:30:00,-15370,1913,17283,907,FALSE,NA,"0.1.4"
"36972","646",2023-09-21 02:45:00,-15234,1913,17147,907,FALSE,NA,"0.1.4"
"36973","646",2023-09-21 03:00:00,-15218,1913,17131,907,FALSE,NA,"0.1.4"
"36974","646",2023-09-21 03:15:00,-14781,1913,16694,907,FALSE,NA,"0.1.4"
"36975","646",2023-09-21 03:30:00,-14756,1913,16669,907,FALSE,NA,"0.1.4"
"36976","646",2023-09-21 03:45:00,-14756,1913,16669,907,FALSE,"jump1","0.1.4"
"36977","646",2023-09-21 04:00:00,-14810,1913,16723,907,FALSE,NA,"0.1.4"
"36978","646",2023-09-21 04:15:00,-14770,1913,16683,907,FALSE,NA,"0.1.4"
"36979","646",2023-09-21 04:30:00,-14712,1913,16625,907,FALSE,NA,"0.1.4"
"36980","646",2023-09-21 04:45:00,-14295.5,1913,16208.5,907,FALSE,"out1, fill","0.1.4"
"36981","646",2023-09-21 05:00:00,-13879,1913,15792,907,FALSE,NA,"0.1.4"
"36982","646",2023-09-21 05:15:00,-13879,1913,15792,907,FALSE,"jump1","0.1.4"
"36983","646",2023-09-21 05:30:00,-14060,1913,15973,907,FALSE,NA,"0.1.4"
"36984","646",2023-09-21 05:45:00,-13930.5,1913,15843.5,907,FALSE,"out1, fill","0.1.4"
"36985","646",2023-09-21 06:00:00,-13801,1913,15714,907,FALSE,"out1, fill","0.1.4"
"36986","646",2023-09-21 06:15:00,-13671.5,1913,15584.5,907,FALSE,"out1, fill","0.1.4"
"36987","646",2023-09-21 06:30:00,-13542,1913,15455,907,FALSE,"out1, fill","0.1.4"
"36988","646",2023-09-21 06:45:00,-13412.5,1913,15325.5,907,FALSE,"out1, fill","0.1.4"
"36989","646",2023-09-21 07:00:00,-13283,1913,15196,907,FALSE,NA,"0.1.4"
"36990","646",2023-09-21 07:15:00,-13283,1913,15196,907,FALSE,"jump1","0.1.4"
"36991","646",2023-09-21 07:30:00,-13283,1913,15196,907,FALSE,"jump1","0.1.4"
"36992","646",2023-09-21 07:45:00,-13265,1913,15178,907,FALSE,NA,"0.1.4"
"36993","646",2023-09-21 08:00:00,-13343.375,1913,15256.375,907,FALSE,"out1, fill","0.1.4"
"36994","646",2023-09-21 08:15:00,-13421.75,1913,15334.75,907,FALSE,"out1, fill","0.1.4"
"36995","646",2023-09-21 08:30:00,-13500.125,1913,15413.125,907,FALSE,"out1, fill","0.1.4"
"36996","646",2023-09-21 08:45:00,-13578.5,1913,15491.5,907,FALSE,"out1, fill","0.1.4"
"36997","646",2023-09-21 09:00:00,-13656.875,1913,15569.875,907,FALSE,"out1, fill","0.1.4"
"36998","646",2023-09-21 09:15:00,-13735.25,1913,15648.25,907,FALSE,"out1, fill","0.1.4"
"36999","646",2023-09-21 09:30:00,-13813.625,1913,15726.625,907,FALSE,"out1, fill","0.1.4"
"37000","646",2023-09-21 09:45:00,-13892,1913,15805,907,FALSE,NA,"0.1.4"
"37001","646",2023-09-21 10:00:00,-13489,1913,15402,907,FALSE,NA,"0.1.4"
"37002","646",2023-09-21 10:15:00,-13289,1913,15202,907,FALSE,NA,"0.1.4"
"37003","646",2023-09-21 10:30:00,-13759,1913,15672,907,FALSE,NA,"0.1.4"
"37004","646",2023-09-21 10:45:00,-13536,1913,15449,907,FALSE,NA,"0.1.4"
"37005","646",2023-09-21 11:00:00,-13814,1913,15727,907,FALSE,"out1, fill","0.1.4"
"37006","646",2023-09-21 11:15:00,-14092,1913,16005,907,FALSE,NA,"0.1.4"
"37007","646",2023-09-21 11:30:00,-14248,1913,16161,907,FALSE,NA,"0.1.4"
"37008","646",2023-09-21 11:45:00,-14125,1913,16038,907,FALSE,NA,"0.1.4"
"37009","646",2023-09-21 12:00:00,-14055,1913,15968,907,FALSE,NA,"0.1.4"
"37010","646",2023-09-21 12:15:00,-13970,1913,15883,907,FALSE,NA,"0.1.4"
"37011","646",2023-09-21 12:30:00,-14093,1913,16006,907,FALSE,NA,"0.1.4"
"37012","646",2023-09-21 12:45:00,-14093,1913,16006,907,FALSE,"jump1","0.1.4"
"37013","646",2023-09-21 13:00:00,-14452,1913,16365,907,FALSE,NA,"0.1.4"
"37014","646",2023-09-21 13:15:00,-14567,1913,16480,907,FALSE,NA,"0.1.4"
"37015","646",2023-09-21 13:30:00,-14567,1913,16480,907,FALSE,"jump1","0.1.4"
"37016","646",2023-09-21 13:45:00,-14632,1913,16545,907,FALSE,NA,"0.1.4"
"37017","646",2023-09-21 14:00:00,-14578,1913,16491,907,FALSE,"out1, fill","0.1.4"
"37018","646",2023-09-21 14:15:00,-14524,1913,16437,907,FALSE,NA,"0.1.4"
"37019","646",2023-09-21 14:30:00,-14524,1913,16437,907,FALSE,"jump1","0.1.4"
"37020","646",2023-09-21 14:45:00,-14433,1913,16346,907,TRUE,NA,"0.1.4"
"37021","646",2023-09-21 15:00:00,-14748,1913,16661,907,FALSE,NA,"0.1.4"
"37022","646",2023-09-21 15:15:00,-14710,1913,16623,907,FALSE,NA,"0.1.4"
"37023","646",2023-09-21 15:30:00,-14809,1913,16722,907,FALSE,NA,"0.1.4"
"37024","646",2023-09-21 15:45:00,-14664,1913,16577,907,FALSE,NA,"0.1.4"
"37025","646",2023-09-21 16:00:00,-14592,1913,16505,907,FALSE,NA,"0.1.4"
"37026","646",2023-09-21 16:15:00,-14790,1913,16703,907,FALSE,NA,"0.1.4"
"37027","646",2023-09-21 16:30:00,-14354,1913,16267,907,FALSE,NA,"0.1.4"
"37028","646",2023-09-21 16:45:00,-14674,1913,16587,907,FALSE,NA,"0.1.4"
"37029","646",2023-09-21 17:00:00,-14674,1913,16587,907,FALSE,"jump1","0.1.4"
"37030","646",2023-09-21 17:15:00,-14436,1913,16349,907,FALSE,NA,"0.1.4"
"37031","646",2023-09-21 17:30:00,-14174,1913,16087,907,FALSE,NA,"0.1.4"
"37032","646",2023-09-21 17:45:00,-14349,1913,16262,907,FALSE,"out1, fill","0.1.4"
"37033","646",2023-09-21 18:00:00,-14524,1913,16437,907,FALSE,"out1, fill","0.1.4"
"37034","646",2023-09-21 18:15:00,-14699,1913,16612,907,FALSE,NA,"0.1.4"
"37035","646",2023-09-21 18:30:00,-14605,1913,16518,907,FALSE,NA,"0.1.4"
"37036","646",2023-09-21 18:45:00,-15061,1913,16974,907,FALSE,NA,"0.1.4"
"37037","646",2023-09-21 19:00:00,-14907,1913,16820,907,FALSE,NA,"0.1.4"
"37038","646",2023-09-21 19:15:00,-15212,1913,17125,907,FALSE,NA,"0.1.4"
"37039","646",2023-09-21 19:30:00,-15389,1913,17302,907,FALSE,NA,"0.1.4"
"37040","646",2023-09-21 19:45:00,-15198.8,1913,17111.8,907,FALSE,"out1, fill","0.1.4"
"37041","646",2023-09-21 20:00:00,-15008.6,1913,16921.6,907,FALSE,"out1, fill","0.1.4"
"37042","646",2023-09-21 20:15:00,-14818.4,1913,16731.4,907,FALSE,"out1, fill","0.1.4"
"37043","646",2023-09-21 20:30:00,-14628.2,1913,16541.2,907,FALSE,"out1, fill","0.1.4"
"37044","646",2023-09-21 20:45:00,-14438,1913,16351,907,FALSE,NA,"0.1.4"
"37045","646",2023-09-21 21:00:00,-14655,1913,16568,907,FALSE,NA,"0.1.4"
"37046","646",2023-09-21 21:15:00,-14634,1913,16547,907,FALSE,NA,"0.1.4"
"37047","646",2023-09-21 21:30:00,-14645,1913,16558,907,FALSE,NA,"0.1.4"
"37048","646",2023-09-21 21:45:00,-14508,1913,16421,907,FALSE,NA,"0.1.4"
"37049","646",2023-09-21 22:00:00,-14572,1913,16485,907,FALSE,NA,"0.1.4"
"37050","646",2023-09-21 22:15:00,-14505,1913,16418,907,FALSE,NA,"0.1.4"
"37051","646",2023-09-21 22:30:00,-14474,1913,16387,907,FALSE,NA,"0.1.4"
"37052","646",2023-09-21 22:45:00,-14498,1913,16411,907,FALSE,NA,"0.1.4"
"37053","646",2023-09-21 23:00:00,-14635,1913,16548,907,FALSE,NA,"0.1.4"
"37054","646",2023-09-21 23:15:00,-14581,1913,16494,907,FALSE,NA,"0.1.4"
"37055","646",2023-09-21 23:30:00,-14774,1913,16687,907,FALSE,NA,"0.1.4"
"37056","646",2023-09-21 23:45:00,-14731,1913,16644,907,FALSE,NA,"0.1.4"
"37057","646",2023-09-22,-14731,1913,16644,907,FALSE,"out1, fill","0.1.4"
"37058","646",2023-09-22 00:15:00,-14731,1913,16644,907,FALSE,"jump1","0.1.4"
"37059","646",2023-09-22 00:30:00,-14707,1913,16620,907,FALSE,NA,"0.1.4"
"37060","646",2023-09-22 00:45:00,-14698,1913,16611,907,FALSE,NA,"0.1.4"
"37061","646",2023-09-22 01:00:00,-14700,1913,16613,907,FALSE,NA,"0.1.4"
"37062","646",2023-09-22 01:15:00,-14706,1913,16619,907,FALSE,NA,"0.1.4"
"37063","646",2023-09-22 01:30:00,-14716,1913,16629,907,FALSE,NA,"0.1.4"
"37064","646",2023-09-22 01:45:00,-14666,1913,16579,907,FALSE,NA,"0.1.4"
"37065","646",2023-09-22 02:00:00,-14715,1913,16628,907,FALSE,NA,"0.1.4"
"37066","646",2023-09-22 02:15:00,-14717,1913,16630,907,FALSE,NA,"0.1.4"
"37067","646",2023-09-22 02:30:00,-14585,1913,16498,907,FALSE,NA,"0.1.4"
"37068","646",2023-09-22 02:45:00,-14616,1913,16529,907,FALSE,NA,"0.1.4"
"37069","646",2023-09-22 03:00:00,-14616,1913,16529,907,FALSE,"jump1","0.1.4"
"37070","646",2023-09-22 03:15:00,-14616,1913,16529,907,FALSE,"jump1","0.1.4"
"37071","646",2023-09-22 03:30:00,-14701.2,1913,16614.2,907,FALSE,"out1, fill","0.1.4"
"37072","646",2023-09-22 03:45:00,-14786.4,1913,16699.4,907,FALSE,"out1, fill","0.1.4"
"37073","646",2023-09-22 04:00:00,-14871.6,1913,16784.6,907,FALSE,"out1, fill","0.1.4"
"37074","646",2023-09-22 04:15:00,-14956.8,1913,16869.8,907,FALSE,"out1, fill","0.1.4"
"37075","646",2023-09-22 04:30:00,-15042,1913,16955,907,FALSE,NA,"0.1.4"
"37076","646",2023-09-22 04:45:00,-14787,1913,16700,907,FALSE,NA,"0.1.4"
"37077","646",2023-09-22 05:00:00,-14636,1913,16549,907,FALSE,NA,"0.1.4"
"37078","646",2023-09-22 05:15:00,-14763,1913,16676,907,FALSE,NA,"0.1.4"
"37079","646",2023-09-22 05:30:00,-14807,1913,16720,907,FALSE,NA,"0.1.4"
"37080","646",2023-09-22 05:45:00,-14874,1913,16787,907,FALSE,NA,"0.1.4"
"37081","646",2023-09-22 06:00:00,-15246,1913,17159,907,FALSE,NA,"0.1.4"
"37082","646",2023-09-22 06:15:00,-15188,1913,17101,907,FALSE,NA,"0.1.4"
"37083","646",2023-09-22 06:30:00,-15188,1913,17101,907,FALSE,"jump1","0.1.4"
"37084","646",2023-09-22 06:45:00,-14898,1913,16811,907,FALSE,NA,"0.1.4"
"37085","646",2023-09-22 07:00:00,-15217,1913,17130,907,FALSE,NA,"0.1.4"
"37086","646",2023-09-22 07:15:00,-14956,1913,16869,907,FALSE,NA,"0.1.4"
"37087","646",2023-09-22 07:30:00,-14956,1913,16869,907,FALSE,"jump1","0.1.4"
"37088","646",2023-09-22 07:45:00,-14674,1913,16587,907,FALSE,NA,"0.1.4"
"37089","646",2023-09-22 08:00:00,-14827,1913,16740,907,FALSE,NA,"0.1.4"
"37090","646",2023-09-22 08:15:00,-15136,1913,17049,907,FALSE,NA,"0.1.4"
"37091","646",2023-09-22 08:30:00,-14936,1913,16849,907,FALSE,NA,"0.1.4"
"37092","646",2023-09-22 08:45:00,-14981,1913,16894,907,FALSE,NA,"0.1.4"
"37093","646",2023-09-22 09:00:00,-14758,1913,16671,907,FALSE,NA,"0.1.4"
"37094","646",2023-09-22 09:15:00,-14815.5555555556,1913,16728.5555555556,907,FALSE,"out1, fill","0.1.4"
"37095","646",2023-09-22 09:30:00,-14873.1111111111,1913,16786.1111111111,907,FALSE,"out1, fill","0.1.4"
"37096","646",2023-09-22 09:45:00,-14930.6666666667,1913,16843.6666666667,907,FALSE,"out1, fill","0.1.4"
"37097","646",2023-09-22 10:00:00,-14988.2222222222,1913,16901.2222222222,907,FALSE,"out1, fill","0.1.4"
"37098","646",2023-09-22 10:15:00,-15045.7777777778,1913,16958.7777777778,907,FALSE,"out1, fill","0.1.4"
"37099","646",2023-09-22 10:30:00,-15103.3333333333,1913,17016.3333333333,907,FALSE,"out1, fill","0.1.4"
"37100","646",2023-09-22 10:45:00,-15160.8888888889,1913,17073.8888888889,907,FALSE,"out1, fill","0.1.4"
"37101","646",2023-09-22 11:00:00,-15218.4444444444,1913,17131.4444444444,907,FALSE,"out1, fill","0.1.4"
"37102","646",2023-09-22 11:15:00,-15276,1913,17189,907,FALSE,NA,"0.1.4"
"37103","646",2023-09-22 11:30:00,-15181,1913,17094,907,FALSE,NA,"0.1.4"
"37104","646",2023-09-22 11:45:00,-14715,1913,16628,907,FALSE,NA,"0.1.4"
"37105","646",2023-09-22 12:00:00,-15160.5,1913,17073.5,907,FALSE,"out1, fill","0.1.4"
"37106","646",2023-09-22 12:15:00,-15606,1913,17519,907,FALSE,NA,"0.1.4"
"37107","646",2023-09-22 12:30:00,-15247,1913,17160,907,FALSE,NA,"0.1.4"
"37108","646",2023-09-22 12:45:00,-15096,1913,17009,907,FALSE,NA,"0.1.4"
"37109","646",2023-09-22 13:00:00,-14975,1913,16888,907,FALSE,NA,"0.1.4"
"37110","646",2023-09-22 13:15:00,-15123.6666666667,1913,17036.6666666667,907,FALSE,"out1, fill","0.1.4"
"37111","646",2023-09-22 13:30:00,-15272.3333333333,1913,17185.3333333333,907,FALSE,"out1, fill","0.1.4"
"37112","646",2023-09-22 13:45:00,-15421,1913,17334,907,FALSE,"out1, fill","0.1.4"
"37113","646",2023-09-22 14:00:00,-15569.6666666667,1913,17482.6666666667,907,FALSE,"out1, fill","0.1.4"
"37114","646",2023-09-22 14:15:00,-15718.3333333333,1913,17631.3333333333,907,FALSE,"out1, fill","0.1.4"
"37115","646",2023-09-22 14:30:00,-15867,1913,17780,907,FALSE,NA,"0.1.4"
"37116","646",2023-09-22 14:45:00,-15837,1913,17750,907,FALSE,NA,"0.1.4"
"37117","646",2023-09-22 15:00:00,-15807,1913,17720,907,FALSE,NA,"0.1.4"
"37118","646",2023-09-22 15:15:00,-15789,1913,17702,907,FALSE,NA,"0.1.4"
"37119","646",2023-09-22 15:30:00,-15811,1913,17724,907,FALSE,NA,"0.1.4"
"37120","646",2023-09-22 15:45:00,-15732,1913,17645,907,FALSE,NA,"0.1.4"
"37121","646",2023-09-22 16:00:00,-15319,1913,17232,907,FALSE,NA,"0.1.4"
"37122","646",2023-09-22 16:15:00,-15814,1913,17727,907,FALSE,NA,"0.1.4"
"37123","646",2023-09-22 16:30:00,-15659,1913,17572,907,FALSE,NA,"0.1.4"
"37124","646",2023-09-22 16:45:00,-15659,1913,17572,907,FALSE,"jump1","0.1.4"
"37125","646",2023-09-22 17:00:00,-16008,1913,17921,907,FALSE,NA,"0.1.4"
"37126","646",2023-09-22 17:15:00,-15511,1913,17424,907,FALSE,NA,"0.1.4"
"37127","646",2023-09-22 17:30:00,-15750,1913,17663,907,FALSE,NA,"0.1.4"
"37128","646",2023-09-22 17:45:00,-15812.3333333333,1913,17725.3333333333,907,FALSE,"out1, fill","0.1.4"
"37129","646",2023-09-22 18:00:00,-15874.6666666667,1913,17787.6666666667,907,FALSE,"out1, fill","0.1.4"
"37130","646",2023-09-22 18:15:00,-15937,1913,17850,907,FALSE,NA,"0.1.4"
"37131","646",2023-09-22 18:30:00,-16127,1913,18040,907,FALSE,NA,"0.1.4"
"37132","646",2023-09-22 18:45:00,-16012,1913,17925,907,FALSE,NA,"0.1.4"
"37133","646",2023-09-22 19:00:00,-16012,1913,17925,907,FALSE,"jump1","0.1.4"
"37134","646",2023-09-22 19:15:00,-15772,1913,17685,907,FALSE,NA,"0.1.4"
"37135","646",2023-09-22 19:30:00,-15710.6666666667,1913,17623.6666666667,907,FALSE,"out1, fill","0.1.4"
"37136","646",2023-09-22 19:45:00,-15649.3333333333,1913,17562.3333333333,907,FALSE,"out1, fill","0.1.4"
"37137","646",2023-09-22 20:00:00,-15588,1913,17501,907,FALSE,NA,"0.1.4"
"37138","646",2023-09-22 20:15:00,-15855,1913,17768,907,FALSE,NA,"0.1.4"
"37139","646",2023-09-22 20:30:00,-15623,1913,17536,907,FALSE,NA,"0.1.4"
"37140","646",2023-09-22 20:45:00,-15438.5555555556,1913,17351.5555555556,907,FALSE,"out1, fill","0.1.4"
"37141","646",2023-09-22 21:00:00,-15254.1111111111,1913,17167.1111111111,907,FALSE,"out1, fill","0.1.4"
"37142","646",2023-09-22 21:15:00,-15069.6666666667,1913,16982.6666666667,907,FALSE,"out1, fill","0.1.4"
"37143","646",2023-09-22 21:30:00,-14885.2222222222,1913,16798.2222222222,907,FALSE,"out1, fill","0.1.4"
"37144","646",2023-09-22 21:45:00,-14700.7777777778,1913,16613.7777777778,907,FALSE,"out1, fill","0.1.4"
"37145","646",2023-09-22 22:00:00,-14516.3333333333,1913,16429.3333333333,907,FALSE,"out1, fill","0.1.4"
"37146","646",2023-09-22 22:15:00,-14331.8888888889,1913,16244.8888888889,907,FALSE,"out1, fill","0.1.4"
"37147","646",2023-09-22 22:30:00,-14147.4444444444,1913,16060.4444444444,907,FALSE,"out1, fill","0.1.4"
"37148","646",2023-09-22 22:45:00,-13963,1913,15876,907,FALSE,NA,"0.1.4"
"37149","646",2023-09-22 23:00:00,-13944,1913,15857,907,FALSE,NA,"0.1.4"
"37150","646",2023-09-22 23:15:00,-13958,1913,15871,907,FALSE,NA,"0.1.4"
"37151","646",2023-09-22 23:30:00,-13940,1913,15853,907,FALSE,NA,"0.1.4"
"37152","646",2023-09-22 23:45:00,-14036.0833333333,1913,15949.0833333333,907,FALSE,"out1, fill","0.1.4"
"37153","646",2023-09-23,-14132.1666666667,1913,16045.1666666667,907,FALSE,"out1, fill","0.1.4"
"37154","646",2023-09-23 00:15:00,-14228.25,1913,16141.25,907,FALSE,"out1, fill","0.1.4"
"37155","646",2023-09-23 00:30:00,-14324.3333333333,1913,16237.3333333333,907,FALSE,"out1, fill","0.1.4"
"37156","646",2023-09-23 00:45:00,-14420.4166666667,1913,16333.4166666667,907,FALSE,"out1, fill","0.1.4"
"37157","646",2023-09-23 01:00:00,-14516.5,1913,16429.5,907,FALSE,"out1, fill","0.1.4"
"37158","646",2023-09-23 01:15:00,-14612.5833333333,1913,16525.5833333333,907,FALSE,"out1, fill","0.1.4"
"37159","646",2023-09-23 01:30:00,-14708.6666666667,1913,16621.6666666667,907,FALSE,"out1, fill","0.1.4"
"37160","646",2023-09-23 01:45:00,-14804.75,1913,16717.75,907,FALSE,"out1, fill","0.1.4"
"37161","646",2023-09-23 02:00:00,-14900.8333333333,1913,16813.8333333333,907,FALSE,"out1, fill","0.1.4"
"37162","646",2023-09-23 02:15:00,-14996.9166666667,1913,16909.9166666667,907,FALSE,"out1, fill","0.1.4"
"37163","646",2023-09-23 02:30:00,-15093,1913,17006,907,FALSE,NA,"0.1.4"
"37164","646",2023-09-23 02:45:00,-15013,1913,16926,907,FALSE,NA,"0.1.4"
"37165","646",2023-09-23 03:00:00,-14722,1913,16635,907,FALSE,NA,"0.1.4"
"37166","646",2023-09-23 03:15:00,-14886.25,1913,16799.25,907,FALSE,"out1, fill","0.1.4"
"37167","646",2023-09-23 03:30:00,-15050.5,1913,16963.5,907,FALSE,"out1, fill","0.1.4"
"37168","646",2023-09-23 03:45:00,-15214.75,1913,17127.75,907,FALSE,"out1, fill","0.1.4"
"37169","646",2023-09-23 04:00:00,-15379,1913,17292,907,FALSE,NA,"0.1.4"
"37170","646",2023-09-23 04:15:00,-15592,1913,17505,907,FALSE,NA,"0.1.4"
"37171","646",2023-09-23 04:30:00,-15266,1913,17179,907,FALSE,NA,"0.1.4"
"37172","646",2023-09-23 04:45:00,-15266,1913,17179,907,FALSE,"jump1","0.1.4"
"37173","646",2023-09-23 05:00:00,-15434,1913,17347,907,FALSE,NA,"0.1.4"
"37174","646",2023-09-23 05:15:00,-15342,1913,17255,907,FALSE,NA,"0.1.4"
"37175","646",2023-09-23 05:30:00,-15429,1913,17342,907,FALSE,NA,"0.1.4"
"37176","646",2023-09-23 05:45:00,-15490,1913,17403,907,FALSE,NA,"0.1.4"
"37177","646",2023-09-23 06:00:00,-15296,1913,17209,907,FALSE,NA,"0.1.4"
"37178","646",2023-09-23 06:15:00,-15488,1913,17401,907,FALSE,NA,"0.1.4"
"37179","646",2023-09-23 06:30:00,-15457,1913,17370,907,FALSE,NA,"0.1.4"
"37180","646",2023-09-23 06:45:00,-15437,1913,17350,907,FALSE,NA,"0.1.4"
"37181","646",2023-09-23 07:00:00,-15438,1913,17351,907,FALSE,NA,"0.1.4"
"37182","646",2023-09-23 07:15:00,-15117,1913,17030,907,FALSE,NA,"0.1.4"
"37183","646",2023-09-23 07:30:00,-15361,1913,17274,907,FALSE,NA,"0.1.4"
"37184","646",2023-09-23 07:45:00,-14978.5,1913,16891.5,907,FALSE,"out1, fill","0.1.4"
"37185","646",2023-09-23 08:00:00,-14596,1913,16509,907,FALSE,NA,"0.1.4"
"37186","646",2023-09-23 08:15:00,-14634,1913,16547,907,FALSE,NA,"0.1.4"
"37187","646",2023-09-23 08:30:00,-14634,1913,16547,907,FALSE,"jump1","0.1.4"
"37188","646",2023-09-23 08:45:00,-14625,1913,16538,907,FALSE,NA,"0.1.4"
"37189","646",2023-09-23 09:00:00,-14763,1913,16676,907,FALSE,NA,"0.1.4"
"37190","646",2023-09-23 09:15:00,-14741,1913,16654,907,FALSE,NA,"0.1.4"
"37191","646",2023-09-23 09:30:00,-14741,1913,16654,907,FALSE,"jump1","0.1.4"
"37192","646",2023-09-23 09:45:00,-14683,1913,16596,907,FALSE,NA,"0.1.4"
"37193","646",2023-09-23 10:00:00,-14736,1913,16649,907,FALSE,NA,"0.1.4"
"37194","646",2023-09-23 10:15:00,-14555,1913,16468,907,FALSE,NA,"0.1.4"
"37195","646",2023-09-23 10:30:00,-14413,1913,16326,907,FALSE,NA,"0.1.4"
"37196","646",2023-09-23 10:45:00,-14466,1913,16379,907,FALSE,"out1, fill","0.1.4"
"37197","646",2023-09-23 11:00:00,-14519,1913,16432,907,FALSE,"out1, fill","0.1.4"
"37198","646",2023-09-23 11:15:00,-14572,1913,16485,907,FALSE,"out1, fill","0.1.4"
"37199","646",2023-09-23 11:30:00,-14625,1913,16538,907,FALSE,NA,"0.1.4"
"37200","646",2023-09-23 11:45:00,-14338,1913,16251,907,FALSE,NA,"0.1.4"
"37201","646",2023-09-23 12:00:00,-14338,1913,16251,907,FALSE,NA,"0.1.4"
"37202","646",2023-09-23 12:15:00,-14353,1913,16266,907,FALSE,NA,"0.1.4"
"37203","646",2023-09-23 12:30:00,-14494.75,1913,16407.75,907,FALSE,"out1, fill","0.1.4"
"37204","646",2023-09-23 12:45:00,-14636.5,1913,16549.5,907,FALSE,"out1, fill","0.1.4"
"37205","646",2023-09-23 13:00:00,-14778.25,1913,16691.25,907,FALSE,"out1, fill","0.1.4"
"37206","646",2023-09-23 13:15:00,-14920,1913,16833,907,FALSE,"out1, fill","0.1.4"
"37207","646",2023-09-23 13:30:00,-15061.75,1913,16974.75,907,FALSE,"out1, fill","0.1.4"
"37208","646",2023-09-23 13:45:00,-15203.5,1913,17116.5,907,FALSE,"out1, fill","0.1.4"
"37209","646",2023-09-23 14:00:00,-15345.25,1913,17258.25,907,FALSE,"out1, fill","0.1.4"
"37210","646",2023-09-23 14:15:00,-15487,1913,17400,907,FALSE,NA,"0.1.4"
"37211","646",2023-09-23 14:30:00,-15456,1913,17369,907,FALSE,NA,"0.1.4"
"37212","646",2023-09-23 14:45:00,-15444,1913,17357,907,FALSE,NA,"0.1.4"
"37213","646",2023-09-23 15:00:00,-15404,1913,17317,907,FALSE,NA,"0.1.4"
"37214","646",2023-09-23 15:15:00,-15328,1913,17241,907,FALSE,NA,"0.1.4"
"37215","646",2023-09-23 15:30:00,-15218,1913,17131,907,FALSE,NA,"0.1.4"
"37216","646",2023-09-23 15:45:00,-15345,1913,17258,907,FALSE,NA,"0.1.4"
"37217","646",2023-09-23 16:00:00,-15381,1913,17294,907,FALSE,NA,"0.1.4"
"37218","646",2023-09-23 16:15:00,-15407,1913,17320,907,FALSE,NA,"0.1.4"
"37219","646",2023-09-23 16:30:00,-15121,1913,17034,907,FALSE,NA,"0.1.4"
"37220","646",2023-09-23 16:45:00,-15440,1913,17353,907,FALSE,NA,"0.1.4"
"37221","646",2023-09-23 17:00:00,-15138,1913,17051,907,FALSE,NA,"0.1.4"
"37222","646",2023-09-23 17:15:00,-14854,1913,16767,907,FALSE,NA,"0.1.4"
"37223","646",2023-09-23 17:30:00,-15050.3333333333,1913,16963.3333333333,907,FALSE,"out1, fill","0.1.4"
"37224","646",2023-09-23 17:45:00,-15246.6666666667,1913,17159.6666666667,907,FALSE,"out1, fill","0.1.4"
"37225","646",2023-09-23 18:00:00,-15443,1913,17356,907,FALSE,NA,"0.1.4"
"37226","646",2023-09-23 18:15:00,-14951,1913,16864,907,FALSE,NA,"0.1.4"
"37227","646",2023-09-23 18:30:00,-14456,1913,16369,907,FALSE,NA,"0.1.4"
"37228","646",2023-09-23 18:45:00,-14745,1913,16658,907,FALSE,NA,"0.1.4"
"37229","646",2023-09-23 19:00:00,-14745,1913,16658,907,FALSE,"jump1","0.1.4"
"37230","646",2023-09-23 19:15:00,-14745,1913,16658,907,FALSE,"jump1","0.1.4"
"37231","646",2023-09-23 19:30:00,-15233,1913,17146,907,FALSE,NA,"0.1.4"
"37232","646",2023-09-23 19:45:00,-14810,1913,16723,907,FALSE,"out1, fill","0.1.4"
"37233","646",2023-09-23 20:00:00,-14387,1913,16300,907,FALSE,NA,"0.1.4"
"37234","646",2023-09-23 20:15:00,-14163,1913,16076,907,FALSE,NA,"0.1.4"
"37235","646",2023-09-23 20:30:00,-14360,1913,16273,907,FALSE,NA,"0.1.4"
"37236","646",2023-09-23 20:45:00,-14360,1913,16273,907,FALSE,"out1, fill","0.1.4"
"37237","646",2023-09-23 21:00:00,-14360,1913,16273,907,FALSE,"jump1","0.1.4"
"37238","646",2023-09-23 21:15:00,-14398,1913,16311,907,FALSE,NA,"0.1.4"
"37239","646",2023-09-23 21:30:00,-14395,1913,16308,907,FALSE,NA,"0.1.4"
"37240","646",2023-09-23 21:45:00,-14300,1913,16213,907,FALSE,NA,"0.1.4"
"37241","646",2023-09-23 22:00:00,-14223,1913,16136,907,FALSE,NA,"0.1.4"
"37242","646",2023-09-23 22:15:00,-14275,1913,16188,907,FALSE,NA,"0.1.4"
"37243","646",2023-09-23 22:30:00,-14263,1913,16176,907,FALSE,NA,"0.1.4"
"37244","646",2023-09-23 22:45:00,-14231,1913,16144,907,FALSE,NA,"0.1.4"
"37245","646",2023-09-23 23:00:00,-14150,1913,16063,907,FALSE,NA,"0.1.4"
"37246","646",2023-09-23 23:15:00,-14136,1913,16049,907,FALSE,NA,"0.1.4"
"37247","646",2023-09-23 23:30:00,-14189,1913,16102,907,FALSE,NA,"0.1.4"
"37248","646",2023-09-23 23:45:00,-14168,1913,16081,907,FALSE,NA,"0.1.4"
"37249","646",2023-09-24,-14262,1913,16175,907,FALSE,NA,"0.1.4"
"37250","646",2023-09-24 00:15:00,-14215,1913,16128,907,FALSE,NA,"0.1.4"
"37251","646",2023-09-24 00:30:00,-14396,1913,16309,907,FALSE,NA,"0.1.4"
"37252","646",2023-09-24 00:45:00,-14359,1913,16272,907,FALSE,NA,"0.1.4"
"37253","646",2023-09-24 01:00:00,-14419,1913,16332,907,FALSE,NA,"0.1.4"
"37254","646",2023-09-24 01:15:00,-14315,1913,16228,907,FALSE,NA,"0.1.4"
"37255","646",2023-09-24 01:30:00,-14427,1913,16340,907,FALSE,NA,"0.1.4"
"37256","646",2023-09-24 01:45:00,-14417,1913,16330,907,FALSE,NA,"0.1.4"
"37257","646",2023-09-24 02:00:00,-14406,1913,16319,907,FALSE,NA,"0.1.4"
"37258","646",2023-09-24 02:15:00,-14359,1913,16272,907,FALSE,NA,"0.1.4"
"37259","646",2023-09-24 02:30:00,-14274,1913,16187,907,FALSE,NA,"0.1.4"
"37260","646",2023-09-24 02:45:00,-14413,1913,16326,907,FALSE,NA,"0.1.4"
"37261","646",2023-09-24 03:00:00,-14335,1913,16248,907,FALSE,"out1, fill","0.1.4"
"37262","646",2023-09-24 03:15:00,-14257,1913,16170,907,FALSE,"out1, fill","0.1.4"
"37263","646",2023-09-24 03:30:00,-14179,1913,16092,907,FALSE,"out1, fill","0.1.4"
"37264","646",2023-09-24 03:45:00,-14101,1913,16014,907,FALSE,"out1, fill","0.1.4"
"37265","646",2023-09-24 04:00:00,-14023,1913,15936,907,FALSE,"out1, fill","0.1.4"
"37266","646",2023-09-24 04:15:00,-13945,1913,15858,907,FALSE,"out1, fill","0.1.4"
"37267","646",2023-09-24 04:30:00,-13867,1913,15780,907,FALSE,NA,"0.1.4"
"37268","646",2023-09-24 04:45:00,-13623,1913,15536,907,FALSE,NA,"0.1.4"
"37269","646",2023-09-24 05:00:00,-13523,1913,15436,907,FALSE,NA,"0.1.4"
"37270","646",2023-09-24 05:15:00,-14008,1913,15921,907,FALSE,NA,"0.1.4"
"37271","646",2023-09-24 05:30:00,-14462,1913,16375,907,FALSE,NA,"0.1.4"
"37272","646",2023-09-24 05:45:00,-14138,1913,16051,907,FALSE,"out1, fill","0.1.4"
"37273","646",2023-09-24 06:00:00,-13814,1913,15727,907,FALSE,NA,"0.1.4"
"37274","646",2023-09-24 06:15:00,-13791,1913,15704,907,FALSE,NA,"0.1.4"
"37275","646",2023-09-24 06:30:00,-13737,1913,15650,907,FALSE,NA,"0.1.4"
"37276","646",2023-09-24 06:45:00,-13737,1913,15650,907,FALSE,"jump1","0.1.4"
"37277","646",2023-09-24 07:00:00,-13775,1913,15688,907,FALSE,NA,"0.1.4"
"37278","646",2023-09-24 07:15:00,-13567.8,1913,15480.8,907,FALSE,"out1, fill","0.1.4"
"37279","646",2023-09-24 07:30:00,-13360.6,1913,15273.6,907,FALSE,"out1, fill","0.1.4"
"37280","646",2023-09-24 07:45:00,-13153.4,1913,15066.4,907,FALSE,"out1, fill","0.1.4"
"37281","646",2023-09-24 08:00:00,-12946.2,1913,14859.2,907,FALSE,"out1, fill","0.1.4"
"37282","646",2023-09-24 08:15:00,-12739,1913,14652,907,FALSE,NA,"0.1.4"
"37283","646",2023-09-24 08:30:00,-12739,1913,14652,907,FALSE,"jump1","0.1.4"
"37284","646",2023-09-24 08:45:00,-12739,1913,14652,907,FALSE,"jump1","0.1.4"
"37285","646",2023-09-24 09:00:00,-13163,1913,15076,907,FALSE,NA,"0.1.4"
"37286","646",2023-09-24 09:15:00,-13136,1913,15049,907,FALSE,NA,"0.1.4"
"37287","646",2023-09-24 09:30:00,-13154,1913,15067,907,FALSE,NA,"0.1.4"
"37288","646",2023-09-24 09:45:00,-13147,1913,15060,907,FALSE,NA,"0.1.4"
"37289","646",2023-09-24 10:00:00,-13103,1913,15016,907,FALSE,NA,"0.1.4"
"37290","646",2023-09-24 10:15:00,-13116,1913,15029,907,FALSE,NA,"0.1.4"
"37291","646",2023-09-24 10:30:00,-13141,1913,15054,907,FALSE,NA,"0.1.4"
"37292","646",2023-09-24 10:45:00,-13154,1913,15067,907,FALSE,NA,"0.1.4"
"37293","646",2023-09-24 11:00:00,-13168,1913,15081,907,FALSE,NA,"0.1.4"
"37294","646",2023-09-24 11:15:00,-13168,1913,15081,907,FALSE,"jump1","0.1.4"
"37295","646",2023-09-24 11:30:00,-12884,1913,14797,907,FALSE,NA,"0.1.4"
"37296","646",2023-09-24 11:45:00,-12697,1913,14610,907,FALSE,NA,"0.1.4"
"37297","646",2023-09-24 12:00:00,-12819,1913,14732,907,FALSE,NA,"0.1.4"
"37298","646",2023-09-24 12:15:00,-12699,1913,14612,907,FALSE,NA,"0.1.4"
"37299","646",2023-09-24 12:30:00,-12720,1913,14633,907,FALSE,NA,"0.1.4"
"37300","646",2023-09-24 12:45:00,-12694,1913,14607,907,FALSE,NA,"0.1.4"
"37301","646",2023-09-24 13:00:00,-12673,1913,14586,907,FALSE,NA,"0.1.4"
"37302","646",2023-09-24 13:15:00,-12714,1913,14627,907,FALSE,NA,"0.1.4"
"37303","646",2023-09-24 13:30:00,-12733,1913,14646,907,FALSE,NA,"0.1.4"
"37304","646",2023-09-24 13:45:00,-12708,1913,14621,907,FALSE,NA,"0.1.4"
"37305","646",2023-09-24 14:00:00,-12729,1913,14642,907,FALSE,NA,"0.1.4"
"37306","646",2023-09-24 14:15:00,-12729,1913,14642,907,FALSE,"jump1","0.1.4"
"37307","646",2023-09-24 14:30:00,-12715.3333333333,1913,14628.3333333333,907,FALSE,"out1, fill","0.1.4"
"37308","646",2023-09-24 14:45:00,-12701.6666666667,1913,14614.6666666667,907,FALSE,"out1, fill","0.1.4"
"37309","646",2023-09-24 15:00:00,-12688,1913,14601,907,FALSE,NA,"0.1.4"
"37310","646",2023-09-24 15:15:00,-12652,1913,14565,907,FALSE,NA,"0.1.4"
"37311","646",2023-09-24 15:30:00,-12533,1913,14446,907,FALSE,NA,"0.1.4"
"37312","646",2023-09-24 15:45:00,-12550.75,1913,14463.75,907,FALSE,"out1, fill","0.1.4"
"37313","646",2023-09-24 16:00:00,-12568.5,1913,14481.5,907,FALSE,"out1, fill","0.1.4"
"37314","646",2023-09-24 16:15:00,-12586.25,1913,14499.25,907,FALSE,"out1, fill","0.1.4"
"37315","646",2023-09-24 16:30:00,-12604,1913,14517,907,FALSE,NA,"0.1.4"
"37316","646",2023-09-24 16:45:00,-12679,1913,14592,907,FALSE,NA,"0.1.4"
"37317","646",2023-09-24 17:00:00,-12628,1913,14541,907,FALSE,NA,"0.1.4"
"37318","646",2023-09-24 17:15:00,-12628,1913,14541,907,FALSE,"jump1","0.1.4"
"37319","646",2023-09-24 17:30:00,-12546,1913,14459,907,FALSE,NA,"0.1.4"
"37320","646",2023-09-24 17:45:00,-12572,1913,14485,907,FALSE,NA,"0.1.4"
"37321","646",2023-09-24 18:00:00,-12520,1913,14433,907,FALSE,NA,"0.1.4"
"37322","646",2023-09-24 18:15:00,-12330,1913,14243,907,FALSE,NA,"0.1.4"
"37323","646",2023-09-24 18:30:00,-12816.5,1913,14729.5,907,FALSE,"out1, fill","0.1.4"
"37324","646",2023-09-24 18:45:00,-13303,1913,15216,907,FALSE,NA,"0.1.4"
"37325","646",2023-09-24 19:00:00,-13447,1913,15360,907,FALSE,NA,"0.1.4"
"37326","646",2023-09-24 19:15:00,-13307,1913,15220,907,FALSE,NA,"0.1.4"
"37327","646",2023-09-24 19:30:00,-13307.9,1913,15220.9,907,FALSE,"out1, fill","0.1.4"
"37328","646",2023-09-24 19:45:00,-13308.8,1913,15221.8,907,FALSE,"out1, fill","0.1.4"
"37329","646",2023-09-24 20:00:00,-13309.7,1913,15222.7,907,FALSE,"out1, fill","0.1.4"
"37330","646",2023-09-24 20:15:00,-13310.6,1913,15223.6,907,FALSE,"out1, fill","0.1.4"
"37331","646",2023-09-24 20:30:00,-13311.5,1913,15224.5,907,FALSE,"out1, fill","0.1.4"
"37332","646",2023-09-24 20:45:00,-13312.4,1913,15225.4,907,FALSE,"out1, fill","0.1.4"
"37333","646",2023-09-24 21:00:00,-13313.3,1913,15226.3,907,FALSE,"out1, fill","0.1.4"
"37334","646",2023-09-24 21:15:00,-13314.2,1913,15227.2,907,FALSE,"out1, fill","0.1.4"
"37335","646",2023-09-24 21:30:00,-13315.1,1913,15228.1,907,FALSE,"out1, fill","0.1.4"
"37336","646",2023-09-24 21:45:00,-13316,1913,15229,907,FALSE,NA,"0.1.4"
"37337","646",2023-09-24 22:00:00,-13316,1913,15229,907,FALSE,"jump1","0.1.4"
"37338","646",2023-09-24 22:15:00,-13276,1913,15189,907,FALSE,NA,"0.1.4"
"37339","646",2023-09-24 22:30:00,-13371.6666666667,1913,15284.6666666667,907,FALSE,"out1, fill","0.1.4"
"37340","646",2023-09-24 22:45:00,-13467.3333333333,1913,15380.3333333333,907,FALSE,"out1, fill","0.1.4"
"37341","646",2023-09-24 23:00:00,-13563,1913,15476,907,FALSE,NA,"0.1.4"
"37342","646",2023-09-24 23:15:00,-13706,1913,15619,907,FALSE,NA,"0.1.4"
"37343","646",2023-09-24 23:30:00,-13608,1913,15521,907,FALSE,NA,"0.1.4"
"37344","646",2023-09-24 23:45:00,-13382,1913,15295,907,FALSE,NA,"0.1.4"
"37345","646",2023-09-25,-13555,1913,15468,907,FALSE,NA,"0.1.4"
"37346","646",2023-09-25 00:15:00,-13587,1913,15500,907,FALSE,NA,"0.1.4"
"37347","646",2023-09-25 00:30:00,-13692,1913,15605,907,FALSE,NA,"0.1.4"
"37348","646",2023-09-25 00:45:00,-13687,1913,15600,907,FALSE,NA,"0.1.4"
"37349","646",2023-09-25 01:00:00,-13689,1913,15602,907,FALSE,NA,"0.1.4"
"37350","646",2023-09-25 01:15:00,-13639.6,1913,15552.6,907,FALSE,"out1, fill","0.1.4"
"37351","646",2023-09-25 01:30:00,-13590.2,1913,15503.2,907,FALSE,"out1, fill","0.1.4"
"37352","646",2023-09-25 01:45:00,-13540.8,1913,15453.8,907,FALSE,"out1, fill","0.1.4"
"37353","646",2023-09-25 02:00:00,-13491.4,1913,15404.4,907,FALSE,"out1, fill","0.1.4"
"37354","646",2023-09-25 02:15:00,-13442,1913,15355,907,FALSE,NA,"0.1.4"
"37355","646",2023-09-25 02:30:00,-13228,1913,15141,907,FALSE,NA,"0.1.4"
"37356","646",2023-09-25 02:45:00,-12934,1913,14847,907,FALSE,NA,"0.1.4"
"37357","646",2023-09-25 03:00:00,-12934,1913,14847,907,FALSE,"out1, fill","0.1.4"
"37358","646",2023-09-25 03:15:00,-12934,1913,14847,907,FALSE,"jump1","0.1.4"
"37359","646",2023-09-25 03:30:00,-12934,1913,14847,907,FALSE,"jump1","0.1.4"
"37360","646",2023-09-25 03:45:00,-12588,1913,14501,907,FALSE,NA,"0.1.4"
"37361","646",2023-09-25 04:00:00,-12588,1913,14501,907,FALSE,"out1, fill","0.1.4"
"37362","646",2023-09-25 04:15:00,-12588,1913,14501,907,FALSE,"jump1","0.1.4"
"37363","646",2023-09-25 04:30:00,-12622,1913,14535,907,FALSE,NA,"0.1.4"
"37364","646",2023-09-25 04:45:00,-12363,1913,14276,907,FALSE,NA,"0.1.4"
"37365","646",2023-09-25 05:00:00,-12828,1913,14741,907,FALSE,"out1, fill","0.1.4"
"37366","646",2023-09-25 05:15:00,-13293,1913,15206,907,FALSE,NA,"0.1.4"
"37367","646",2023-09-25 05:30:00,-13390,1913,15303,907,FALSE,NA,"0.1.4"
"37368","646",2023-09-25 05:45:00,-13398,1913,15311,907,FALSE,NA,"0.1.4"
"37369","646",2023-09-25 06:00:00,-13436,1913,15349,907,FALSE,NA,"0.1.4"
"37370","646",2023-09-25 06:15:00,-13404,1913,15317,907,FALSE,NA,"0.1.4"
"37371","646",2023-09-25 06:30:00,-13380.6666666667,1913,15293.6666666667,907,FALSE,"out1, fill","0.1.4"
"37372","646",2023-09-25 06:45:00,-13357.3333333333,1913,15270.3333333333,907,FALSE,"out1, fill","0.1.4"
"37373","646",2023-09-25 07:00:00,-13334,1913,15247,907,FALSE,NA,"0.1.4"
"37374","646",2023-09-25 07:15:00,-13469,1913,15382,907,FALSE,NA,"0.1.4"
"37375","646",2023-09-25 07:30:00,-13446,1913,15359,907,FALSE,NA,"0.1.4"
"37376","646",2023-09-25 07:45:00,-13310,1913,15223,907,FALSE,NA,"0.1.4"
"37377","646",2023-09-25 08:00:00,-13342,1913,15255,907,FALSE,NA,"0.1.4"
"37378","646",2023-09-25 08:15:00,-13160,1913,15073,907,FALSE,NA,"0.1.4"
"37379","646",2023-09-25 08:30:00,-13129,1913,15042,907,FALSE,NA,"0.1.4"
"37380","646",2023-09-25 08:45:00,-13141,1913,15054,907,FALSE,NA,"0.1.4"
"37381","646",2023-09-25 09:00:00,-12773,1913,14686,907,FALSE,NA,"0.1.4"
"37382","646",2023-09-25 09:15:00,-13079,1913,14992,907,FALSE,NA,"0.1.4"
"37383","646",2023-09-25 09:30:00,-13199,1913,15112,907,FALSE,NA,"0.1.4"
"37384","646",2023-09-25 09:45:00,-13073,1913,14986,907,FALSE,NA,"0.1.4"
"37385","646",2023-09-25 10:00:00,-13221,1913,15134,907,FALSE,NA,"0.1.4"
"37386","646",2023-09-25 10:15:00,-13420,1913,15333,907,FALSE,NA,"0.1.4"
"37387","646",2023-09-25 10:30:00,-13442,1913,15355,907,FALSE,NA,"0.1.4"
"37388","646",2023-09-25 10:45:00,-13470,1913,15383,907,FALSE,NA,"0.1.4"
"37389","646",2023-09-25 11:00:00,-13148,1913,15061,907,FALSE,NA,"0.1.4"
"37390","646",2023-09-25 11:15:00,-13229,1913,15142,907,FALSE,NA,"0.1.4"
"37391","646",2023-09-25 11:30:00,-13434,1913,15347,907,FALSE,NA,"0.1.4"
"37392","646",2023-09-25 11:45:00,-13409,1913,15322,907,FALSE,NA,"0.1.4"
"37393","646",2023-09-25 12:00:00,-13412,1913,15325,907,FALSE,NA,"0.1.4"
"37394","646",2023-09-25 12:15:00,-13435,1913,15348,907,FALSE,NA,"0.1.4"
"37395","646",2023-09-25 12:30:00,-13373,1913,15286,907,FALSE,NA,"0.1.4"
"37396","646",2023-09-25 12:45:00,-13373,1913,15286,907,FALSE,"out1, fill","0.1.4"
"37397","646",2023-09-25 13:00:00,-13373,1913,15286,907,FALSE,"jump1","0.1.4"
"37398","646",2023-09-25 13:15:00,-13442,1913,15355,907,FALSE,NA,"0.1.4"
"37399","646",2023-09-25 13:30:00,-13606,1913,15519,907,FALSE,NA,"0.1.4"
"37400","646",2023-09-25 13:45:00,-13986,1913,15899,907,FALSE,NA,"0.1.4"
"37401","646",2023-09-25 14:00:00,-13840,1913,15753,907,FALSE,NA,"0.1.4"
"37402","646",2023-09-25 14:15:00,-14014,1913,15927,907,FALSE,NA,"0.1.4"
"37403","646",2023-09-25 14:30:00,-14014,1913,15927,907,FALSE,"jump1","0.1.4"
"37404","646",2023-09-25 14:45:00,-14043,1913,15956,907,FALSE,NA,"0.1.4"
"37405","646",2023-09-25 15:00:00,-14030,1913,15943,907,FALSE,NA,"0.1.4"
"37406","646",2023-09-25 15:15:00,-14006,1913,15919,907,FALSE,NA,"0.1.4"
"37407","646",2023-09-25 15:30:00,-13985,1913,15898,907,FALSE,NA,"0.1.4"
"37408","646",2023-09-25 15:45:00,-14018,1913,15931,907,FALSE,NA,"0.1.4"
"37409","646",2023-09-25 16:00:00,-14009,1913,15922,907,FALSE,NA,"0.1.4"
"37410","646",2023-09-25 16:15:00,-13978,1913,15891,907,FALSE,NA,"0.1.4"
"37411","646",2023-09-25 16:30:00,-13995,1913,15908,907,FALSE,NA,"0.1.4"
"37412","646",2023-09-25 16:45:00,-13908,1913,15821,907,FALSE,NA,"0.1.4"
"37413","646",2023-09-25 17:00:00,-13805,1913,15718,907,FALSE,NA,"0.1.4"
"37414","646",2023-09-25 17:15:00,-13861,1913,15774,907,FALSE,NA,"0.1.4"
"37415","646",2023-09-25 17:30:00,-13913,1913,15826,907,FALSE,NA,"0.1.4"
"37416","646",2023-09-25 17:45:00,-13969,1913,15882,907,FALSE,NA,"0.1.4"
"37417","646",2023-09-25 18:00:00,-13945,1913,15858,907,FALSE,NA,"0.1.4"
"37418","646",2023-09-25 18:15:00,-13927,1913,15840,907,FALSE,NA,"0.1.4"
"37419","646",2023-09-25 18:30:00,-13908,1913,15821,907,FALSE,NA,"0.1.4"
"37420","646",2023-09-25 18:45:00,-13919,1913,15832,907,FALSE,NA,"0.1.4"
"37421","646",2023-09-25 19:00:00,-13895,1913,15808,907,FALSE,NA,"0.1.4"
"37422","646",2023-09-25 19:15:00,-13935,1913,15848,907,FALSE,NA,"0.1.4"
"37423","646",2023-09-25 19:30:00,-13879,1913,15792,907,FALSE,NA,"0.1.4"
"37424","646",2023-09-25 19:45:00,-13867,1913,15780,907,FALSE,NA,"0.1.4"
"37425","646",2023-09-25 20:00:00,-13823,1913,15736,907,FALSE,NA,"0.1.4"
"37426","646",2023-09-25 20:15:00,-13934,1913,15847,907,FALSE,NA,"0.1.4"
"37427","646",2023-09-25 20:30:00,-13888,1913,15801,907,FALSE,NA,"0.1.4"
"37428","646",2023-09-25 20:45:00,-13872,1913,15785,907,FALSE,NA,"0.1.4"
"37429","646",2023-09-25 21:00:00,-13891,1913,15804,907,FALSE,NA,"0.1.4"
"37430","646",2023-09-25 21:15:00,-13891,1913,15804,907,FALSE,NA,"0.1.4"
"37431","646",2023-09-25 21:30:00,-13904,1913,15817,907,FALSE,NA,"0.1.4"
"37432","646",2023-09-25 21:45:00,-13901,1913,15814,907,FALSE,NA,"0.1.4"
"37433","646",2023-09-25 22:00:00,-13829,1913,15742,907,FALSE,NA,"0.1.4"
"37434","646",2023-09-25 22:15:00,-13861,1913,15774,907,FALSE,NA,"0.1.4"
"37435","646",2023-09-25 22:30:00,-13875,1913,15788,907,FALSE,NA,"0.1.4"
"37436","646",2023-09-25 22:45:00,-13935,1913,15848,907,FALSE,NA,"0.1.4"
"37437","646",2023-09-25 23:00:00,-13917,1913,15830,907,FALSE,NA,"0.1.4"
"37438","646",2023-09-25 23:15:00,-13947,1913,15860,907,FALSE,NA,"0.1.4"
"37439","646",2023-09-25 23:30:00,-13964,1913,15877,907,FALSE,NA,"0.1.4"
"37440","646",2023-09-25 23:45:00,-13953,1913,15866,907,FALSE,NA,"0.1.4"
"37441","646",2023-09-26,-14108,1913,16021,907,FALSE,NA,"0.1.4"
"37442","646",2023-09-26 00:15:00,-14074,1913,15987,907,FALSE,NA,"0.1.4"
"37443","646",2023-09-26 00:30:00,-14042,1913,15955,907,FALSE,NA,"0.1.4"
"37444","646",2023-09-26 00:45:00,-14042,1913,15955,907,FALSE,"jump1","0.1.4"
"37445","646",2023-09-26 01:00:00,-14042,1913,15955,907,FALSE,"jump1","0.1.4"
"37446","646",2023-09-26 01:15:00,-14055,1913,15968,907,FALSE,NA,"0.1.4"
"37447","646",2023-09-26 01:30:00,-14135,1913,16048,907,FALSE,NA,"0.1.4"
"37448","646",2023-09-26 01:45:00,-14471,1913,16384,907,FALSE,NA,"0.1.4"
"37449","646",2023-09-26 02:00:00,-14283,1913,16196,907,FALSE,NA,"0.1.4"
"37450","646",2023-09-26 02:15:00,-14587,1913,16500,907,FALSE,NA,"0.1.4"
"37451","646",2023-09-26 02:30:00,-14392,1913,16305,907,FALSE,NA,"0.1.4"
"37452","646",2023-09-26 02:45:00,-14641,1913,16554,907,FALSE,NA,"0.1.4"
"37453","646",2023-09-26 03:00:00,-14586,1913,16499,907,FALSE,NA,"0.1.4"
"37454","646",2023-09-26 03:15:00,-14963.5,1913,16876.5,907,FALSE,"out1, fill","0.1.4"
"37455","646",2023-09-26 03:30:00,-15341,1913,17254,907,FALSE,NA,"0.1.4"
"37456","646",2023-09-26 03:45:00,-15337,1913,17250,907,FALSE,NA,"0.1.4"
"37457","646",2023-09-26 04:00:00,-15244,1913,17157,907,FALSE,NA,"0.1.4"
"37458","646",2023-09-26 04:15:00,-15169,1913,17082,907,FALSE,NA,"0.1.4"
"37459","646",2023-09-26 04:30:00,-15274,1913,17187,907,FALSE,NA,"0.1.4"
"37460","646",2023-09-26 04:45:00,-15272,1913,17185,907,FALSE,NA,"0.1.4"
"37461","646",2023-09-26 05:00:00,-14885,1913,16798,907,FALSE,NA,"0.1.4"
"37462","646",2023-09-26 05:15:00,-14559,1913,16472,907,FALSE,NA,"0.1.4"
"37463","646",2023-09-26 05:30:00,-14633,1913,16546,907,FALSE,NA,"0.1.4"
"37464","646",2023-09-26 05:45:00,-14734,1913,16647,907,FALSE,NA,"0.1.4"
"37465","646",2023-09-26 06:00:00,-14627,1913,16540,907,FALSE,NA,"0.1.4"
"37466","646",2023-09-26 06:15:00,-14576,1913,16489,907,FALSE,NA,"0.1.4"
"37467","646",2023-09-26 06:30:00,-14821,1913,16734,907,FALSE,NA,"0.1.4"
"37468","646",2023-09-26 06:45:00,-15311,1913,17224,907,FALSE,NA,"0.1.4"
"37469","646",2023-09-26 07:00:00,-14902,1913,16815,907,FALSE,NA,"0.1.4"
"37470","646",2023-09-26 07:15:00,-15050,1913,16963,907,FALSE,NA,"0.1.4"
"37471","646",2023-09-26 07:30:00,-14936,1913,16849,907,FALSE,NA,"0.1.4"
"37472","646",2023-09-26 07:45:00,-14988,1913,16901,907,FALSE,NA,"0.1.4"
"37473","646",2023-09-26 08:00:00,-15051,1913,16964,907,FALSE,NA,"0.1.4"
"37474","646",2023-09-26 08:15:00,-14977,1913,16890,907,FALSE,NA,"0.1.4"
"37475","646",2023-09-26 08:30:00,-14938,1913,16851,907,FALSE,NA,"0.1.4"
"37476","646",2023-09-26 08:45:00,-15105,1913,17018,907,FALSE,NA,"0.1.4"
"37477","646",2023-09-26 09:00:00,-15105,1913,17018,907,FALSE,"jump1","0.1.4"
"37478","646",2023-09-26 09:15:00,-15199.2,1913,17112.2,907,FALSE,"out1, fill","0.1.4"
"37479","646",2023-09-26 09:30:00,-15293.4,1913,17206.4,907,FALSE,"out1, fill","0.1.4"
"37480","646",2023-09-26 09:45:00,-15387.6,1913,17300.6,907,FALSE,"out1, fill","0.1.4"
"37481","646",2023-09-26 10:00:00,-15481.8,1913,17394.8,907,FALSE,"out1, fill","0.1.4"
"37482","646",2023-09-26 10:15:00,-15576,1913,17489,907,FALSE,NA,"0.1.4"
"37483","646",2023-09-26 10:30:00,-15910,1913,17823,907,FALSE,NA,"0.1.4"
"37484","646",2023-09-26 10:45:00,-15799,1913,17712,907,FALSE,NA,"0.1.4"
"37485","646",2023-09-26 11:00:00,-15799,1913,17712,907,FALSE,"jump1","0.1.4"
"37486","646",2023-09-26 11:15:00,-16095,1913,18008,907,FALSE,NA,"0.1.4"
"37487","646",2023-09-26 11:30:00,-16250,1913,18163,907,FALSE,NA,"0.1.4"
"37488","646",2023-09-26 11:45:00,-16254,1913,18167,907,FALSE,NA,"0.1.4"
"37489","646",2023-09-26 12:00:00,-16019,1913,17932,907,FALSE,NA,"0.1.4"
"37490","646",2023-09-26 12:15:00,-15591,1913,17504,907,FALSE,NA,"0.1.4"
"37491","646",2023-09-26 12:30:00,-15655.5833333333,1913,17568.5833333333,907,FALSE,"out1, fill","0.1.4"
"37492","646",2023-09-26 12:45:00,-15720.1666666667,1913,17633.1666666667,907,FALSE,"out1, fill","0.1.4"
"37493","646",2023-09-26 13:00:00,-15784.75,1913,17697.75,907,FALSE,"out1, fill","0.1.4"
"37494","646",2023-09-26 13:15:00,-15849.3333333333,1913,17762.3333333333,907,FALSE,"out1, fill","0.1.4"
"37495","646",2023-09-26 13:30:00,-15913.9166666667,1913,17826.9166666667,907,FALSE,"out1, fill","0.1.4"
"37496","646",2023-09-26 13:45:00,-15978.5,1913,17891.5,907,FALSE,"out1, fill","0.1.4"
"37497","646",2023-09-26 14:00:00,-16043.0833333333,1913,17956.0833333333,907,FALSE,"out1, fill","0.1.4"
"37498","646",2023-09-26 14:15:00,-16107.6666666667,1913,18020.6666666667,907,FALSE,"out1, fill","0.1.4"
"37499","646",2023-09-26 14:30:00,-16172.25,1913,18085.25,907,FALSE,"out1, fill","0.1.4"
"37500","646",2023-09-26 14:45:00,-16236.8333333333,1913,18149.8333333333,907,FALSE,"out1, fill","0.1.4"
"37501","646",2023-09-26 15:00:00,-16301.4166666667,1913,18214.4166666667,907,FALSE,"out1, fill","0.1.4"
"37502","646",2023-09-26 15:15:00,-16366,1913,18279,907,FALSE,NA,"0.1.4"
"37503","646",2023-09-26 15:30:00,-16391,1913,18304,907,FALSE,NA,"0.1.4"
"37504","646",2023-09-26 15:45:00,-16271,1913,18184,907,FALSE,NA,"0.1.4"
"37505","646",2023-09-26 16:00:00,-16271,1913,18184,907,FALSE,"out1, fill","0.1.4"
"37506","646",2023-09-26 16:15:00,-16271,1913,18184,907,FALSE,"jump1","0.1.4"
"37507","646",2023-09-26 16:30:00,-16205,1913,18118,907,FALSE,NA,"0.1.4"
"37508","646",2023-09-26 16:45:00,-16205,1913,18118,907,FALSE,"jump1","0.1.4"
"37509","646",2023-09-26 17:00:00,-16477.3333333333,1913,18390.3333333333,907,FALSE,"out1, fill","0.1.4"
"37510","646",2023-09-26 17:15:00,-16749.6666666667,1913,18662.6666666667,907,FALSE,"out1, fill","0.1.4"
"37511","646",2023-09-26 17:30:00,-17022,1913,18935,907,FALSE,NA,"0.1.4"
"37512","646",2023-09-26 17:45:00,-17022,1913,18935,907,FALSE,"jump1","0.1.4"
"37513","646",2023-09-26 18:00:00,-16703,1913,18616,907,FALSE,NA,"0.1.4"
"37514","646",2023-09-26 18:15:00,-16312.5,1913,18225.5,907,FALSE,"out1, fill","0.1.4"
"37515","646",2023-09-26 18:30:00,-15922,1913,17835,907,FALSE,NA,"0.1.4"
"37516","646",2023-09-26 18:45:00,-16057,1913,17970,907,FALSE,NA,"0.1.4"
"37517","646",2023-09-26 19:00:00,-16510,1913,18423,907,FALSE,NA,"0.1.4"
"37518","646",2023-09-26 19:15:00,-16851,1913,18764,907,FALSE,NA,"0.1.4"
"37519","646",2023-09-26 19:30:00,-16913,1913,18826,907,FALSE,NA,"0.1.4"
"37520","646",2023-09-26 19:45:00,-16951,1913,18864,907,FALSE,NA,"0.1.4"
"37521","646",2023-09-26 20:00:00,-16932,1913,18845,907,FALSE,NA,"0.1.4"
"37522","646",2023-09-26 20:15:00,-16944,1913,18857,907,FALSE,NA,"0.1.4"
"37523","646",2023-09-26 20:30:00,-16970,1913,18883,907,FALSE,NA,"0.1.4"
"37524","646",2023-09-26 20:45:00,-16991,1913,18904,907,FALSE,NA,"0.1.4"
"37525","646",2023-09-26 21:00:00,-16950,1913,18863,907,FALSE,NA,"0.1.4"
"37526","646",2023-09-26 21:15:00,-16983,1913,18896,907,FALSE,NA,"0.1.4"
"37527","646",2023-09-26 21:30:00,-16995,1913,18908,907,FALSE,NA,"0.1.4"
"37528","646",2023-09-26 21:45:00,-17011,1913,18924,907,FALSE,NA,"0.1.4"
"37529","646",2023-09-26 22:00:00,-17030,1913,18943,907,FALSE,NA,"0.1.4"
"37530","646",2023-09-26 22:15:00,-17182,1913,19095,907,FALSE,NA,"0.1.4"
"37531","646",2023-09-26 22:30:00,-17042,1913,18955,907,FALSE,NA,"0.1.4"
"37532","646",2023-09-26 22:45:00,-16791,1913,18704,907,FALSE,NA,"0.1.4"
"37533","646",2023-09-26 23:00:00,-16406,1913,18319,907,FALSE,NA,"0.1.4"
"37534","646",2023-09-26 23:15:00,-16351,1913,18264,907,FALSE,NA,"0.1.4"
"37535","646",2023-09-26 23:30:00,-16351,1913,18264,907,FALSE,"out1, fill","0.1.4"
"37536","646",2023-09-26 23:45:00,-16351,1913,18264,907,FALSE,"jump1","0.1.4"
"37537","646",2023-09-27,-16498,1913,18411,907,FALSE,NA,"0.1.4"
"37538","646",2023-09-27 00:15:00,-16358,1913,18271,907,FALSE,NA,"0.1.4"
"37539","646",2023-09-27 00:30:00,-16329,1913,18242,907,FALSE,NA,"0.1.4"
"37540","646",2023-09-27 00:45:00,-16377,1913,18290,907,FALSE,NA,"0.1.4"
"37541","646",2023-09-27 01:00:00,-16307,1913,18220,907,FALSE,NA,"0.1.4"
"37542","646",2023-09-27 01:15:00,-16454,1913,18367,907,FALSE,NA,"0.1.4"
"37543","646",2023-09-27 01:30:00,-16474,1913,18387,907,FALSE,NA,"0.1.4"
"37544","646",2023-09-27 01:45:00,-16513,1913,18426,907,FALSE,NA,"0.1.4"
"37545","646",2023-09-27 02:00:00,-16507,1913,18420,907,FALSE,NA,"0.1.4"
"37546","646",2023-09-27 02:15:00,-16452,1913,18365,907,FALSE,NA,"0.1.4"
"37547","646",2023-09-27 02:30:00,-16452,1913,18365,907,FALSE,"jump1","0.1.4"
"37548","646",2023-09-27 02:45:00,-16923,1913,18836,907,FALSE,NA,"0.1.4"
"37549","646",2023-09-27 03:00:00,-16923,1913,18836,907,FALSE,"out1, fill","0.1.4"
"37550","646",2023-09-27 03:15:00,-16923,1913,18836,907,FALSE,"jump1","0.1.4"
"37551","646",2023-09-27 03:30:00,-16474,1913,18387,907,FALSE,NA,"0.1.4"
"37552","646",2023-09-27 03:45:00,-16722,1913,18635,907,FALSE,NA,"0.1.4"
"37553","646",2023-09-27 04:00:00,-17044,1913,18957,907,FALSE,NA,"0.1.4"
"37554","646",2023-09-27 04:15:00,-17359,1913,19272,907,FALSE,NA,"0.1.4"
"37555","646",2023-09-27 04:30:00,-17133,1913,19046,907,FALSE,NA,"0.1.4"
"37556","646",2023-09-27 04:45:00,-17355.6666666667,1913,19268.6666666667,907,FALSE,"out1, fill","0.1.4"
"37557","646",2023-09-27 05:00:00,-17578.3333333333,1913,19491.3333333333,907,FALSE,"out1, fill","0.1.4"
"37558","646",2023-09-27 05:15:00,-17801,1913,19714,907,FALSE,"out1, fill","0.1.4"
"37559","646",2023-09-27 05:30:00,-18023.6666666667,1913,19936.6666666667,907,FALSE,"out1, fill","0.1.4"
"37560","646",2023-09-27 05:45:00,-18246.3333333333,1913,20159.3333333333,907,FALSE,"out1, fill","0.1.4"
"37561","646",2023-09-27 06:00:00,-18469,1913,20382,907,FALSE,NA,"0.1.4"
"37562","646",2023-09-27 06:15:00,-18367,1913,20280,907,FALSE,NA,"0.1.4"
"37563","646",2023-09-27 06:30:00,-18126,1913,20039,907,FALSE,NA,"0.1.4"
"37564","646",2023-09-27 06:45:00,-18343,1913,20256,907,FALSE,NA,"0.1.4"
"37565","646",2023-09-27 07:00:00,-18343,1913,20256,907,FALSE,"jump1","0.1.4"
"37566","646",2023-09-27 07:15:00,-18762.5,1913,20675.5,907,FALSE,"out1, fill","0.1.4"
"37567","646",2023-09-27 07:30:00,-19182,1913,21095,907,FALSE,NA,"0.1.4"
"37568","646",2023-09-27 07:45:00,-19235,1913,21148,907,FALSE,NA,"0.1.4"
"37569","646",2023-09-27 08:00:00,-19250,1913,21163,907,FALSE,NA,"0.1.4"
"37570","646",2023-09-27 08:15:00,-18851,1913,20764,907,FALSE,NA,"0.1.4"
"37571","646",2023-09-27 08:30:00,-18851,1913,20764,907,FALSE,"jump1","0.1.4"
"37572","646",2023-09-27 08:45:00,-18956,1913,20869,907,FALSE,NA,"0.1.4"
"37573","646",2023-09-27 09:00:00,-18947,1913,20860,907,FALSE,NA,"0.1.4"
"37574","646",2023-09-27 09:15:00,-18947,1913,20860,907,FALSE,"jump1","0.1.4"
"37575","646",2023-09-27 09:30:00,-19104,1913,21017,907,FALSE,NA,"0.1.4"
"37576","646",2023-09-27 09:45:00,-19037,1913,20950,907,FALSE,NA,"0.1.4"
"37577","646",2023-09-27 10:00:00,-18888,1913,20801,907,FALSE,NA,"0.1.4"
"37578","646",2023-09-27 10:15:00,-18962,1913,20875,907,FALSE,NA,"0.1.4"
"37579","646",2023-09-27 10:30:00,-19085,1913,20998,907,FALSE,NA,"0.1.4"
"37580","646",2023-09-27 10:45:00,-19041,1913,20954,907,FALSE,NA,"0.1.4"
"37581","646",2023-09-27 11:00:00,-19041,1913,20954,907,FALSE,"out1, fill","0.1.4"
"37582","646",2023-09-27 11:15:00,-19041,1913,20954,907,FALSE,"jump1","0.1.4"
"37583","646",2023-09-27 11:30:00,-19038,1913,20951,907,FALSE,NA,"0.1.4"
"37584","646",2023-09-27 11:45:00,-19038,1913,20951,907,FALSE,NA,"0.1.4"
"37585","646",2023-09-27 12:00:00,-19038,1913,20951,907,FALSE,"out1, fill","0.1.4"
"37586","646",2023-09-27 12:15:00,-19038,1913,20951,907,FALSE,"jump1","0.1.4"
"37587","646",2023-09-27 12:30:00,-18937,1913,20850,907,FALSE,NA,"0.1.4"
"37588","646",2023-09-27 12:45:00,-18971,1913,20884,907,FALSE,NA,"0.1.4"
"37589","646",2023-09-27 13:00:00,-19064,1913,20977,907,FALSE,NA,"0.1.4"
"37590","646",2023-09-27 13:15:00,-19123,1913,21036,907,FALSE,NA,"0.1.4"
"37591","646",2023-09-27 13:30:00,-19119,1913,21032,907,FALSE,NA,"0.1.4"
"37592","646",2023-09-27 13:45:00,-18638,1913,20551,907,FALSE,NA,"0.1.4"
"37593","646",2023-09-27 14:00:00,-18978,1913,20891,907,FALSE,NA,"0.1.4"
"37594","646",2023-09-27 14:15:00,-19177,1913,21090,907,FALSE,NA,"0.1.4"
"37595","646",2023-09-27 14:30:00,-19150,1913,21063,907,FALSE,NA,"0.1.4"
"37596","646",2023-09-27 14:45:00,-19190,1913,21103,907,FALSE,NA,"0.1.4"
"37597","646",2023-09-27 15:00:00,-19035,1913,20948,907,FALSE,"out1, fill","0.1.4"
"37598","646",2023-09-27 15:15:00,-18880,1913,20793,907,FALSE,"out1, fill","0.1.4"
"37599","646",2023-09-27 15:30:00,-18725,1913,20638,907,FALSE,"out1, fill","0.1.4"
"37600","646",2023-09-27 15:45:00,-18570,1913,20483,907,FALSE,"out1, fill","0.1.4"
"37601","646",2023-09-27 16:00:00,-18415,1913,20328,907,FALSE,"out1, fill","0.1.4"
"37602","646",2023-09-27 16:15:00,-18260,1913,20173,907,FALSE,"out1, fill","0.1.4"
"37603","646",2023-09-27 16:30:00,-18105,1913,20018,907,FALSE,NA,"0.1.4"
"37604","646",2023-09-27 16:45:00,-17932,1913,19845,907,FALSE,NA,"0.1.4"
"37605","646",2023-09-27 17:00:00,-17845,1913,19758,907,FALSE,NA,"0.1.4"
"37606","646",2023-09-27 17:15:00,-17845,1913,19758,907,FALSE,"jump1","0.1.4"
"37607","646",2023-09-27 17:30:00,-17845,1913,19758,907,FALSE,"jump1","0.1.4"
"37608","646",2023-09-27 17:45:00,-17608,1913,19521,907,FALSE,NA,"0.1.4"
"37609","646",2023-09-27 18:00:00,-17728,1913,19641,907,FALSE,NA,"0.1.4"
"37610","646",2023-09-27 18:15:00,-17454,1913,19367,907,FALSE,NA,"0.1.4"
"37611","646",2023-09-27 18:30:00,-17434,1913,19347,907,FALSE,NA,"0.1.4"
"37612","646",2023-09-27 18:45:00,-17447,1913,19360,907,FALSE,NA,"0.1.4"
"37613","646",2023-09-27 19:00:00,-17430,1913,19343,907,FALSE,NA,"0.1.4"
"37614","646",2023-09-27 19:15:00,-17447,1913,19360,907,FALSE,NA,"0.1.4"
"37615","646",2023-09-27 19:30:00,-17359,1913,19272,907,FALSE,NA,"0.1.4"
"37616","646",2023-09-27 19:45:00,-17435,1913,19348,907,FALSE,NA,"0.1.4"
"37617","646",2023-09-27 20:00:00,-17415,1913,19328,907,FALSE,NA,"0.1.4"
"37618","646",2023-09-27 20:15:00,-17413,1913,19326,907,FALSE,NA,"0.1.4"
"37619","646",2023-09-27 20:30:00,-17595,1913,19508,907,FALSE,NA,"0.1.4"
"37620","646",2023-09-27 20:45:00,-17590,1913,19503,907,FALSE,NA,"0.1.4"
"37621","646",2023-09-27 21:00:00,-17628,1913,19541,907,FALSE,NA,"0.1.4"
"37622","646",2023-09-27 21:15:00,-17680,1913,19593,907,FALSE,"out1, fill","0.1.4"
"37623","646",2023-09-27 21:30:00,-17732,1913,19645,907,FALSE,"out1, fill","0.1.4"
"37624","646",2023-09-27 21:45:00,-17784,1913,19697,907,FALSE,NA,"0.1.4"
"37625","646",2023-09-27 22:00:00,-17404,1913,19317,907,FALSE,NA,"0.1.4"
"37626","646",2023-09-27 22:15:00,-17291,1913,19204,907,FALSE,NA,"0.1.4"
"37627","646",2023-09-27 22:30:00,-17302,1913,19215,907,FALSE,NA,"0.1.4"
"37628","646",2023-09-27 22:45:00,-17106,1913,19019,907,FALSE,NA,"0.1.4"
"37629","646",2023-09-27 23:00:00,-17110,1913,19023,907,FALSE,NA,"0.1.4"
"37630","646",2023-09-27 23:15:00,-17113,1913,19026,907,FALSE,NA,"0.1.4"
"37631","646",2023-09-27 23:30:00,-17157,1913,19070,907,FALSE,NA,"0.1.4"
"37632","646",2023-09-27 23:45:00,-17233,1913,19146,907,FALSE,NA,"0.1.4"
"37633","646",2023-09-28,-17246,1913,19159,907,FALSE,NA,"0.1.4"
"37634","646",2023-09-28 00:15:00,-17222,1913,19135,907,FALSE,NA,"0.1.4"
"37635","646",2023-09-28 00:30:00,-17230,1913,19143,907,FALSE,NA,"0.1.4"
"37636","646",2023-09-28 00:45:00,-17248,1913,19161,907,FALSE,NA,"0.1.4"
"37637","646",2023-09-28 01:00:00,-17280,1913,19193,907,FALSE,NA,"0.1.4"
"37638","646",2023-09-28 01:15:00,-17228,1913,19141,907,FALSE,NA,"0.1.4"
"37639","646",2023-09-28 01:30:00,-17188,1913,19101,907,FALSE,NA,"0.1.4"
"37640","646",2023-09-28 01:45:00,-17221,1913,19134,907,FALSE,NA,"0.1.4"
"37641","646",2023-09-28 02:00:00,-17197,1913,19110,907,FALSE,NA,"0.1.4"
"37642","646",2023-09-28 02:15:00,-17132,1913,19045,907,FALSE,NA,"0.1.4"
"37643","646",2023-09-28 02:30:00,-17145,1913,19058,907,FALSE,NA,"0.1.4"
"37644","646",2023-09-28 02:45:00,-17126,1913,19039,907,FALSE,NA,"0.1.4"
"37645","646",2023-09-28 03:00:00,-17123,1913,19036,907,FALSE,NA,"0.1.4"
"37646","646",2023-09-28 03:15:00,-17157,1913,19070,907,FALSE,NA,"0.1.4"
"37647","646",2023-09-28 03:30:00,-17114,1913,19027,907,FALSE,NA,"0.1.4"
"37648","646",2023-09-28 03:45:00,-17104,1913,19017,907,FALSE,NA,"0.1.4"
"37649","646",2023-09-28 04:00:00,-17108,1913,19021,907,FALSE,NA,"0.1.4"
"37650","646",2023-09-28 04:15:00,-17097,1913,19010,907,FALSE,NA,"0.1.4"
"37651","646",2023-09-28 04:30:00,-17123,1913,19036,907,FALSE,NA,"0.1.4"
"37652","646",2023-09-28 04:45:00,-17101,1913,19014,907,FALSE,NA,"0.1.4"
"37653","646",2023-09-28 05:00:00,-17122,1913,19035,907,FALSE,NA,"0.1.4"
"37654","646",2023-09-28 05:15:00,-17421,1913,19334,907,FALSE,NA,"0.1.4"
"37655","646",2023-09-28 05:30:00,-17287,1913,19200,907,FALSE,NA,"0.1.4"
"37656","646",2023-09-28 05:45:00,-17307,1913,19220,907,FALSE,NA,"0.1.4"
"37657","646",2023-09-28 06:00:00,-17350,1913,19263,907,FALSE,NA,"0.1.4"
"37658","646",2023-09-28 06:15:00,-17406,1913,19319,907,FALSE,NA,"0.1.4"
"37659","646",2023-09-28 06:30:00,-17399,1913,19312,907,FALSE,NA,"0.1.4"
"37660","646",2023-09-28 06:45:00,-17374,1913,19287,907,FALSE,NA,"0.1.4"
"37661","646",2023-09-28 07:00:00,-17393,1913,19306,907,FALSE,NA,"0.1.4"
"37662","646",2023-09-28 07:15:00,-17384.4,1913,19297.4,907,FALSE,"out1, fill","0.1.4"
"37663","646",2023-09-28 07:30:00,-17375.8,1913,19288.8,907,FALSE,"out1, fill","0.1.4"
"37664","646",2023-09-28 07:45:00,-17367.2,1913,19280.2,907,FALSE,"out1, fill","0.1.4"
"37665","646",2023-09-28 08:00:00,-17358.6,1913,19271.6,907,FALSE,"out1, fill","0.1.4"
"37666","646",2023-09-28 08:15:00,-17350,1913,19263,907,FALSE,NA,"0.1.4"
"37667","646",2023-09-28 08:30:00,-17349,1913,19262,907,FALSE,NA,"0.1.4"
"37668","646",2023-09-28 08:45:00,-17353,1913,19266,907,FALSE,NA,"0.1.4"
"37669","646",2023-09-28 09:00:00,-17138,1913,19051,907,FALSE,NA,"0.1.4"
"37670","646",2023-09-28 09:15:00,-17227,1913,19140,907,FALSE,NA,"0.1.4"
"37671","646",2023-09-28 09:30:00,-17338,1913,19251,907,FALSE,NA,"0.1.4"
"37672","646",2023-09-28 09:45:00,-17340,1913,19253,907,FALSE,NA,"0.1.4"
"37673","646",2023-09-28 10:00:00,-17328,1913,19241,907,FALSE,NA,"0.1.4"
"37674","646",2023-09-28 10:15:00,-17334,1913,19247,907,FALSE,NA,"0.1.4"
"37675","646",2023-09-28 10:30:00,-17334,1913,19247,907,FALSE,NA,"0.1.4"
"37676","646",2023-09-28 10:45:00,-17339,1913,19252,907,FALSE,NA,"0.1.4"
"37677","646",2023-09-28 11:00:00,-17306,1913,19219,907,FALSE,NA,"0.1.4"
"37678","646",2023-09-28 11:15:00,-17124,1913,19037,907,FALSE,NA,"0.1.4"
"37679","646",2023-09-28 11:30:00,-17347,1913,19260,907,FALSE,NA,"0.1.4"
"37680","646",2023-09-28 11:45:00,-17347,1913,19260,907,FALSE,"jump1","0.1.4"
"37681","646",2023-09-28 12:00:00,-16972.5,1913,18885.5,907,FALSE,"out1, fill","0.1.4"
"37682","646",2023-09-28 12:15:00,-16598,1913,18511,907,FALSE,NA,"0.1.4"
"37683","646",2023-09-28 12:30:00,-16598,1913,18511,907,FALSE,NA,"0.1.4"
"37684","646",2023-09-28 12:45:00,-16820,1913,18733,907,FALSE,NA,"0.1.4"
"37685","646",2023-09-28 13:00:00,-16820,1913,18733,907,FALSE,"jump1","0.1.4"
"37686","646",2023-09-28 13:15:00,-16543,1913,18456,907,FALSE,"out1, fill","0.1.4"
"37687","646",2023-09-28 13:30:00,-16266,1913,18179,907,FALSE,NA,"0.1.4"
"37688","646",2023-09-28 13:45:00,-16300,1913,18213,907,FALSE,NA,"0.1.4"
"37689","646",2023-09-28 14:00:00,-15991,1913,17904,907,FALSE,NA,"0.1.4"
"37690","646",2023-09-28 14:15:00,-15977,1913,17890,907,FALSE,NA,"0.1.4"
"37691","646",2023-09-28 14:30:00,-15978,1913,17891,907,FALSE,NA,"0.1.4"
"37692","646",2023-09-28 14:45:00,-15994,1913,17907,907,FALSE,NA,"0.1.4"
"37693","646",2023-09-28 15:00:00,-15982,1913,17895,907,FALSE,NA,"0.1.4"
"37694","646",2023-09-28 15:15:00,-15978,1913,17891,907,FALSE,NA,"0.1.4"
"37695","646",2023-09-28 15:30:00,-15974,1913,17887,907,FALSE,NA,"0.1.4"
"37696","646",2023-09-28 15:45:00,-15975,1913,17888,907,FALSE,NA,"0.1.4"
"37697","646",2023-09-28 16:00:00,-15985,1913,17898,907,FALSE,NA,"0.1.4"
"37698","646",2023-09-28 16:15:00,-16000,1913,17913,907,FALSE,NA,"0.1.4"
"37699","646",2023-09-28 16:30:00,-16274,1913,18187,907,FALSE,NA,"0.1.4"
"37700","646",2023-09-28 16:45:00,-16716,1913,18629,907,FALSE,NA,"0.1.4"
"37701","646",2023-09-28 17:00:00,-16719,1913,18632,907,FALSE,NA,"0.1.4"
"37702","646",2023-09-28 17:15:00,-16550,1913,18463,907,FALSE,NA,"0.1.4"
"37703","646",2023-09-28 17:30:00,-16349,1913,18262,907,FALSE,NA,"0.1.4"
"37704","646",2023-09-28 17:45:00,-16103,1913,18016,907,FALSE,NA,"0.1.4"
"37705","646",2023-09-28 18:00:00,-16193,1913,18106,907,FALSE,NA,"0.1.4"
"37706","646",2023-09-28 18:15:00,-16128,1913,18041,907,FALSE,NA,"0.1.4"
"37707","646",2023-09-28 18:30:00,-16177,1913,18090,907,FALSE,NA,"0.1.4"
"37708","646",2023-09-28 18:45:00,-16194,1913,18107,907,FALSE,NA,"0.1.4"
"37709","646",2023-09-28 19:00:00,-16161,1913,18074,907,FALSE,NA,"0.1.4"
"37710","646",2023-09-28 19:15:00,-16130,1913,18043,907,FALSE,NA,"0.1.4"
"37711","646",2023-09-28 19:30:00,-16103,1913,18016,907,FALSE,NA,"0.1.4"
"37712","646",2023-09-28 19:45:00,-16101,1913,18014,907,FALSE,NA,"0.1.4"
"37713","646",2023-09-28 20:00:00,-15985,1913,17898,907,FALSE,NA,"0.1.4"
"37714","646",2023-09-28 20:15:00,-15974,1913,17887,907,FALSE,NA,"0.1.4"
"37715","646",2023-09-28 20:30:00,-15965,1913,17878,907,FALSE,NA,"0.1.4"
"37716","646",2023-09-28 20:45:00,-15960,1913,17873,907,FALSE,NA,"0.1.4"
"37717","646",2023-09-28 21:00:00,-15953,1913,17866,907,FALSE,NA,"0.1.4"
"37718","646",2023-09-28 21:15:00,-16107,1913,18020,907,FALSE,NA,"0.1.4"
"37719","646",2023-09-28 21:30:00,-15954,1913,17867,907,FALSE,NA,"0.1.4"
"37720","646",2023-09-28 21:45:00,-16132,1913,18045,907,FALSE,NA,"0.1.4"
"37721","646",2023-09-28 22:00:00,-16137,1913,18050,907,FALSE,NA,"0.1.4"
"37722","646",2023-09-28 22:15:00,-15966,1913,17879,907,FALSE,NA,"0.1.4"
"37723","646",2023-09-28 22:30:00,-15957,1913,17870,907,FALSE,NA,"0.1.4"
"37724","646",2023-09-28 22:45:00,-15971,1913,17884,907,FALSE,NA,"0.1.4"
"37725","646",2023-09-28 23:00:00,-15972,1913,17885,907,FALSE,NA,"0.1.4"
"37726","646",2023-09-28 23:15:00,-15980,1913,17893,907,FALSE,NA,"0.1.4"
"37727","646",2023-09-28 23:30:00,-15984,1913,17897,907,FALSE,NA,"0.1.4"
"37728","646",2023-09-28 23:45:00,-15983,1913,17896,907,FALSE,NA,"0.1.4"
"37729","646",2023-09-29,-15982,1913,17895,907,FALSE,NA,"0.1.4"
"37730","646",2023-09-29 00:15:00,-15983,1913,17896,907,FALSE,NA,"0.1.4"
"37731","646",2023-09-29 00:30:00,-15982,1913,17895,907,FALSE,NA,"0.1.4"
"37732","646",2023-09-29 00:45:00,-15980,1913,17893,907,FALSE,NA,"0.1.4"
"37733","646",2023-09-29 01:00:00,-15984,1913,17897,907,FALSE,NA,"0.1.4"
"37734","646",2023-09-29 01:15:00,-15984,1913,17897,907,FALSE,NA,"0.1.4"
"37735","646",2023-09-29 01:30:00,-15952,1913,17865,907,FALSE,NA,"0.1.4"
"37736","646",2023-09-29 01:45:00,-15960,1913,17873,907,FALSE,NA,"0.1.4"
"37737","646",2023-09-29 02:00:00,-15955,1913,17868,907,FALSE,NA,"0.1.4"
"37738","646",2023-09-29 02:15:00,-15957,1913,17870,907,FALSE,NA,"0.1.4"
"37739","646",2023-09-29 02:30:00,-15960,1913,17873,907,FALSE,NA,"0.1.4"
"37740","646",2023-09-29 02:45:00,-15964,1913,17877,907,FALSE,NA,"0.1.4"
"37741","646",2023-09-29 03:00:00,-15961,1913,17874,907,FALSE,NA,"0.1.4"
"37742","646",2023-09-29 03:15:00,-15966,1913,17879,907,FALSE,NA,"0.1.4"
"37743","646",2023-09-29 03:30:00,-15975,1913,17888,907,FALSE,NA,"0.1.4"
"37744","646",2023-09-29 03:45:00,-16167,1913,18080,907,FALSE,NA,"0.1.4"
"37745","646",2023-09-29 04:00:00,-16050,1913,17963,907,FALSE,NA,"0.1.4"
"37746","646",2023-09-29 04:15:00,-16054,1913,17967,907,FALSE,NA,"0.1.4"
"37747","646",2023-09-29 04:30:00,-16185,1913,18098,907,FALSE,NA,"0.1.4"
"37748","646",2023-09-29 04:45:00,-16124,1913,18037,907,FALSE,NA,"0.1.4"
"37749","646",2023-09-29 05:00:00,-15973,1913,17886,907,FALSE,NA,"0.1.4"
"37750","646",2023-09-29 05:15:00,-16005,1913,17918,907,FALSE,NA,"0.1.4"
"37751","646",2023-09-29 05:30:00,-15981,1913,17894,907,FALSE,NA,"0.1.4"
"37752","646",2023-09-29 05:45:00,-15977,1913,17890,907,FALSE,NA,"0.1.4"
"37753","646",2023-09-29 06:00:00,-15971,1913,17884,907,FALSE,NA,"0.1.4"
"37754","646",2023-09-29 06:15:00,-15934,1913,17847,907,FALSE,NA,"0.1.4"
"37755","646",2023-09-29 06:30:00,-16188,1913,18101,907,FALSE,NA,"0.1.4"
"37756","646",2023-09-29 06:45:00,-16223,1913,18136,907,FALSE,NA,"0.1.4"
"37757","646",2023-09-29 07:00:00,-16230,1913,18143,907,FALSE,NA,"0.1.4"
"37758","646",2023-09-29 07:15:00,-16208,1913,18121,907,FALSE,NA,"0.1.4"
"37759","646",2023-09-29 07:30:00,-16223,1913,18136,907,FALSE,NA,"0.1.4"
"37760","646",2023-09-29 07:45:00,-16230,1913,18143,907,FALSE,NA,"0.1.4"
"37761","646",2023-09-29 08:00:00,-16224,1913,18137,907,FALSE,NA,"0.1.4"
"37762","646",2023-09-29 08:15:00,-16113,1913,18026,907,FALSE,NA,"0.1.4"
"37763","646",2023-09-29 08:30:00,-16097,1913,18010,907,FALSE,NA,"0.1.4"
"37764","646",2023-09-29 08:45:00,-16105,1913,18018,907,FALSE,NA,"0.1.4"
"37765","646",2023-09-29 09:00:00,-16223,1913,18136,907,FALSE,NA,"0.1.4"
"37766","646",2023-09-29 09:15:00,-16236,1913,18149,907,FALSE,NA,"0.1.4"
"37767","646",2023-09-29 09:30:00,-16224,1913,18137,907,FALSE,NA,"0.1.4"
"37768","646",2023-09-29 09:45:00,-16200,1913,18113,907,FALSE,NA,"0.1.4"
"37769","646",2023-09-29 10:00:00,-16183,1913,18096,907,FALSE,NA,"0.1.4"
"37770","646",2023-09-29 10:15:00,-16165,1913,18078,907,FALSE,NA,"0.1.4"
"37771","646",2023-09-29 10:30:00,-16178,1913,18091,907,FALSE,NA,"0.1.4"
"37772","646",2023-09-29 10:45:00,-15988,1913,17901,907,FALSE,NA,"0.1.4"
"37773","646",2023-09-29 11:00:00,-15987,1913,17900,907,FALSE,NA,"0.1.4"
"37774","646",2023-09-29 11:15:00,-15987,1913,17900,907,FALSE,NA,"0.1.4"
"37775","646",2023-09-29 11:30:00,-15986,1913,17899,907,FALSE,NA,"0.1.4"
"37776","646",2023-09-29 11:45:00,-15986,1913,17899,907,FALSE,NA,"0.1.4"
"37777","646",2023-09-29 12:00:00,-15988,1913,17901,907,FALSE,NA,"0.1.4"
"37778","646",2023-09-29 12:15:00,-16234,1913,18147,907,FALSE,NA,"0.1.4"
"37779","646",2023-09-29 12:30:00,-16229,1913,18142,907,FALSE,NA,"0.1.4"
"37780","646",2023-09-29 12:45:00,-16226,1913,18139,907,FALSE,NA,"0.1.4"
"37781","646",2023-09-29 13:00:00,-16223,1913,18136,907,FALSE,NA,"0.1.4"
"37782","646",2023-09-29 13:15:00,-16003,1913,17916,907,FALSE,NA,"0.1.4"
"37783","646",2023-09-29 13:30:00,-16004,1913,17917,907,FALSE,NA,"0.1.4"
"37784","646",2023-09-29 13:45:00,-16058,1913,17971,907,FALSE,NA,"0.1.4"
"37785","646",2023-09-29 14:00:00,-16044,1913,17957,907,FALSE,NA,"0.1.4"
"37786","646",2023-09-29 14:15:00,-16248,1913,18161,907,FALSE,NA,"0.1.4"
"37787","646",2023-09-29 14:30:00,-16209,1913,18122,907,FALSE,NA,"0.1.4"
"37788","646",2023-09-29 14:45:00,-16194,1913,18107,907,FALSE,NA,"0.1.4"
"37789","646",2023-09-29 15:00:00,-16179,1913,18092,907,FALSE,NA,"0.1.4"
"37790","646",2023-09-29 15:15:00,-15972,1913,17885,907,FALSE,NA,"0.1.4"
"37791","646",2023-09-29 15:30:00,-15970,1913,17883,907,FALSE,NA,"0.1.4"
"37792","646",2023-09-29 15:45:00,-16420,1913,18333,907,FALSE,NA,"0.1.4"
"37793","646",2023-09-29 16:00:00,-16520,1913,18433,907,FALSE,NA,"0.1.4"
"37794","646",2023-09-29 16:15:00,-16520,1913,18433,907,FALSE,"jump1","0.1.4"
"37795","646",2023-09-29 16:30:00,-16518,1913,18431,907,FALSE,NA,"0.1.4"
"37796","646",2023-09-29 16:45:00,-16588,1913,18501,907,FALSE,"out1, fill","0.1.4"
"37797","646",2023-09-29 17:00:00,-16658,1913,18571,907,FALSE,"out1, fill","0.1.4"
"37798","646",2023-09-29 17:15:00,-16728,1913,18641,907,FALSE,"out1, fill","0.1.4"
"37799","646",2023-09-29 17:30:00,-16798,1913,18711,907,FALSE,"out1, fill","0.1.4"
"37800","646",2023-09-29 17:45:00,-16868,1913,18781,907,FALSE,NA,"0.1.4"
"37801","646",2023-09-29 18:00:00,-16838,1913,18751,907,FALSE,NA,"0.1.4"
"37802","646",2023-09-29 18:15:00,-16616,1913,18529,907,FALSE,NA,"0.1.4"
"37803","646",2023-09-29 18:30:00,-16611,1913,18524,907,FALSE,NA,"0.1.4"
"37804","646",2023-09-29 18:45:00,-16611,1913,18524,907,FALSE,"out1, fill","0.1.4"
"37805","646",2023-09-29 19:00:00,-16611,1913,18524,907,FALSE,"jump1","0.1.4"
"37806","646",2023-09-29 19:15:00,-16603,1913,18516,907,FALSE,NA,"0.1.4"
"37807","646",2023-09-29 19:30:00,-16507,1913,18420,907,FALSE,NA,"0.1.4"
"37808","646",2023-09-29 19:45:00,-16483,1913,18396,907,FALSE,NA,"0.1.4"
"37809","646",2023-09-29 20:00:00,-16451,1913,18364,907,FALSE,NA,"0.1.4"
"37810","646",2023-09-29 20:15:00,-16448,1913,18361,907,FALSE,NA,"0.1.4"
"37811","646",2023-09-29 20:30:00,-16414,1913,18327,907,FALSE,NA,"0.1.4"
"37812","646",2023-09-29 20:45:00,-16523,1913,18436,907,FALSE,NA,"0.1.4"
"37813","646",2023-09-29 21:00:00,-16444,1913,18357,907,FALSE,NA,"0.1.4"
"37814","646",2023-09-29 21:15:00,-16363,1913,18276,907,FALSE,NA,"0.1.4"
"37815","646",2023-09-29 21:30:00,-16363,1913,18276,907,FALSE,NA,"0.1.4"
"37816","646",2023-09-29 21:45:00,-16235,1913,18148,907,FALSE,NA,"0.1.4"
"37817","646",2023-09-29 22:00:00,-16131,1913,18044,907,FALSE,NA,"0.1.4"
"37818","646",2023-09-29 22:15:00,-16146,1913,18059,907,FALSE,NA,"0.1.4"
"37819","646",2023-09-29 22:30:00,-16058,1913,17971,907,FALSE,NA,"0.1.4"
"37820","646",2023-09-29 22:45:00,-15998,1913,17911,907,FALSE,NA,"0.1.4"
"37821","646",2023-09-29 23:00:00,-15945,1913,17858,907,FALSE,NA,"0.1.4"
"37822","646",2023-09-29 23:15:00,-15878,1913,17791,907,FALSE,NA,"0.1.4"
"37823","646",2023-09-29 23:30:00,-15950,1913,17863,907,FALSE,NA,"0.1.4"
"37824","646",2023-09-29 23:45:00,-15923,1913,17836,907,FALSE,NA,"0.1.4"
"37825","646",2023-09-30,-15925,1913,17838,907,FALSE,NA,"0.1.4"
"37826","646",2023-09-30 00:15:00,-15899,1913,17812,907,FALSE,NA,"0.1.4"
"37827","646",2023-09-30 00:30:00,-15871,1913,17784,907,FALSE,NA,"0.1.4"
"37828","646",2023-09-30 00:45:00,-15948,1913,17861,907,FALSE,NA,"0.1.4"
"37829","646",2023-09-30 01:00:00,-15948,1913,17861,907,FALSE,"out1, fill","0.1.4"
"37830","646",2023-09-30 01:15:00,-15948,1913,17861,907,FALSE,"jump1","0.1.4"
"37831","646",2023-09-30 01:30:00,-15968,1913,17881,907,FALSE,NA,"0.1.4"
"37832","646",2023-09-30 01:45:00,-15942,1913,17855,907,FALSE,NA,"0.1.4"
"37833","646",2023-09-30 02:00:00,-15950,1913,17863,907,FALSE,NA,"0.1.4"
"37834","646",2023-09-30 02:15:00,-15943,1913,17856,907,FALSE,NA,"0.1.4"
"37835","646",2023-09-30 02:30:00,-15934,1913,17847,907,FALSE,NA,"0.1.4"
"37836","646",2023-09-30 02:45:00,-16062,1913,17975,907,FALSE,NA,"0.1.4"
"37837","646",2023-09-30 03:00:00,-16293,1913,18206,907,FALSE,NA,"0.1.4"
"37838","646",2023-09-30 03:15:00,-16048,1913,17961,907,FALSE,NA,"0.1.4"
"37839","646",2023-09-30 03:30:00,-15926,1913,17839,907,FALSE,NA,"0.1.4"
"37840","646",2023-09-30 03:45:00,-15926,1913,17839,907,FALSE,NA,"0.1.4"
"37841","646",2023-09-30 04:00:00,-15932,1913,17845,907,FALSE,NA,"0.1.4"
"37842","646",2023-09-30 04:15:00,-15921,1913,17834,907,FALSE,NA,"0.1.4"
"37843","646",2023-09-30 04:30:00,-15921,1913,17834,907,FALSE,NA,"0.1.4"
"37844","646",2023-09-30 04:45:00,-16002,1913,17915,907,FALSE,NA,"0.1.4"
"37845","646",2023-09-30 05:00:00,-15937,1913,17850,907,FALSE,NA,"0.1.4"
"37846","646",2023-09-30 05:15:00,-15928,1913,17841,907,FALSE,NA,"0.1.4"
"37847","646",2023-09-30 05:30:00,-15923,1913,17836,907,FALSE,NA,"0.1.4"
"37848","646",2023-09-30 05:45:00,-15922,1913,17835,907,FALSE,NA,"0.1.4"
"37849","646",2023-09-30 06:00:00,-15922,1913,17835,907,FALSE,NA,"0.1.4"
"37850","646",2023-09-30 06:15:00,-15985,1913,17898,907,FALSE,NA,"0.1.4"
"37851","646",2023-09-30 06:30:00,-15987,1913,17900,907,FALSE,NA,"0.1.4"
"37852","646",2023-09-30 06:45:00,-15934,1913,17847,907,FALSE,NA,"0.1.4"
"37853","646",2023-09-30 07:00:00,-15948,1913,17861,907,FALSE,NA,"0.1.4"
"37854","646",2023-09-30 07:15:00,-15933,1913,17846,907,FALSE,NA,"0.1.4"
"37855","646",2023-09-30 07:30:00,-15943,1913,17856,907,FALSE,NA,"0.1.4"
"37856","646",2023-09-30 07:45:00,-15982,1913,17895,907,FALSE,NA,"0.1.4"
"37857","646",2023-09-30 08:00:00,-16027,1913,17940,907,FALSE,"out1, fill","0.1.4"
"37858","646",2023-09-30 08:15:00,-16072,1913,17985,907,FALSE,"out1, fill","0.1.4"
"37859","646",2023-09-30 08:30:00,-16117,1913,18030,907,FALSE,"out1, fill","0.1.4"
"37860","646",2023-09-30 08:45:00,-16162,1913,18075,907,FALSE,"out1, fill","0.1.4"
"37861","646",2023-09-30 09:00:00,-16207,1913,18120,907,FALSE,"out1, fill","0.1.4"
"37862","646",2023-09-30 09:15:00,-16252,1913,18165,907,FALSE,"out1, fill","0.1.4"
"37863","646",2023-09-30 09:30:00,-16297,1913,18210,907,FALSE,"out1, fill","0.1.4"
"37864","646",2023-09-30 09:45:00,-16342,1913,18255,907,FALSE,"out1, fill","0.1.4"
"37865","646",2023-09-30 10:00:00,-16387,1913,18300,907,FALSE,"out1, fill","0.1.4"
"37866","646",2023-09-30 10:15:00,-16432,1913,18345,907,FALSE,"out1, fill","0.1.4"
"37867","646",2023-09-30 10:30:00,-16477,1913,18390,907,FALSE,NA,"0.1.4"
"37868","646",2023-09-30 10:45:00,-16274,1913,18187,907,FALSE,NA,"0.1.4"
"37869","646",2023-09-30 11:00:00,-16530,1913,18443,907,FALSE,NA,"0.1.4"
"37870","646",2023-09-30 11:15:00,-16813,1913,18726,907,FALSE,NA,"0.1.4"
"37871","646",2023-09-30 11:30:00,-16463,1913,18376,907,FALSE,NA,"0.1.4"
"37872","646",2023-09-30 11:45:00,-16463,1913,18376,907,FALSE,"jump1","0.1.4"
"37873","646",2023-09-30 12:00:00,-16453,1913,18366,907,FALSE,NA,"0.1.4"
"37874","646",2023-09-30 12:15:00,-16621.6666666667,1913,18534.6666666667,907,FALSE,"out1, fill","0.1.4"
"37875","646",2023-09-30 12:30:00,-16790.3333333333,1913,18703.3333333333,907,FALSE,"out1, fill","0.1.4"
"37876","646",2023-09-30 12:45:00,-16959,1913,18872,907,FALSE,"out1, fill","0.1.4"
"37877","646",2023-09-30 13:00:00,-17127.6666666667,1913,19040.6666666667,907,FALSE,"out1, fill","0.1.4"
"37878","646",2023-09-30 13:15:00,-17296.3333333333,1913,19209.3333333333,907,FALSE,"out1, fill","0.1.4"
"37879","646",2023-09-30 13:30:00,-17465,1913,19378,907,FALSE,"out1, fill","0.1.4"
"37880","646",2023-09-30 13:45:00,-17633.6666666667,1913,19546.6666666667,907,FALSE,"out1, fill","0.1.4"
"37881","646",2023-09-30 14:00:00,-17802.3333333333,1913,19715.3333333333,907,FALSE,"out1, fill","0.1.4"
"37882","646",2023-09-30 14:15:00,-17971,1913,19884,907,FALSE,"out1, fill","0.1.4"
"37883","646",2023-09-30 14:30:00,-18139.6666666667,1913,20052.6666666667,907,FALSE,"out1, fill","0.1.4"
"37884","646",2023-09-30 14:45:00,-18308.3333333333,1913,20221.3333333333,907,FALSE,"out1, fill","0.1.4"
"37885","646",2023-09-30 15:00:00,-18477,1913,20390,907,FALSE,NA,"0.1.4"
"37886","646",2023-09-30 15:15:00,-18370,1913,20283,907,FALSE,NA,"0.1.4"
"37887","646",2023-09-30 15:30:00,-18552,1913,20465,907,FALSE,NA,"0.1.4"
"37888","646",2023-09-30 15:45:00,-18552,1913,20465,907,FALSE,"out1, fill","0.1.4"
"37889","646",2023-09-30 16:00:00,-18552,1913,20465,907,FALSE,"jump1","0.1.4"
"37890","646",2023-09-30 16:15:00,-18989,1913,20902,907,FALSE,NA,"0.1.4"
"37891","646",2023-09-30 16:30:00,-19369,1913,21282,907,FALSE,NA,"0.1.4"
"37892","646",2023-09-30 16:45:00,-18983,1913,20896,907,FALSE,NA,"0.1.4"
"37893","646",2023-09-30 17:00:00,-18570,1913,20483,907,FALSE,NA,"0.1.4"
"37894","646",2023-09-30 17:15:00,-18750.7,1913,20663.7,907,FALSE,"out1, fill","0.1.4"
"37895","646",2023-09-30 17:30:00,-18931.4,1913,20844.4,907,FALSE,"out1, fill","0.1.4"
"37896","646",2023-09-30 17:45:00,-19112.1,1913,21025.1,907,FALSE,"out1, fill","0.1.4"
"37897","646",2023-09-30 18:00:00,-19292.8,1913,21205.8,907,FALSE,"out1, fill","0.1.4"
"37898","646",2023-09-30 18:15:00,-19473.5,1913,21386.5,907,FALSE,"out1, fill","0.1.4"
"37899","646",2023-09-30 18:30:00,-19654.2,1913,21567.2,907,FALSE,"out1, fill","0.1.4"
"37900","646",2023-09-30 18:45:00,-19834.9,1913,21747.9,907,FALSE,"out1, fill","0.1.4"
"37901","646",2023-09-30 19:00:00,-20015.6,1913,21928.6,907,FALSE,"out1, fill","0.1.4"
"37902","646",2023-09-30 19:15:00,-20196.3,1913,22109.3,907,FALSE,"out1, fill","0.1.4"
"37903","646",2023-09-30 19:30:00,-20377,1913,22290,907,FALSE,NA,"0.1.4"
"37904","646",2023-09-30 19:45:00,-20069,1913,21982,907,FALSE,NA,"0.1.4"
"37905","646",2023-09-30 20:00:00,-20201,1913,22114,907,FALSE,NA,"0.1.4"
"37906","646",2023-09-30 20:15:00,-20354,1913,22267,907,FALSE,NA,"0.1.4"
"37907","646",2023-09-30 20:30:00,-20236,1913,22149,907,FALSE,NA,"0.1.4"
"37908","646",2023-09-30 20:45:00,-20147,1913,22060,907,FALSE,NA,"0.1.4"
"37909","646",2023-09-30 21:00:00,-20263,1913,22176,907,FALSE,NA,"0.1.4"
"37910","646",2023-09-30 21:15:00,-20164,1913,22077,907,FALSE,NA,"0.1.4"
"37911","646",2023-09-30 21:30:00,-20076,1913,21989,907,FALSE,NA,"0.1.4"
"37912","646",2023-09-30 21:45:00,-20113,1913,22026,907,FALSE,NA,"0.1.4"
"37913","646",2023-09-30 22:00:00,-20066,1913,21979,907,FALSE,NA,"0.1.4"
"37914","646",2023-09-30 22:15:00,-20199,1913,22112,907,FALSE,NA,"0.1.4"
"37915","646",2023-09-30 22:30:00,-20129,1913,22042,907,FALSE,NA,"0.1.4"
"37916","646",2023-09-30 22:45:00,-20158,1913,22071,907,FALSE,NA,"0.1.4"
"37917","646",2023-09-30 23:00:00,-20077,1913,21990,907,FALSE,NA,"0.1.4"
"37918","646",2023-09-30 23:15:00,-20170,1913,22083,907,FALSE,NA,"0.1.4"
"37919","646",2023-09-30 23:30:00,-20082,1913,21995,907,FALSE,NA,"0.1.4"
"37920","646",2023-09-30 23:45:00,-20196,1913,22109,907,FALSE,NA,"0.1.4"
"37921","646",2023-10-01,-19996,1913,21909,907,FALSE,NA,"0.1.4"
"37922","646",2023-10-01 00:15:00,-20039,1913,21952,907,FALSE,NA,"0.1.4"
"37923","646",2023-10-01 00:30:00,-20017,1913,21930,907,FALSE,NA,"0.1.4"
"37924","646",2023-10-01 00:45:00,-20002,1913,21915,907,FALSE,NA,"0.1.4"
"37925","646",2023-10-01 01:00:00,-19952,1913,21865,907,FALSE,NA,"0.1.4"
"37926","646",2023-10-01 01:15:00,-19992,1913,21905,907,FALSE,NA,"0.1.4"
"37927","646",2023-10-01 01:30:00,-20127,1913,22040,907,FALSE,NA,"0.1.4"
"37928","646",2023-10-01 01:45:00,-20040,1913,21953,907,FALSE,NA,"0.1.4"
"37929","646",2023-10-01 02:00:00,-19705,1913,21618,907,FALSE,NA,"0.1.4"
"37930","646",2023-10-01 02:15:00,NA,NA,NA,NA,NA,"out1","0.1.4"
"37931","646",2023-10-01 02:30:00,NA,NA,NA,NA,NA,"out1","0.1.4"
"37932","646",2023-10-01 02:45:00,NA,NA,NA,NA,NA,"out1","0.1.4"
"37933","646",2023-10-01 03:00:00,NA,NA,NA,NA,NA,"out1","0.1.4"
"37934","646",2023-10-01 03:15:00,NA,NA,NA,NA,NA,"out1","0.1.4"
"37935","646",2023-10-01 03:30:00,NA,NA,NA,NA,NA,"out1","0.1.4"
"37936","646",2023-10-01 03:45:00,NA,NA,NA,NA,NA,"out1","0.1.4"
"37937","646",2023-10-01 04:00:00,NA,NA,NA,NA,NA,"out1","0.1.4"
"37938","646",2023-10-01 04:15:00,NA,NA,NA,NA,NA,"out1","0.1.4"
"37939","646",2023-10-01 04:30:00,NA,NA,NA,NA,NA,"out1","0.1.4"
"37940","646",2023-10-01 04:45:00,NA,NA,NA,NA,NA,"out1","0.1.4"
"37941","646",2023-10-01 05:00:00,NA,NA,NA,NA,NA,"out1","0.1.4"
"37942","646",2023-10-01 05:15:00,NA,NA,NA,NA,NA,"out1","0.1.4"
"37943","646",2023-10-01 05:30:00,NA,NA,NA,NA,NA,"out1","0.1.4"
"37944","646",2023-10-01 05:45:00,NA,NA,NA,NA,NA,"out1","0.1.4"
"37945","646",2023-10-01 06:00:00,NA,NA,NA,NA,NA,"out1","0.1.4"
"37946","646",2023-10-01 06:15:00,NA,NA,NA,NA,NA,"out1","0.1.4"
"37947","646",2023-10-01 06:30:00,NA,NA,NA,NA,NA,"out1","0.1.4"
"37948","646",2023-10-01 06:45:00,NA,NA,NA,NA,NA,"out1","0.1.4"
"37949","646",2023-10-01 07:00:00,NA,NA,NA,NA,NA,"out1","0.1.4"
"37950","646",2023-10-01 07:15:00,-18558,1913,20471,907,FALSE,NA,"0.1.4"
"37951","646",2023-10-01 07:30:00,-18558,1913,20471,907,FALSE,"jump1","0.1.4"
"37952","646",2023-10-01 07:45:00,-18913,1913,20826,907,FALSE,NA,"0.1.4"
"37953","646",2023-10-01 08:00:00,-18830,1913,20743,907,FALSE,NA,"0.1.4"
"37954","646",2023-10-01 08:15:00,-19182,1913,21095,907,FALSE,NA,"0.1.4"
"37955","646",2023-10-01 08:30:00,-19093.2857142857,1913,21006.2857142857,907,FALSE,"out1, fill","0.1.4"
"37956","646",2023-10-01 08:45:00,-19004.5714285714,1913,20917.5714285714,907,FALSE,"out1, fill","0.1.4"
"37957","646",2023-10-01 09:00:00,-18915.8571428571,1913,20828.8571428571,907,FALSE,"out1, fill","0.1.4"
"37958","646",2023-10-01 09:15:00,-18827.1428571429,1913,20740.1428571429,907,FALSE,"out1, fill","0.1.4"
"37959","646",2023-10-01 09:30:00,-18738.4285714286,1913,20651.4285714286,907,FALSE,"out1, fill","0.1.4"
"37960","646",2023-10-01 09:45:00,-18649.7142857143,1913,20562.7142857143,907,FALSE,"out1, fill","0.1.4"
"37961","646",2023-10-01 10:00:00,-18561,1913,20474,907,FALSE,NA,"0.1.4"
"37962","646",2023-10-01 10:15:00,-18750,1913,20663,907,FALSE,NA,"0.1.4"
"37963","646",2023-10-01 10:30:00,-19068,1913,20981,907,FALSE,NA,"0.1.4"
"37964","646",2023-10-01 10:45:00,-18906,1913,20819,907,FALSE,NA,"0.1.4"
"37965","646",2023-10-01 11:00:00,NA,NA,NA,NA,NA,"out1","0.1.4"
"37966","646",2023-10-01 11:15:00,NA,NA,NA,NA,NA,"out1","0.1.4"
"37967","646",2023-10-01 11:30:00,NA,NA,NA,NA,NA,"out1","0.1.4"
"37968","646",2023-10-01 11:45:00,NA,NA,NA,NA,NA,"out1","0.1.4"
"37969","646",2023-10-01 12:00:00,NA,NA,NA,NA,NA,"out1","0.1.4"
"37970","646",2023-10-01 12:15:00,NA,NA,NA,NA,NA,"out1","0.1.4"
"37971","646",2023-10-01 12:30:00,NA,NA,NA,NA,NA,"out1","0.1.4"
"37972","646",2023-10-01 12:45:00,NA,NA,NA,NA,NA,"out1","0.1.4"
"37973","646",2023-10-01 13:00:00,NA,NA,NA,NA,NA,"out1","0.1.4"
"37974","646",2023-10-01 13:15:00,NA,NA,NA,NA,NA,"out1","0.1.4"
"37975","646",2023-10-01 13:30:00,NA,NA,NA,NA,NA,"out1","0.1.4"
"37976","646",2023-10-01 13:45:00,NA,NA,NA,NA,NA,"out1","0.1.4"
"37977","646",2023-10-01 14:00:00,NA,NA,NA,NA,NA,"out1","0.1.4"
"37978","646",2023-10-01 14:15:00,NA,NA,NA,NA,NA,"out1","0.1.4"
"37979","646",2023-10-01 14:30:00,NA,NA,NA,NA,NA,"out1","0.1.4"
"37980","646",2023-10-01 14:45:00,NA,NA,NA,NA,NA,"out1","0.1.4"
"37981","646",2023-10-01 15:00:00,-18632,1913,20545,907,TRUE,NA,"0.1.4"
"37982","646",2023-10-01 15:15:00,-18499,1913,20412,907,TRUE,NA,"0.1.4"
"37983","646",2023-10-01 15:30:00,-18697,1913,20610,907,TRUE,NA,"0.1.4"
"37984","646",2023-10-01 15:45:00,-18837,1913,20750,907,TRUE,NA,"0.1.4"
"37985","646",2023-10-01 16:00:00,-18693,1913,20606,907,TRUE,NA,"0.1.4"
"37986","646",2023-10-01 16:15:00,-18554,1913,20467,907,TRUE,NA,"0.1.4"
"37987","646",2023-10-01 16:30:00,-18548,1913,20461,907,TRUE,NA,"0.1.4"
"37988","646",2023-10-01 16:45:00,-18632,1913,20545,907,TRUE,NA,"0.1.4"
"37989","646",2023-10-01 17:00:00,-18522,1913,20435,907,FALSE,NA,"0.1.4"
"37990","646",2023-10-01 17:15:00,-18399,1913,20312,907,FALSE,NA,"0.1.4"
"37991","646",2023-10-01 17:30:00,-18030,1913,19943,907,FALSE,NA,"0.1.4"
"37992","646",2023-10-01 17:45:00,-18316,1913,20229,907,FALSE,NA,"0.1.4"
"37993","646",2023-10-01 18:00:00,-18545,1913,20458,907,FALSE,NA,"0.1.4"
"37994","646",2023-10-01 18:15:00,-18735,1913,20648,907,FALSE,NA,"0.1.4"
"37995","646",2023-10-01 18:30:00,-18614,1913,20527,907,FALSE,NA,"0.1.4"
"37996","646",2023-10-01 18:45:00,-18614,1913,20527,907,FALSE,"jump1","0.1.4"
"37997","646",2023-10-01 19:00:00,-19023,1913,20936,907,FALSE,NA,"0.1.4"
"37998","646",2023-10-01 19:15:00,-19023,1913,20936,907,FALSE,"jump1","0.1.4"
"37999","646",2023-10-01 19:30:00,-19052,1913,20965,907,FALSE,NA,"0.1.4"
"38000","646",2023-10-01 19:45:00,-19100,1913,21013,907,FALSE,NA,"0.1.4"
"38001","646",2023-10-01 20:00:00,-19596,1913,21509,907,FALSE,NA,"0.1.4"
"38002","646",2023-10-01 20:15:00,-19464,1913,21377,907,FALSE,NA,"0.1.4"
"38003","646",2023-10-01 20:30:00,-19022,1913,20935,907,FALSE,NA,"0.1.4"
"38004","646",2023-10-01 20:45:00,-19020,1913,20933,907,FALSE,NA,"0.1.4"
"38005","646",2023-10-01 21:00:00,-19402,1913,21315,907,FALSE,NA,"0.1.4"
"38006","646",2023-10-01 21:15:00,-19422.2857142857,1913,21335.2857142857,907,FALSE,"out1, fill","0.1.4"
"38007","646",2023-10-01 21:30:00,-19442.5714285714,1913,21355.5714285714,907,FALSE,"out1, fill","0.1.4"
"38008","646",2023-10-01 21:45:00,-19462.8571428571,1913,21375.8571428571,907,FALSE,"out1, fill","0.1.4"
"38009","646",2023-10-01 22:00:00,-19483.1428571429,1913,21396.1428571429,907,FALSE,"out1, fill","0.1.4"
"38010","646",2023-10-01 22:15:00,-19503.4285714286,1913,21416.4285714286,907,FALSE,"out1, fill","0.1.4"
"38011","646",2023-10-01 22:30:00,-19523.7142857143,1913,21436.7142857143,907,FALSE,"out1, fill","0.1.4"
"38012","646",2023-10-01 22:45:00,-19544,1913,21457,907,FALSE,NA,"0.1.4"
"38013","646",2023-10-01 23:00:00,-19818,1913,21731,907,FALSE,NA,"0.1.4"
"38014","646",2023-10-01 23:15:00,-19818,1913,21731,907,FALSE,NA,"0.1.4"
"38015","646",2023-10-01 23:30:00,-19750,1913,21663,907,FALSE,NA,"0.1.4"
"38016","646",2023-10-01 23:45:00,-19284,1913,21197,907,FALSE,NA,"0.1.4"
"38017","646",2023-10-02,-19259,1913,21172,907,FALSE,NA,"0.1.4"
"38018","646",2023-10-02 00:15:00,-19314,1913,21227,907,FALSE,NA,"0.1.4"
"38019","646",2023-10-02 00:30:00,-19314,1913,21227,907,FALSE,"jump1","0.1.4"
"38020","646",2023-10-02 00:45:00,-18955,1913,20868,907,FALSE,NA,"0.1.4"
"38021","646",2023-10-02 01:00:00,-19414,1913,21327,907,FALSE,NA,"0.1.4"
"38022","646",2023-10-02 01:15:00,-19172,1913,21085,907,FALSE,NA,"0.1.4"
"38023","646",2023-10-02 01:30:00,-19070,1913,20983,907,FALSE,NA,"0.1.4"
"38024","646",2023-10-02 01:45:00,-19510,1913,21423,907,FALSE,NA,"0.1.4"
"38025","646",2023-10-02 02:00:00,-19704,1913,21617,907,FALSE,NA,"0.1.4"
"38026","646",2023-10-02 02:15:00,-19701.8888888889,1913,21614.8888888889,907,FALSE,"out1, fill","0.1.4"
"38027","646",2023-10-02 02:30:00,-19699.7777777778,1913,21612.7777777778,907,FALSE,"out1, fill","0.1.4"
"38028","646",2023-10-02 02:45:00,-19697.6666666667,1913,21610.6666666667,907,FALSE,"out1, fill","0.1.4"
"38029","646",2023-10-02 03:00:00,-19695.5555555556,1913,21608.5555555556,907,FALSE,"out1, fill","0.1.4"
"38030","646",2023-10-02 03:15:00,-19693.4444444444,1913,21606.4444444444,907,FALSE,"out1, fill","0.1.4"
"38031","646",2023-10-02 03:30:00,-19691.3333333333,1913,21604.3333333333,907,FALSE,"out1, fill","0.1.4"
"38032","646",2023-10-02 03:45:00,-19689.2222222222,1913,21602.2222222222,907,FALSE,"out1, fill","0.1.4"
"38033","646",2023-10-02 04:00:00,-19687.1111111111,1913,21600.1111111111,907,FALSE,"out1, fill","0.1.4"
"38034","646",2023-10-02 04:15:00,-19685,1913,21598,907,FALSE,NA,"0.1.4"
"38035","646",2023-10-02 04:30:00,-19562,1913,21475,907,FALSE,NA,"0.1.4"
"38036","646",2023-10-02 04:45:00,-19295,1913,21208,907,FALSE,NA,"0.1.4"
"38037","646",2023-10-02 05:00:00,-19519,1913,21432,907,FALSE,NA,"0.1.4"
"38038","646",2023-10-02 05:15:00,-19312,1913,21225,907,FALSE,NA,"0.1.4"
"38039","646",2023-10-02 05:30:00,-19531,1913,21444,907,FALSE,"out1, fill","0.1.4"
"38040","646",2023-10-02 05:45:00,-19750,1913,21663,907,FALSE,"out1, fill","0.1.4"
"38041","646",2023-10-02 06:00:00,-19969,1913,21882,907,FALSE,NA,"0.1.4"
"38042","646",2023-10-02 06:15:00,-20321,1913,22234,907,FALSE,NA,"0.1.4"
"38043","646",2023-10-02 06:30:00,-20321,1913,22234,907,FALSE,"jump1","0.1.4"
"38044","646",2023-10-02 06:45:00,-20389,1913,22302,907,FALSE,"out1, fill","0.1.4"
"38045","646",2023-10-02 07:00:00,-20457,1913,22370,907,FALSE,"out1, fill","0.1.4"
"38046","646",2023-10-02 07:15:00,-20525,1913,22438,907,FALSE,"out1, fill","0.1.4"
"38047","646",2023-10-02 07:30:00,-20593,1913,22506,907,FALSE,"out1, fill","0.1.4"
"38048","646",2023-10-02 07:45:00,-20661,1913,22574,907,FALSE,"out1, fill","0.1.4"
"38049","646",2023-10-02 08:00:00,-20729,1913,22642,907,FALSE,NA,"0.1.4"
"38050","646",2023-10-02 08:15:00,-20729,1913,22642,907,FALSE,"jump1","0.1.4"
"38051","646",2023-10-02 08:30:00,-20767,1913,22680,907,FALSE,NA,"0.1.4"
"38052","646",2023-10-02 08:45:00,-20902.5,1913,22815.5,907,FALSE,"out1, fill","0.1.4"
"38053","646",2023-10-02 09:00:00,-21038,1913,22951,907,FALSE,NA,"0.1.4"
"38054","646",2023-10-02 09:15:00,-21177,1913,23090,907,FALSE,NA,"0.1.4"
"38055","646",2023-10-02 09:30:00,-21644,1913,23557,907,FALSE,NA,"0.1.4"
"38056","646",2023-10-02 09:45:00,-21199.5,1913,23112.5,907,FALSE,"out1, fill","0.1.4"
"38057","646",2023-10-02 10:00:00,-20755,1913,22668,907,FALSE,NA,"0.1.4"
"38058","646",2023-10-02 10:15:00,-20717,1913,22630,907,FALSE,NA,"0.1.4"
"38059","646",2023-10-02 10:30:00,-20952,1913,22865,907,FALSE,NA,"0.1.4"
"38060","646",2023-10-02 10:45:00,-20952,1913,22865,907,FALSE,"jump1","0.1.4"
"38061","646",2023-10-02 11:00:00,-20644,1913,22557,907,FALSE,NA,"0.1.4"
"38062","646",2023-10-02 11:15:00,-20644,1913,22557,907,FALSE,"jump1","0.1.4"
"38063","646",2023-10-02 11:30:00,-20816,1913,22729,907,FALSE,NA,"0.1.4"
"38064","646",2023-10-02 11:45:00,-21088,1913,23001,907,FALSE,NA,"0.1.4"
"38065","646",2023-10-02 12:00:00,-21088,1913,23001,907,FALSE,"jump1","0.1.4"
"38066","646",2023-10-02 12:15:00,-21088,1913,23001,907,FALSE,"jump1","0.1.4"
"38067","646",2023-10-02 12:30:00,-20717,1913,22630,907,FALSE,NA,"0.1.4"
"38068","646",2023-10-02 12:45:00,-20856,1913,22769,907,FALSE,NA,"0.1.4"
"38069","646",2023-10-02 13:00:00,-20671,1913,22584,907,FALSE,NA,"0.1.4"
"38070","646",2023-10-02 13:15:00,-20883,1913,22796,907,FALSE,NA,"0.1.4"
"38071","646",2023-10-02 13:30:00,-20946,1913,22859,907,FALSE,NA,"0.1.4"
"38072","646",2023-10-02 13:45:00,-20942,1913,22855,907,FALSE,NA,"0.1.4"
"38073","646",2023-10-02 14:00:00,-20930,1913,22843,907,FALSE,NA,"0.1.4"
"38074","646",2023-10-02 14:15:00,-20923,1913,22836,907,FALSE,NA,"0.1.4"
"38075","646",2023-10-02 14:30:00,-20930,1913,22843,907,FALSE,NA,"0.1.4"
"38076","646",2023-10-02 14:45:00,-20912,1913,22825,907,FALSE,NA,"0.1.4"
"38077","646",2023-10-02 15:00:00,-20745,1913,22658,907,FALSE,NA,"0.1.4"
"38078","646",2023-10-02 15:15:00,-20616,1913,22529,907,FALSE,NA,"0.1.4"
"38079","646",2023-10-02 15:30:00,-20616,1913,22529,907,FALSE,"jump1","0.1.4"
"38080","646",2023-10-02 15:45:00,-20479,1913,22392,907,FALSE,NA,"0.1.4"
"38081","646",2023-10-02 16:00:00,-20479,1913,22392,907,FALSE,"jump1","0.1.4"
"38082","646",2023-10-02 16:15:00,-20479,1913,22392,907,FALSE,"jump1","0.1.4"
"38083","646",2023-10-02 16:30:00,-20470,1913,22383,907,FALSE,NA,"0.1.4"
"38084","646",2023-10-02 16:45:00,-20494,1913,22407,907,FALSE,NA,"0.1.4"
"38085","646",2023-10-02 17:00:00,-20521,1913,22434,907,FALSE,NA,"0.1.4"
"38086","646",2023-10-02 17:15:00,-20577,1913,22490,907,FALSE,NA,"0.1.4"
"38087","646",2023-10-02 17:30:00,-20550,1913,22463,907,FALSE,NA,"0.1.4"
"38088","646",2023-10-02 17:45:00,-20469,1913,22382,907,FALSE,NA,"0.1.4"
"38089","646",2023-10-02 18:00:00,-20473,1913,22386,907,FALSE,NA,"0.1.4"
"38090","646",2023-10-02 18:15:00,-20510,1913,22423,907,FALSE,NA,"0.1.4"
"38091","646",2023-10-02 18:30:00,-20523,1913,22436,907,FALSE,NA,"0.1.4"
"38092","646",2023-10-02 18:45:00,-20992,1913,22905,907,FALSE,NA,"0.1.4"
"38093","646",2023-10-02 19:00:00,-21305,1913,23218,907,FALSE,NA,"0.1.4"
"38094","646",2023-10-02 19:15:00,-21013,1913,22926,907,FALSE,NA,"0.1.4"
"38095","646",2023-10-02 19:30:00,-20776,1913,22689,907,FALSE,NA,"0.1.4"
"38096","646",2023-10-02 19:45:00,-20776,1913,22689,907,FALSE,"jump1","0.1.4"
"38097","646",2023-10-02 20:00:00,-20787,1913,22700,907,FALSE,NA,"0.1.4"
"38098","646",2023-10-02 20:15:00,-20715,1913,22628,907,FALSE,NA,"0.1.4"
"38099","646",2023-10-02 20:30:00,-20361,1913,22274,907,FALSE,NA,"0.1.4"
"38100","646",2023-10-02 20:45:00,-19935,1913,21848,907,FALSE,NA,"0.1.4"
"38101","646",2023-10-02 21:00:00,-19991,1913,21904,907,FALSE,NA,"0.1.4"
"38102","646",2023-10-02 21:15:00,-19947,1913,21860,907,FALSE,NA,"0.1.4"
"38103","646",2023-10-02 21:30:00,-19948,1913,21861,907,FALSE,NA,"0.1.4"
"38104","646",2023-10-02 21:45:00,-19949,1913,21862,907,FALSE,NA,"0.1.4"
"38105","646",2023-10-02 22:00:00,-19951,1913,21864,907,FALSE,NA,"0.1.4"
"38106","646",2023-10-02 22:15:00,-19935,1913,21848,907,FALSE,NA,"0.1.4"
"38107","646",2023-10-02 22:30:00,-19935,1913,21848,907,FALSE,NA,"0.1.4"
"38108","646",2023-10-02 22:45:00,-20044,1913,21957,907,FALSE,NA,"0.1.4"
"38109","646",2023-10-02 23:00:00,-20044,1913,21957,907,FALSE,"jump1","0.1.4"
"38110","646",2023-10-02 23:15:00,-19608,1913,21521,907,FALSE,NA,"0.1.4"
"38111","646",2023-10-02 23:30:00,-19857,1913,21770,907,FALSE,NA,"0.1.4"
"38112","646",2023-10-02 23:45:00,-19886,1913,21799,907,FALSE,NA,"0.1.4"
"38113","646",2023-10-03,-20002,1913,21915,907,FALSE,NA,"0.1.4"
"38114","646",2023-10-03 00:15:00,-20003,1913,21916,907,FALSE,NA,"0.1.4"
"38115","646",2023-10-03 00:30:00,-20124,1913,22037,907,FALSE,NA,"0.1.4"
"38116","646",2023-10-03 00:45:00,-19897,1913,21810,907,FALSE,NA,"0.1.4"
"38117","646",2023-10-03 01:00:00,-20007,1913,21920,907,FALSE,NA,"0.1.4"
"38118","646",2023-10-03 01:15:00,-20244,1913,22157,907,FALSE,NA,"0.1.4"
"38119","646",2023-10-03 01:30:00,-20222,1913,22135,907,FALSE,NA,"0.1.4"
"38120","646",2023-10-03 01:45:00,-20207,1913,22120,907,FALSE,NA,"0.1.4"
"38121","646",2023-10-03 02:00:00,-20395,1913,22308,907,FALSE,NA,"0.1.4"
"38122","646",2023-10-03 02:15:00,-20470,1913,22383,907,FALSE,NA,"0.1.4"
"38123","646",2023-10-03 02:30:00,-20626,1913,22539,907,FALSE,NA,"0.1.4"
"38124","646",2023-10-03 02:45:00,-20553,1913,22466,907,FALSE,NA,"0.1.4"
"38125","646",2023-10-03 03:00:00,-20377,1913,22290,907,FALSE,NA,"0.1.4"
"38126","646",2023-10-03 03:15:00,-20446,1913,22359,907,FALSE,NA,"0.1.4"
"38127","646",2023-10-03 03:30:00,-20459,1913,22372,907,FALSE,NA,"0.1.4"
"38128","646",2023-10-03 03:45:00,-20362,1913,22275,907,FALSE,NA,"0.1.4"
"38129","646",2023-10-03 04:00:00,-20728,1913,22641,907,FALSE,NA,"0.1.4"
"38130","646",2023-10-03 04:15:00,-20635,1913,22548,907,FALSE,NA,"0.1.4"
"38131","646",2023-10-03 04:30:00,-20677,1913,22590,907,FALSE,NA,"0.1.4"
"38132","646",2023-10-03 04:45:00,-20811,1913,22724,907,FALSE,NA,"0.1.4"
"38133","646",2023-10-03 05:00:00,-20796,1913,22709,907,FALSE,NA,"0.1.4"
"38134","646",2023-10-03 05:15:00,-20806,1913,22719,907,FALSE,NA,"0.1.4"
"38135","646",2023-10-03 05:30:00,-20766,1913,22679,907,FALSE,NA,"0.1.4"
"38136","646",2023-10-03 05:45:00,-20722,1913,22635,907,FALSE,NA,"0.1.4"
"38137","646",2023-10-03 06:00:00,-20780,1913,22693,907,FALSE,NA,"0.1.4"
"38138","646",2023-10-03 06:15:00,-20780,1913,22693,907,FALSE,"jump1","0.1.4"
"38139","646",2023-10-03 06:30:00,-20538,1913,22451,907,FALSE,NA,"0.1.4"
"38140","646",2023-10-03 06:45:00,-20459,1913,22372,907,FALSE,NA,"0.1.4"
"38141","646",2023-10-03 07:00:00,-20551,1913,22464,907,FALSE,NA,"0.1.4"
"38142","646",2023-10-03 07:15:00,-20577,1913,22490,907,FALSE,NA,"0.1.4"
"38143","646",2023-10-03 07:30:00,-20778,1913,22691,907,FALSE,NA,"0.1.4"
"38144","646",2023-10-03 07:45:00,-20739,1913,22652,907,FALSE,NA,"0.1.4"
"38145","646",2023-10-03 08:00:00,-20677,1913,22590,907,FALSE,NA,"0.1.4"
"38146","646",2023-10-03 08:15:00,-20654,1913,22567,907,FALSE,NA,"0.1.4"
"38147","646",2023-10-03 08:30:00,-20567,1913,22480,907,FALSE,NA,"0.1.4"
"38148","646",2023-10-03 08:45:00,-20373,1913,22286,907,FALSE,NA,"0.1.4"
"38149","646",2023-10-03 09:00:00,-20394,1913,22307,907,FALSE,NA,"0.1.4"
"38150","646",2023-10-03 09:15:00,-20385,1913,22298,907,FALSE,NA,"0.1.4"
"38151","646",2023-10-03 09:30:00,-20477,1913,22390,907,FALSE,NA,"0.1.4"
"38152","646",2023-10-03 09:45:00,-20616,1913,22529,907,FALSE,NA,"0.1.4"
"38153","646",2023-10-03 10:00:00,-20597,1913,22510,907,FALSE,NA,"0.1.4"
"38154","646",2023-10-03 10:15:00,-20570,1913,22483,907,FALSE,NA,"0.1.4"
"38155","646",2023-10-03 10:30:00,-20592,1913,22505,907,FALSE,NA,"0.1.4"
"38156","646",2023-10-03 10:45:00,-20608,1913,22521,907,FALSE,NA,"0.1.4"
"38157","646",2023-10-03 11:00:00,-20590,1913,22503,907,FALSE,NA,"0.1.4"
"38158","646",2023-10-03 11:15:00,-20601,1913,22514,907,FALSE,NA,"0.1.4"
"38159","646",2023-10-03 11:30:00,-20610,1913,22523,907,FALSE,NA,"0.1.4"
"38160","646",2023-10-03 11:45:00,-20621,1913,22534,907,FALSE,NA,"0.1.4"
"38161","646",2023-10-03 12:00:00,-20531,1913,22444,907,FALSE,NA,"0.1.4"
"38162","646",2023-10-03 12:15:00,-20524,1913,22437,907,FALSE,NA,"0.1.4"
"38163","646",2023-10-03 12:30:00,-20553,1913,22466,907,FALSE,NA,"0.1.4"
"38164","646",2023-10-03 12:45:00,-20571,1913,22484,907,FALSE,NA,"0.1.4"
"38165","646",2023-10-03 13:00:00,-20527,1913,22440,907,FALSE,NA,"0.1.4"
"38166","646",2023-10-03 13:15:00,-20557,1913,22470,907,FALSE,NA,"0.1.4"
"38167","646",2023-10-03 13:30:00,-20537,1913,22450,907,FALSE,NA,"0.1.4"
"38168","646",2023-10-03 13:45:00,-20541,1913,22454,907,FALSE,NA,"0.1.4"
"38169","646",2023-10-03 14:00:00,-20592,1913,22505,907,FALSE,NA,"0.1.4"
"38170","646",2023-10-03 14:15:00,-20502,1913,22415,907,FALSE,NA,"0.1.4"
"38171","646",2023-10-03 14:30:00,-20440,1913,22353,907,FALSE,NA,"0.1.4"
"38172","646",2023-10-03 14:45:00,-20463,1913,22376,907,FALSE,NA,"0.1.4"
"38173","646",2023-10-03 15:00:00,-20520,1913,22433,907,FALSE,NA,"0.1.4"
"38174","646",2023-10-03 15:15:00,-20495,1913,22408,907,FALSE,NA,"0.1.4"
"38175","646",2023-10-03 15:30:00,-20495,1913,22408,907,FALSE,NA,"0.1.4"
"38176","646",2023-10-03 15:45:00,-20436,1913,22349,907,FALSE,NA,"0.1.4"
"38177","646",2023-10-03 16:00:00,-20457,1913,22370,907,FALSE,NA,"0.1.4"
"38178","646",2023-10-03 16:15:00,-20491,1913,22404,907,FALSE,NA,"0.1.4"
"38179","646",2023-10-03 16:30:00,-20440,1913,22353,907,FALSE,NA,"0.1.4"
"38180","646",2023-10-03 16:45:00,-20551,1913,22464,907,FALSE,NA,"0.1.4"
"38181","646",2023-10-03 17:00:00,-20567,1913,22480,907,FALSE,NA,"0.1.4"
"38182","646",2023-10-03 17:15:00,-20861,1913,22774,907,FALSE,NA,"0.1.4"
"38183","646",2023-10-03 17:30:00,-20962,1913,22875,907,FALSE,NA,"0.1.4"
"38184","646",2023-10-03 17:45:00,-20629,1913,22542,907,FALSE,NA,"0.1.4"
"38185","646",2023-10-03 18:00:00,-20590,1913,22503,907,FALSE,NA,"0.1.4"
"38186","646",2023-10-03 18:15:00,-20605,1913,22518,907,FALSE,NA,"0.1.4"
"38187","646",2023-10-03 18:30:00,-20648,1913,22561,907,FALSE,NA,"0.1.4"
"38188","646",2023-10-03 18:45:00,-20619,1913,22532,907,FALSE,NA,"0.1.4"
"38189","646",2023-10-03 19:00:00,-20577,1913,22490,907,FALSE,NA,"0.1.4"
"38190","646",2023-10-03 19:15:00,-20594,1913,22507,907,FALSE,NA,"0.1.4"
"38191","646",2023-10-03 19:30:00,-20584,1913,22497,907,FALSE,NA,"0.1.4"
"38192","646",2023-10-03 19:45:00,-20612,1913,22525,907,FALSE,NA,"0.1.4"
"38193","646",2023-10-03 20:00:00,-20620,1913,22533,907,FALSE,NA,"0.1.4"
"38194","646",2023-10-03 20:15:00,-20500,1913,22413,907,FALSE,NA,"0.1.4"
"38195","646",2023-10-03 20:30:00,-20588,1913,22501,907,FALSE,NA,"0.1.4"
"38196","646",2023-10-03 20:45:00,-20619,1913,22532,907,FALSE,NA,"0.1.4"
"38197","646",2023-10-03 21:00:00,-20469,1913,22382,907,FALSE,NA,"0.1.4"
"38198","646",2023-10-03 21:15:00,-20585,1913,22498,907,FALSE,NA,"0.1.4"
"38199","646",2023-10-03 21:30:00,-20702,1913,22615,907,FALSE,NA,"0.1.4"
"38200","646",2023-10-03 21:45:00,-20488,1913,22401,907,FALSE,NA,"0.1.4"
"38201","646",2023-10-03 22:00:00,-20557,1913,22470,907,FALSE,NA,"0.1.4"
"38202","646",2023-10-03 22:15:00,-20645,1913,22558,907,FALSE,NA,"0.1.4"
"38203","646",2023-10-03 22:30:00,-20645,1913,22558,907,FALSE,"jump1","0.1.4"
"38204","646",2023-10-03 22:45:00,-20655,1913,22568,907,FALSE,NA,"0.1.4"
"38205","646",2023-10-03 23:00:00,-20654,1913,22567,907,FALSE,NA,"0.1.4"
"38206","646",2023-10-03 23:15:00,-20651,1913,22564,907,FALSE,NA,"0.1.4"
"38207","646",2023-10-03 23:30:00,-20653,1913,22566,907,FALSE,NA,"0.1.4"
"38208","646",2023-10-03 23:45:00,-20649,1913,22562,907,FALSE,NA,"0.1.4"
"38209","646",2023-10-04,-20639,1913,22552,907,FALSE,NA,"0.1.4"
"38210","646",2023-10-04 00:15:00,-20637,1913,22550,907,FALSE,NA,"0.1.4"
"38211","646",2023-10-04 00:30:00,-20637,1913,22550,907,FALSE,NA,"0.1.4"
"38212","646",2023-10-04 00:45:00,-20637,1913,22550,907,FALSE,NA,"0.1.4"
"38213","646",2023-10-04 01:00:00,-20645,1913,22558,907,FALSE,NA,"0.1.4"
"38214","646",2023-10-04 01:15:00,-20645,1913,22558,907,FALSE,NA,"0.1.4"
"38215","646",2023-10-04 01:30:00,-20814,1913,22727,907,FALSE,NA,"0.1.4"
"38216","646",2023-10-04 01:45:00,-20742,1913,22655,907,FALSE,NA,"0.1.4"
"38217","646",2023-10-04 02:00:00,-20692,1913,22605,907,FALSE,NA,"0.1.4"
"38218","646",2023-10-04 02:15:00,-20650,1913,22563,907,FALSE,NA,"0.1.4"
"38219","646",2023-10-04 02:30:00,-20635,1913,22548,907,FALSE,NA,"0.1.4"
"38220","646",2023-10-04 02:45:00,-20637,1913,22550,907,FALSE,NA,"0.1.4"
"38221","646",2023-10-04 03:00:00,-20724,1913,22637,907,FALSE,"out1, fill","0.1.4"
"38222","646",2023-10-04 03:15:00,-20811,1913,22724,907,FALSE,"out1, fill","0.1.4"
"38223","646",2023-10-04 03:30:00,-20898,1913,22811,907,FALSE,"out1, fill","0.1.4"
"38224","646",2023-10-04 03:45:00,-20985,1913,22898,907,FALSE,"out1, fill","0.1.4"
"38225","646",2023-10-04 04:00:00,-21072,1913,22985,907,FALSE,NA,"0.1.4"
"38226","646",2023-10-04 04:15:00,-20646,1913,22559,907,FALSE,NA,"0.1.4"
"38227","646",2023-10-04 04:30:00,-20724,1913,22637,907,FALSE,NA,"0.1.4"
"38228","646",2023-10-04 04:45:00,-20642,1913,22555,907,FALSE,NA,"0.1.4"
"38229","646",2023-10-04 05:00:00,-20673,1913,22586,907,FALSE,NA,"0.1.4"
"38230","646",2023-10-04 05:15:00,-20645,1913,22558,907,FALSE,NA,"0.1.4"
"38231","646",2023-10-04 05:30:00,-20645,1913,22558,907,FALSE,NA,"0.1.4"
"38232","646",2023-10-04 05:45:00,-20877,1913,22790,907,FALSE,"out1, fill","0.1.4"
"38233","646",2023-10-04 06:00:00,-21109,1913,23022,907,FALSE,NA,"0.1.4"
"38234","646",2023-10-04 06:15:00,-21109,1913,23022,907,FALSE,"jump1","0.1.4"
"38235","646",2023-10-04 06:30:00,-20759,1913,22672,907,FALSE,NA,"0.1.4"
"38236","646",2023-10-04 06:45:00,-20751.6,1913,22664.6,907,FALSE,"out1, fill","0.1.4"
"38237","646",2023-10-04 07:00:00,-20744.2,1913,22657.2,907,FALSE,"out1, fill","0.1.4"
"38238","646",2023-10-04 07:15:00,-20736.8,1913,22649.8,907,FALSE,"out1, fill","0.1.4"
"38239","646",2023-10-04 07:30:00,-20729.4,1913,22642.4,907,FALSE,"out1, fill","0.1.4"
"38240","646",2023-10-04 07:45:00,-20722,1913,22635,907,FALSE,NA,"0.1.4"
"38241","646",2023-10-04 08:00:00,-20970,1913,22883,907,FALSE,NA,"0.1.4"
"38242","646",2023-10-04 08:15:00,-20909,1913,22822,907,FALSE,NA,"0.1.4"
"38243","646",2023-10-04 08:30:00,-20987,1913,22900,907,FALSE,NA,"0.1.4"
"38244","646",2023-10-04 08:45:00,-20924,1913,22837,907,FALSE,NA,"0.1.4"
"38245","646",2023-10-04 09:00:00,-20607,1913,22520,907,FALSE,NA,"0.1.4"
"38246","646",2023-10-04 09:15:00,-20539,1913,22452,907,FALSE,NA,"0.1.4"
"38247","646",2023-10-04 09:30:00,-20702,1913,22615,907,FALSE,NA,"0.1.4"
"38248","646",2023-10-04 09:45:00,-20841,1913,22754,907,FALSE,NA,"0.1.4"
"38249","646",2023-10-04 10:00:00,-20501,1913,22414,907,FALSE,NA,"0.1.4"
"38250","646",2023-10-04 10:15:00,-20469,1913,22382,907,FALSE,NA,"0.1.4"
"38251","646",2023-10-04 10:30:00,-20565,1913,22478,907,FALSE,NA,"0.1.4"
"38252","646",2023-10-04 10:45:00,-20457,1913,22370,907,FALSE,NA,"0.1.4"
"38253","646",2023-10-04 11:00:00,-20468,1913,22381,907,FALSE,NA,"0.1.4"
"38254","646",2023-10-04 11:15:00,-20402,1913,22315,907,FALSE,NA,"0.1.4"
"38255","646",2023-10-04 11:30:00,-20562,1913,22475,907,FALSE,NA,"0.1.4"
"38256","646",2023-10-04 11:45:00,-20381,1913,22294,907,FALSE,NA,"0.1.4"
"38257","646",2023-10-04 12:00:00,-20382,1913,22295,907,FALSE,NA,"0.1.4"
"38258","646",2023-10-04 12:15:00,-20442,1913,22355,907,FALSE,NA,"0.1.4"
"38259","646",2023-10-04 12:30:00,-20671,1913,22584,907,FALSE,NA,"0.1.4"
"38260","646",2023-10-04 12:45:00,-20700,1913,22613,907,FALSE,NA,"0.1.4"
"38261","646",2023-10-04 13:00:00,-20626,1913,22539,907,FALSE,NA,"0.1.4"
"38262","646",2023-10-04 13:15:00,-20616,1913,22529,907,FALSE,NA,"0.1.4"
"38263","646",2023-10-04 13:30:00,-20459,1913,22372,907,FALSE,NA,"0.1.4"
"38264","646",2023-10-04 13:45:00,-20596,1913,22509,907,FALSE,NA,"0.1.4"
"38265","646",2023-10-04 14:00:00,-20356,1913,22269,907,FALSE,NA,"0.1.4"
"38266","646",2023-10-04 14:15:00,-20470,1913,22383,907,FALSE,NA,"0.1.4"
"38267","646",2023-10-04 14:30:00,-20419,1913,22332,907,FALSE,NA,"0.1.4"
"38268","646",2023-10-04 14:45:00,-20669,1913,22582,907,FALSE,NA,"0.1.4"
"38269","646",2023-10-04 15:00:00,-20799,1913,22712,907,FALSE,NA,"0.1.4"
"38270","646",2023-10-04 15:15:00,-20798,1913,22711,907,FALSE,NA,"0.1.4"
"38271","646",2023-10-04 15:30:00,-20757,1913,22670,907,FALSE,NA,"0.1.4"
"38272","646",2023-10-04 15:45:00,-20761,1913,22674,907,FALSE,NA,"0.1.4"
"38273","646",2023-10-04 16:00:00,-20761,1913,22674,907,FALSE,"jump1","0.1.4"
"38274","646",2023-10-04 16:15:00,-20572,1913,22485,907,FALSE,NA,"0.1.4"
"38275","646",2023-10-04 16:30:00,-20587,1913,22500,907,FALSE,NA,"0.1.4"
"38276","646",2023-10-04 16:45:00,-20587,1913,22500,907,FALSE,"jump1","0.1.4"
"38277","646",2023-10-04 17:00:00,-20587,1913,22500,907,FALSE,"jump1","0.1.4"
"38278","646",2023-10-04 17:15:00,-20589,1913,22502,907,FALSE,NA,"0.1.4"
"38279","646",2023-10-04 17:30:00,-20588,1913,22501,907,FALSE,NA,"0.1.4"
"38280","646",2023-10-04 17:45:00,-20588,1913,22501,907,FALSE,NA,"0.1.4"
"38281","646",2023-10-04 18:00:00,-20925,1913,22838,907,FALSE,NA,"0.1.4"
"38282","646",2023-10-04 18:15:00,-20587,1913,22500,907,FALSE,NA,"0.1.4"
"38283","646",2023-10-04 18:30:00,-20819.5,1913,22732.5,907,FALSE,"out1, fill","0.1.4"
"38284","646",2023-10-04 18:45:00,-21052,1913,22965,907,FALSE,NA,"0.1.4"
"38285","646",2023-10-04 19:00:00,-21434,1913,23347,907,FALSE,NA,"0.1.4"
"38286","646",2023-10-04 19:15:00,-21434,1913,23347,907,FALSE,"jump1","0.1.4"
"38287","646",2023-10-04 19:30:00,-21328,1913,23241,907,FALSE,NA,"0.1.4"
"38288","646",2023-10-04 19:45:00,-21328,1913,23241,907,FALSE,"jump1","0.1.4"
"38289","646",2023-10-04 20:00:00,-21257,1913,23170,907,FALSE,NA,"0.1.4"
"38290","646",2023-10-04 20:15:00,-21257,1913,23170,907,FALSE,"jump1","0.1.4"
"38291","646",2023-10-04 20:30:00,-21289,1913,23202,907,FALSE,NA,"0.1.4"
"38292","646",2023-10-04 20:45:00,-21565,1913,23478,907,FALSE,NA,"0.1.4"
"38293","646",2023-10-04 21:00:00,-21777,1913,23690,907,FALSE,NA,"0.1.4"
"38294","646",2023-10-04 21:15:00,-21777,1913,23690,907,FALSE,"jump1","0.1.4"
"38295","646",2023-10-04 21:30:00,-21753,1913,23666,907,FALSE,NA,"0.1.4"
"38296","646",2023-10-04 21:45:00,-22239,1913,24152,907,FALSE,NA,"0.1.4"
"38297","646",2023-10-04 22:00:00,-21833,1913,23746,907,FALSE,NA,"0.1.4"
"38298","646",2023-10-04 22:15:00,-21804,1913,23717,907,FALSE,NA,"0.1.4"
"38299","646",2023-10-04 22:30:00,-22093,1913,24006,907,FALSE,NA,"0.1.4"
"38300","646",2023-10-04 22:45:00,-21753,1913,23666,907,FALSE,NA,"0.1.4"
"38301","646",2023-10-04 23:00:00,-21752,1913,23665,907,FALSE,NA,"0.1.4"
"38302","646",2023-10-04 23:15:00,-21752,1913,23665,907,FALSE,NA,"0.1.4"
"38303","646",2023-10-04 23:30:00,-21752,1913,23665,907,FALSE,NA,"0.1.4"
"38304","646",2023-10-04 23:45:00,-21752,1913,23665,907,FALSE,"jump1","0.1.4"
"38305","646",2023-10-05,-22091,1913,24004,907,FALSE,NA,"0.1.4"
"38306","646",2023-10-05 00:15:00,-22083,1913,23996,907,FALSE,NA,"0.1.4"
"38307","646",2023-10-05 00:30:00,-21697,1913,23610,907,FALSE,NA,"0.1.4"
"38308","646",2023-10-05 00:45:00,-22031,1913,23944,907,FALSE,NA,"0.1.4"
"38309","646",2023-10-05 01:00:00,-21554,1913,23467,907,FALSE,NA,"0.1.4"
"38310","646",2023-10-05 01:15:00,-21909,1913,23822,907,FALSE,NA,"0.1.4"
"38311","646",2023-10-05 01:30:00,-21942,1913,23855,907,FALSE,NA,"0.1.4"
"38312","646",2023-10-05 01:45:00,-21595.5,1913,23508.5,907,FALSE,"out1, fill","0.1.4"
"38313","646",2023-10-05 02:00:00,-21249,1913,23162,907,FALSE,NA,"0.1.4"
"38314","646",2023-10-05 02:15:00,-21249,1913,23162,907,FALSE,"jump1","0.1.4"
"38315","646",2023-10-05 02:30:00,-20940,1913,22853,907,FALSE,NA,"0.1.4"
"38316","646",2023-10-05 02:45:00,-20545,1913,22458,907,FALSE,NA,"0.1.4"
"38317","646",2023-10-05 03:00:00,-20698,1913,22611,907,FALSE,NA,"0.1.4"
"38318","646",2023-10-05 03:15:00,-20596,1913,22509,907,FALSE,NA,"0.1.4"
"38319","646",2023-10-05 03:30:00,-20548,1913,22461,907,FALSE,NA,"0.1.4"
"38320","646",2023-10-05 03:45:00,-20730,1913,22643,907,FALSE,NA,"0.1.4"
"38321","646",2023-10-05 04:00:00,-20586,1913,22499,907,FALSE,NA,"0.1.4"
"38322","646",2023-10-05 04:15:00,-20735,1913,22648,907,FALSE,NA,"0.1.4"
"38323","646",2023-10-05 04:30:00,-20735,1913,22648,907,FALSE,"jump1","0.1.4"
"38324","646",2023-10-05 04:45:00,-20785,1913,22698,907,FALSE,NA,"0.1.4"
"38325","646",2023-10-05 05:00:00,-20705,1913,22618,907,FALSE,NA,"0.1.4"
"38326","646",2023-10-05 05:15:00,-20705.8333333333,1913,22618.8333333333,907,FALSE,"out1, fill","0.1.4"
"38327","646",2023-10-05 05:30:00,-20706.6666666667,1913,22619.6666666667,907,FALSE,"out1, fill","0.1.4"
"38328","646",2023-10-05 05:45:00,-20707.5,1913,22620.5,907,FALSE,"out1, fill","0.1.4"
"38329","646",2023-10-05 06:00:00,-20708.3333333333,1913,22621.3333333333,907,FALSE,"out1, fill","0.1.4"
"38330","646",2023-10-05 06:15:00,-20709.1666666667,1913,22622.1666666667,907,FALSE,"out1, fill","0.1.4"
"38331","646",2023-10-05 06:30:00,-20710,1913,22623,907,FALSE,NA,"0.1.4"
"38332","646",2023-10-05 06:45:00,-20932,1913,22845,907,FALSE,NA,"0.1.4"
"38333","646",2023-10-05 07:00:00,-21005,1913,22918,907,FALSE,NA,"0.1.4"
"38334","646",2023-10-05 07:15:00,-21075,1913,22988,907,FALSE,NA,"0.1.4"
"38335","646",2023-10-05 07:30:00,-20944,1913,22857,907,FALSE,NA,"0.1.4"
"38336","646",2023-10-05 07:45:00,-20928,1913,22841,907,FALSE,NA,"0.1.4"
"38337","646",2023-10-05 08:00:00,-21044,1913,22957,907,FALSE,NA,"0.1.4"
"38338","646",2023-10-05 08:15:00,-20951,1913,22864,907,FALSE,NA,"0.1.4"
"38339","646",2023-10-05 08:30:00,-20970,1913,22883,907,FALSE,NA,"0.1.4"
"38340","646",2023-10-05 08:45:00,-21143,1913,23056,907,FALSE,NA,"0.1.4"
"38341","646",2023-10-05 09:00:00,-20693,1913,22606,907,FALSE,NA,"0.1.4"
"38342","646",2023-10-05 09:15:00,-20813,1913,22726,907,FALSE,NA,"0.1.4"
"38343","646",2023-10-05 09:30:00,-20517,1913,22430,907,FALSE,NA,"0.1.4"
"38344","646",2023-10-05 09:45:00,-20815,1913,22728,907,FALSE,NA,"0.1.4"
"38345","646",2023-10-05 10:00:00,-20926,1913,22839,907,FALSE,NA,"0.1.4"
"38346","646",2023-10-05 10:15:00,-20870,1913,22783,907,FALSE,NA,"0.1.4"
"38347","646",2023-10-05 10:30:00,-20817.3333333333,1913,22730.3333333333,907,FALSE,"out1, fill","0.1.4"
"38348","646",2023-10-05 10:45:00,-20764.6666666667,1913,22677.6666666667,907,FALSE,"out1, fill","0.1.4"
"38349","646",2023-10-05 11:00:00,-20712,1913,22625,907,FALSE,"out1, fill","0.1.4"
"38350","646",2023-10-05 11:15:00,-20659.3333333333,1913,22572.3333333333,907,FALSE,"out1, fill","0.1.4"
"38351","646",2023-10-05 11:30:00,-20606.6666666667,1913,22519.6666666667,907,FALSE,"out1, fill","0.1.4"
"38352","646",2023-10-05 11:45:00,-20554,1913,22467,907,FALSE,NA,"0.1.4"
"38353","646",2023-10-05 12:00:00,-20554,1913,22467,907,FALSE,"jump1","0.1.4"
"38354","646",2023-10-05 12:15:00,-21037,1913,22950,907,FALSE,NA,"0.1.4"
"38355","646",2023-10-05 12:30:00,-21339,1913,23252,907,FALSE,NA,"0.1.4"
"38356","646",2023-10-05 12:45:00,-21383,1913,23296,907,FALSE,NA,"0.1.4"
"38357","646",2023-10-05 13:00:00,-21311,1913,23224,907,FALSE,NA,"0.1.4"
"38358","646",2023-10-05 13:15:00,-21302,1913,23215,907,FALSE,NA,"0.1.4"
"38359","646",2023-10-05 13:30:00,-21224.7777777778,1913,23137.7777777778,907,FALSE,"out1, fill","0.1.4"
"38360","646",2023-10-05 13:45:00,-21147.5555555556,1913,23060.5555555556,907,FALSE,"out1, fill","0.1.4"
"38361","646",2023-10-05 14:00:00,-21070.3333333333,1913,22983.3333333333,907,FALSE,"out1, fill","0.1.4"
"38362","646",2023-10-05 14:15:00,-20993.1111111111,1913,22906.1111111111,907,FALSE,"out1, fill","0.1.4"
"38363","646",2023-10-05 14:30:00,-20915.8888888889,1913,22828.8888888889,907,FALSE,"out1, fill","0.1.4"
"38364","646",2023-10-05 14:45:00,-20838.6666666667,1913,22751.6666666667,907,FALSE,"out1, fill","0.1.4"
"38365","646",2023-10-05 15:00:00,-20761.4444444444,1913,22674.4444444444,907,FALSE,"out1, fill","0.1.4"
"38366","646",2023-10-05 15:15:00,-20684.2222222222,1913,22597.2222222222,907,FALSE,"out1, fill","0.1.4"
"38367","646",2023-10-05 15:30:00,-20607,1913,22520,907,FALSE,NA,"0.1.4"
"38368","646",2023-10-05 15:45:00,-20632,1913,22545,907,FALSE,NA,"0.1.4"
"38369","646",2023-10-05 16:00:00,-20617,1913,22530,907,FALSE,NA,"0.1.4"
"38370","646",2023-10-05 16:15:00,-20625,1913,22538,907,FALSE,NA,"0.1.4"
"38371","646",2023-10-05 16:30:00,-20625,1913,22538,907,FALSE,"jump1","0.1.4"
"38372","646",2023-10-05 16:45:00,-20235.5,1913,22148.5,907,FALSE,"out1, fill","0.1.4"
"38373","646",2023-10-05 17:00:00,-19846,1913,21759,907,FALSE,NA,"0.1.4"
"38374","646",2023-10-05 17:15:00,-19835,1913,21748,907,FALSE,NA,"0.1.4"
"38375","646",2023-10-05 17:30:00,-19835,1913,21748,907,FALSE,"jump1","0.1.4"
"38376","646",2023-10-05 17:45:00,-19675,1913,21588,907,FALSE,NA,"0.1.4"
"38377","646",2023-10-05 18:00:00,-19206,1913,21119,907,FALSE,NA,"0.1.4"
"38378","646",2023-10-05 18:15:00,-19206,1913,21119,907,FALSE,"jump1","0.1.4"
"38379","646",2023-10-05 18:30:00,-19206,1913,21119,907,FALSE,"jump1","0.1.4"
"38380","646",2023-10-05 18:45:00,-19205,1913,21118,907,FALSE,NA,"0.1.4"
"38381","646",2023-10-05 19:00:00,-19335,1913,21248,907,FALSE,NA,"0.1.4"
"38382","646",2023-10-05 19:15:00,-19706,1913,21619,907,FALSE,NA,"0.1.4"
"38383","646",2023-10-05 19:30:00,-19919,1913,21832,907,FALSE,NA,"0.1.4"
"38384","646",2023-10-05 19:45:00,-19919,1913,21832,907,FALSE,"jump1","0.1.4"
"38385","646",2023-10-05 20:00:00,-20293,1913,22206,907,FALSE,NA,"0.1.4"
"38386","646",2023-10-05 20:15:00,-19825,1913,21738,907,FALSE,NA,"0.1.4"
"38387","646",2023-10-05 20:30:00,-19966,1913,21879,907,FALSE,NA,"0.1.4"
"38388","646",2023-10-05 20:45:00,-20417,1913,22330,907,FALSE,NA,"0.1.4"
"38389","646",2023-10-05 21:00:00,-20417,1913,22330,907,FALSE,"jump1","0.1.4"
"38390","646",2023-10-05 21:15:00,-20813,1913,22726,907,FALSE,NA,"0.1.4"
"38391","646",2023-10-05 21:30:00,-21057,1913,22970,907,FALSE,NA,"0.1.4"
"38392","646",2023-10-05 21:45:00,-20994,1913,22907,907,FALSE,NA,"0.1.4"
"38393","646",2023-10-05 22:00:00,-20994,1913,22907,907,FALSE,"jump1","0.1.4"
"38394","646",2023-10-05 22:15:00,-21012,1913,22925,907,FALSE,NA,"0.1.4"
"38395","646",2023-10-05 22:30:00,-20939,1913,22852,907,FALSE,NA,"0.1.4"
"38396","646",2023-10-05 22:45:00,-20939,1913,22852,907,FALSE,"jump1","0.1.4"
"38397","646",2023-10-05 23:00:00,-21027,1913,22940,907,FALSE,NA,"0.1.4"
"38398","646",2023-10-05 23:15:00,-21006,1913,22919,907,FALSE,NA,"0.1.4"
"38399","646",2023-10-05 23:30:00,-20986,1913,22899,907,FALSE,NA,"0.1.4"
"38400","646",2023-10-05 23:45:00,-20960,1913,22873,907,FALSE,NA,"0.1.4"
"38401","646",2023-10-06,-21017,1913,22930,907,FALSE,NA,"0.1.4"
"38402","646",2023-10-06 00:15:00,-21090,1913,23003,907,FALSE,NA,"0.1.4"
"38403","646",2023-10-06 00:30:00,-21171,1913,23084,907,FALSE,NA,"0.1.4"
"38404","646",2023-10-06 00:45:00,-21242,1913,23155,907,FALSE,NA,"0.1.4"
"38405","646",2023-10-06 01:00:00,-21242,1913,23155,907,FALSE,"jump1","0.1.4"
"38406","646",2023-10-06 01:15:00,-21091,1913,23004,907,FALSE,NA,"0.1.4"
"38407","646",2023-10-06 01:30:00,-21098,1913,23011,907,FALSE,NA,"0.1.4"
"38408","646",2023-10-06 01:45:00,-21503.5,1913,23416.5,907,FALSE,"out1, fill","0.1.4"
"38409","646",2023-10-06 02:00:00,-21909,1913,23822,907,FALSE,NA,"0.1.4"
"38410","646",2023-10-06 02:15:00,-21546,1913,23459,907,FALSE,NA,"0.1.4"
"38411","646",2023-10-06 02:30:00,-21406,1913,23319,907,FALSE,NA,"0.1.4"
"38412","646",2023-10-06 02:45:00,-21098,1913,23011,907,FALSE,NA,"0.1.4"
"38413","646",2023-10-06 03:00:00,-21057,1913,22970,907,FALSE,NA,"0.1.4"
"38414","646",2023-10-06 03:15:00,-21179,1913,23092,907,FALSE,"out1, fill","0.1.4"
"38415","646",2023-10-06 03:30:00,-21301,1913,23214,907,FALSE,"out1, fill","0.1.4"
"38416","646",2023-10-06 03:45:00,-21423,1913,23336,907,FALSE,"out1, fill","0.1.4"
"38417","646",2023-10-06 04:00:00,-21545,1913,23458,907,FALSE,"out1, fill","0.1.4"
"38418","646",2023-10-06 04:15:00,-21667,1913,23580,907,FALSE,NA,"0.1.4"
"38419","646",2023-10-06 04:30:00,-21667,1913,23580,907,FALSE,"jump1","0.1.4"
"38420","646",2023-10-06 04:45:00,-21667,1913,23580,907,FALSE,"jump1","0.1.4"
"38421","646",2023-10-06 05:00:00,-21614,1913,23527,907,FALSE,NA,"0.1.4"
"38422","646",2023-10-06 05:15:00,-21448,1913,23361,907,FALSE,NA,"0.1.4"
"38423","646",2023-10-06 05:30:00,-21909,1913,23822,907,FALSE,NA,"0.1.4"
"38424","646",2023-10-06 05:45:00,-21909,1913,23822,907,FALSE,"jump1","0.1.4"
"38425","646",2023-10-06 06:00:00,-21909,1913,23822,907,FALSE,"jump1","0.1.4"
"38426","646",2023-10-06 06:15:00,-21704,1913,23617,907,FALSE,NA,"0.1.4"
"38427","646",2023-10-06 06:30:00,-21291,1913,23204,907,FALSE,NA,"0.1.4"
"38428","646",2023-10-06 06:45:00,-21409.6,1913,23322.6,907,FALSE,"out1, fill","0.1.4"
"38429","646",2023-10-06 07:00:00,-21528.2,1913,23441.2,907,FALSE,"out1, fill","0.1.4"
"38430","646",2023-10-06 07:15:00,-21646.8,1913,23559.8,907,FALSE,"out1, fill","0.1.4"
"38431","646",2023-10-06 07:30:00,-21765.4,1913,23678.4,907,FALSE,"out1, fill","0.1.4"
"38432","646",2023-10-06 07:45:00,-21884,1913,23797,907,FALSE,NA,"0.1.4"
"38433","646",2023-10-06 08:00:00,-21746,1913,23659,907,FALSE,NA,"0.1.4"
"38434","646",2023-10-06 08:15:00,-21746,1913,23659,907,FALSE,"jump1","0.1.4"
"38435","646",2023-10-06 08:30:00,-21746,1913,23659,907,FALSE,"jump1","0.1.4"
"38436","646",2023-10-06 08:45:00,-21600,1913,23513,907,FALSE,NA,"0.1.4"
"38437","646",2023-10-06 09:00:00,-21831,1913,23744,907,FALSE,NA,"0.1.4"
"38438","646",2023-10-06 09:15:00,-21565,1913,23478,907,FALSE,NA,"0.1.4"
"38439","646",2023-10-06 09:30:00,-21627.75,1913,23540.75,907,FALSE,"out1, fill","0.1.4"
"38440","646",2023-10-06 09:45:00,-21690.5,1913,23603.5,907,FALSE,"out1, fill","0.1.4"
"38441","646",2023-10-06 10:00:00,-21753.25,1913,23666.25,907,FALSE,"out1, fill","0.1.4"
"38442","646",2023-10-06 10:15:00,-21816,1913,23729,907,FALSE,NA,"0.1.4"
"38443","646",2023-10-06 10:30:00,-21600,1913,23513,907,FALSE,NA,"0.1.4"
"38444","646",2023-10-06 10:45:00,-21745,1913,23658,907,FALSE,NA,"0.1.4"
"38445","646",2023-10-06 11:00:00,-21573,1913,23486,907,FALSE,NA,"0.1.4"
"38446","646",2023-10-06 11:15:00,-21761,1913,23674,907,FALSE,NA,"0.1.4"
"38447","646",2023-10-06 11:30:00,-21662,1913,23575,907,FALSE,NA,"0.1.4"
"38448","646",2023-10-06 11:45:00,-21579,1913,23492,907,FALSE,NA,"0.1.4"
"38449","646",2023-10-06 12:00:00,-21376,1913,23289,907,FALSE,NA,"0.1.4"
"38450","646",2023-10-06 12:15:00,-20906,1913,22819,907,FALSE,NA,"0.1.4"
"38451","646",2023-10-06 12:30:00,-20906,1913,22819,907,FALSE,"jump1","0.1.4"
"38452","646",2023-10-06 12:45:00,-21274,1913,23187,907,FALSE,NA,"0.1.4"
"38453","646",2023-10-06 13:00:00,-21695,1913,23608,907,FALSE,NA,"0.1.4"
"38454","646",2023-10-06 13:15:00,-21549,1913,23462,907,FALSE,NA,"0.1.4"
"38455","646",2023-10-06 13:30:00,-21549,1913,23462,907,FALSE,"jump1","0.1.4"
"38456","646",2023-10-06 13:45:00,-21549,1913,23462,907,FALSE,"jump1","0.1.4"
"38457","646",2023-10-06 14:00:00,-21547,1913,23460,907,FALSE,NA,"0.1.4"
"38458","646",2023-10-06 14:15:00,-21547,1913,23460,907,FALSE,"jump1","0.1.4"
"38459","646",2023-10-06 14:30:00,-21547,1913,23460,907,FALSE,"jump1","0.1.4"
"38460","646",2023-10-06 14:45:00,-21362,1913,23275,907,FALSE,NA,"0.1.4"
"38461","646",2023-10-06 15:00:00,-21320,1913,23233,907,FALSE,NA,"0.1.4"
"38462","646",2023-10-06 15:15:00,-21329,1913,23242,907,FALSE,NA,"0.1.4"
"38463","646",2023-10-06 15:30:00,-21329,1913,23242,907,FALSE,"jump1","0.1.4"
"38464","646",2023-10-06 15:45:00,-21394,1913,23307,907,FALSE,NA,"0.1.4"
"38465","646",2023-10-06 16:00:00,-21310,1913,23223,907,FALSE,NA,"0.1.4"
"38466","646",2023-10-06 16:15:00,-21236,1913,23149,907,FALSE,NA,"0.1.4"
"38467","646",2023-10-06 16:30:00,-21261,1913,23174,907,FALSE,NA,"0.1.4"
"38468","646",2023-10-06 16:45:00,-21198,1913,23111,907,FALSE,NA,"0.1.4"
"38469","646",2023-10-06 17:00:00,-21078,1913,22991,907,FALSE,NA,"0.1.4"
"38470","646",2023-10-06 17:15:00,-20651,1913,22564,907,FALSE,NA,"0.1.4"
"38471","646",2023-10-06 17:30:00,-20647.4,1913,22560.4,907,FALSE,"out1, fill","0.1.4"
"38472","646",2023-10-06 17:45:00,-20643.8,1913,22556.8,907,FALSE,"out1, fill","0.1.4"
"38473","646",2023-10-06 18:00:00,-20640.2,1913,22553.2,907,FALSE,"out1, fill","0.1.4"
"38474","646",2023-10-06 18:15:00,-20636.6,1913,22549.6,907,FALSE,"out1, fill","0.1.4"
"38475","646",2023-10-06 18:30:00,-20633,1913,22546,907,FALSE,NA,"0.1.4"
"38476","646",2023-10-06 18:45:00,-20760,1913,22673,907,FALSE,NA,"0.1.4"
"38477","646",2023-10-06 19:00:00,-20760,1913,22673,907,FALSE,"jump1","0.1.4"
"38478","646",2023-10-06 19:15:00,-20629,1913,22542,907,FALSE,NA,"0.1.4"
"38479","646",2023-10-06 19:30:00,-20686,1913,22599,907,FALSE,NA,"0.1.4"
"38480","646",2023-10-06 19:45:00,-20249,1913,22162,907,FALSE,NA,"0.1.4"
"38481","646",2023-10-06 20:00:00,-19950,1913,21863,907,FALSE,NA,"0.1.4"
"38482","646",2023-10-06 20:15:00,-19948,1913,21861,907,FALSE,NA,"0.1.4"
"38483","646",2023-10-06 20:30:00,-20076,1913,21989,907,FALSE,NA,"0.1.4"
"38484","646",2023-10-06 20:45:00,-20226,1913,22139,907,FALSE,NA,"0.1.4"
"38485","646",2023-10-06 21:00:00,-19948,1913,21861,907,FALSE,NA,"0.1.4"
"38486","646",2023-10-06 21:15:00,-20010,1913,21923,907,FALSE,NA,"0.1.4"
"38487","646",2023-10-06 21:30:00,-20106,1913,22019,907,FALSE,NA,"0.1.4"
"38488","646",2023-10-06 21:45:00,-20082,1913,21995,907,FALSE,NA,"0.1.4"
"38489","646",2023-10-06 22:00:00,-20376,1913,22289,907,FALSE,NA,"0.1.4"
"38490","646",2023-10-06 22:15:00,-20187,1913,22100,907,FALSE,NA,"0.1.4"
"38491","646",2023-10-06 22:30:00,-20473,1913,22386,907,FALSE,NA,"0.1.4"
"38492","646",2023-10-06 22:45:00,-20514,1913,22427,907,FALSE,NA,"0.1.4"
"38493","646",2023-10-06 23:00:00,-20153,1913,22066,907,FALSE,NA,"0.1.4"
"38494","646",2023-10-06 23:15:00,-20355,1913,22268,907,FALSE,NA,"0.1.4"
"38495","646",2023-10-06 23:30:00,-20578,1913,22491,907,FALSE,NA,"0.1.4"
"38496","646",2023-10-06 23:45:00,-20414,1913,22327,907,FALSE,NA,"0.1.4"
"38497","646",2023-10-07,-20412,1913,22325,907,FALSE,NA,"0.1.4"
"38498","646",2023-10-07 00:15:00,-20486,1913,22399,907,FALSE,NA,"0.1.4"
"38499","646",2023-10-07 00:30:00,-20321,1913,22234,907,FALSE,NA,"0.1.4"
"38500","646",2023-10-07 00:45:00,-20119,1913,22032,907,FALSE,NA,"0.1.4"
"38501","646",2023-10-07 01:00:00,-20222.6,1913,22135.6,907,FALSE,"out1, fill","0.1.4"
"38502","646",2023-10-07 01:15:00,-20326.2,1913,22239.2,907,FALSE,"out1, fill","0.1.4"
"38503","646",2023-10-07 01:30:00,-20429.8,1913,22342.8,907,FALSE,"out1, fill","0.1.4"
"38504","646",2023-10-07 01:45:00,-20533.4,1913,22446.4,907,FALSE,"out1, fill","0.1.4"
"38505","646",2023-10-07 02:00:00,-20637,1913,22550,907,FALSE,NA,"0.1.4"
"38506","646",2023-10-07 02:15:00,-20752,1913,22665,907,FALSE,NA,"0.1.4"
"38507","646",2023-10-07 02:30:00,-20834,1913,22747,907,FALSE,NA,"0.1.4"
"38508","646",2023-10-07 02:45:00,-21011,1913,22924,907,FALSE,NA,"0.1.4"
"38509","646",2023-10-07 03:00:00,-20975.3333333333,1913,22888.3333333333,907,FALSE,"out1, fill","0.1.4"
"38510","646",2023-10-07 03:15:00,-20939.6666666667,1913,22852.6666666667,907,FALSE,"out1, fill","0.1.4"
"38511","646",2023-10-07 03:30:00,-20904,1913,22817,907,FALSE,NA,"0.1.4"
"38512","646",2023-10-07 03:45:00,-20760,1913,22673,907,FALSE,NA,"0.1.4"
"38513","646",2023-10-07 04:00:00,-20826,1913,22739,907,FALSE,NA,"0.1.4"
"38514","646",2023-10-07 04:15:00,-20756,1913,22669,907,FALSE,NA,"0.1.4"
"38515","646",2023-10-07 04:30:00,-20631.5,1913,22544.5,907,FALSE,"out1, fill","0.1.4"
"38516","646",2023-10-07 04:45:00,-20507,1913,22420,907,FALSE,"out1, fill","0.1.4"
"38517","646",2023-10-07 05:00:00,-20382.5,1913,22295.5,907,FALSE,"out1, fill","0.1.4"
"38518","646",2023-10-07 05:15:00,-20258,1913,22171,907,FALSE,NA,"0.1.4"
"38519","646",2023-10-07 05:30:00,-20485,1913,22398,907,FALSE,NA,"0.1.4"
"38520","646",2023-10-07 05:45:00,-20526,1913,22439,907,FALSE,NA,"0.1.4"
"38521","646",2023-10-07 06:00:00,-20567.3333333333,1913,22480.3333333333,907,FALSE,"out1, fill","0.1.4"
"38522","646",2023-10-07 06:15:00,-20608.6666666667,1913,22521.6666666667,907,FALSE,"out1, fill","0.1.4"
"38523","646",2023-10-07 06:30:00,-20650,1913,22563,907,FALSE,NA,"0.1.4"
"38524","646",2023-10-07 06:45:00,-20456,1913,22369,907,FALSE,NA,"0.1.4"
"38525","646",2023-10-07 07:00:00,-20765,1913,22678,907,FALSE,NA,"0.1.4"
"38526","646",2023-10-07 07:15:00,-20775.7777777778,1913,22688.7777777778,907,FALSE,"out1, fill","0.1.4"
"38527","646",2023-10-07 07:30:00,-20786.5555555556,1913,22699.5555555556,907,FALSE,"out1, fill","0.1.4"
"38528","646",2023-10-07 07:45:00,-20797.3333333333,1913,22710.3333333333,907,FALSE,"out1, fill","0.1.4"
"38529","646",2023-10-07 08:00:00,-20808.1111111111,1913,22721.1111111111,907,FALSE,"out1, fill","0.1.4"
"38530","646",2023-10-07 08:15:00,-20818.8888888889,1913,22731.8888888889,907,FALSE,"out1, fill","0.1.4"
"38531","646",2023-10-07 08:30:00,-20829.6666666667,1913,22742.6666666667,907,FALSE,"out1, fill","0.1.4"
"38532","646",2023-10-07 08:45:00,-20840.4444444444,1913,22753.4444444444,907,FALSE,"out1, fill","0.1.4"
"38533","646",2023-10-07 09:00:00,-20851.2222222222,1913,22764.2222222222,907,FALSE,"out1, fill","0.1.4"
"38534","646",2023-10-07 09:15:00,-20862,1913,22775,907,FALSE,NA,"0.1.4"
"38535","646",2023-10-07 09:30:00,-20544,1913,22457,907,FALSE,NA,"0.1.4"
"38536","646",2023-10-07 09:45:00,-20553,1913,22466,907,FALSE,NA,"0.1.4"
"38537","646",2023-10-07 10:00:00,-20928,1913,22841,907,FALSE,NA,"0.1.4"
"38538","646",2023-10-07 10:15:00,-20892,1913,22805,907,FALSE,NA,"0.1.4"
"38539","646",2023-10-07 10:30:00,-20824,1913,22737,907,FALSE,NA,"0.1.4"
"38540","646",2023-10-07 10:45:00,-20941,1913,22854,907,FALSE,NA,"0.1.4"
"38541","646",2023-10-07 11:00:00,-21101,1913,23014,907,FALSE,NA,"0.1.4"
"38542","646",2023-10-07 11:15:00,-20815,1913,22728,907,FALSE,NA,"0.1.4"
"38543","646",2023-10-07 11:30:00,-20425,1913,22338,907,FALSE,"out1, fill","0.1.4"
"38544","646",2023-10-07 11:45:00,-20035,1913,21948,907,FALSE,NA,"0.1.4"
"38545","646",2023-10-07 12:00:00,-20007,1913,21920,907,FALSE,NA,"0.1.4"
"38546","646",2023-10-07 12:15:00,-20003,1913,21916,907,FALSE,NA,"0.1.4"
"38547","646",2023-10-07 12:30:00,-20031,1913,21944,907,FALSE,NA,"0.1.4"
"38548","646",2023-10-07 12:45:00,-20136,1913,22049,907,FALSE,"out1, fill","0.1.4"
"38549","646",2023-10-07 13:00:00,-20241,1913,22154,907,FALSE,"out1, fill","0.1.4"
"38550","646",2023-10-07 13:15:00,-20346,1913,22259,907,FALSE,"out1, fill","0.1.4"
"38551","646",2023-10-07 13:30:00,-20451,1913,22364,907,FALSE,"out1, fill","0.1.4"
"38552","646",2023-10-07 13:45:00,-20556,1913,22469,907,FALSE,NA,"0.1.4"
"38553","646",2023-10-07 14:00:00,-20850,1913,22763,907,FALSE,NA,"0.1.4"
"38554","646",2023-10-07 14:15:00,-20776,1913,22689,907,FALSE,NA,"0.1.4"
"38555","646",2023-10-07 14:30:00,-20865,1913,22778,907,FALSE,NA,"0.1.4"
"38556","646",2023-10-07 14:45:00,-20744,1913,22657,907,FALSE,NA,"0.1.4"
"38557","646",2023-10-07 15:00:00,-20795,1913,22708,907,FALSE,NA,"0.1.4"
"38558","646",2023-10-07 15:15:00,-20795,1913,22708,907,FALSE,"jump1","0.1.4"
"38559","646",2023-10-07 15:30:00,-21173,1913,23086,907,FALSE,"out1, fill","0.1.4"
"38560","646",2023-10-07 15:45:00,-21551,1913,23464,907,FALSE,NA,"0.1.4"
"38561","646",2023-10-07 16:00:00,-21555,1913,23468,907,FALSE,NA,"0.1.4"
"38562","646",2023-10-07 16:15:00,-21624,1913,23537,907,FALSE,NA,"0.1.4"
"38563","646",2023-10-07 16:30:00,-21457,1913,23370,907,FALSE,NA,"0.1.4"
"38564","646",2023-10-07 16:45:00,-21394,1913,23307,907,FALSE,NA,"0.1.4"
"38565","646",2023-10-07 17:00:00,-21484,1913,23397,907,FALSE,NA,"0.1.4"
"38566","646",2023-10-07 17:15:00,-21484,1913,23397,907,FALSE,"jump1","0.1.4"
"38567","646",2023-10-07 17:30:00,-21305,1913,23218,907,FALSE,NA,"0.1.4"
"38568","646",2023-10-07 17:45:00,-21305,1913,23218,907,FALSE,"jump1","0.1.4"
"38569","646",2023-10-07 18:00:00,-20856,1913,22769,907,FALSE,NA,"0.1.4"
"38570","646",2023-10-07 18:15:00,-20716,1913,22629,907,FALSE,NA,"0.1.4"
"38571","646",2023-10-07 18:30:00,-20716,1913,22629,907,FALSE,"jump1","0.1.4"
"38572","646",2023-10-07 18:45:00,-20716,1913,22629,907,FALSE,"jump1","0.1.4"
"38573","646",2023-10-07 19:00:00,-20725,1913,22638,907,FALSE,NA,"0.1.4"
"38574","646",2023-10-07 19:15:00,-20725,1913,22638,907,FALSE,"jump1","0.1.4"
"38575","646",2023-10-07 19:30:00,-20725,1913,22638,907,FALSE,"jump1","0.1.4"
"38576","646",2023-10-07 19:45:00,-20654,1913,22567,907,FALSE,NA,"0.1.4"
"38577","646",2023-10-07 20:00:00,-20848,1913,22761,907,FALSE,NA,"0.1.4"
"38578","646",2023-10-07 20:15:00,-20799,1913,22712,907,FALSE,NA,"0.1.4"
"38579","646",2023-10-07 20:30:00,-20658,1913,22571,907,FALSE,NA,"0.1.4"
"38580","646",2023-10-07 20:45:00,-20652,1913,22565,907,FALSE,NA,"0.1.4"
"38581","646",2023-10-07 21:00:00,-20650,1913,22563,907,FALSE,NA,"0.1.4"
"38582","646",2023-10-07 21:15:00,-20651,1913,22564,907,FALSE,NA,"0.1.4"
"38583","646",2023-10-07 21:30:00,-20654,1913,22567,907,FALSE,NA,"0.1.4"
"38584","646",2023-10-07 21:45:00,-20831,1913,22744,907,FALSE,NA,"0.1.4"
"38585","646",2023-10-07 22:00:00,-20655,1913,22568,907,FALSE,NA,"0.1.4"
"38586","646",2023-10-07 22:15:00,-20654,1913,22567,907,FALSE,NA,"0.1.4"
"38587","646",2023-10-07 22:30:00,-20654,1913,22567,907,FALSE,NA,"0.1.4"
"38588","646",2023-10-07 22:45:00,-20655,1913,22568,907,FALSE,NA,"0.1.4"
"38589","646",2023-10-07 23:00:00,-20907,1913,22820,907,FALSE,NA,"0.1.4"
"38590","646",2023-10-07 23:15:00,-21307,1913,23220,907,FALSE,NA,"0.1.4"
"38591","646",2023-10-07 23:30:00,-21337,1913,23250,907,FALSE,NA,"0.1.4"
"38592","646",2023-10-07 23:45:00,-21344,1913,23257,907,FALSE,NA,"0.1.4"
"38593","646",2023-10-08,-21349,1913,23262,907,FALSE,NA,"0.1.4"
"38594","646",2023-10-08 00:15:00,-21349,1913,23262,907,FALSE,"jump1","0.1.4"
"38595","646",2023-10-08 00:30:00,-21349,1913,23262,907,FALSE,"jump1","0.1.4"
"38596","646",2023-10-08 00:45:00,-21481,1913,23394,907,FALSE,NA,"0.1.4"
"38597","646",2023-10-08 01:00:00,-21385,1913,23298,907,FALSE,NA,"0.1.4"
"38598","646",2023-10-08 01:15:00,-21366,1913,23279,907,FALSE,NA,"0.1.4"
"38599","646",2023-10-08 01:30:00,-21270.4444444444,1913,23183.4444444444,907,FALSE,"out1, fill","0.1.4"
"38600","646",2023-10-08 01:45:00,-21174.8888888889,1913,23087.8888888889,907,FALSE,"out1, fill","0.1.4"
"38601","646",2023-10-08 02:00:00,-21079.3333333333,1913,22992.3333333333,907,FALSE,"out1, fill","0.1.4"
"38602","646",2023-10-08 02:15:00,-20983.7777777778,1913,22896.7777777778,907,FALSE,"out1, fill","0.1.4"
"38603","646",2023-10-08 02:30:00,-20888.2222222222,1913,22801.2222222222,907,FALSE,"out1, fill","0.1.4"
"38604","646",2023-10-08 02:45:00,-20792.6666666667,1913,22705.6666666667,907,FALSE,"out1, fill","0.1.4"
"38605","646",2023-10-08 03:00:00,-20697.1111111111,1913,22610.1111111111,907,FALSE,"out1, fill","0.1.4"
"38606","646",2023-10-08 03:15:00,-20601.5555555556,1913,22514.5555555556,907,FALSE,"out1, fill","0.1.4"
"38607","646",2023-10-08 03:30:00,-20506,1913,22419,907,FALSE,NA,"0.1.4"
"38608","646",2023-10-08 03:45:00,-20506,1913,22419,907,FALSE,"jump1","0.1.4"
"38609","646",2023-10-08 04:00:00,-20735,1913,22648,907,FALSE,NA,"0.1.4"
"38610","646",2023-10-08 04:15:00,-20651.1111111111,1913,22564.1111111111,907,FALSE,"out1, fill","0.1.4"
"38611","646",2023-10-08 04:30:00,-20567.2222222222,1913,22480.2222222222,907,FALSE,"out1, fill","0.1.4"
"38612","646",2023-10-08 04:45:00,-20483.3333333333,1913,22396.3333333333,907,FALSE,"out1, fill","0.1.4"
"38613","646",2023-10-08 05:00:00,-20399.4444444444,1913,22312.4444444444,907,FALSE,"out1, fill","0.1.4"
"38614","646",2023-10-08 05:15:00,-20315.5555555556,1913,22228.5555555556,907,FALSE,"out1, fill","0.1.4"
"38615","646",2023-10-08 05:30:00,-20231.6666666667,1913,22144.6666666667,907,FALSE,"out1, fill","0.1.4"
"38616","646",2023-10-08 05:45:00,-20147.7777777778,1913,22060.7777777778,907,FALSE,"out1, fill","0.1.4"
"38617","646",2023-10-08 06:00:00,-20063.8888888889,1913,21976.8888888889,907,FALSE,"out1, fill","0.1.4"
"38618","646",2023-10-08 06:15:00,-19980,1913,21893,907,FALSE,NA,"0.1.4"
"38619","646",2023-10-08 06:30:00,-19887,1913,21800,907,FALSE,NA,"0.1.4"
"38620","646",2023-10-08 06:45:00,-19834,1913,21747,907,FALSE,NA,"0.1.4"
"38621","646",2023-10-08 07:00:00,-19937,1913,21850,907,FALSE,NA,"0.1.4"
"38622","646",2023-10-08 07:15:00,-19840,1913,21753,907,FALSE,NA,"0.1.4"
"38623","646",2023-10-08 07:30:00,NA,NA,NA,NA,NA,"out1","0.1.4"
"38624","646",2023-10-08 07:45:00,NA,NA,NA,NA,NA,"out1","0.1.4"
"38625","646",2023-10-08 08:00:00,NA,NA,NA,NA,NA,"out1","0.1.4"
"38626","646",2023-10-08 08:15:00,NA,NA,NA,NA,NA,"out1","0.1.4"
"38627","646",2023-10-08 08:30:00,NA,NA,NA,NA,NA,"out1","0.1.4"
"38628","646",2023-10-08 08:45:00,NA,NA,NA,NA,NA,"out1","0.1.4"
"38629","646",2023-10-08 09:00:00,NA,NA,NA,NA,NA,"out1","0.1.4"
"38630","646",2023-10-08 09:15:00,NA,NA,NA,NA,NA,"out1","0.1.4"
"38631","646",2023-10-08 09:30:00,NA,NA,NA,NA,NA,"out1","0.1.4"
"38632","646",2023-10-08 09:45:00,NA,NA,NA,NA,NA,"out1","0.1.4"
"38633","646",2023-10-08 10:00:00,NA,NA,NA,NA,NA,"out1","0.1.4"
"38634","646",2023-10-08 10:15:00,NA,NA,NA,NA,NA,"out1","0.1.4"
"38635","646",2023-10-08 10:30:00,NA,NA,NA,NA,NA,"out1","0.1.4"
"38636","646",2023-10-08 10:45:00,NA,NA,NA,NA,NA,"out1","0.1.4"
"38637","646",2023-10-08 11:00:00,NA,NA,NA,NA,NA,"out1","0.1.4"
"38638","646",2023-10-08 11:15:00,NA,NA,NA,NA,NA,"out1","0.1.4"
"38639","646",2023-10-08 11:30:00,NA,NA,NA,NA,NA,"out1","0.1.4"
"38640","646",2023-10-08 11:45:00,NA,NA,NA,NA,NA,"out1","0.1.4"
"38641","646",2023-10-08 12:00:00,NA,NA,NA,NA,NA,"out1","0.1.4"
"38642","646",2023-10-08 12:15:00,NA,NA,NA,NA,NA,"out1","0.1.4"
"38643","646",2023-10-08 12:30:00,NA,NA,NA,NA,NA,"out1","0.1.4"
"38644","646",2023-10-08 12:45:00,NA,NA,NA,NA,NA,"out1","0.1.4"
"38645","646",2023-10-08 13:00:00,NA,NA,NA,NA,NA,"out1","0.1.4"
"38646","646",2023-10-08 13:15:00,NA,NA,NA,NA,NA,"out1","0.1.4"
"38647","646",2023-10-08 13:30:00,NA,NA,NA,NA,NA,"out1","0.1.4"
"38648","646",2023-10-08 13:45:00,NA,NA,NA,NA,NA,"out1","0.1.4"
"38649","646",2023-10-08 14:00:00,NA,NA,NA,NA,NA,"out1","0.1.4"
"38650","646",2023-10-08 14:15:00,NA,NA,NA,NA,NA,"out1","0.1.4"
"38651","646",2023-10-08 14:30:00,NA,NA,NA,NA,NA,"out1","0.1.4"
"38652","646",2023-10-08 14:45:00,-20654,1913,22567,907,FALSE,NA,"0.1.4"
"38653","646",2023-10-08 15:00:00,-20654,1913,22567,907,FALSE,"jump1","0.1.4"
"38654","646",2023-10-08 15:15:00,-21147,1913,23060,907,FALSE,NA,"0.1.4"
"38655","646",2023-10-08 15:30:00,-21145,1913,23058,907,FALSE,NA,"0.1.4"
"38656","646",2023-10-08 15:45:00,-21166,1913,23079,907,FALSE,NA,"0.1.4"
"38657","646",2023-10-08 16:00:00,-21116,1913,23029,907,FALSE,NA,"0.1.4"
"38658","646",2023-10-08 16:15:00,-21155,1913,23068,907,FALSE,NA,"0.1.4"
"38659","646",2023-10-08 16:30:00,-21156,1913,23069,907,FALSE,NA,"0.1.4"
"38660","646",2023-10-08 16:45:00,-21047,1913,22960,907,FALSE,NA,"0.1.4"
"38661","646",2023-10-08 17:00:00,-20925,1913,22838,907,FALSE,NA,"0.1.4"
"38662","646",2023-10-08 17:15:00,-20736,1913,22649,907,FALSE,NA,"0.1.4"
"38663","646",2023-10-08 17:30:00,-20536,1913,22449,907,FALSE,NA,"0.1.4"
"38664","646",2023-10-08 17:45:00,-20576,1913,22489,907,FALSE,NA,"0.1.4"
"38665","646",2023-10-08 18:00:00,-20569,1913,22482,907,FALSE,NA,"0.1.4"
"38666","646",2023-10-08 18:15:00,-20941,1913,22854,907,FALSE,NA,"0.1.4"
"38667","646",2023-10-08 18:30:00,-20524,1913,22437,907,FALSE,NA,"0.1.4"
"38668","646",2023-10-08 18:45:00,-20566,1913,22479,907,FALSE,NA,"0.1.4"
"38669","646",2023-10-08 19:00:00,-20575,1913,22488,907,FALSE,NA,"0.1.4"
"38670","646",2023-10-08 19:15:00,-20656,1913,22569,907,FALSE,NA,"0.1.4"
"38671","646",2023-10-08 19:30:00,-20563,1913,22476,907,FALSE,NA,"0.1.4"
"38672","646",2023-10-08 19:45:00,-20636,1913,22549,907,FALSE,NA,"0.1.4"
"38673","646",2023-10-08 20:00:00,-20550,1913,22463,907,FALSE,NA,"0.1.4"
"38674","646",2023-10-08 20:15:00,-20566,1913,22479,907,FALSE,NA,"0.1.4"
"38675","646",2023-10-08 20:30:00,-20563.3333333333,1913,22476.3333333333,907,FALSE,"out1, fill","0.1.4"
"38676","646",2023-10-08 20:45:00,-20560.6666666667,1913,22473.6666666667,907,FALSE,"out1, fill","0.1.4"
"38677","646",2023-10-08 21:00:00,-20558,1913,22471,907,FALSE,NA,"0.1.4"
"38678","646",2023-10-08 21:15:00,-20564,1913,22477,907,FALSE,NA,"0.1.4"
"38679","646",2023-10-08 21:30:00,-20667,1913,22580,907,FALSE,NA,"0.1.4"
"38680","646",2023-10-08 21:45:00,-21044,1913,22957,907,FALSE,NA,"0.1.4"
"38681","646",2023-10-08 22:00:00,-20677,1913,22590,907,FALSE,NA,"0.1.4"
"38682","646",2023-10-08 22:15:00,-20969,1913,22882,907,FALSE,NA,"0.1.4"
"38683","646",2023-10-08 22:30:00,-20888,1913,22801,907,FALSE,NA,"0.1.4"
"38684","646",2023-10-08 22:45:00,-20996,1913,22909,907,FALSE,NA,"0.1.4"
"38685","646",2023-10-08 23:00:00,-21022,1913,22935,907,FALSE,NA,"0.1.4"
"38686","646",2023-10-08 23:15:00,-21043,1913,22956,907,FALSE,NA,"0.1.4"
"38687","646",2023-10-08 23:30:00,-21140,1913,23053,907,FALSE,NA,"0.1.4"
"38688","646",2023-10-08 23:45:00,-21132,1913,23045,907,FALSE,NA,"0.1.4"
"38689","646",2023-10-09,-21283,1913,23196,907,FALSE,NA,"0.1.4"
"38690","646",2023-10-09 00:15:00,-21283,1913,23196,907,FALSE,"jump1","0.1.4"
"38691","646",2023-10-09 00:30:00,-21348,1913,23261,907,FALSE,NA,"0.1.4"
"38692","646",2023-10-09 00:45:00,-21182,1913,23095,907,FALSE,NA,"0.1.4"
"38693","646",2023-10-09 01:00:00,-21647,1913,23560,907,FALSE,"out1, fill","0.1.4"
"38694","646",2023-10-09 01:15:00,-22112,1913,24025,907,FALSE,NA,"0.1.4"
"38695","646",2023-10-09 01:30:00,-22112,1913,24025,907,FALSE,"jump1","0.1.4"
"38696","646",2023-10-09 01:45:00,-21920,1913,23833,907,FALSE,NA,"0.1.4"
"38697","646",2023-10-09 02:00:00,-21870.5714285714,1913,23783.5714285714,907,FALSE,"out1, fill","0.1.4"
"38698","646",2023-10-09 02:15:00,-21821.1428571429,1913,23734.1428571429,907,FALSE,"out1, fill","0.1.4"
"38699","646",2023-10-09 02:30:00,-21771.7142857143,1913,23684.7142857143,907,FALSE,"out1, fill","0.1.4"
"38700","646",2023-10-09 02:45:00,-21722.2857142857,1913,23635.2857142857,907,FALSE,"out1, fill","0.1.4"
"38701","646",2023-10-09 03:00:00,-21672.8571428571,1913,23585.8571428571,907,FALSE,"out1, fill","0.1.4"
"38702","646",2023-10-09 03:15:00,-21623.4285714286,1913,23536.4285714286,907,FALSE,"out1, fill","0.1.4"
"38703","646",2023-10-09 03:30:00,-21574,1913,23487,907,FALSE,NA,"0.1.4"
"38704","646",2023-10-09 03:45:00,-21362,1913,23275,907,FALSE,NA,"0.1.4"
"38705","646",2023-10-09 04:00:00,-21362,1913,23275,907,FALSE,"jump1","0.1.4"
"38706","646",2023-10-09 04:15:00,-21076,1913,22989,907,FALSE,NA,"0.1.4"
"38707","646",2023-10-09 04:30:00,-21076,1913,22989,907,FALSE,"jump1","0.1.4"
"38708","646",2023-10-09 04:45:00,-21076,1913,22989,907,FALSE,"out1, fill","0.1.4"
"38709","646",2023-10-09 05:00:00,-21076,1913,22989,907,FALSE,"jump1","0.1.4"
"38710","646",2023-10-09 05:15:00,-20907,1913,22820,907,FALSE,NA,"0.1.4"
"38711","646",2023-10-09 05:30:00,-20989,1913,22902,907,FALSE,NA,"0.1.4"
"38712","646",2023-10-09 05:45:00,-20991.2857142857,1913,22904.2857142857,907,FALSE,"out1, fill","0.1.4"
"38713","646",2023-10-09 06:00:00,-20993.5714285714,1913,22906.5714285714,907,FALSE,"out1, fill","0.1.4"
"38714","646",2023-10-09 06:15:00,-20995.8571428571,1913,22908.8571428571,907,FALSE,"out1, fill","0.1.4"
"38715","646",2023-10-09 06:30:00,-20998.1428571429,1913,22911.1428571429,907,FALSE,"out1, fill","0.1.4"
"38716","646",2023-10-09 06:45:00,-21000.4285714286,1913,22913.4285714286,907,FALSE,"out1, fill","0.1.4"
"38717","646",2023-10-09 07:00:00,-21002.7142857143,1913,22915.7142857143,907,FALSE,"out1, fill","0.1.4"
"38718","646",2023-10-09 07:15:00,-21005,1913,22918,907,FALSE,NA,"0.1.4"
"38719","646",2023-10-09 07:30:00,-20835,1913,22748,907,FALSE,NA,"0.1.4"
"38720","646",2023-10-09 07:45:00,-20865,1913,22778,907,FALSE,NA,"0.1.4"
"38721","646",2023-10-09 08:00:00,-20569,1913,22482,907,FALSE,NA,"0.1.4"
"38722","646",2023-10-09 08:15:00,-20837,1913,22750,907,FALSE,NA,"0.1.4"
"38723","646",2023-10-09 08:30:00,-20837,1913,22750,907,FALSE,"out1, fill","0.1.4"
"38724","646",2023-10-09 08:45:00,-20837,1913,22750,907,FALSE,"jump1","0.1.4"
"38725","646",2023-10-09 09:00:00,-20837,1913,22750,907,FALSE,"jump1","0.1.4"
"38726","646",2023-10-09 09:15:00,-21069,1913,22982,907,FALSE,NA,"0.1.4"
"38727","646",2023-10-09 09:30:00,-21069,1913,22982,907,FALSE,"out1, fill","0.1.4"
"38728","646",2023-10-09 09:45:00,-21069,1913,22982,907,FALSE,"jump1","0.1.4"
"38729","646",2023-10-09 10:00:00,-21068,1913,22981,907,FALSE,NA,"0.1.4"
"38730","646",2023-10-09 10:15:00,-21166,1913,23079,907,FALSE,NA,"0.1.4"
"38731","646",2023-10-09 10:30:00,-21164,1913,23077,907,FALSE,NA,"0.1.4"
"38732","646",2023-10-09 10:45:00,-21148,1913,23061,907,FALSE,NA,"0.1.4"
"38733","646",2023-10-09 11:00:00,-21141,1913,23054,907,FALSE,NA,"0.1.4"
"38734","646",2023-10-09 11:15:00,-21152,1913,23065,907,FALSE,NA,"0.1.4"
"38735","646",2023-10-09 11:30:00,-21144,1913,23057,907,FALSE,NA,"0.1.4"
"38736","646",2023-10-09 11:45:00,-21252,1913,23165,907,FALSE,NA,"0.1.4"
"38737","646",2023-10-09 12:00:00,-21327,1913,23240,907,FALSE,NA,"0.1.4"
"38738","646",2023-10-09 12:15:00,-21480,1913,23393,907,FALSE,NA,"0.1.4"
"38739","646",2023-10-09 12:30:00,-21528,1913,23441,907,FALSE,NA,"0.1.4"
"38740","646",2023-10-09 12:45:00,-21584,1913,23497,907,FALSE,NA,"0.1.4"
"38741","646",2023-10-09 13:00:00,-21218,1913,23131,907,FALSE,NA,"0.1.4"
"38742","646",2023-10-09 13:15:00,-21573,1913,23486,907,FALSE,NA,"0.1.4"
"38743","646",2023-10-09 13:30:00,-21576,1913,23489,907,FALSE,NA,"0.1.4"
"38744","646",2023-10-09 13:45:00,-21603,1913,23516,907,FALSE,NA,"0.1.4"
"38745","646",2023-10-09 14:00:00,-21633,1913,23546,907,FALSE,NA,"0.1.4"
"38746","646",2023-10-09 14:15:00,-21731,1913,23644,907,FALSE,NA,"0.1.4"
"38747","646",2023-10-09 14:30:00,-21681,1913,23594,907,FALSE,NA,"0.1.4"
"38748","646",2023-10-09 14:45:00,-21673,1913,23586,907,FALSE,NA,"0.1.4"
"38749","646",2023-10-09 15:00:00,-21627,1913,23540,907,FALSE,NA,"0.1.4"
"38750","646",2023-10-09 15:15:00,-21663,1913,23576,907,FALSE,NA,"0.1.4"
"38751","646",2023-10-09 15:30:00,-21649,1913,23562,907,FALSE,NA,"0.1.4"
"38752","646",2023-10-09 15:45:00,-21762,1913,23675,907,FALSE,NA,"0.1.4"
"38753","646",2023-10-09 16:00:00,-21765,1913,23678,907,FALSE,NA,"0.1.4"
"38754","646",2023-10-09 16:15:00,-21764,1913,23677,907,FALSE,NA,"0.1.4"
"38755","646",2023-10-09 16:30:00,-21743,1913,23656,907,FALSE,NA,"0.1.4"
"38756","646",2023-10-09 16:45:00,-21740,1913,23653,907,FALSE,NA,"0.1.4"
"38757","646",2023-10-09 17:00:00,-21783,1913,23696,907,FALSE,NA,"0.1.4"
"38758","646",2023-10-09 17:15:00,-21767,1913,23680,907,FALSE,NA,"0.1.4"
"38759","646",2023-10-09 17:30:00,-21759,1913,23672,907,FALSE,NA,"0.1.4"
"38760","646",2023-10-09 17:45:00,-21702,1913,23615,907,FALSE,NA,"0.1.4"
"38761","646",2023-10-09 18:00:00,-21730,1913,23643,907,FALSE,NA,"0.1.4"
"38762","646",2023-10-09 18:15:00,-21759,1913,23672,907,FALSE,NA,"0.1.4"
"38763","646",2023-10-09 18:30:00,-21714,1913,23627,907,FALSE,NA,"0.1.4"
"38764","646",2023-10-09 18:45:00,-21697,1913,23610,907,FALSE,NA,"0.1.4"
"38765","646",2023-10-09 19:00:00,-21645,1913,23558,907,FALSE,NA,"0.1.4"
"38766","646",2023-10-09 19:15:00,-21530,1913,23443,907,FALSE,NA,"0.1.4"
"38767","646",2023-10-09 19:30:00,-21513,1913,23426,907,FALSE,NA,"0.1.4"
"38768","646",2023-10-09 19:45:00,-21170,1913,23083,907,FALSE,NA,"0.1.4"
"38769","646",2023-10-09 20:00:00,-21226,1913,23139,907,FALSE,NA,"0.1.4"
"38770","646",2023-10-09 20:15:00,-21140,1913,23053,907,FALSE,NA,"0.1.4"
"38771","646",2023-10-09 20:30:00,-21201,1913,23114,907,FALSE,NA,"0.1.4"
"38772","646",2023-10-09 20:45:00,-21192,1913,23105,907,FALSE,NA,"0.1.4"
"38773","646",2023-10-09 21:00:00,-21156,1913,23069,907,FALSE,NA,"0.1.4"
"38774","646",2023-10-09 21:15:00,-21222,1913,23135,907,FALSE,NA,"0.1.4"
"38775","646",2023-10-09 21:30:00,-21408,1913,23321,907,FALSE,NA,"0.1.4"
"38776","646",2023-10-09 21:45:00,-21552,1913,23465,907,FALSE,NA,"0.1.4"
"38777","646",2023-10-09 22:00:00,-21416,1913,23329,907,FALSE,NA,"0.1.4"
"38778","646",2023-10-09 22:15:00,-21463,1913,23376,907,FALSE,NA,"0.1.4"
"38779","646",2023-10-09 22:30:00,-21535,1913,23448,907,FALSE,NA,"0.1.4"
"38780","646",2023-10-09 22:45:00,-21657,1913,23570,907,FALSE,NA,"0.1.4"
"38781","646",2023-10-09 23:00:00,-21657,1913,23570,907,FALSE,"jump1","0.1.4"
"38782","646",2023-10-09 23:15:00,-21660,1913,23573,907,FALSE,NA,"0.1.4"
"38783","646",2023-10-09 23:30:00,-21650,1913,23563,907,FALSE,NA,"0.1.4"
"38784","646",2023-10-09 23:45:00,-21650,1913,23563,907,FALSE,NA,"0.1.4"
"38785","646",2023-10-10,-21650,1913,23563,907,FALSE,NA,"0.1.4"
"38786","646",2023-10-10 00:15:00,-21650,1913,23563,907,FALSE,NA,"0.1.4"
"38787","646",2023-10-10 00:30:00,-21650,1913,23563,907,FALSE,NA,"0.1.4"
"38788","646",2023-10-10 00:45:00,-21650,1913,23563,907,FALSE,NA,"0.1.4"
"38789","646",2023-10-10 01:00:00,-21650,1913,23563,907,FALSE,NA,"0.1.4"
"38790","646",2023-10-10 01:15:00,-21650,1913,23563,907,FALSE,NA,"0.1.4"
"38791","646",2023-10-10 01:30:00,-21650,1913,23563,907,FALSE,NA,"0.1.4"
"38792","646",2023-10-10 01:45:00,-21650,1913,23563,907,FALSE,NA,"0.1.4"
"38793","646",2023-10-10 02:00:00,-21650,1913,23563,907,FALSE,NA,"0.1.4"
"38794","646",2023-10-10 02:15:00,-21650,1913,23563,907,FALSE,NA,"0.1.4"
"38795","646",2023-10-10 02:30:00,-21651,1913,23564,907,FALSE,NA,"0.1.4"
"38796","646",2023-10-10 02:45:00,-21647,1913,23560,907,FALSE,NA,"0.1.4"
"38797","646",2023-10-10 03:00:00,-21627,1913,23540,907,FALSE,NA,"0.1.4"
"38798","646",2023-10-10 03:15:00,-21726,1913,23639,907,FALSE,NA,"0.1.4"
"38799","646",2023-10-10 03:30:00,-21726,1913,23639,907,FALSE,"jump1","0.1.4"
"38800","646",2023-10-10 03:45:00,-21726,1913,23639,907,FALSE,"jump1","0.1.4"
"38801","646",2023-10-10 04:00:00,-22064,1913,23977,907,FALSE,"out1, fill","0.1.4"
"38802","646",2023-10-10 04:15:00,-22402,1913,24315,907,FALSE,NA,"0.1.4"
"38803","646",2023-10-10 04:30:00,-22487,1913,24400,907,FALSE,NA,"0.1.4"
"38804","646",2023-10-10 04:45:00,-22522,1913,24435,907,FALSE,NA,"0.1.4"
"38805","646",2023-10-10 05:00:00,-22248.5,1913,24161.5,907,FALSE,"out1, fill","0.1.4"
"38806","646",2023-10-10 05:15:00,-21975,1913,23888,907,FALSE,NA,"0.1.4"
"38807","646",2023-10-10 05:30:00,-22396,1913,24309,907,FALSE,NA,"0.1.4"
"38808","646",2023-10-10 05:45:00,-22213,1913,24126,907,FALSE,NA,"0.1.4"
"38809","646",2023-10-10 06:00:00,-21876,1913,23789,907,FALSE,NA,"0.1.4"
"38810","646",2023-10-10 06:15:00,-21801,1913,23714,907,FALSE,NA,"0.1.4"
"38811","646",2023-10-10 06:30:00,-21807,1913,23720,907,FALSE,NA,"0.1.4"
"38812","646",2023-10-10 06:45:00,-21763,1913,23676,907,FALSE,NA,"0.1.4"
"38813","646",2023-10-10 07:00:00,-21648,1913,23561,907,FALSE,NA,"0.1.4"
"38814","646",2023-10-10 07:15:00,-21919,1913,23832,907,FALSE,NA,"0.1.4"
"38815","646",2023-10-10 07:30:00,-21669,1913,23582,907,FALSE,NA,"0.1.4"
"38816","646",2023-10-10 07:45:00,-21669,1913,23582,907,FALSE,"jump1","0.1.4"
"38817","646",2023-10-10 08:00:00,-21669,1913,23582,907,FALSE,"jump1","0.1.4"
"38818","646",2023-10-10 08:15:00,-21677,1913,23590,907,FALSE,NA,"0.1.4"
"38819","646",2023-10-10 08:30:00,-21683,1913,23596,907,FALSE,NA,"0.1.4"
"38820","646",2023-10-10 08:45:00,-21677,1913,23590,907,FALSE,NA,"0.1.4"
"38821","646",2023-10-10 09:00:00,-21683,1913,23596,907,FALSE,NA,"0.1.4"
"38822","646",2023-10-10 09:15:00,-21674,1913,23587,907,FALSE,NA,"0.1.4"
"38823","646",2023-10-10 09:30:00,-21681,1913,23594,907,FALSE,NA,"0.1.4"
"38824","646",2023-10-10 09:45:00,-21685,1913,23598,907,FALSE,NA,"0.1.4"
"38825","646",2023-10-10 10:00:00,-21856,1913,23769,907,FALSE,NA,"0.1.4"
"38826","646",2023-10-10 10:15:00,-22347,1913,24260,907,FALSE,NA,"0.1.4"
"38827","646",2023-10-10 10:30:00,-22178,1913,24091,907,FALSE,NA,"0.1.4"
"38828","646",2023-10-10 10:45:00,-21739,1913,23652,907,FALSE,NA,"0.1.4"
"38829","646",2023-10-10 11:00:00,-21852,1913,23765,907,FALSE,NA,"0.1.4"
"38830","646",2023-10-10 11:15:00,-21962,1913,23875,907,FALSE,NA,"0.1.4"
"38831","646",2023-10-10 11:30:00,-21965,1913,23878,907,FALSE,NA,"0.1.4"
"38832","646",2023-10-10 11:45:00,-21969,1913,23882,907,FALSE,NA,"0.1.4"
"38833","646",2023-10-10 12:00:00,-21903,1913,23816,907,FALSE,NA,"0.1.4"
"38834","646",2023-10-10 12:15:00,-22008,1913,23921,907,FALSE,NA,"0.1.4"
"38835","646",2023-10-10 12:30:00,-22190,1913,24103,907,FALSE,NA,"0.1.4"
"38836","646",2023-10-10 12:45:00,-22241,1913,24154,907,FALSE,NA,"0.1.4"
"38837","646",2023-10-10 13:00:00,-22361,1913,24274,907,FALSE,NA,"0.1.4"
"38838","646",2023-10-10 13:15:00,-22369,1913,24282,907,FALSE,NA,"0.1.4"
"38839","646",2023-10-10 13:30:00,-22231,1913,24144,907,FALSE,NA,"0.1.4"
"38840","646",2023-10-10 13:45:00,-22340,1913,24253,907,FALSE,NA,"0.1.4"
"38841","646",2023-10-10 14:00:00,-21851,1913,23764,907,FALSE,NA,"0.1.4"
"38842","646",2023-10-10 14:15:00,-21859,1913,23772,907,FALSE,NA,"0.1.4"
"38843","646",2023-10-10 14:30:00,-21832,1913,23745,907,FALSE,NA,"0.1.4"
"38844","646",2023-10-10 14:45:00,-21695,1913,23608,907,FALSE,NA,"0.1.4"
"38845","646",2023-10-10 15:00:00,-21769,1913,23682,907,FALSE,NA,"0.1.4"
"38846","646",2023-10-10 15:15:00,-21987,1913,23900,907,FALSE,"out1, fill","0.1.4"
"38847","646",2023-10-10 15:30:00,-22205,1913,24118,907,FALSE,NA,"0.1.4"
"38848","646",2023-10-10 15:45:00,-22205,1913,24118,907,FALSE,"jump1","0.1.4"
"38849","646",2023-10-10 16:00:00,-22205,1913,24118,907,FALSE,"jump1","0.1.4"
"38850","646",2023-10-10 16:15:00,-21954,1913,23867,907,FALSE,NA,"0.1.4"
"38851","646",2023-10-10 16:30:00,-22099,1913,24012,907,FALSE,NA,"0.1.4"
"38852","646",2023-10-10 16:45:00,-21849,1913,23762,907,FALSE,NA,"0.1.4"
"38853","646",2023-10-10 17:00:00,-21904,1913,23817,907,FALSE,NA,"0.1.4"
"38854","646",2023-10-10 17:15:00,-21940,1913,23853,907,FALSE,NA,"0.1.4"
"38855","646",2023-10-10 17:30:00,-22061,1913,23974,907,FALSE,NA,"0.1.4"
"38856","646",2023-10-10 17:45:00,-21952,1913,23865,907,FALSE,NA,"0.1.4"
"38857","646",2023-10-10 18:00:00,-21876,1913,23789,907,FALSE,NA,"0.1.4"
"38858","646",2023-10-10 18:15:00,-21799,1913,23712,907,FALSE,NA,"0.1.4"
"38859","646",2023-10-10 18:30:00,-21822,1913,23735,907,FALSE,NA,"0.1.4"
"38860","646",2023-10-10 18:45:00,-21831,1913,23744,907,FALSE,NA,"0.1.4"
"38861","646",2023-10-10 19:00:00,-21744,1913,23657,907,FALSE,NA,"0.1.4"
"38862","646",2023-10-10 19:15:00,-21821,1913,23734,907,FALSE,NA,"0.1.4"
"38863","646",2023-10-10 19:30:00,-21861,1913,23774,907,FALSE,NA,"0.1.4"
"38864","646",2023-10-10 19:45:00,-21854,1913,23767,907,FALSE,NA,"0.1.4"
"38865","646",2023-10-10 20:00:00,-21970,1913,23883,907,FALSE,NA,"0.1.4"
"38866","646",2023-10-10 20:15:00,-21788,1913,23701,907,FALSE,NA,"0.1.4"
"38867","646",2023-10-10 20:30:00,-21755,1913,23668,907,FALSE,NA,"0.1.4"
"38868","646",2023-10-10 20:45:00,-21781,1913,23694,907,FALSE,NA,"0.1.4"
"38869","646",2023-10-10 21:00:00,-21736,1913,23649,907,FALSE,NA,"0.1.4"
"38870","646",2023-10-10 21:15:00,-21786,1913,23699,907,FALSE,NA,"0.1.4"
"38871","646",2023-10-10 21:30:00,-21748,1913,23661,907,FALSE,NA,"0.1.4"
"38872","646",2023-10-10 21:45:00,-21735,1913,23648,907,FALSE,NA,"0.1.4"
"38873","646",2023-10-10 22:00:00,-21771,1913,23684,907,FALSE,NA,"0.1.4"
"38874","646",2023-10-10 22:15:00,-21783,1913,23696,907,FALSE,NA,"0.1.4"
"38875","646",2023-10-10 22:30:00,-21759,1913,23672,907,FALSE,NA,"0.1.4"
"38876","646",2023-10-10 22:45:00,-21742,1913,23655,907,FALSE,NA,"0.1.4"
"38877","646",2023-10-10 23:00:00,-21740,1913,23653,907,FALSE,NA,"0.1.4"
"38878","646",2023-10-10 23:15:00,-21745,1913,23658,907,FALSE,NA,"0.1.4"
"38879","646",2023-10-10 23:30:00,-21737,1913,23650,907,FALSE,NA,"0.1.4"
"38880","646",2023-10-10 23:45:00,-21786,1913,23699,907,FALSE,NA,"0.1.4"
"38881","646",2023-10-11,-21783,1913,23696,907,FALSE,NA,"0.1.4"
"38882","646",2023-10-11 00:15:00,-21901,1913,23814,907,FALSE,NA,"0.1.4"
"38883","646",2023-10-11 00:30:00,-21919,1913,23832,907,FALSE,NA,"0.1.4"
"38884","646",2023-10-11 00:45:00,-21884,1913,23797,907,FALSE,NA,"0.1.4"
"38885","646",2023-10-11 01:00:00,-21837,1913,23750,907,FALSE,NA,"0.1.4"
"38886","646",2023-10-11 01:15:00,-21871,1913,23784,907,FALSE,NA,"0.1.4"
"38887","646",2023-10-11 01:30:00,-21843,1913,23756,907,FALSE,NA,"0.1.4"
"38888","646",2023-10-11 01:45:00,-21843,1913,23756,907,FALSE,NA,"0.1.4"
"38889","646",2023-10-11 02:00:00,-21855,1913,23768,907,FALSE,NA,"0.1.4"
"38890","646",2023-10-11 02:15:00,-21786,1913,23699,907,FALSE,NA,"0.1.4"
"38891","646",2023-10-11 02:30:00,-21734,1913,23647,907,FALSE,NA,"0.1.4"
"38892","646",2023-10-11 02:45:00,-21716,1913,23629,907,FALSE,NA,"0.1.4"
"38893","646",2023-10-11 03:00:00,-21724,1913,23637,907,FALSE,NA,"0.1.4"
"38894","646",2023-10-11 03:15:00,-21716,1913,23629,907,FALSE,NA,"0.1.4"
"38895","646",2023-10-11 03:30:00,-21725,1913,23638,907,FALSE,NA,"0.1.4"
"38896","646",2023-10-11 03:45:00,-21728,1913,23641,907,FALSE,NA,"0.1.4"
"38897","646",2023-10-11 04:00:00,-21724,1913,23637,907,FALSE,NA,"0.1.4"
"38898","646",2023-10-11 04:15:00,-21729,1913,23642,907,FALSE,NA,"0.1.4"
"38899","646",2023-10-11 04:30:00,-21734,1913,23647,907,FALSE,NA,"0.1.4"
"38900","646",2023-10-11 04:45:00,-21734,1913,23647,907,FALSE,NA,"0.1.4"
"38901","646",2023-10-11 05:00:00,-21735,1913,23648,907,FALSE,NA,"0.1.4"
"38902","646",2023-10-11 05:15:00,-21733,1913,23646,907,FALSE,NA,"0.1.4"
"38903","646",2023-10-11 05:30:00,-21734,1913,23647,907,FALSE,NA,"0.1.4"
"38904","646",2023-10-11 05:45:00,-21729,1913,23642,907,FALSE,NA,"0.1.4"
"38905","646",2023-10-11 06:00:00,-21729,1913,23642,907,FALSE,NA,"0.1.4"
"38906","646",2023-10-11 06:15:00,-21730,1913,23643,907,FALSE,NA,"0.1.4"
"38907","646",2023-10-11 06:30:00,-21731,1913,23644,907,FALSE,NA,"0.1.4"
"38908","646",2023-10-11 06:45:00,-21731,1913,23644,907,FALSE,NA,"0.1.4"
"38909","646",2023-10-11 07:00:00,-21730,1913,23643,907,FALSE,NA,"0.1.4"
"38910","646",2023-10-11 07:15:00,-21731,1913,23644,907,FALSE,NA,"0.1.4"
"38911","646",2023-10-11 07:30:00,-21731,1913,23644,907,FALSE,NA,"0.1.4"
"38912","646",2023-10-11 07:45:00,-21729,1913,23642,907,FALSE,NA,"0.1.4"
"38913","646",2023-10-11 08:00:00,-21725,1913,23638,907,FALSE,NA,"0.1.4"
"38914","646",2023-10-11 08:15:00,-21725,1913,23638,907,FALSE,NA,"0.1.4"
"38915","646",2023-10-11 08:30:00,-21731,1913,23644,907,FALSE,NA,"0.1.4"
"38916","646",2023-10-11 08:45:00,-21730,1913,23643,907,FALSE,NA,"0.1.4"
"38917","646",2023-10-11 09:00:00,-21725,1913,23638,907,FALSE,NA,"0.1.4"
"38918","646",2023-10-11 09:15:00,-21725,1913,23638,907,FALSE,NA,"0.1.4"
"38919","646",2023-10-11 09:30:00,-21723,1913,23636,907,FALSE,NA,"0.1.4"
"38920","646",2023-10-11 09:45:00,-21706,1913,23619,907,FALSE,NA,"0.1.4"
"38921","646",2023-10-11 10:00:00,-21716,1913,23629,907,FALSE,NA,"0.1.4"
"38922","646",2023-10-11 10:15:00,-21726,1913,23639,907,FALSE,NA,"0.1.4"
"38923","646",2023-10-11 10:30:00,-21725,1913,23638,907,FALSE,NA,"0.1.4"
"38924","646",2023-10-11 10:45:00,-21714,1913,23627,907,FALSE,NA,"0.1.4"
"38925","646",2023-10-11 11:00:00,-21714,1913,23627,907,FALSE,NA,"0.1.4"
"38926","646",2023-10-11 11:15:00,-21720,1913,23633,907,FALSE,NA,"0.1.4"
"38927","646",2023-10-11 11:30:00,-21709,1913,23622,907,FALSE,NA,"0.1.4"
"38928","646",2023-10-11 11:45:00,-21734,1913,23647,907,FALSE,NA,"0.1.4"
"38929","646",2023-10-11 12:00:00,-21730,1913,23643,907,FALSE,NA,"0.1.4"
"38930","646",2023-10-11 12:15:00,-21726,1913,23639,907,FALSE,NA,"0.1.4"
"38931","646",2023-10-11 12:30:00,-21736,1913,23649,907,FALSE,NA,"0.1.4"
"38932","646",2023-10-11 12:45:00,-21724,1913,23637,907,FALSE,NA,"0.1.4"
"38933","646",2023-10-11 13:00:00,-21731,1913,23644,907,FALSE,NA,"0.1.4"
"38934","646",2023-10-11 13:15:00,-21731,1913,23644,907,FALSE,NA,"0.1.4"
"38935","646",2023-10-11 13:30:00,-21726,1913,23639,907,FALSE,NA,"0.1.4"
"38936","646",2023-10-11 13:45:00,-21730,1913,23643,907,FALSE,NA,"0.1.4"
"38937","646",2023-10-11 14:00:00,-21730,1913,23643,907,FALSE,NA,"0.1.4"
"38938","646",2023-10-11 14:15:00,-21733,1913,23646,907,FALSE,NA,"0.1.4"
"38939","646",2023-10-11 14:30:00,-21733,1913,23646,907,FALSE,NA,"0.1.4"
"38940","646",2023-10-11 14:45:00,-21732,1913,23645,907,FALSE,NA,"0.1.4"
"38941","646",2023-10-11 15:00:00,-21731,1913,23644,907,FALSE,NA,"0.1.4"
"38942","646",2023-10-11 15:15:00,-21731,1913,23644,907,FALSE,NA,"0.1.4"
"38943","646",2023-10-11 15:30:00,-21727,1913,23640,907,FALSE,NA,"0.1.4"
"38944","646",2023-10-11 15:45:00,-21734,1913,23647,907,FALSE,NA,"0.1.4"
"38945","646",2023-10-11 16:00:00,-21733,1913,23646,907,FALSE,NA,"0.1.4"
"38946","646",2023-10-11 16:15:00,-21738,1913,23651,907,FALSE,NA,"0.1.4"
"38947","646",2023-10-11 16:30:00,-21738,1913,23651,907,FALSE,NA,"0.1.4"
"38948","646",2023-10-11 16:45:00,-21737,1913,23650,907,FALSE,NA,"0.1.4"
"38949","646",2023-10-11 17:00:00,-21739,1913,23652,907,FALSE,NA,"0.1.4"
"38950","646",2023-10-11 17:15:00,-21739,1913,23652,907,FALSE,NA,"0.1.4"
"38951","646",2023-10-11 17:30:00,-21739,1913,23652,907,FALSE,NA,"0.1.4"
"38952","646",2023-10-11 17:45:00,-21739,1913,23652,907,FALSE,NA,"0.1.4"
"38953","646",2023-10-11 18:00:00,-21736,1913,23649,907,FALSE,NA,"0.1.4"
"38954","646",2023-10-11 18:15:00,-21734,1913,23647,907,FALSE,NA,"0.1.4"
"38955","646",2023-10-11 18:30:00,-21736,1913,23649,907,FALSE,NA,"0.1.4"
"38956","646",2023-10-11 18:45:00,-21737,1913,23650,907,FALSE,NA,"0.1.4"
"38957","646",2023-10-11 19:00:00,-21739,1913,23652,907,FALSE,NA,"0.1.4"
"38958","646",2023-10-11 19:15:00,-21739,1913,23652,907,FALSE,NA,"0.1.4"
"38959","646",2023-10-11 19:30:00,-21734,1913,23647,907,FALSE,NA,"0.1.4"
"38960","646",2023-10-11 19:45:00,-21738,1913,23651,907,FALSE,NA,"0.1.4"
"38961","646",2023-10-11 20:00:00,-21739,1913,23652,907,FALSE,NA,"0.1.4"
"38962","646",2023-10-11 20:15:00,-21739,1913,23652,907,FALSE,NA,"0.1.4"
"38963","646",2023-10-11 20:30:00,-21738,1913,23651,907,FALSE,NA,"0.1.4"
"38964","646",2023-10-11 20:45:00,-21737,1913,23650,907,FALSE,NA,"0.1.4"
"38965","646",2023-10-11 21:00:00,-21738,1913,23651,907,FALSE,NA,"0.1.4"
"38966","646",2023-10-11 21:15:00,-21736,1913,23649,907,FALSE,NA,"0.1.4"
"38967","646",2023-10-11 21:30:00,-21731,1913,23644,907,FALSE,NA,"0.1.4"
"38968","646",2023-10-11 21:45:00,-21737,1913,23650,907,FALSE,NA,"0.1.4"
"38969","646",2023-10-11 22:00:00,-21739,1913,23652,907,FALSE,NA,"0.1.4"
"38970","646",2023-10-11 22:15:00,-21730,1913,23643,907,FALSE,NA,"0.1.4"
"38971","646",2023-10-11 22:30:00,-21721,1913,23634,907,FALSE,NA,"0.1.4"
"38972","646",2023-10-11 22:45:00,-21739,1913,23652,907,FALSE,NA,"0.1.4"
"38973","646",2023-10-11 23:00:00,-21736,1913,23649,907,FALSE,NA,"0.1.4"
"38974","646",2023-10-11 23:15:00,-21738,1913,23651,907,FALSE,NA,"0.1.4"
"38975","646",2023-10-11 23:30:00,-21736,1913,23649,907,FALSE,NA,"0.1.4"
"38976","646",2023-10-11 23:45:00,-21737,1913,23650,907,FALSE,NA,"0.1.4"
"38977","646",2023-10-12,-21738,1913,23651,907,FALSE,NA,"0.1.4"
"38978","646",2023-10-12 00:15:00,-21737,1913,23650,907,FALSE,NA,"0.1.4"
"38979","646",2023-10-12 00:30:00,-21740,1913,23653,907,FALSE,NA,"0.1.4"
"38980","646",2023-10-12 00:45:00,-21740,1913,23653,907,FALSE,NA,"0.1.4"
"38981","646",2023-10-12 01:00:00,-21740,1913,23653,907,FALSE,NA,"0.1.4"
"38982","646",2023-10-12 01:15:00,-21741,1913,23654,907,FALSE,NA,"0.1.4"
"38983","646",2023-10-12 01:30:00,-21740,1913,23653,907,FALSE,NA,"0.1.4"
"38984","646",2023-10-12 01:45:00,-21739,1913,23652,907,FALSE,NA,"0.1.4"
"38985","646",2023-10-12 02:00:00,-21740,1913,23653,907,FALSE,NA,"0.1.4"
"38986","646",2023-10-12 02:15:00,-21741,1913,23654,907,FALSE,NA,"0.1.4"
"38987","646",2023-10-12 02:30:00,-21739,1913,23652,907,FALSE,NA,"0.1.4"
"38988","646",2023-10-12 02:45:00,-21740,1913,23653,907,FALSE,NA,"0.1.4"
"38989","646",2023-10-12 03:00:00,-21739,1913,23652,907,FALSE,NA,"0.1.4"
"38990","646",2023-10-12 03:15:00,-21739,1913,23652,907,FALSE,NA,"0.1.4"
"38991","646",2023-10-12 03:30:00,-21739,1913,23652,907,FALSE,NA,"0.1.4"
"38992","646",2023-10-12 03:45:00,-21738,1913,23651,907,FALSE,NA,"0.1.4"
"38993","646",2023-10-12 04:00:00,-21739,1913,23652,907,FALSE,NA,"0.1.4"
"38994","646",2023-10-12 04:15:00,-21740,1913,23653,907,FALSE,NA,"0.1.4"
"38995","646",2023-10-12 04:30:00,-21740,1913,23653,907,FALSE,NA,"0.1.4"
"38996","646",2023-10-12 04:45:00,-21740,1913,23653,907,FALSE,NA,"0.1.4"
"38997","646",2023-10-12 05:00:00,-21740,1913,23653,907,FALSE,NA,"0.1.4"
"38998","646",2023-10-12 05:15:00,-21740,1913,23653,907,FALSE,NA,"0.1.4"
"38999","646",2023-10-12 05:30:00,-21740,1913,23653,907,FALSE,NA,"0.1.4"
"39000","646",2023-10-12 05:45:00,-21740,1913,23653,907,FALSE,NA,"0.1.4"
"39001","646",2023-10-12 06:00:00,-21740,1913,23653,907,FALSE,NA,"0.1.4"
"39002","646",2023-10-12 06:15:00,-21739,1913,23652,907,FALSE,NA,"0.1.4"
"39003","646",2023-10-12 06:30:00,-21739,1913,23652,907,FALSE,NA,"0.1.4"
"39004","646",2023-10-12 06:45:00,-21739,1913,23652,907,FALSE,NA,"0.1.4"
"39005","646",2023-10-12 07:00:00,-21739,1913,23652,907,FALSE,NA,"0.1.4"
"39006","646",2023-10-12 07:15:00,-21739,1913,23652,907,FALSE,NA,"0.1.4"
"39007","646",2023-10-12 07:30:00,-21733,1913,23646,907,FALSE,NA,"0.1.4"
"39008","646",2023-10-12 07:45:00,-21734,1913,23647,907,FALSE,NA,"0.1.4"
"39009","646",2023-10-12 08:00:00,-21736,1913,23649,907,FALSE,NA,"0.1.4"
"39010","646",2023-10-12 08:15:00,-21733,1913,23646,907,FALSE,NA,"0.1.4"
"39011","646",2023-10-12 08:30:00,-21733,1913,23646,907,FALSE,NA,"0.1.4"
"39012","646",2023-10-12 08:45:00,-21733,1913,23646,907,FALSE,NA,"0.1.4"
"39013","646",2023-10-12 09:00:00,-21732,1913,23645,907,FALSE,NA,"0.1.4"
"39014","646",2023-10-12 09:15:00,-21733,1913,23646,907,FALSE,NA,"0.1.4"
"39015","646",2023-10-12 09:30:00,-21733,1913,23646,907,FALSE,NA,"0.1.4"
"39016","646",2023-10-12 09:45:00,-21733,1913,23646,907,FALSE,NA,"0.1.4"
"39017","646",2023-10-12 10:00:00,-21736,1913,23649,907,FALSE,NA,"0.1.4"
"39018","646",2023-10-12 10:15:00,-21736,1913,23649,907,FALSE,NA,"0.1.4"
"39019","646",2023-10-12 10:30:00,-21737,1913,23650,907,FALSE,NA,"0.1.4"
"39020","646",2023-10-12 10:45:00,-21737,1913,23650,907,FALSE,NA,"0.1.4"
"39021","646",2023-10-12 11:00:00,-21737,1913,23650,907,FALSE,NA,"0.1.4"
"39022","646",2023-10-12 11:15:00,-21737,1913,23650,907,FALSE,NA,"0.1.4"
"39023","646",2023-10-12 11:30:00,-21737,1913,23650,907,FALSE,NA,"0.1.4"
"39024","646",2023-10-12 11:45:00,-21737,1913,23650,907,FALSE,NA,"0.1.4"
"39025","646",2023-10-12 12:00:00,-21737,1913,23650,907,FALSE,NA,"0.1.4"
"39026","646",2023-10-12 12:15:00,-21737,1913,23650,907,FALSE,NA,"0.1.4"
"39027","646",2023-10-12 12:30:00,-21737,1913,23650,907,FALSE,NA,"0.1.4"
"39028","646",2023-10-12 12:45:00,-21737,1913,23650,907,FALSE,NA,"0.1.4"
"39029","646",2023-10-12 13:00:00,-21737,1913,23650,907,FALSE,NA,"0.1.4"
"39030","646",2023-10-12 13:15:00,-21737,1913,23650,907,FALSE,NA,"0.1.4"
"39031","646",2023-10-12 13:30:00,-21737,1913,23650,907,FALSE,NA,"0.1.4"
"39032","646",2023-10-12 13:45:00,-21736,1913,23649,907,FALSE,NA,"0.1.4"
"39033","646",2023-10-12 14:00:00,-21737,1913,23650,907,FALSE,NA,"0.1.4"
"39034","646",2023-10-12 14:15:00,-21737,1913,23650,907,FALSE,NA,"0.1.4"
"39035","646",2023-10-12 14:30:00,-21738,1913,23651,907,FALSE,NA,"0.1.4"
"39036","646",2023-10-12 14:45:00,-21742,1913,23655,907,FALSE,NA,"0.1.4"
"39037","646",2023-10-12 15:00:00,-21741,1913,23654,907,FALSE,NA,"0.1.4"
"39038","646",2023-10-12 15:15:00,-21742,1913,23655,907,FALSE,NA,"0.1.4"
"39039","646",2023-10-12 15:30:00,-21741,1913,23654,907,FALSE,NA,"0.1.4"
"39040","646",2023-10-12 15:45:00,-21742,1913,23655,907,FALSE,NA,"0.1.4"
"39041","646",2023-10-12 16:00:00,-21742,1913,23655,907,FALSE,NA,"0.1.4"
"39042","646",2023-10-12 16:15:00,-21742,1913,23655,907,FALSE,NA,"0.1.4"
"39043","646",2023-10-12 16:30:00,-21742,1913,23655,907,FALSE,NA,"0.1.4"
"39044","646",2023-10-12 16:45:00,-21742,1913,23655,907,FALSE,NA,"0.1.4"
"39045","646",2023-10-12 17:00:00,-21742,1913,23655,907,FALSE,NA,"0.1.4"
"39046","646",2023-10-12 17:15:00,-21742,1913,23655,907,FALSE,NA,"0.1.4"
"39047","646",2023-10-12 17:30:00,-21742,1913,23655,907,FALSE,NA,"0.1.4"
"39048","646",2023-10-12 17:45:00,-21741,1913,23654,907,FALSE,NA,"0.1.4"
"39049","646",2023-10-12 18:00:00,-21741,1913,23654,907,FALSE,NA,"0.1.4"
"39050","646",2023-10-12 18:15:00,-21741,1913,23654,907,FALSE,NA,"0.1.4"
"39051","646",2023-10-12 18:30:00,-21741,1913,23654,907,FALSE,NA,"0.1.4"
"39052","646",2023-10-12 18:45:00,-21734,1913,23647,907,FALSE,NA,"0.1.4"
"39053","646",2023-10-12 19:00:00,-21721,1913,23634,907,FALSE,NA,"0.1.4"
"39054","646",2023-10-12 19:15:00,-21737,1913,23650,907,FALSE,NA,"0.1.4"
"39055","646",2023-10-12 19:30:00,-21736,1913,23649,907,FALSE,NA,"0.1.4"
"39056","646",2023-10-12 19:45:00,-21739,1913,23652,907,FALSE,NA,"0.1.4"
"39057","646",2023-10-12 20:00:00,-21738,1913,23651,907,FALSE,NA,"0.1.4"
"39058","646",2023-10-12 20:15:00,-21739,1913,23652,907,FALSE,NA,"0.1.4"
"39059","646",2023-10-12 20:30:00,-21739,1913,23652,907,FALSE,NA,"0.1.4"
"39060","646",2023-10-12 20:45:00,-21738,1913,23651,907,FALSE,NA,"0.1.4"
"39061","646",2023-10-12 21:00:00,-21739,1913,23652,907,FALSE,NA,"0.1.4"
"39062","646",2023-10-12 21:15:00,-21727,1913,23640,907,FALSE,NA,"0.1.4"
"39063","646",2023-10-12 21:30:00,-21729,1913,23642,907,FALSE,NA,"0.1.4"
"39064","646",2023-10-12 21:45:00,-21727,1913,23640,907,FALSE,NA,"0.1.4"
"39065","646",2023-10-12 22:00:00,-21726,1913,23639,907,FALSE,NA,"0.1.4"
"39066","646",2023-10-12 22:15:00,-21729,1913,23642,907,FALSE,NA,"0.1.4"
"39067","646",2023-10-12 22:30:00,-21736,1913,23649,907,FALSE,NA,"0.1.4"
"39068","646",2023-10-12 22:45:00,-21735,1913,23648,907,FALSE,NA,"0.1.4"
"39069","646",2023-10-12 23:00:00,-21735,1913,23648,907,FALSE,NA,"0.1.4"
"39070","646",2023-10-12 23:15:00,-21735,1913,23648,907,FALSE,NA,"0.1.4"
"39071","646",2023-10-12 23:30:00,-21734,1913,23647,907,FALSE,NA,"0.1.4"
"39072","646",2023-10-12 23:45:00,-21735,1913,23648,907,FALSE,NA,"0.1.4"
"39073","646",2023-10-13,-21734,1913,23647,907,FALSE,NA,"0.1.4"
"39074","646",2023-10-13 00:15:00,-21734,1913,23647,907,FALSE,NA,"0.1.4"
"39075","646",2023-10-13 00:30:00,-21734,1913,23647,907,FALSE,NA,"0.1.4"
"39076","646",2023-10-13 00:45:00,-21735,1913,23648,907,FALSE,NA,"0.1.4"
"39077","646",2023-10-13 01:00:00,-21735,1913,23648,907,FALSE,NA,"0.1.4"
"39078","646",2023-10-13 01:15:00,-21737,1913,23650,907,FALSE,NA,"0.1.4"
"39079","646",2023-10-13 01:30:00,-21732,1913,23645,907,FALSE,NA,"0.1.4"
"39080","646",2023-10-13 01:45:00,-21733,1913,23646,907,FALSE,NA,"0.1.4"
"39081","646",2023-10-13 02:00:00,-21720,1913,23633,907,FALSE,NA,"0.1.4"
"39082","646",2023-10-13 02:15:00,-21725,1913,23638,907,FALSE,NA,"0.1.4"
"39083","646",2023-10-13 02:30:00,-21784,1913,23697,907,FALSE,NA,"0.1.4"
"39084","646",2023-10-13 02:45:00,-21845,1913,23758,907,FALSE,NA,"0.1.4"
"39085","646",2023-10-13 03:00:00,-21804,1913,23717,907,FALSE,NA,"0.1.4"
"39086","646",2023-10-13 03:15:00,-21834,1913,23747,907,FALSE,NA,"0.1.4"
"39087","646",2023-10-13 03:30:00,-21750,1913,23663,907,FALSE,NA,"0.1.4"
"39088","646",2023-10-13 03:45:00,-21748,1913,23661,907,FALSE,NA,"0.1.4"
"39089","646",2023-10-13 04:00:00,-21751,1913,23664,907,FALSE,NA,"0.1.4"
"39090","646",2023-10-13 04:15:00,-21749,1913,23662,907,FALSE,NA,"0.1.4"
"39091","646",2023-10-13 04:30:00,-21800,1913,23713,907,FALSE,NA,"0.1.4"
"39092","646",2023-10-13 04:45:00,-21846,1913,23759,907,FALSE,NA,"0.1.4"
"39093","646",2023-10-13 05:00:00,-22165,1913,24078,907,FALSE,NA,"0.1.4"
"39094","646",2023-10-13 05:15:00,-21800,1913,23713,907,FALSE,NA,"0.1.4"
"39095","646",2023-10-13 05:30:00,-21809,1913,23722,907,FALSE,NA,"0.1.4"
"39096","646",2023-10-13 05:45:00,-21961,1913,23874,907,FALSE,NA,"0.1.4"
"39097","646",2023-10-13 06:00:00,-21868,1913,23781,907,FALSE,NA,"0.1.4"
"39098","646",2023-10-13 06:15:00,-21811,1913,23724,907,FALSE,NA,"0.1.4"
"39099","646",2023-10-13 06:30:00,-21751,1913,23664,907,FALSE,NA,"0.1.4"
"39100","646",2023-10-13 06:45:00,-22048,1913,23961,907,FALSE,NA,"0.1.4"
"39101","646",2023-10-13 07:00:00,-22050,1913,23963,907,FALSE,NA,"0.1.4"
"39102","646",2023-10-13 07:15:00,-22190,1913,24103,907,FALSE,NA,"0.1.4"
"39103","646",2023-10-13 07:30:00,-21774,1913,23687,907,FALSE,NA,"0.1.4"
"39104","646",2023-10-13 07:45:00,-21748,1913,23661,907,FALSE,NA,"0.1.4"
"39105","646",2023-10-13 08:00:00,-21753,1913,23666,907,FALSE,NA,"0.1.4"
"39106","646",2023-10-13 08:15:00,-21752,1913,23665,907,FALSE,NA,"0.1.4"
"39107","646",2023-10-13 08:30:00,-21749,1913,23662,907,FALSE,NA,"0.1.4"
"39108","646",2023-10-13 08:45:00,-21757,1913,23670,907,FALSE,NA,"0.1.4"
"39109","646",2023-10-13 09:00:00,-21748,1913,23661,907,FALSE,NA,"0.1.4"
"39110","646",2023-10-13 09:15:00,-21752,1913,23665,907,FALSE,NA,"0.1.4"
"39111","646",2023-10-13 09:30:00,-22225,1913,24138,907,FALSE,NA,"0.1.4"
"39112","646",2023-10-13 09:45:00,-22241,1913,24154,907,FALSE,NA,"0.1.4"
"39113","646",2023-10-13 10:00:00,-21821,1913,23734,907,FALSE,NA,"0.1.4"
"39114","646",2023-10-13 10:15:00,-21821,1913,23734,907,FALSE,"jump1","0.1.4"
"39115","646",2023-10-13 10:30:00,-21821,1913,23734,907,FALSE,"jump1","0.1.4"
"39116","646",2023-10-13 10:45:00,-21791,1913,23704,907,FALSE,NA,"0.1.4"
"39117","646",2023-10-13 11:00:00,-22110,1913,24023,907,FALSE,NA,"0.1.4"
"39118","646",2023-10-13 11:15:00,-22038,1913,23951,907,FALSE,NA,"0.1.4"
"39119","646",2023-10-13 11:30:00,-21827,1913,23740,907,FALSE,NA,"0.1.4"
"39120","646",2023-10-13 11:45:00,-21812,1913,23725,907,FALSE,NA,"0.1.4"
"39121","646",2023-10-13 12:00:00,-21827,1913,23740,907,FALSE,NA,"0.1.4"
"39122","646",2023-10-13 12:15:00,-21804,1913,23717,907,FALSE,NA,"0.1.4"
"39123","646",2023-10-13 12:30:00,-21804,1913,23717,907,FALSE,NA,"0.1.4"
"39124","646",2023-10-13 12:45:00,-21804,1913,23717,907,FALSE,NA,"0.1.4"
"39125","646",2023-10-13 13:00:00,-21783,1913,23696,907,FALSE,NA,"0.1.4"
"39126","646",2023-10-13 13:15:00,-21782,1913,23695,907,FALSE,NA,"0.1.4"
"39127","646",2023-10-13 13:30:00,-21769,1913,23682,907,FALSE,NA,"0.1.4"
"39128","646",2023-10-13 13:45:00,-22266,1913,24179,907,FALSE,NA,"0.1.4"
"39129","646",2023-10-13 14:00:00,-22414,1913,24327,907,FALSE,NA,"0.1.4"
"39130","646",2023-10-13 14:15:00,-22004,1913,23917,907,FALSE,NA,"0.1.4"
"39131","646",2023-10-13 14:30:00,-21769,1913,23682,907,TRUE,NA,"0.1.4"
"39132","646",2023-10-13 14:45:00,-21786,1913,23699,907,FALSE,NA,"0.1.4"
"39133","646",2023-10-13 15:00:00,-21803,1913,23716,907,FALSE,NA,"0.1.4"
"39134","646",2023-10-13 15:15:00,-21797,1913,23710,907,FALSE,NA,"0.1.4"
"39135","646",2023-10-13 15:30:00,-21755,1913,23668,907,FALSE,NA,"0.1.4"
"39136","646",2023-10-13 15:45:00,-21768,1913,23681,907,FALSE,NA,"0.1.4"
"39137","646",2023-10-13 16:00:00,-21769,1913,23682,907,FALSE,NA,"0.1.4"
"39138","646",2023-10-13 16:15:00,-21769,1913,23682,907,FALSE,NA,"0.1.4"
"39139","646",2023-10-13 16:30:00,-21769,1913,23682,907,FALSE,NA,"0.1.4"
"39140","646",2023-10-13 16:45:00,-21900,1913,23813,907,FALSE,NA,"0.1.4"
"39141","646",2023-10-13 17:00:00,-21780,1913,23693,907,FALSE,NA,"0.1.4"
"39142","646",2023-10-13 17:15:00,-21800,1913,23713,907,FALSE,NA,"0.1.4"
"39143","646",2023-10-13 17:30:00,-21765,1913,23678,907,FALSE,NA,"0.1.4"
"39144","646",2023-10-13 17:45:00,-21816,1913,23729,907,FALSE,NA,"0.1.4"
"39145","646",2023-10-13 18:00:00,-21764,1913,23677,907,FALSE,NA,"0.1.4"
"39146","646",2023-10-13 18:15:00,-21780,1913,23693,907,FALSE,NA,"0.1.4"
"39147","646",2023-10-13 18:30:00,-21746,1913,23659,907,FALSE,NA,"0.1.4"
"39148","646",2023-10-13 18:45:00,-21765,1913,23678,907,FALSE,NA,"0.1.4"
"39149","646",2023-10-13 19:00:00,-21772,1913,23685,907,FALSE,NA,"0.1.4"
"39150","646",2023-10-13 19:15:00,-21767,1913,23680,907,FALSE,NA,"0.1.4"
"39151","646",2023-10-13 19:30:00,-21769,1913,23682,907,FALSE,NA,"0.1.4"
"39152","646",2023-10-13 19:45:00,-21759,1913,23672,907,FALSE,NA,"0.1.4"
"39153","646",2023-10-13 20:00:00,-21756,1913,23669,907,FALSE,NA,"0.1.4"
"39154","646",2023-10-13 20:15:00,-21771,1913,23684,907,FALSE,NA,"0.1.4"
"39155","646",2023-10-13 20:30:00,-21769,1913,23682,907,FALSE,NA,"0.1.4"
"39156","646",2023-10-13 20:45:00,-21770,1913,23683,907,FALSE,NA,"0.1.4"
"39157","646",2023-10-13 21:00:00,-21772,1913,23685,907,FALSE,NA,"0.1.4"
"39158","646",2023-10-13 21:15:00,-21782,1913,23695,907,FALSE,NA,"0.1.4"
"39159","646",2023-10-13 21:30:00,-21769,1913,23682,907,FALSE,NA,"0.1.4"
"39160","646",2023-10-13 21:45:00,-21767,1913,23680,907,FALSE,NA,"0.1.4"
"39161","646",2023-10-13 22:00:00,-21767,1913,23680,907,FALSE,NA,"0.1.4"
"39162","646",2023-10-13 22:15:00,-21766,1913,23679,907,FALSE,NA,"0.1.4"
"39163","646",2023-10-13 22:30:00,-21767,1913,23680,907,FALSE,NA,"0.1.4"
"39164","646",2023-10-13 22:45:00,-21767,1913,23680,907,FALSE,NA,"0.1.4"
"39165","646",2023-10-13 23:00:00,-21767,1913,23680,907,FALSE,NA,"0.1.4"
"39166","646",2023-10-13 23:15:00,-21767,1913,23680,907,FALSE,NA,"0.1.4"
"39167","646",2023-10-13 23:30:00,-21765,1913,23678,907,FALSE,NA,"0.1.4"
"39168","646",2023-10-13 23:45:00,-21764,1913,23677,907,FALSE,NA,"0.1.4"
"39169","646",2023-10-14,-21765,1913,23678,907,FALSE,NA,"0.1.4"
"39170","646",2023-10-14 00:15:00,-21764,1913,23677,907,FALSE,NA,"0.1.4"
"39171","646",2023-10-14 00:30:00,-21766,1913,23679,907,FALSE,NA,"0.1.4"
"39172","646",2023-10-14 00:45:00,-21761,1913,23674,907,FALSE,NA,"0.1.4"
"39173","646",2023-10-14 01:00:00,-21768,1913,23681,907,FALSE,NA,"0.1.4"
"39174","646",2023-10-14 01:15:00,-21768,1913,23681,907,FALSE,NA,"0.1.4"
"39175","646",2023-10-14 01:30:00,-21770,1913,23683,907,FALSE,NA,"0.1.4"
"39176","646",2023-10-14 01:45:00,-21770,1913,23683,907,FALSE,NA,"0.1.4"
"39177","646",2023-10-14 02:00:00,-21772,1913,23685,907,FALSE,NA,"0.1.4"
"39178","646",2023-10-14 02:15:00,-21779,1913,23692,907,FALSE,NA,"0.1.4"
"39179","646",2023-10-14 02:30:00,-21872,1913,23785,907,FALSE,NA,"0.1.4"
"39180","646",2023-10-14 02:45:00,-21775,1913,23688,907,FALSE,NA,"0.1.4"
"39181","646",2023-10-14 03:00:00,-21772,1913,23685,907,FALSE,NA,"0.1.4"
"39182","646",2023-10-14 03:15:00,-21772,1913,23685,907,FALSE,"jump1","0.1.4"
"39183","646",2023-10-14 03:30:00,-21533,1913,23446,907,FALSE,NA,"0.1.4"
"39184","646",2023-10-14 03:45:00,-21258,1913,23171,907,FALSE,NA,"0.1.4"
"39185","646",2023-10-14 04:00:00,-21258,1913,23171,907,FALSE,NA,"0.1.4"
"39186","646",2023-10-14 04:15:00,-21258,1913,23171,907,FALSE,NA,"0.1.4"
"39187","646",2023-10-14 04:30:00,-21262,1913,23175,907,FALSE,NA,"0.1.4"
"39188","646",2023-10-14 04:45:00,-21665,1913,23578,907,FALSE,NA,"0.1.4"
"39189","646",2023-10-14 05:00:00,-21551,1913,23464,907,FALSE,NA,"0.1.4"
"39190","646",2023-10-14 05:15:00,-21800,1913,23713,907,FALSE,NA,"0.1.4"
"39191","646",2023-10-14 05:30:00,-21814,1913,23727,907,FALSE,NA,"0.1.4"
"39192","646",2023-10-14 05:45:00,-21908,1913,23821,907,FALSE,NA,"0.1.4"
"39193","646",2023-10-14 06:00:00,-21750,1913,23663,907,FALSE,NA,"0.1.4"
"39194","646",2023-10-14 06:15:00,-21754,1913,23667,907,FALSE,NA,"0.1.4"
"39195","646",2023-10-14 06:30:00,-21603,1913,23516,907,FALSE,NA,"0.1.4"
"39196","646",2023-10-14 06:45:00,-21260,1913,23173,907,FALSE,NA,"0.1.4"
"39197","646",2023-10-14 07:00:00,-21491,1913,23404,907,FALSE,NA,"0.1.4"
"39198","646",2023-10-14 07:15:00,-21259,1913,23172,907,FALSE,NA,"0.1.4"
"39199","646",2023-10-14 07:30:00,-21620,1913,23533,907,FALSE,NA,"0.1.4"
"39200","646",2023-10-14 07:45:00,-21672,1913,23585,907,FALSE,NA,"0.1.4"
"39201","646",2023-10-14 08:00:00,-21692,1913,23605,907,FALSE,NA,"0.1.4"
"39202","646",2023-10-14 08:15:00,-21579,1913,23492,907,FALSE,NA,"0.1.4"
"39203","646",2023-10-14 08:30:00,-21640,1913,23553,907,FALSE,NA,"0.1.4"
"39204","646",2023-10-14 08:45:00,-21723,1913,23636,907,FALSE,NA,"0.1.4"
"39205","646",2023-10-14 09:00:00,-21277,1913,23190,907,FALSE,NA,"0.1.4"
"39206","646",2023-10-14 09:15:00,-21379,1913,23292,907,FALSE,NA,"0.1.4"
"39207","646",2023-10-14 09:30:00,-21460,1913,23373,907,FALSE,NA,"0.1.4"
"39208","646",2023-10-14 09:45:00,-21405,1913,23318,907,FALSE,NA,"0.1.4"
"39209","646",2023-10-14 10:00:00,-21260,1913,23173,907,FALSE,NA,"0.1.4"
"39210","646",2023-10-14 10:15:00,-21641,1913,23554,907,FALSE,NA,"0.1.4"
"39211","646",2023-10-14 10:30:00,-21258,1913,23171,907,FALSE,NA,"0.1.4"
"39212","646",2023-10-14 10:45:00,-21258,1913,23171,907,FALSE,NA,"0.1.4"
"39213","646",2023-10-14 11:00:00,-21259,1913,23172,907,FALSE,NA,"0.1.4"
"39214","646",2023-10-14 11:15:00,-21259,1913,23172,907,FALSE,NA,"0.1.4"
"39215","646",2023-10-14 11:30:00,-21259,1913,23172,907,FALSE,NA,"0.1.4"
"39216","646",2023-10-14 11:45:00,-21274,1913,23187,907,FALSE,NA,"0.1.4"
"39217","646",2023-10-14 12:00:00,-21336,1913,23249,907,FALSE,NA,"0.1.4"
"39218","646",2023-10-14 12:15:00,-21259,1913,23172,907,FALSE,NA,"0.1.4"
"39219","646",2023-10-14 12:30:00,-21260,1913,23173,907,FALSE,NA,"0.1.4"
"39220","646",2023-10-14 12:45:00,-21257,1913,23170,907,FALSE,NA,"0.1.4"
"39221","646",2023-10-14 13:00:00,-21258,1913,23171,907,FALSE,NA,"0.1.4"
"39222","646",2023-10-14 13:15:00,-21261,1913,23174,907,FALSE,NA,"0.1.4"
"39223","646",2023-10-14 13:30:00,-21258,1913,23171,907,FALSE,NA,"0.1.4"
"39224","646",2023-10-14 13:45:00,-21710,1913,23623,907,FALSE,NA,"0.1.4"
"39225","646",2023-10-14 14:00:00,-21483,1913,23396,907,FALSE,NA,"0.1.4"
"39226","646",2023-10-14 14:15:00,-21275,1913,23188,907,FALSE,NA,"0.1.4"
"39227","646",2023-10-14 14:30:00,-21279,1913,23192,907,FALSE,NA,"0.1.4"
"39228","646",2023-10-14 14:45:00,-21275,1913,23188,907,FALSE,NA,"0.1.4"
"39229","646",2023-10-14 15:00:00,-21271,1913,23184,907,FALSE,NA,"0.1.4"
"39230","646",2023-10-14 15:15:00,-21269,1913,23182,907,FALSE,NA,"0.1.4"
"39231","646",2023-10-14 15:30:00,-21261,1913,23174,907,FALSE,NA,"0.1.4"
"39232","646",2023-10-14 15:45:00,-21253,1913,23166,907,FALSE,NA,"0.1.4"
"39233","646",2023-10-14 16:00:00,-21252,1913,23165,907,FALSE,NA,"0.1.4"
"39234","646",2023-10-14 16:15:00,-21251,1913,23164,907,FALSE,NA,"0.1.4"
"39235","646",2023-10-14 16:30:00,-21252,1913,23165,907,FALSE,NA,"0.1.4"
"39236","646",2023-10-14 16:45:00,-21252,1913,23165,907,FALSE,NA,"0.1.4"
"39237","646",2023-10-14 17:00:00,-21253,1913,23166,907,FALSE,NA,"0.1.4"
"39238","646",2023-10-14 17:15:00,-21253,1913,23166,907,FALSE,NA,"0.1.4"
"39239","646",2023-10-14 17:30:00,-21255,1913,23168,907,FALSE,NA,"0.1.4"
"39240","646",2023-10-14 17:45:00,-21259,1913,23172,907,FALSE,NA,"0.1.4"
"39241","646",2023-10-14 18:00:00,-21257,1913,23170,907,FALSE,NA,"0.1.4"
"39242","646",2023-10-14 18:15:00,-21258,1913,23171,907,FALSE,NA,"0.1.4"
"39243","646",2023-10-14 18:30:00,-21253,1913,23166,907,FALSE,NA,"0.1.4"
"39244","646",2023-10-14 18:45:00,-21250,1913,23163,907,FALSE,NA,"0.1.4"
"39245","646",2023-10-14 19:00:00,-21253,1913,23166,907,FALSE,NA,"0.1.4"
"39246","646",2023-10-14 19:15:00,-21258,1913,23171,907,FALSE,NA,"0.1.4"
"39247","646",2023-10-14 19:30:00,-21258,1913,23171,907,FALSE,NA,"0.1.4"
"39248","646",2023-10-14 19:45:00,-21258,1913,23171,907,FALSE,NA,"0.1.4"
"39249","646",2023-10-14 20:00:00,-21258,1913,23171,907,FALSE,NA,"0.1.4"
"39250","646",2023-10-14 20:15:00,-21277,1913,23190,907,FALSE,NA,"0.1.4"
"39251","646",2023-10-14 20:30:00,-21264,1913,23177,907,FALSE,NA,"0.1.4"
"39252","646",2023-10-14 20:45:00,-21352,1913,23265,907,FALSE,NA,"0.1.4"
"39253","646",2023-10-14 21:00:00,-21256,1913,23169,907,FALSE,NA,"0.1.4"
"39254","646",2023-10-14 21:15:00,-21252,1913,23165,907,FALSE,NA,"0.1.4"
"39255","646",2023-10-14 21:30:00,-21255,1913,23168,907,FALSE,NA,"0.1.4"
"39256","646",2023-10-14 21:45:00,-21256,1913,23169,907,FALSE,NA,"0.1.4"
"39257","646",2023-10-14 22:00:00,-21256,1913,23169,907,FALSE,NA,"0.1.4"
"39258","646",2023-10-14 22:15:00,-21294,1913,23207,907,FALSE,NA,"0.1.4"
"39259","646",2023-10-14 22:30:00,-21286,1913,23199,907,FALSE,NA,"0.1.4"
"39260","646",2023-10-14 22:45:00,-21253,1913,23166,907,FALSE,NA,"0.1.4"
"39261","646",2023-10-14 23:00:00,-21243,1913,23156,907,FALSE,NA,"0.1.4"
"39262","646",2023-10-14 23:15:00,-21289,1913,23202,907,FALSE,NA,"0.1.4"
"39263","646",2023-10-14 23:30:00,-21285,1913,23198,907,FALSE,NA,"0.1.4"
"39264","646",2023-10-14 23:45:00,-21290,1913,23203,907,FALSE,NA,"0.1.4"
"39265","646",2023-10-15,-21263,1913,23176,907,FALSE,NA,"0.1.4"
"39266","646",2023-10-15 00:15:00,-21244,1913,23157,907,FALSE,NA,"0.1.4"
"39267","646",2023-10-15 00:30:00,-21211,1913,23124,907,FALSE,NA,"0.1.4"
"39268","646",2023-10-15 00:45:00,-21240,1913,23153,907,FALSE,NA,"0.1.4"
"39269","646",2023-10-15 01:00:00,-21244,1913,23157,907,FALSE,NA,"0.1.4"
"39270","646",2023-10-15 01:15:00,-21299,1913,23212,907,FALSE,NA,"0.1.4"
"39271","646",2023-10-15 01:30:00,-21319,1913,23232,907,FALSE,NA,"0.1.4"
"39272","646",2023-10-15 01:45:00,-21294,1913,23207,907,FALSE,NA,"0.1.4"
"39273","646",2023-10-15 02:00:00,-21212,1913,23125,907,FALSE,NA,"0.1.4"
"39274","646",2023-10-15 02:15:00,-21213,1913,23126,907,FALSE,NA,"0.1.4"
"39275","646",2023-10-15 02:30:00,-21206,1913,23119,907,FALSE,NA,"0.1.4"
"39276","646",2023-10-15 02:45:00,-21502,1913,23415,907,FALSE,NA,"0.1.4"
"39277","646",2023-10-15 03:00:00,-21434,1913,23347,907,FALSE,NA,"0.1.4"
"39278","646",2023-10-15 03:15:00,-21217,1913,23130,907,FALSE,NA,"0.1.4"
"39279","646",2023-10-15 03:30:00,-21264,1913,23177,907,FALSE,NA,"0.1.4"
"39280","646",2023-10-15 03:45:00,-21509,1913,23422,907,FALSE,NA,"0.1.4"
"39281","646",2023-10-15 04:00:00,-21339,1913,23252,907,FALSE,NA,"0.1.4"
"39282","646",2023-10-15 04:15:00,-21268,1913,23181,907,FALSE,NA,"0.1.4"
"39283","646",2023-10-15 04:30:00,-21578,1913,23491,907,FALSE,NA,"0.1.4"
"39284","646",2023-10-15 04:45:00,-21214,1913,23127,907,FALSE,NA,"0.1.4"
"39285","646",2023-10-15 05:00:00,-21266,1913,23179,907,FALSE,NA,"0.1.4"
"39286","646",2023-10-15 05:15:00,-21275,1913,23188,907,FALSE,NA,"0.1.4"
"39287","646",2023-10-15 05:30:00,-21256,1913,23169,907,FALSE,NA,"0.1.4"
"39288","646",2023-10-15 05:45:00,-21239,1913,23152,907,FALSE,NA,"0.1.4"
"39289","646",2023-10-15 06:00:00,-21257,1913,23170,907,FALSE,NA,"0.1.4"
"39290","646",2023-10-15 06:15:00,-21230,1913,23143,907,FALSE,NA,"0.1.4"
"39291","646",2023-10-15 06:30:00,-21240,1913,23153,907,FALSE,NA,"0.1.4"
"39292","646",2023-10-15 06:45:00,-21237,1913,23150,907,FALSE,NA,"0.1.4"
"39293","646",2023-10-15 07:00:00,-21343,1913,23256,907,FALSE,NA,"0.1.4"
"39294","646",2023-10-15 07:15:00,-21384,1913,23297,907,FALSE,NA,"0.1.4"
"39295","646",2023-10-15 07:30:00,-21267,1913,23180,907,FALSE,NA,"0.1.4"
"39296","646",2023-10-15 07:45:00,-21594,1913,23507,907,FALSE,NA,"0.1.4"
"39297","646",2023-10-15 08:00:00,-21290,1913,23203,907,FALSE,NA,"0.1.4"
"39298","646",2023-10-15 08:15:00,-21325,1913,23238,907,FALSE,NA,"0.1.4"
"39299","646",2023-10-15 08:30:00,-21351,1913,23264,907,FALSE,NA,"0.1.4"
"39300","646",2023-10-15 08:45:00,-21426,1913,23339,907,FALSE,NA,"0.1.4"
"39301","646",2023-10-15 09:00:00,-21257,1913,23170,907,FALSE,NA,"0.1.4"
"39302","646",2023-10-15 09:15:00,-21435,1913,23348,907,FALSE,NA,"0.1.4"
"39303","646",2023-10-15 09:30:00,-21275,1913,23188,907,FALSE,NA,"0.1.4"
"39304","646",2023-10-15 09:45:00,-21352,1913,23265,907,FALSE,NA,"0.1.4"
"39305","646",2023-10-15 10:00:00,-21257,1913,23170,907,FALSE,NA,"0.1.4"
"39306","646",2023-10-15 10:15:00,-21257,1913,23170,907,FALSE,NA,"0.1.4"
"39307","646",2023-10-15 10:30:00,-21257,1913,23170,907,FALSE,NA,"0.1.4"
"39308","646",2023-10-15 10:45:00,-21258,1913,23171,907,FALSE,NA,"0.1.4"
"39309","646",2023-10-15 11:00:00,-21258,1913,23171,907,FALSE,NA,"0.1.4"
"39310","646",2023-10-15 11:15:00,-21258,1913,23171,907,FALSE,NA,"0.1.4"
"39311","646",2023-10-15 11:30:00,-21259,1913,23172,907,FALSE,NA,"0.1.4"
"39312","646",2023-10-15 11:45:00,-21258,1913,23171,907,FALSE,NA,"0.1.4"
"39313","646",2023-10-15 12:00:00,-21257,1913,23170,907,FALSE,NA,"0.1.4"
"39314","646",2023-10-15 12:15:00,-21345,1913,23258,907,FALSE,NA,"0.1.4"
"39315","646",2023-10-15 12:30:00,-21343,1913,23256,907,FALSE,NA,"0.1.4"
"39316","646",2023-10-15 12:45:00,-21366,1913,23279,907,FALSE,NA,"0.1.4"
"39317","646",2023-10-15 13:00:00,-21385,1913,23298,907,FALSE,NA,"0.1.4"
"39318","646",2023-10-15 13:15:00,-21762,1913,23675,907,FALSE,NA,"0.1.4"
"39319","646",2023-10-15 13:30:00,-21571,1913,23484,907,FALSE,NA,"0.1.4"
"39320","646",2023-10-15 13:45:00,-21262,1913,23175,907,FALSE,NA,"0.1.4"
"39321","646",2023-10-15 14:00:00,-21611,1913,23524,907,FALSE,NA,"0.1.4"
"39322","646",2023-10-15 14:15:00,-21289,1913,23202,907,FALSE,NA,"0.1.4"
"39323","646",2023-10-15 14:30:00,-21416,1913,23329,907,FALSE,NA,"0.1.4"
"39324","646",2023-10-15 14:45:00,-21268,1913,23181,907,FALSE,NA,"0.1.4"
"39325","646",2023-10-15 15:00:00,-21640.5,1913,23553.5,907,FALSE,"out1, fill","0.1.4"
"39326","646",2023-10-15 15:15:00,-22013,1913,23926,907,FALSE,NA,"0.1.4"
"39327","646",2023-10-15 15:30:00,-21904,1913,23817,907,FALSE,NA,"0.1.4"
"39328","646",2023-10-15 15:45:00,-21973,1913,23886,907,FALSE,NA,"0.1.4"
"39329","646",2023-10-15 16:00:00,-21986,1913,23899,907,FALSE,NA,"0.1.4"
"39330","646",2023-10-15 16:15:00,-21785,1913,23698,907,FALSE,NA,"0.1.4"
"39331","646",2023-10-15 16:30:00,-21906,1913,23819,907,FALSE,NA,"0.1.4"
"39332","646",2023-10-15 16:45:00,-21849,1913,23762,907,FALSE,NA,"0.1.4"
"39333","646",2023-10-15 17:00:00,-21568,1913,23481,907,FALSE,NA,"0.1.4"
"39334","646",2023-10-15 17:15:00,-21589,1913,23502,907,FALSE,NA,"0.1.4"
"39335","646",2023-10-15 17:30:00,-21312,1913,23225,907,FALSE,NA,"0.1.4"
"39336","646",2023-10-15 17:45:00,-21271,1913,23184,907,FALSE,NA,"0.1.4"
"39337","646",2023-10-15 18:00:00,-21295,1913,23208,907,FALSE,NA,"0.1.4"
"39338","646",2023-10-15 18:15:00,-21355,1913,23268,907,FALSE,NA,"0.1.4"
"39339","646",2023-10-15 18:30:00,-21264,1913,23177,907,FALSE,NA,"0.1.4"
"39340","646",2023-10-15 18:45:00,-21255,1913,23168,907,FALSE,NA,"0.1.4"
"39341","646",2023-10-15 19:00:00,-21257,1913,23170,907,FALSE,NA,"0.1.4"
"39342","646",2023-10-15 19:15:00,-21253,1913,23166,907,FALSE,NA,"0.1.4"
"39343","646",2023-10-15 19:30:00,-21257,1913,23170,907,FALSE,NA,"0.1.4"
"39344","646",2023-10-15 19:45:00,-21256,1913,23169,907,FALSE,NA,"0.1.4"
"39345","646",2023-10-15 20:00:00,-21258,1913,23171,907,FALSE,NA,"0.1.4"
"39346","646",2023-10-15 20:15:00,-21262,1913,23175,907,FALSE,NA,"0.1.4"
"39347","646",2023-10-15 20:30:00,-21259,1913,23172,907,FALSE,NA,"0.1.4"
"39348","646",2023-10-15 20:45:00,-21254,1913,23167,907,FALSE,NA,"0.1.4"
"39349","646",2023-10-15 21:00:00,-21256,1913,23169,907,FALSE,NA,"0.1.4"
"39350","646",2023-10-15 21:15:00,-21252,1913,23165,907,FALSE,NA,"0.1.4"
"39351","646",2023-10-15 21:30:00,-21255,1913,23168,907,FALSE,NA,"0.1.4"
"39352","646",2023-10-15 21:45:00,-21255,1913,23168,907,FALSE,NA,"0.1.4"
"39353","646",2023-10-15 22:00:00,-21256,1913,23169,907,FALSE,NA,"0.1.4"
"39354","646",2023-10-15 22:15:00,-21255,1913,23168,907,FALSE,NA,"0.1.4"
"39355","646",2023-10-15 22:30:00,-21254,1913,23167,907,FALSE,NA,"0.1.4"
"39356","646",2023-10-15 22:45:00,-21534,1913,23447,907,FALSE,NA,"0.1.4"
"39357","646",2023-10-15 23:00:00,-21271,1913,23184,907,FALSE,NA,"0.1.4"
"39358","646",2023-10-15 23:15:00,-21323,1913,23236,907,FALSE,NA,"0.1.4"
"39359","646",2023-10-15 23:30:00,-21277,1913,23190,907,FALSE,NA,"0.1.4"
"39360","646",2023-10-15 23:45:00,-21271,1913,23184,907,FALSE,NA,"0.1.4"
"39361","646",2023-10-16,-21267,1913,23180,907,FALSE,NA,"0.1.4"
"39362","646",2023-10-16 00:15:00,-21283,1913,23196,907,FALSE,NA,"0.1.4"
"39363","646",2023-10-16 00:30:00,-21284,1913,23197,907,FALSE,NA,"0.1.4"
"39364","646",2023-10-16 00:45:00,-21313,1913,23226,907,FALSE,NA,"0.1.4"
"39365","646",2023-10-16 01:00:00,-21355,1913,23268,907,FALSE,NA,"0.1.4"
"39366","646",2023-10-16 01:15:00,-21275,1913,23188,907,FALSE,NA,"0.1.4"
"39367","646",2023-10-16 01:30:00,-21273,1913,23186,907,FALSE,NA,"0.1.4"
"39368","646",2023-10-16 01:45:00,-21258,1913,23171,907,FALSE,NA,"0.1.4"
"39369","646",2023-10-16 02:00:00,-21248,1913,23161,907,FALSE,NA,"0.1.4"
"39370","646",2023-10-16 02:15:00,-21395,1913,23308,907,FALSE,NA,"0.1.4"
"39371","646",2023-10-16 02:30:00,-21352,1913,23265,907,FALSE,NA,"0.1.4"
"39372","646",2023-10-16 02:45:00,-21630,1913,23543,907,FALSE,NA,"0.1.4"
"39373","646",2023-10-16 03:00:00,-21873,1913,23786,907,FALSE,NA,"0.1.4"
"39374","646",2023-10-16 03:15:00,-21643,1913,23556,907,FALSE,NA,"0.1.4"
"39375","646",2023-10-16 03:30:00,-21539,1913,23452,907,FALSE,NA,"0.1.4"
"39376","646",2023-10-16 03:45:00,-21442,1913,23355,907,FALSE,NA,"0.1.4"
"39377","646",2023-10-16 04:00:00,-21889,1913,23802,907,FALSE,NA,"0.1.4"
"39378","646",2023-10-16 04:15:00,-21889,1913,23802,907,FALSE,"jump1","0.1.4"
"39379","646",2023-10-16 04:30:00,-21889,1913,23802,907,FALSE,"jump1","0.1.4"
"39380","646",2023-10-16 04:45:00,-21889,1913,23802,907,FALSE,"jump1","0.1.4"
"39381","646",2023-10-16 05:00:00,-22193,1913,24106,907,FALSE,NA,"0.1.4"
"39382","646",2023-10-16 05:15:00,-22478,1913,24391,907,FALSE,NA,"0.1.4"
"39383","646",2023-10-16 05:30:00,-22586,1913,24499,907,FALSE,NA,"0.1.4"
"39384","646",2023-10-16 05:45:00,-22426,1913,24339,907,FALSE,NA,"0.1.4"
"39385","646",2023-10-16 06:00:00,-22582,1913,24495,907,FALSE,NA,"0.1.4"
"39386","646",2023-10-16 06:15:00,-22460,1913,24373,907,FALSE,NA,"0.1.4"
"39387","646",2023-10-16 06:30:00,-22460,1913,24373,907,FALSE,"jump1","0.1.4"
"39388","646",2023-10-16 06:45:00,-22460,1913,24373,907,FALSE,"jump1","0.1.4"
"39389","646",2023-10-16 07:00:00,-22557,1913,24470,907,FALSE,NA,"0.1.4"
"39390","646",2023-10-16 07:15:00,-22502,1913,24415,907,FALSE,NA,"0.1.4"
"39391","646",2023-10-16 07:30:00,-22240,1913,24153,907,FALSE,NA,"0.1.4"
"39392","646",2023-10-16 07:45:00,-22529,1913,24442,907,FALSE,NA,"0.1.4"
"39393","646",2023-10-16 08:00:00,-22774,1913,24687,907,FALSE,NA,"0.1.4"
"39394","646",2023-10-16 08:15:00,-22759,1913,24672,907,FALSE,NA,"0.1.4"
"39395","646",2023-10-16 08:30:00,-22592,1913,24505,907,FALSE,NA,"0.1.4"
"39396","646",2023-10-16 08:45:00,-22578,1913,24491,907,FALSE,NA,"0.1.4"
"39397","646",2023-10-16 09:00:00,-22553.75,1913,24466.75,907,FALSE,"out1, fill","0.1.4"
"39398","646",2023-10-16 09:15:00,-22529.5,1913,24442.5,907,FALSE,"out1, fill","0.1.4"
"39399","646",2023-10-16 09:30:00,-22505.25,1913,24418.25,907,FALSE,"out1, fill","0.1.4"
"39400","646",2023-10-16 09:45:00,-22481,1913,24394,907,FALSE,"out1, fill","0.1.4"
"39401","646",2023-10-16 10:00:00,-22456.75,1913,24369.75,907,FALSE,"out1, fill","0.1.4"
"39402","646",2023-10-16 10:15:00,-22432.5,1913,24345.5,907,FALSE,"out1, fill","0.1.4"
"39403","646",2023-10-16 10:30:00,-22408.25,1913,24321.25,907,FALSE,"out1, fill","0.1.4"
"39404","646",2023-10-16 10:45:00,-22384,1913,24297,907,FALSE,NA,"0.1.4"
"39405","646",2023-10-16 11:00:00,-22471,1913,24384,907,FALSE,NA,"0.1.4"
"39406","646",2023-10-16 11:15:00,-22522,1913,24435,907,FALSE,NA,"0.1.4"
"39407","646",2023-10-16 11:30:00,-22572,1913,24485,907,FALSE,NA,"0.1.4"
"39408","646",2023-10-16 11:45:00,-22641,1913,24554,907,FALSE,NA,"0.1.4"
"39409","646",2023-10-16 12:00:00,-22640,1913,24553,907,FALSE,NA,"0.1.4"
"39410","646",2023-10-16 12:15:00,-22593,1913,24506,907,FALSE,NA,"0.1.4"
"39411","646",2023-10-16 12:30:00,-22523,1913,24436,907,FALSE,NA,"0.1.4"
"39412","646",2023-10-16 12:45:00,-22581,1913,24494,907,FALSE,NA,"0.1.4"
"39413","646",2023-10-16 13:00:00,-22663,1913,24576,907,FALSE,NA,"0.1.4"
"39414","646",2023-10-16 13:15:00,-22242.5,1913,24155.5,907,FALSE,"out1, fill","0.1.4"
"39415","646",2023-10-16 13:30:00,-21822,1913,23735,907,FALSE,NA,"0.1.4"
"39416","646",2023-10-16 13:45:00,-21823,1913,23736,907,FALSE,NA,"0.1.4"
"39417","646",2023-10-16 14:00:00,-21823,1913,23736,907,FALSE,NA,"0.1.4"
"39418","646",2023-10-16 14:15:00,-21822,1913,23735,907,FALSE,NA,"0.1.4"
"39419","646",2023-10-16 14:30:00,-21824,1913,23737,907,FALSE,NA,"0.1.4"
"39420","646",2023-10-16 14:45:00,-21826,1913,23739,907,FALSE,NA,"0.1.4"
"39421","646",2023-10-16 15:00:00,-21826,1913,23739,907,FALSE,NA,"0.1.4"
"39422","646",2023-10-16 15:15:00,-21829,1913,23742,907,FALSE,NA,"0.1.4"
"39423","646",2023-10-16 15:30:00,-21828,1913,23741,907,FALSE,NA,"0.1.4"
"39424","646",2023-10-16 15:45:00,-21827,1913,23740,907,FALSE,NA,"0.1.4"
"39425","646",2023-10-16 16:00:00,-21827,1913,23740,907,FALSE,NA,"0.1.4"
"39426","646",2023-10-16 16:15:00,-21828,1913,23741,907,FALSE,NA,"0.1.4"
"39427","646",2023-10-16 16:30:00,-21829,1913,23742,907,FALSE,NA,"0.1.4"
"39428","646",2023-10-16 16:45:00,-21826,1913,23739,907,FALSE,NA,"0.1.4"
"39429","646",2023-10-16 17:00:00,-21823,1913,23736,907,FALSE,NA,"0.1.4"
"39430","646",2023-10-16 17:15:00,-21906,1913,23819,907,FALSE,NA,"0.1.4"
"39431","646",2023-10-16 17:30:00,-21821,1913,23734,907,FALSE,NA,"0.1.4"
"39432","646",2023-10-16 17:45:00,-21821,1913,23734,907,FALSE,NA,"0.1.4"
"39433","646",2023-10-16 18:00:00,-21824,1913,23737,907,FALSE,NA,"0.1.4"
"39434","646",2023-10-16 18:15:00,-21823,1913,23736,907,FALSE,NA,"0.1.4"
"39435","646",2023-10-16 18:30:00,-21834,1913,23747,907,FALSE,NA,"0.1.4"
"39436","646",2023-10-16 18:45:00,-21821,1913,23734,907,FALSE,NA,"0.1.4"
"39437","646",2023-10-16 19:00:00,-21822,1913,23735,907,FALSE,NA,"0.1.4"
"39438","646",2023-10-16 19:15:00,-21831,1913,23744,907,FALSE,NA,"0.1.4"
"39439","646",2023-10-16 19:30:00,-22263,1913,24176,907,FALSE,NA,"0.1.4"
"39440","646",2023-10-16 19:45:00,-21897,1913,23810,907,FALSE,NA,"0.1.4"
"39441","646",2023-10-16 20:00:00,-21893,1913,23806,907,FALSE,NA,"0.1.4"
"39442","646",2023-10-16 20:15:00,-21885,1913,23798,907,FALSE,NA,"0.1.4"
"39443","646",2023-10-16 20:30:00,-21964,1913,23877,907,FALSE,NA,"0.1.4"
"39444","646",2023-10-16 20:45:00,-22106,1913,24019,907,FALSE,NA,"0.1.4"
"39445","646",2023-10-16 21:00:00,-22123,1913,24036,907,FALSE,NA,"0.1.4"
"39446","646",2023-10-16 21:15:00,-22333,1913,24246,907,FALSE,NA,"0.1.4"
"39447","646",2023-10-16 21:30:00,-22227,1913,24140,907,FALSE,NA,"0.1.4"
"39448","646",2023-10-16 21:45:00,-22188,1913,24101,907,FALSE,NA,"0.1.4"
"39449","646",2023-10-16 22:00:00,-22257,1913,24170,907,FALSE,NA,"0.1.4"
"39450","646",2023-10-16 22:15:00,-22289,1913,24202,907,FALSE,NA,"0.1.4"
"39451","646",2023-10-16 22:30:00,-21841,1913,23754,907,FALSE,NA,"0.1.4"
"39452","646",2023-10-16 22:45:00,-21835,1913,23748,907,FALSE,NA,"0.1.4"
"39453","646",2023-10-16 23:00:00,-21830,1913,23743,907,FALSE,NA,"0.1.4"
"39454","646",2023-10-16 23:15:00,-21815,1913,23728,907,FALSE,NA,"0.1.4"
"39455","646",2023-10-16 23:30:00,-21813,1913,23726,907,FALSE,NA,"0.1.4"
"39456","646",2023-10-16 23:45:00,-21816,1913,23729,907,FALSE,NA,"0.1.4"
"39457","646",2023-10-17,-21816,1913,23729,907,FALSE,NA,"0.1.4"
"39458","646",2023-10-17 00:15:00,-21820,1913,23733,907,FALSE,NA,"0.1.4"
"39459","646",2023-10-17 00:30:00,-21817,1913,23730,907,FALSE,NA,"0.1.4"
"39460","646",2023-10-17 00:45:00,-21810,1913,23723,907,FALSE,NA,"0.1.4"
"39461","646",2023-10-17 01:00:00,-21814,1913,23727,907,FALSE,NA,"0.1.4"
"39462","646",2023-10-17 01:15:00,-21814,1913,23727,907,FALSE,NA,"0.1.4"
"39463","646",2023-10-17 01:30:00,-21811,1913,23724,907,FALSE,NA,"0.1.4"
"39464","646",2023-10-17 01:45:00,-22028,1913,23941,907,FALSE,NA,"0.1.4"
"39465","646",2023-10-17 02:00:00,-22147,1913,24060,907,FALSE,NA,"0.1.4"
"39466","646",2023-10-17 02:15:00,-21940,1913,23853,907,FALSE,NA,"0.1.4"
"39467","646",2023-10-17 02:30:00,-22002,1913,23915,907,FALSE,NA,"0.1.4"
"39468","646",2023-10-17 02:45:00,-22045,1913,23958,907,FALSE,NA,"0.1.4"
"39469","646",2023-10-17 03:00:00,-22099,1913,24012,907,FALSE,NA,"0.1.4"
"39470","646",2023-10-17 03:15:00,-22001,1913,23914,907,FALSE,NA,"0.1.4"
"39471","646",2023-10-17 03:30:00,-21993,1913,23906,907,FALSE,NA,"0.1.4"
"39472","646",2023-10-17 03:45:00,-21847,1913,23760,907,FALSE,NA,"0.1.4"
"39473","646",2023-10-17 04:00:00,-21844,1913,23757,907,FALSE,NA,"0.1.4"
"39474","646",2023-10-17 04:15:00,-21847,1913,23760,907,FALSE,NA,"0.1.4"
"39475","646",2023-10-17 04:30:00,-21848,1913,23761,907,FALSE,NA,"0.1.4"
"39476","646",2023-10-17 04:45:00,-21806,1913,23719,907,FALSE,NA,"0.1.4"
"39477","646",2023-10-17 05:00:00,-21853,1913,23766,907,FALSE,NA,"0.1.4"
"39478","646",2023-10-17 05:15:00,-21853,1913,23766,907,FALSE,"jump1","0.1.4"
"39479","646",2023-10-17 05:30:00,-21703.5,1913,23616.5,907,FALSE,"out1, fill","0.1.4"
"39480","646",2023-10-17 05:45:00,-21554,1913,23467,907,FALSE,"out1, fill","0.1.4"
"39481","646",2023-10-17 06:00:00,-21404.5,1913,23317.5,907,FALSE,"out1, fill","0.1.4"
"39482","646",2023-10-17 06:15:00,-21255,1913,23168,907,FALSE,NA,"0.1.4"
"39483","646",2023-10-17 06:30:00,-21694,1913,23607,907,FALSE,NA,"0.1.4"
"39484","646",2023-10-17 06:45:00,-21727,1913,23640,907,FALSE,NA,"0.1.4"
"39485","646",2023-10-17 07:00:00,-21727,1913,23640,907,FALSE,"jump1","0.1.4"
"39486","646",2023-10-17 07:15:00,-21727,1913,23640,907,FALSE,NA,"0.1.4"
"39487","646",2023-10-17 07:30:00,-21727,1913,23640,907,FALSE,NA,"0.1.4"
"39488","646",2023-10-17 07:45:00,-21726,1913,23639,907,FALSE,NA,"0.1.4"
"39489","646",2023-10-17 08:00:00,-21725,1913,23638,907,FALSE,NA,"0.1.4"
"39490","646",2023-10-17 08:15:00,-21725,1913,23638,907,FALSE,NA,"0.1.4"
"39491","646",2023-10-17 08:30:00,-21725,1913,23638,907,FALSE,NA,"0.1.4"
"39492","646",2023-10-17 08:45:00,-21725,1913,23638,907,FALSE,NA,"0.1.4"
"39493","646",2023-10-17 09:00:00,-21724,1913,23637,907,FALSE,NA,"0.1.4"
"39494","646",2023-10-17 09:15:00,-21720,1913,23633,907,FALSE,NA,"0.1.4"
"39495","646",2023-10-17 09:30:00,-21722,1913,23635,907,FALSE,NA,"0.1.4"
"39496","646",2023-10-17 09:45:00,-21723,1913,23636,907,FALSE,NA,"0.1.4"
"39497","646",2023-10-17 10:00:00,-21723,1913,23636,907,FALSE,NA,"0.1.4"
"39498","646",2023-10-17 10:15:00,-21723,1913,23636,907,FALSE,NA,"0.1.4"
"39499","646",2023-10-17 10:30:00,-21728,1913,23641,907,FALSE,NA,"0.1.4"
"39500","646",2023-10-17 10:45:00,-21728,1913,23641,907,FALSE,NA,"0.1.4"
"39501","646",2023-10-17 11:00:00,-21723,1913,23636,907,FALSE,NA,"0.1.4"
"39502","646",2023-10-17 11:15:00,-21729,1913,23642,907,FALSE,NA,"0.1.4"
"39503","646",2023-10-17 11:30:00,-21962,1913,23875,907,FALSE,"out1, fill","0.1.4"
"39504","646",2023-10-17 11:45:00,-22195,1913,24108,907,FALSE,NA,"0.1.4"
"39505","646",2023-10-17 12:00:00,-22638,1913,24551,907,FALSE,NA,"0.1.4"
"39506","646",2023-10-17 12:15:00,-22383,1913,24296,907,FALSE,NA,"0.1.4"
"39507","646",2023-10-17 12:30:00,-22539,1913,24452,907,FALSE,NA,"0.1.4"
"39508","646",2023-10-17 12:45:00,-22346,1913,24259,907,FALSE,NA,"0.1.4"
"39509","646",2023-10-17 13:00:00,-22346,1913,24259,907,FALSE,"jump1","0.1.4"
"39510","646",2023-10-17 13:15:00,-22761,1913,24674,907,FALSE,NA,"0.1.4"
"39511","646",2023-10-17 13:30:00,-22998,1913,24911,907,FALSE,NA,"0.1.4"
"39512","646",2023-10-17 13:45:00,-22880,1913,24793,907,FALSE,NA,"0.1.4"
"39513","646",2023-10-17 14:00:00,-22850,1913,24763,907,FALSE,NA,"0.1.4"
"39514","646",2023-10-17 14:15:00,-22850,1913,24763,907,FALSE,"jump1","0.1.4"
"39515","646",2023-10-17 14:30:00,-22842,1913,24755,907,FALSE,NA,"0.1.4"
"39516","646",2023-10-17 14:45:00,-22877,1913,24790,907,FALSE,NA,"0.1.4"
"39517","646",2023-10-17 15:00:00,-22862,1913,24775,907,FALSE,NA,"0.1.4"
"39518","646",2023-10-17 15:15:00,-22868,1913,24781,907,FALSE,NA,"0.1.4"
"39519","646",2023-10-17 15:30:00,-22852,1913,24765,907,FALSE,NA,"0.1.4"
"39520","646",2023-10-17 15:45:00,-22841,1913,24754,907,FALSE,NA,"0.1.4"
"39521","646",2023-10-17 16:00:00,-22842,1913,24755,907,FALSE,NA,"0.1.4"
"39522","646",2023-10-17 16:15:00,-22854,1913,24767,907,FALSE,NA,"0.1.4"
"39523","646",2023-10-17 16:30:00,-23120,1913,25033,907,FALSE,NA,"0.1.4"
"39524","646",2023-10-17 16:45:00,-22908,1913,24821,907,FALSE,NA,"0.1.4"
"39525","646",2023-10-17 17:00:00,-22876,1913,24789,907,FALSE,NA,"0.1.4"
"39526","646",2023-10-17 17:15:00,-22884,1913,24797,907,FALSE,NA,"0.1.4"
"39527","646",2023-10-17 17:30:00,-22862,1913,24775,907,FALSE,NA,"0.1.4"
"39528","646",2023-10-17 17:45:00,-22851,1913,24764,907,FALSE,NA,"0.1.4"
"39529","646",2023-10-17 18:00:00,-22867,1913,24780,907,FALSE,NA,"0.1.4"
"39530","646",2023-10-17 18:15:00,-22838,1913,24751,907,FALSE,NA,"0.1.4"
"39531","646",2023-10-17 18:30:00,-22848,1913,24761,907,FALSE,NA,"0.1.4"
"39532","646",2023-10-17 18:45:00,-22836,1913,24749,907,FALSE,NA,"0.1.4"
"39533","646",2023-10-17 19:00:00,-22846,1913,24759,907,FALSE,NA,"0.1.4"
"39534","646",2023-10-17 19:15:00,-22846,1913,24759,907,FALSE,NA,"0.1.4"
"39535","646",2023-10-17 19:30:00,-22841,1913,24754,907,FALSE,NA,"0.1.4"
"39536","646",2023-10-17 19:45:00,-22857,1913,24770,907,FALSE,NA,"0.1.4"
"39537","646",2023-10-17 20:00:00,-22844,1913,24757,907,FALSE,NA,"0.1.4"
"39538","646",2023-10-17 20:15:00,-22845,1913,24758,907,FALSE,NA,"0.1.4"
"39539","646",2023-10-17 20:30:00,-22845,1913,24758,907,FALSE,NA,"0.1.4"
"39540","646",2023-10-17 20:45:00,-22845,1913,24758,907,FALSE,NA,"0.1.4"
"39541","646",2023-10-17 21:00:00,-22844,1913,24757,907,FALSE,NA,"0.1.4"
"39542","646",2023-10-17 21:15:00,-22843,1913,24756,907,FALSE,NA,"0.1.4"
"39543","646",2023-10-17 21:30:00,-22844,1913,24757,907,FALSE,NA,"0.1.4"
"39544","646",2023-10-17 21:45:00,-22843,1913,24756,907,FALSE,NA,"0.1.4"
"39545","646",2023-10-17 22:00:00,-22844,1913,24757,907,FALSE,NA,"0.1.4"
"39546","646",2023-10-17 22:15:00,-22840,1913,24753,907,FALSE,NA,"0.1.4"
"39547","646",2023-10-17 22:30:00,-22840,1913,24753,907,FALSE,NA,"0.1.4"
"39548","646",2023-10-17 22:45:00,-22840,1913,24753,907,FALSE,NA,"0.1.4"
"39549","646",2023-10-17 23:00:00,-22842,1913,24755,907,FALSE,NA,"0.1.4"
"39550","646",2023-10-17 23:15:00,-22843,1913,24756,907,FALSE,NA,"0.1.4"
"39551","646",2023-10-17 23:30:00,-22841,1913,24754,907,FALSE,NA,"0.1.4"
"39552","646",2023-10-17 23:45:00,-22840,1913,24753,907,FALSE,NA,"0.1.4"
"39553","646",2023-10-18,-22842,1913,24755,907,FALSE,NA,"0.1.4"
"39554","646",2023-10-18 00:15:00,-22851,1913,24764,907,FALSE,NA,"0.1.4"
"39555","646",2023-10-18 00:30:00,-22847,1913,24760,907,FALSE,NA,"0.1.4"
"39556","646",2023-10-18 00:45:00,-22847,1913,24760,907,FALSE,NA,"0.1.4"
"39557","646",2023-10-18 01:00:00,-22852,1913,24765,907,FALSE,NA,"0.1.4"
"39558","646",2023-10-18 01:15:00,-22842,1913,24755,907,FALSE,NA,"0.1.4"
"39559","646",2023-10-18 01:30:00,-22845,1913,24758,907,FALSE,NA,"0.1.4"
"39560","646",2023-10-18 01:45:00,-22841,1913,24754,907,FALSE,NA,"0.1.4"
"39561","646",2023-10-18 02:00:00,-22831,1913,24744,907,FALSE,NA,"0.1.4"
"39562","646",2023-10-18 02:15:00,-22846,1913,24759,907,FALSE,NA,"0.1.4"
"39563","646",2023-10-18 02:30:00,-22993,1913,24906,907,FALSE,NA,"0.1.4"
"39564","646",2023-10-18 02:45:00,-23400,1913,25313,907,FALSE,NA,"0.1.4"
"39565","646",2023-10-18 03:00:00,-23554,1913,25467,907,FALSE,NA,"0.1.4"
"39566","646",2023-10-18 03:15:00,-23661,1913,25574,907,FALSE,NA,"0.1.4"
"39567","646",2023-10-18 03:30:00,-23664,1913,25577,907,FALSE,NA,"0.1.4"
"39568","646",2023-10-18 03:45:00,-23486,1913,25399,907,FALSE,NA,"0.1.4"
"39569","646",2023-10-18 04:00:00,-23303,1913,25216,907,FALSE,NA,"0.1.4"
"39570","646",2023-10-18 04:15:00,-22900,1913,24813,907,FALSE,NA,"0.1.4"
"39571","646",2023-10-18 04:30:00,-23222,1913,25135,907,FALSE,NA,"0.1.4"
"39572","646",2023-10-18 04:45:00,-22908,1913,24821,907,FALSE,NA,"0.1.4"
"39573","646",2023-10-18 05:00:00,-22963,1913,24876,907,FALSE,NA,"0.1.4"
"39574","646",2023-10-18 05:15:00,-22839,1913,24752,907,FALSE,NA,"0.1.4"
"39575","646",2023-10-18 05:30:00,-22929.5,1913,24842.5,907,FALSE,"out1, fill","0.1.4"
"39576","646",2023-10-18 05:45:00,-23020,1913,24933,907,FALSE,NA,"0.1.4"
"39577","646",2023-10-18 06:00:00,-22846,1913,24759,907,FALSE,NA,"0.1.4"
"39578","646",2023-10-18 06:15:00,-23112,1913,25025,907,FALSE,NA,"0.1.4"
"39579","646",2023-10-18 06:30:00,-23303,1913,25216,907,FALSE,NA,"0.1.4"
"39580","646",2023-10-18 06:45:00,-23066,1913,24979,907,FALSE,NA,"0.1.4"
"39581","646",2023-10-18 07:00:00,-23291,1913,25204,907,FALSE,NA,"0.1.4"
"39582","646",2023-10-18 07:15:00,-23024,1913,24937,907,FALSE,NA,"0.1.4"
"39583","646",2023-10-18 07:30:00,-23200,1913,25113,907,FALSE,NA,"0.1.4"
"39584","646",2023-10-18 07:45:00,-23332,1913,25245,907,FALSE,NA,"0.1.4"
"39585","646",2023-10-18 08:00:00,-22862,1913,24775,907,FALSE,NA,"0.1.4"
"39586","646",2023-10-18 08:15:00,-22837,1913,24750,907,FALSE,NA,"0.1.4"
"39587","646",2023-10-18 08:30:00,-22828,1913,24741,907,FALSE,NA,"0.1.4"
"39588","646",2023-10-18 08:45:00,-22990,1913,24903,907,FALSE,NA,"0.1.4"
"39589","646",2023-10-18 09:00:00,-22897,1913,24810,907,FALSE,NA,"0.1.4"
"39590","646",2023-10-18 09:15:00,-22842,1913,24755,907,FALSE,NA,"0.1.4"
"39591","646",2023-10-18 09:30:00,-22815,1913,24728,907,FALSE,NA,"0.1.4"
"39592","646",2023-10-18 09:45:00,-22913,1913,24826,907,FALSE,NA,"0.1.4"
"39593","646",2023-10-18 10:00:00,-22817,1913,24730,907,FALSE,NA,"0.1.4"
"39594","646",2023-10-18 10:15:00,-22814,1913,24727,907,FALSE,NA,"0.1.4"
"39595","646",2023-10-18 10:30:00,-22805,1913,24718,907,FALSE,NA,"0.1.4"
"39596","646",2023-10-18 10:45:00,-22835,1913,24748,907,FALSE,NA,"0.1.4"
"39597","646",2023-10-18 11:00:00,-22825,1913,24738,907,FALSE,NA,"0.1.4"
"39598","646",2023-10-18 11:15:00,-22818,1913,24731,907,FALSE,NA,"0.1.4"
"39599","646",2023-10-18 11:30:00,-22814,1913,24727,907,FALSE,NA,"0.1.4"
"39600","646",2023-10-18 11:45:00,-22817,1913,24730,907,FALSE,NA,"0.1.4"
"39601","646",2023-10-18 12:00:00,-22821,1913,24734,907,FALSE,NA,"0.1.4"
"39602","646",2023-10-18 12:15:00,-22837,1913,24750,907,FALSE,NA,"0.1.4"
"39603","646",2023-10-18 12:30:00,-22810,1913,24723,907,FALSE,NA,"0.1.4"
"39604","646",2023-10-18 12:45:00,-22799,1913,24712,907,FALSE,NA,"0.1.4"
"39605","646",2023-10-18 13:00:00,-22826,1913,24739,907,FALSE,NA,"0.1.4"
"39606","646",2023-10-18 13:15:00,-22872,1913,24785,907,FALSE,NA,"0.1.4"
"39607","646",2023-10-18 13:30:00,-23174,1913,25087,907,FALSE,NA,"0.1.4"
"39608","646",2023-10-18 13:45:00,-22916,1913,24829,907,FALSE,NA,"0.1.4"
"39609","646",2023-10-18 14:00:00,-22842,1913,24755,907,FALSE,NA,"0.1.4"
"39610","646",2023-10-18 14:15:00,-22851,1913,24764,907,FALSE,NA,"0.1.4"
"39611","646",2023-10-18 14:30:00,-23071,1913,24984,907,FALSE,NA,"0.1.4"
"39612","646",2023-10-18 14:45:00,-23029,1913,24942,907,FALSE,NA,"0.1.4"
"39613","646",2023-10-18 15:00:00,-22922,1913,24835,907,FALSE,NA,"0.1.4"
"39614","646",2023-10-18 15:15:00,-22844,1913,24757,907,FALSE,NA,"0.1.4"
"39615","646",2023-10-18 15:30:00,-22845,1913,24758,907,FALSE,NA,"0.1.4"
"39616","646",2023-10-18 15:45:00,-22848,1913,24761,907,FALSE,NA,"0.1.4"
"39617","646",2023-10-18 16:00:00,-22848,1913,24761,907,FALSE,NA,"0.1.4"
"39618","646",2023-10-18 16:15:00,-22846,1913,24759,907,FALSE,NA,"0.1.4"
"39619","646",2023-10-18 16:30:00,-22845,1913,24758,907,FALSE,NA,"0.1.4"
"39620","646",2023-10-18 16:45:00,-22842,1913,24755,907,FALSE,NA,"0.1.4"
"39621","646",2023-10-18 17:00:00,-22998,1913,24911,907,FALSE,NA,"0.1.4"
"39622","646",2023-10-18 17:15:00,-22828,1913,24741,907,FALSE,NA,"0.1.4"
"39623","646",2023-10-18 17:30:00,-22794,1913,24707,907,FALSE,NA,"0.1.4"
"39624","646",2023-10-18 17:45:00,-22804,1913,24717,907,FALSE,NA,"0.1.4"
"39625","646",2023-10-18 18:00:00,-22826,1913,24739,907,FALSE,NA,"0.1.4"
"39626","646",2023-10-18 18:15:00,-22825,1913,24738,907,FALSE,NA,"0.1.4"
"39627","646",2023-10-18 18:30:00,-22806,1913,24719,907,FALSE,NA,"0.1.4"
"39628","646",2023-10-18 18:45:00,-22822,1913,24735,907,FALSE,NA,"0.1.4"
"39629","646",2023-10-18 19:00:00,-22823,1913,24736,907,FALSE,NA,"0.1.4"
"39630","646",2023-10-18 19:15:00,-22816,1913,24729,907,FALSE,NA,"0.1.4"
"39631","646",2023-10-18 19:30:00,-22810,1913,24723,907,FALSE,NA,"0.1.4"
"39632","646",2023-10-18 19:45:00,-22818,1913,24731,907,FALSE,NA,"0.1.4"
"39633","646",2023-10-18 20:00:00,-22829,1913,24742,907,FALSE,NA,"0.1.4"
"39634","646",2023-10-18 20:15:00,-22864,1913,24777,907,FALSE,NA,"0.1.4"
"39635","646",2023-10-18 20:30:00,-22829,1913,24742,907,FALSE,NA,"0.1.4"
"39636","646",2023-10-18 20:45:00,-22834,1913,24747,907,FALSE,NA,"0.1.4"
"39637","646",2023-10-18 21:00:00,-22839,1913,24752,907,FALSE,NA,"0.1.4"
"39638","646",2023-10-18 21:15:00,-22869,1913,24782,907,FALSE,NA,"0.1.4"
"39639","646",2023-10-18 21:30:00,-22834,1913,24747,907,FALSE,NA,"0.1.4"
"39640","646",2023-10-18 21:45:00,-22839,1913,24752,907,FALSE,NA,"0.1.4"
"39641","646",2023-10-18 22:00:00,-22852,1913,24765,907,FALSE,NA,"0.1.4"
"39642","646",2023-10-18 22:15:00,-22874,1913,24787,907,FALSE,NA,"0.1.4"
"39643","646",2023-10-18 22:30:00,-22839,1913,24752,907,FALSE,NA,"0.1.4"
"39644","646",2023-10-18 22:45:00,-22837,1913,24750,907,FALSE,NA,"0.1.4"
"39645","646",2023-10-18 23:00:00,-22839,1913,24752,907,FALSE,NA,"0.1.4"
"39646","646",2023-10-18 23:15:00,-22839,1913,24752,907,FALSE,NA,"0.1.4"
"39647","646",2023-10-18 23:30:00,-22839,1913,24752,907,FALSE,NA,"0.1.4"
"39648","646",2023-10-18 23:45:00,-22839,1913,24752,907,FALSE,NA,"0.1.4"
"39649","646",2023-10-19,-22839,1913,24752,907,FALSE,NA,"0.1.4"
"39650","646",2023-10-19 00:15:00,-22839,1913,24752,907,FALSE,NA,"0.1.4"
"39651","646",2023-10-19 00:30:00,-22839,1913,24752,907,FALSE,NA,"0.1.4"
"39652","646",2023-10-19 00:45:00,-22839,1913,24752,907,FALSE,NA,"0.1.4"
"39653","646",2023-10-19 01:00:00,-22805,1913,24718,907,FALSE,NA,"0.1.4"
"39654","646",2023-10-19 01:15:00,-23143,1913,25056,907,FALSE,NA,"0.1.4"
"39655","646",2023-10-19 01:30:00,-22773,1913,24686,907,FALSE,NA,"0.1.4"
"39656","646",2023-10-19 01:45:00,-22776,1913,24689,907,FALSE,NA,"0.1.4"
"39657","646",2023-10-19 02:00:00,-22840,1913,24753,907,FALSE,NA,"0.1.4"
"39658","646",2023-10-19 02:15:00,-22977,1913,24890,907,FALSE,NA,"0.1.4"
"39659","646",2023-10-19 02:30:00,-22896,1913,24809,907,FALSE,NA,"0.1.4"
"39660","646",2023-10-19 02:45:00,-23118,1913,25031,907,FALSE,NA,"0.1.4"
"39661","646",2023-10-19 03:00:00,-22838,1913,24751,907,FALSE,NA,"0.1.4"
"39662","646",2023-10-19 03:15:00,-22839,1913,24752,907,FALSE,NA,"0.1.4"
"39663","646",2023-10-19 03:30:00,-22839,1913,24752,907,FALSE,NA,"0.1.4"
"39664","646",2023-10-19 03:45:00,-22839,1913,24752,907,FALSE,NA,"0.1.4"
"39665","646",2023-10-19 04:00:00,-22840,1913,24753,907,FALSE,NA,"0.1.4"
"39666","646",2023-10-19 04:15:00,-22839,1913,24752,907,FALSE,NA,"0.1.4"
"39667","646",2023-10-19 04:30:00,-22845,1913,24758,907,FALSE,NA,"0.1.4"
"39668","646",2023-10-19 04:45:00,-22865,1913,24778,907,FALSE,NA,"0.1.4"
"39669","646",2023-10-19 05:00:00,-23213,1913,25126,907,FALSE,NA,"0.1.4"
"39670","646",2023-10-19 05:15:00,-22839,1913,24752,907,FALSE,NA,"0.1.4"
"39671","646",2023-10-19 05:30:00,-22838,1913,24751,907,FALSE,NA,"0.1.4"
"39672","646",2023-10-19 05:45:00,-23031,1913,24944,907,FALSE,NA,"0.1.4"
"39673","646",2023-10-19 06:00:00,-22978,1913,24891,907,FALSE,NA,"0.1.4"
"39674","646",2023-10-19 06:15:00,-23087,1913,25000,907,FALSE,NA,"0.1.4"
"39675","646",2023-10-19 06:30:00,-22836,1913,24749,907,FALSE,NA,"0.1.4"
"39676","646",2023-10-19 06:45:00,-23003,1913,24916,907,FALSE,NA,"0.1.4"
"39677","646",2023-10-19 07:00:00,-22866,1913,24779,907,FALSE,NA,"0.1.4"
"39678","646",2023-10-19 07:15:00,-22851,1913,24764,907,FALSE,NA,"0.1.4"
"39679","646",2023-10-19 07:30:00,-22849,1913,24762,907,FALSE,NA,"0.1.4"
"39680","646",2023-10-19 07:45:00,-22847,1913,24760,907,FALSE,NA,"0.1.4"
"39681","646",2023-10-19 08:00:00,-22955,1913,24868,907,FALSE,NA,"0.1.4"
"39682","646",2023-10-19 08:15:00,-22837,1913,24750,907,FALSE,NA,"0.1.4"
"39683","646",2023-10-19 08:30:00,-22831,1913,24744,907,FALSE,NA,"0.1.4"
"39684","646",2023-10-19 08:45:00,-22838,1913,24751,907,FALSE,NA,"0.1.4"
"39685","646",2023-10-19 09:00:00,-22836,1913,24749,907,FALSE,NA,"0.1.4"
"39686","646",2023-10-19 09:15:00,-22834,1913,24747,907,FALSE,NA,"0.1.4"
"39687","646",2023-10-19 09:30:00,-22832,1913,24745,907,FALSE,NA,"0.1.4"
"39688","646",2023-10-19 09:45:00,-22836,1913,24749,907,FALSE,NA,"0.1.4"
"39689","646",2023-10-19 10:00:00,-22836,1913,24749,907,FALSE,NA,"0.1.4"
"39690","646",2023-10-19 10:15:00,-22842,1913,24755,907,FALSE,NA,"0.1.4"
"39691","646",2023-10-19 10:30:00,-22899,1913,24812,907,FALSE,NA,"0.1.4"
"39692","646",2023-10-19 10:45:00,-22900,1913,24813,907,FALSE,NA,"0.1.4"
"39693","646",2023-10-19 11:00:00,-23336,1913,25249,907,FALSE,NA,"0.1.4"
"39694","646",2023-10-19 11:15:00,-23217,1913,25130,907,FALSE,NA,"0.1.4"
"39695","646",2023-10-19 11:30:00,-23046,1913,24959,907,FALSE,NA,"0.1.4"
"39696","646",2023-10-19 11:45:00,-23280,1913,25193,907,FALSE,NA,"0.1.4"
"39697","646",2023-10-19 12:00:00,-22838,1913,24751,907,FALSE,NA,"0.1.4"
"39698","646",2023-10-19 12:15:00,-23307,1913,25220,907,FALSE,NA,"0.1.4"
"39699","646",2023-10-19 12:30:00,-23112,1913,25025,907,FALSE,NA,"0.1.4"
"39700","646",2023-10-19 12:45:00,-23174,1913,25087,907,FALSE,NA,"0.1.4"
"39701","646",2023-10-19 13:00:00,-23267,1913,25180,907,FALSE,NA,"0.1.4"
"39702","646",2023-10-19 13:15:00,-23268,1913,25181,907,FALSE,NA,"0.1.4"
"39703","646",2023-10-19 13:30:00,-22861,1913,24774,907,FALSE,NA,"0.1.4"
"39704","646",2023-10-19 13:45:00,-22900,1913,24813,907,FALSE,NA,"0.1.4"
"39705","646",2023-10-19 14:00:00,-23193,1913,25106,907,FALSE,NA,"0.1.4"
"39706","646",2023-10-19 14:15:00,-23110,1913,25023,907,FALSE,NA,"0.1.4"
"39707","646",2023-10-19 14:30:00,-23509,1913,25422,907,FALSE,NA,"0.1.4"
"39708","646",2023-10-19 14:45:00,-23345,1913,25258,907,FALSE,NA,"0.1.4"
"39709","646",2023-10-19 15:00:00,-23389,1913,25302,907,FALSE,NA,"0.1.4"
"39710","646",2023-10-19 15:15:00,-23389,1913,25302,907,FALSE,"jump1","0.1.4"
"39711","646",2023-10-19 15:30:00,-23386,1913,25299,907,FALSE,NA,"0.1.4"
"39712","646",2023-10-19 15:45:00,-23390,1913,25303,907,FALSE,NA,"0.1.4"
"39713","646",2023-10-19 16:00:00,-23384,1913,25297,907,FALSE,NA,"0.1.4"
"39714","646",2023-10-19 16:15:00,-23382,1913,25295,907,FALSE,NA,"0.1.4"
"39715","646",2023-10-19 16:30:00,-23382,1913,25295,907,FALSE,NA,"0.1.4"
"39716","646",2023-10-19 16:45:00,-23381,1913,25294,907,FALSE,NA,"0.1.4"
"39717","646",2023-10-19 17:00:00,-23379,1913,25292,907,FALSE,NA,"0.1.4"
"39718","646",2023-10-19 17:15:00,-23380,1913,25293,907,FALSE,NA,"0.1.4"
"39719","646",2023-10-19 17:30:00,-23374,1913,25287,907,FALSE,NA,"0.1.4"
"39720","646",2023-10-19 17:45:00,-23360,1913,25273,907,FALSE,NA,"0.1.4"
"39721","646",2023-10-19 18:00:00,-23363,1913,25276,907,FALSE,NA,"0.1.4"
"39722","646",2023-10-19 18:15:00,-23363,1913,25276,907,FALSE,NA,"0.1.4"
"39723","646",2023-10-19 18:30:00,-23349,1913,25262,907,FALSE,NA,"0.1.4"
"39724","646",2023-10-19 18:45:00,-23361,1913,25274,907,FALSE,NA,"0.1.4"
"39725","646",2023-10-19 19:00:00,-23360,1913,25273,907,FALSE,NA,"0.1.4"
"39726","646",2023-10-19 19:15:00,-23360,1913,25273,907,FALSE,NA,"0.1.4"
"39727","646",2023-10-19 19:30:00,-23361,1913,25274,907,FALSE,NA,"0.1.4"
"39728","646",2023-10-19 19:45:00,-23356,1913,25269,907,FALSE,NA,"0.1.4"
"39729","646",2023-10-19 20:00:00,-23363,1913,25276,907,FALSE,NA,"0.1.4"
"39730","646",2023-10-19 20:15:00,-23363,1913,25276,907,FALSE,NA,"0.1.4"
"39731","646",2023-10-19 20:30:00,-23363,1913,25276,907,FALSE,NA,"0.1.4"
"39732","646",2023-10-19 20:45:00,-23359,1913,25272,907,FALSE,NA,"0.1.4"
"39733","646",2023-10-19 21:00:00,-23363,1913,25276,907,FALSE,NA,"0.1.4"
"39734","646",2023-10-19 21:15:00,-23352,1913,25265,907,FALSE,NA,"0.1.4"
"39735","646",2023-10-19 21:30:00,-23373,1913,25286,907,FALSE,NA,"0.1.4"
"39736","646",2023-10-19 21:45:00,-23363,1913,25276,907,FALSE,NA,"0.1.4"
"39737","646",2023-10-19 22:00:00,-23360,1913,25273,907,FALSE,NA,"0.1.4"
"39738","646",2023-10-19 22:15:00,-23359,1913,25272,907,FALSE,NA,"0.1.4"
"39739","646",2023-10-19 22:30:00,-23352,1913,25265,907,FALSE,NA,"0.1.4"
"39740","646",2023-10-19 22:45:00,-23357,1913,25270,907,FALSE,NA,"0.1.4"
"39741","646",2023-10-19 23:00:00,-23359,1913,25272,907,FALSE,NA,"0.1.4"
"39742","646",2023-10-19 23:15:00,-23359,1913,25272,907,FALSE,NA,"0.1.4"
"39743","646",2023-10-19 23:30:00,-23357,1913,25270,907,FALSE,NA,"0.1.4"
"39744","646",2023-10-19 23:45:00,-23357,1913,25270,907,FALSE,NA,"0.1.4"
"39745","646",2023-10-20,-23357,1913,25270,907,FALSE,NA,"0.1.4"
"39746","646",2023-10-20 00:15:00,-23357,1913,25270,907,FALSE,NA,"0.1.4"
"39747","646",2023-10-20 00:30:00,-23362,1913,25275,907,FALSE,NA,"0.1.4"
"39748","646",2023-10-20 00:45:00,-23357,1913,25270,907,FALSE,NA,"0.1.4"
"39749","646",2023-10-20 01:00:00,-23504,1913,25417,907,FALSE,NA,"0.1.4"
"39750","646",2023-10-20 01:15:00,-23538,1913,25451,907,FALSE,NA,"0.1.4"
"39751","646",2023-10-20 01:30:00,-23586,1913,25499,907,FALSE,NA,"0.1.4"
"39752","646",2023-10-20 01:45:00,-23511,1913,25424,907,FALSE,NA,"0.1.4"
"39753","646",2023-10-20 02:00:00,-23736,1913,25649,907,FALSE,NA,"0.1.4"
"39754","646",2023-10-20 02:15:00,-23545,1913,25458,907,FALSE,NA,"0.1.4"
"39755","646",2023-10-20 02:30:00,-23532,1913,25445,907,FALSE,NA,"0.1.4"
"39756","646",2023-10-20 02:45:00,-23852,1913,25765,907,FALSE,NA,"0.1.4"
"39757","646",2023-10-20 03:00:00,-23727,1913,25640,907,FALSE,NA,"0.1.4"
"39758","646",2023-10-20 03:15:00,-23598,1913,25511,907,FALSE,NA,"0.1.4"
"39759","646",2023-10-20 03:30:00,-23598,1913,25511,907,FALSE,"jump1","0.1.4"
"39760","646",2023-10-20 03:45:00,-23569,1913,25482,907,FALSE,NA,"0.1.4"
"39761","646",2023-10-20 04:00:00,-23213,1913,25126,907,FALSE,NA,"0.1.4"
"39762","646",2023-10-20 04:15:00,-23032,1913,24945,907,FALSE,NA,"0.1.4"
"39763","646",2023-10-20 04:30:00,-23009,1913,24922,907,FALSE,NA,"0.1.4"
"39764","646",2023-10-20 04:45:00,-22975,1913,24888,907,FALSE,NA,"0.1.4"
"39765","646",2023-10-20 05:00:00,-22970,1913,24883,907,FALSE,NA,"0.1.4"
"39766","646",2023-10-20 05:15:00,-23273,1913,25186,907,FALSE,"out1, fill","0.1.4"
"39767","646",2023-10-20 05:30:00,-23576,1913,25489,907,FALSE,NA,"0.1.4"
"39768","646",2023-10-20 05:45:00,-23532,1913,25445,907,FALSE,NA,"0.1.4"
"39769","646",2023-10-20 06:00:00,-23777,1913,25690,907,FALSE,NA,"0.1.4"
"39770","646",2023-10-20 06:15:00,-23443,1913,25356,907,FALSE,NA,"0.1.4"
"39771","646",2023-10-20 06:30:00,-23515,1913,25428,907,FALSE,NA,"0.1.4"
"39772","646",2023-10-20 06:45:00,-23415,1913,25328,907,FALSE,NA,"0.1.4"
"39773","646",2023-10-20 07:00:00,-23591,1913,25504,907,FALSE,NA,"0.1.4"
"39774","646",2023-10-20 07:15:00,-23567,1913,25480,907,FALSE,NA,"0.1.4"
"39775","646",2023-10-20 07:30:00,-23567,1913,25480,907,FALSE,"jump1","0.1.4"
"39776","646",2023-10-20 07:45:00,-23978,1913,25891,907,FALSE,NA,"0.1.4"
"39777","646",2023-10-20 08:00:00,-24102,1913,26015,907,FALSE,NA,"0.1.4"
"39778","646",2023-10-20 08:15:00,-24069,1913,25982,907,FALSE,NA,"0.1.4"
"39779","646",2023-10-20 08:30:00,-23726,1913,25639,907,FALSE,NA,"0.1.4"
"39780","646",2023-10-20 08:45:00,-23720,1913,25633,907,FALSE,NA,"0.1.4"
"39781","646",2023-10-20 09:00:00,-23438,1913,25351,907,FALSE,NA,"0.1.4"
"39782","646",2023-10-20 09:15:00,-23775,1913,25688,907,FALSE,NA,"0.1.4"
"39783","646",2023-10-20 09:30:00,-23920,1913,25833,907,FALSE,NA,"0.1.4"
"39784","646",2023-10-20 09:45:00,-23577,1913,25490,907,FALSE,NA,"0.1.4"
"39785","646",2023-10-20 10:00:00,-23809,1913,25722,907,FALSE,NA,"0.1.4"
"39786","646",2023-10-20 10:15:00,-23728,1913,25641,907,FALSE,NA,"0.1.4"
"39787","646",2023-10-20 10:30:00,-23728,1913,25641,907,FALSE,"jump1","0.1.4"
"39788","646",2023-10-20 10:45:00,-23611,1913,25524,907,FALSE,NA,"0.1.4"
"39789","646",2023-10-20 11:00:00,-23611,1913,25524,907,FALSE,"jump1","0.1.4"
"39790","646",2023-10-20 11:15:00,-24022,1913,25935,907,FALSE,NA,"0.1.4"
"39791","646",2023-10-20 11:30:00,-24245,1913,26158,907,FALSE,NA,"0.1.4"
"39792","646",2023-10-20 11:45:00,-24245,1913,26158,907,FALSE,"jump1","0.1.4"
"39793","646",2023-10-20 12:00:00,-24245,1913,26158,907,FALSE,"jump1","0.1.4"
"39794","646",2023-10-20 12:15:00,-23999,1913,25912,907,FALSE,NA,"0.1.4"
"39795","646",2023-10-20 12:30:00,-24134,1913,26047,907,FALSE,NA,"0.1.4"
"39796","646",2023-10-20 12:45:00,-24165,1913,26078,907,FALSE,NA,"0.1.4"
"39797","646",2023-10-20 13:00:00,-23907,1913,25820,907,FALSE,NA,"0.1.4"
"39798","646",2023-10-20 13:15:00,-23925,1913,25838,907,FALSE,NA,"0.1.4"
"39799","646",2023-10-20 13:30:00,-24379,1913,26292,907,FALSE,NA,"0.1.4"
"39800","646",2023-10-20 13:45:00,-24082,1913,25995,907,FALSE,NA,"0.1.4"
"39801","646",2023-10-20 14:00:00,-23664,1913,25577,907,FALSE,NA,"0.1.4"
"39802","646",2023-10-20 14:15:00,-23762,1913,25675,907,FALSE,NA,"0.1.4"
"39803","646",2023-10-20 14:30:00,-23726,1913,25639,907,FALSE,NA,"0.1.4"
"39804","646",2023-10-20 14:45:00,-23767,1913,25680,907,FALSE,NA,"0.1.4"
"39805","646",2023-10-20 15:00:00,-23761,1913,25674,907,FALSE,NA,"0.1.4"
"39806","646",2023-10-20 15:15:00,-23845,1913,25758,907,FALSE,NA,"0.1.4"
"39807","646",2023-10-20 15:30:00,-23697,1913,25610,907,FALSE,NA,"0.1.4"
"39808","646",2023-10-20 15:45:00,-23831,1913,25744,907,FALSE,NA,"0.1.4"
"39809","646",2023-10-20 16:00:00,-23806,1913,25719,907,FALSE,NA,"0.1.4"
"39810","646",2023-10-20 16:15:00,-23912,1913,25825,907,FALSE,NA,"0.1.4"
"39811","646",2023-10-20 16:30:00,-23663,1913,25576,907,FALSE,NA,"0.1.4"
"39812","646",2023-10-20 16:45:00,-23662,1913,25575,907,FALSE,NA,"0.1.4"
"39813","646",2023-10-20 17:00:00,-23611,1913,25524,907,FALSE,NA,"0.1.4"
"39814","646",2023-10-20 17:15:00,-23914,1913,25827,907,FALSE,NA,"0.1.4"
"39815","646",2023-10-20 17:30:00,-23610,1913,25523,907,FALSE,NA,"0.1.4"
"39816","646",2023-10-20 17:45:00,-23609,1913,25522,907,FALSE,NA,"0.1.4"
"39817","646",2023-10-20 18:00:00,-23823,1913,25736,907,FALSE,NA,"0.1.4"
"39818","646",2023-10-20 18:15:00,-23650,1913,25563,907,FALSE,NA,"0.1.4"
"39819","646",2023-10-20 18:30:00,-23612,1913,25525,907,FALSE,NA,"0.1.4"
"39820","646",2023-10-20 18:45:00,-23633,1913,25546,907,FALSE,NA,"0.1.4"
"39821","646",2023-10-20 19:00:00,-23609,1913,25522,907,FALSE,NA,"0.1.4"
"39822","646",2023-10-20 19:15:00,-23618,1913,25531,907,FALSE,NA,"0.1.4"
"39823","646",2023-10-20 19:30:00,-23644,1913,25557,907,FALSE,NA,"0.1.4"
"39824","646",2023-10-20 19:45:00,-23670,1913,25583,907,FALSE,NA,"0.1.4"
"39825","646",2023-10-20 20:00:00,-23618,1913,25531,907,FALSE,NA,"0.1.4"
"39826","646",2023-10-20 20:15:00,-23607,1913,25520,907,FALSE,NA,"0.1.4"
"39827","646",2023-10-20 20:30:00,-23613,1913,25526,907,FALSE,NA,"0.1.4"
"39828","646",2023-10-20 20:45:00,-23560,1913,25473,907,FALSE,NA,"0.1.4"
"39829","646",2023-10-20 21:00:00,-23608,1913,25521,907,FALSE,NA,"0.1.4"
"39830","646",2023-10-20 21:15:00,-23609,1913,25522,907,FALSE,NA,"0.1.4"
"39831","646",2023-10-20 21:30:00,-23609,1913,25522,907,FALSE,NA,"0.1.4"
"39832","646",2023-10-20 21:45:00,-23585,1913,25498,907,FALSE,NA,"0.1.4"
"39833","646",2023-10-20 22:00:00,-23604,1913,25517,907,FALSE,NA,"0.1.4"
"39834","646",2023-10-20 22:15:00,-23601,1913,25514,907,FALSE,NA,"0.1.4"
"39835","646",2023-10-20 22:30:00,-23602,1913,25515,907,FALSE,NA,"0.1.4"
"39836","646",2023-10-20 22:45:00,-23600,1913,25513,907,FALSE,NA,"0.1.4"
"39837","646",2023-10-20 23:00:00,-23609,1913,25522,907,FALSE,NA,"0.1.4"
"39838","646",2023-10-20 23:15:00,-23609,1913,25522,907,FALSE,NA,"0.1.4"
"39839","646",2023-10-20 23:30:00,-23821,1913,25734,907,FALSE,NA,"0.1.4"
"39840","646",2023-10-20 23:45:00,-23838,1913,25751,907,FALSE,NA,"0.1.4"
"39841","646",2023-10-21,-23835,1913,25748,907,FALSE,NA,"0.1.4"
"39842","646",2023-10-21 00:15:00,-23844,1913,25757,907,FALSE,NA,"0.1.4"
"39843","646",2023-10-21 00:30:00,-23817,1913,25730,907,FALSE,NA,"0.1.4"
"39844","646",2023-10-21 00:45:00,-23791,1913,25704,907,FALSE,NA,"0.1.4"
"39845","646",2023-10-21 01:00:00,-23780,1913,25693,907,FALSE,NA,"0.1.4"
"39846","646",2023-10-21 01:15:00,-23820,1913,25733,907,FALSE,NA,"0.1.4"
"39847","646",2023-10-21 01:30:00,-23816,1913,25729,907,FALSE,NA,"0.1.4"
"39848","646",2023-10-21 01:45:00,-23803,1913,25716,907,FALSE,NA,"0.1.4"
"39849","646",2023-10-21 02:00:00,-23796,1913,25709,907,FALSE,NA,"0.1.4"
"39850","646",2023-10-21 02:15:00,-23715,1913,25628,907,FALSE,NA,"0.1.4"
"39851","646",2023-10-21 02:30:00,-23715,1913,25628,907,FALSE,"jump1","0.1.4"
"39852","646",2023-10-21 02:45:00,-23715,1913,25628,907,FALSE,"jump1","0.1.4"
"39853","646",2023-10-21 03:00:00,-23721,1913,25634,907,FALSE,NA,"0.1.4"
"39854","646",2023-10-21 03:15:00,-23754,1913,25667,907,FALSE,NA,"0.1.4"
"39855","646",2023-10-21 03:30:00,-23841,1913,25754,907,FALSE,NA,"0.1.4"
"39856","646",2023-10-21 03:45:00,-23887,1913,25800,907,FALSE,NA,"0.1.4"
"39857","646",2023-10-21 04:00:00,-24322,1913,26235,907,FALSE,NA,"0.1.4"
"39858","646",2023-10-21 04:15:00,-24427,1913,26340,907,FALSE,NA,"0.1.4"
"39859","646",2023-10-21 04:30:00,-24171,1913,26084,907,FALSE,NA,"0.1.4"
"39860","646",2023-10-21 04:45:00,-24028,1913,25941,907,FALSE,NA,"0.1.4"
"39861","646",2023-10-21 05:00:00,-23945,1913,25858,907,FALSE,NA,"0.1.4"
"39862","646",2023-10-21 05:15:00,-24306,1913,26219,907,FALSE,NA,"0.1.4"
"39863","646",2023-10-21 05:30:00,-24289,1913,26202,907,FALSE,NA,"0.1.4"
"39864","646",2023-10-21 05:45:00,-24475,1913,26388,907,FALSE,NA,"0.1.4"
"39865","646",2023-10-21 06:00:00,-24086,1913,25999,907,FALSE,NA,"0.1.4"
"39866","646",2023-10-21 06:15:00,-24223,1913,26136,907,FALSE,NA,"0.1.4"
"39867","646",2023-10-21 06:30:00,-24318,1913,26231,907,FALSE,NA,"0.1.4"
"39868","646",2023-10-21 06:45:00,-24318,1913,26231,907,FALSE,"jump1","0.1.4"
"39869","646",2023-10-21 07:00:00,-24318,1913,26231,907,FALSE,"jump1","0.1.4"
"39870","646",2023-10-21 07:15:00,-24236,1913,26149,907,FALSE,NA,"0.1.4"
"39871","646",2023-10-21 07:30:00,-24330,1913,26243,907,FALSE,NA,"0.1.4"
"39872","646",2023-10-21 07:45:00,-24204,1913,26117,907,FALSE,NA,"0.1.4"
"39873","646",2023-10-21 08:00:00,-24204,1913,26117,907,FALSE,"jump1","0.1.4"
"39874","646",2023-10-21 08:15:00,-24204,1913,26117,907,FALSE,"jump1","0.1.4"
"39875","646",2023-10-21 08:30:00,-23772,1913,25685,907,FALSE,NA,"0.1.4"
"39876","646",2023-10-21 08:45:00,-24232,1913,26145,907,FALSE,NA,"0.1.4"
"39877","646",2023-10-21 09:00:00,-23735,1913,25648,907,FALSE,NA,"0.1.4"
"39878","646",2023-10-21 09:15:00,-23691,1913,25604,907,FALSE,NA,"0.1.4"
"39879","646",2023-10-21 09:30:00,-23686,1913,25599,907,FALSE,NA,"0.1.4"
"39880","646",2023-10-21 09:45:00,-23724,1913,25637,907,FALSE,NA,"0.1.4"
"39881","646",2023-10-21 10:00:00,-24135,1913,26048,907,FALSE,NA,"0.1.4"
"39882","646",2023-10-21 10:15:00,-24153,1913,26066,907,FALSE,NA,"0.1.4"
"39883","646",2023-10-21 10:30:00,-23782,1913,25695,907,FALSE,NA,"0.1.4"
"39884","646",2023-10-21 10:45:00,-23741,1913,25654,907,FALSE,NA,"0.1.4"
"39885","646",2023-10-21 11:00:00,-23795,1913,25708,907,FALSE,NA,"0.1.4"
"39886","646",2023-10-21 11:15:00,-23744,1913,25657,907,FALSE,NA,"0.1.4"
"39887","646",2023-10-21 11:30:00,-23733,1913,25646,907,FALSE,NA,"0.1.4"
"39888","646",2023-10-21 11:45:00,-23677,1913,25590,907,FALSE,NA,"0.1.4"
"39889","646",2023-10-21 12:00:00,-23679,1913,25592,907,FALSE,NA,"0.1.4"
"39890","646",2023-10-21 12:15:00,-23678,1913,25591,907,FALSE,NA,"0.1.4"
"39891","646",2023-10-21 12:30:00,-23678,1913,25591,907,FALSE,NA,"0.1.4"
"39892","646",2023-10-21 12:45:00,-23678,1913,25591,907,FALSE,NA,"0.1.4"
"39893","646",2023-10-21 13:00:00,-23678,1913,25591,907,FALSE,NA,"0.1.4"
"39894","646",2023-10-21 13:15:00,-23681,1913,25594,907,FALSE,NA,"0.1.4"
"39895","646",2023-10-21 13:30:00,-23683,1913,25596,907,FALSE,NA,"0.1.4"
"39896","646",2023-10-21 13:45:00,-23682,1913,25595,907,FALSE,NA,"0.1.4"
"39897","646",2023-10-21 14:00:00,-23678,1913,25591,907,FALSE,NA,"0.1.4"
"39898","646",2023-10-21 14:15:00,-23676,1913,25589,907,FALSE,NA,"0.1.4"
"39899","646",2023-10-21 14:30:00,-23687,1913,25600,907,FALSE,NA,"0.1.4"
"39900","646",2023-10-21 14:45:00,-23690,1913,25603,907,FALSE,NA,"0.1.4"
"39901","646",2023-10-21 15:00:00,-23684,1913,25597,907,FALSE,NA,"0.1.4"
"39902","646",2023-10-21 15:15:00,-23684,1913,25597,907,FALSE,NA,"0.1.4"
"39903","646",2023-10-21 15:30:00,-23684,1913,25597,907,FALSE,NA,"0.1.4"
"39904","646",2023-10-21 15:45:00,-23685,1913,25598,907,FALSE,NA,"0.1.4"
"39905","646",2023-10-21 16:00:00,-23685,1913,25598,907,FALSE,NA,"0.1.4"
"39906","646",2023-10-21 16:15:00,-23684,1913,25597,907,FALSE,NA,"0.1.4"
"39907","646",2023-10-21 16:30:00,-23684,1913,25597,907,FALSE,NA,"0.1.4"
"39908","646",2023-10-21 16:45:00,-23683,1913,25596,907,FALSE,NA,"0.1.4"
"39909","646",2023-10-21 17:00:00,-23684,1913,25597,907,FALSE,NA,"0.1.4"
"39910","646",2023-10-21 17:15:00,-23681,1913,25594,907,FALSE,NA,"0.1.4"
"39911","646",2023-10-21 17:30:00,-23683,1913,25596,907,FALSE,NA,"0.1.4"
"39912","646",2023-10-21 17:45:00,-23669,1913,25582,907,FALSE,NA,"0.1.4"
"39913","646",2023-10-21 18:00:00,-23683,1913,25596,907,FALSE,NA,"0.1.4"
"39914","646",2023-10-21 18:15:00,-23659,1913,25572,907,FALSE,NA,"0.1.4"
"39915","646",2023-10-21 18:30:00,-23657,1913,25570,907,FALSE,NA,"0.1.4"
"39916","646",2023-10-21 18:45:00,-23747,1913,25660,907,FALSE,NA,"0.1.4"
"39917","646",2023-10-21 19:00:00,-23857,1913,25770,907,FALSE,NA,"0.1.4"
"39918","646",2023-10-21 19:15:00,-23988,1913,25901,907,FALSE,NA,"0.1.4"
"39919","646",2023-10-21 19:30:00,-23788,1913,25701,907,FALSE,NA,"0.1.4"
"39920","646",2023-10-21 19:45:00,-23737,1913,25650,907,FALSE,NA,"0.1.4"
"39921","646",2023-10-21 20:00:00,-23678,1913,25591,907,FALSE,NA,"0.1.4"
"39922","646",2023-10-21 20:15:00,-23686,1913,25599,907,FALSE,NA,"0.1.4"
"39923","646",2023-10-21 20:30:00,-23686,1913,25599,907,FALSE,NA,"0.1.4"
"39924","646",2023-10-21 20:45:00,-23689,1913,25602,907,FALSE,NA,"0.1.4"
"39925","646",2023-10-21 21:00:00,-23833,1913,25746,907,FALSE,NA,"0.1.4"
"39926","646",2023-10-21 21:15:00,-23815,1913,25728,907,FALSE,NA,"0.1.4"
"39927","646",2023-10-21 21:30:00,-23843,1913,25756,907,FALSE,NA,"0.1.4"
"39928","646",2023-10-21 21:45:00,-23732,1913,25645,907,FALSE,NA,"0.1.4"
"39929","646",2023-10-21 22:00:00,-23712,1913,25625,907,FALSE,NA,"0.1.4"
"39930","646",2023-10-21 22:15:00,-23707,1913,25620,907,FALSE,NA,"0.1.4"
"39931","646",2023-10-21 22:30:00,-23687,1913,25600,907,FALSE,NA,"0.1.4"
"39932","646",2023-10-21 22:45:00,-23726,1913,25639,907,FALSE,NA,"0.1.4"
"39933","646",2023-10-21 23:00:00,-23714,1913,25627,907,FALSE,NA,"0.1.4"
"39934","646",2023-10-21 23:15:00,-23696,1913,25609,907,FALSE,NA,"0.1.4"
"39935","646",2023-10-21 23:30:00,-23827,1913,25740,907,FALSE,NA,"0.1.4"
"39936","646",2023-10-21 23:45:00,-23801,1913,25714,907,FALSE,NA,"0.1.4"
"39937","646",2023-10-22,-23772,1913,25685,907,FALSE,NA,"0.1.4"
"39938","646",2023-10-22 00:15:00,-23791,1913,25704,907,FALSE,NA,"0.1.4"
"39939","646",2023-10-22 00:30:00,-23806,1913,25719,907,FALSE,NA,"0.1.4"
"39940","646",2023-10-22 00:45:00,-23715,1913,25628,907,FALSE,NA,"0.1.4"
"39941","646",2023-10-22 01:00:00,-23715,1913,25628,907,FALSE,"jump1","0.1.4"
"39942","646",2023-10-22 01:15:00,-23292,1913,25205,907,FALSE,NA,"0.1.4"
"39943","646",2023-10-22 01:30:00,-23292,1913,25205,907,FALSE,"jump1","0.1.4"
"39944","646",2023-10-22 01:45:00,-22873,1913,24786,907,FALSE,NA,"0.1.4"
"39945","646",2023-10-22 02:00:00,-23158,1913,25071,907,FALSE,NA,"0.1.4"
"39946","646",2023-10-22 02:15:00,-22852,1913,24765,907,FALSE,NA,"0.1.4"
"39947","646",2023-10-22 02:30:00,-23303,1913,25216,907,FALSE,NA,"0.1.4"
"39948","646",2023-10-22 02:45:00,-23438,1913,25351,907,FALSE,NA,"0.1.4"
"39949","646",2023-10-22 03:00:00,-23419,1913,25332,907,FALSE,NA,"0.1.4"
"39950","646",2023-10-22 03:15:00,-23259,1913,25172,907,FALSE,NA,"0.1.4"
"39951","646",2023-10-22 03:30:00,-23291,1913,25204,907,FALSE,NA,"0.1.4"
"39952","646",2023-10-22 03:45:00,-23291,1913,25204,907,FALSE,"jump1","0.1.4"
"39953","646",2023-10-22 04:00:00,-23593,1913,25506,907,FALSE,NA,"0.1.4"
"39954","646",2023-10-22 04:15:00,-23777,1913,25690,907,FALSE,NA,"0.1.4"
"39955","646",2023-10-22 04:30:00,-23716,1913,25629,907,FALSE,NA,"0.1.4"
"39956","646",2023-10-22 04:45:00,-23820,1913,25733,907,FALSE,NA,"0.1.4"
"39957","646",2023-10-22 05:00:00,-23333,1913,25246,907,FALSE,NA,"0.1.4"
"39958","646",2023-10-22 05:15:00,-23346,1913,25259,907,FALSE,NA,"0.1.4"
"39959","646",2023-10-22 05:30:00,-23499,1913,25412,907,FALSE,NA,"0.1.4"
"39960","646",2023-10-22 05:45:00,-23592,1913,25505,907,FALSE,NA,"0.1.4"
"39961","646",2023-10-22 06:00:00,-23481,1913,25394,907,FALSE,NA,"0.1.4"
"39962","646",2023-10-22 06:15:00,-23624,1913,25537,907,FALSE,NA,"0.1.4"
"39963","646",2023-10-22 06:30:00,-23666,1913,25579,907,FALSE,NA,"0.1.4"
"39964","646",2023-10-22 06:45:00,-23740,1913,25653,907,FALSE,NA,"0.1.4"
"39965","646",2023-10-22 07:00:00,-23886,1913,25799,907,FALSE,NA,"0.1.4"
"39966","646",2023-10-22 07:15:00,-23674,1913,25587,907,FALSE,NA,"0.1.4"
"39967","646",2023-10-22 07:30:00,-23787,1913,25700,907,FALSE,NA,"0.1.4"
"39968","646",2023-10-22 07:45:00,-23606,1913,25519,907,FALSE,NA,"0.1.4"
"39969","646",2023-10-22 08:00:00,-23747,1913,25660,907,FALSE,NA,"0.1.4"
"39970","646",2023-10-22 08:15:00,-23530,1913,25443,907,FALSE,NA,"0.1.4"
"39971","646",2023-10-22 08:30:00,-23977,1913,25890,907,FALSE,NA,"0.1.4"
"39972","646",2023-10-22 08:45:00,-23500,1913,25413,907,FALSE,NA,"0.1.4"
"39973","646",2023-10-22 09:00:00,-23492,1913,25405,907,FALSE,NA,"0.1.4"
"39974","646",2023-10-22 09:15:00,-23492,1913,25405,907,FALSE,"jump1","0.1.4"
"39975","646",2023-10-22 09:30:00,-23248,1913,25161,907,FALSE,NA,"0.1.4"
"39976","646",2023-10-22 09:45:00,-23254,1913,25167,907,FALSE,NA,"0.1.4"
"39977","646",2023-10-22 10:00:00,-23033,1913,24946,907,FALSE,NA,"0.1.4"
"39978","646",2023-10-22 10:15:00,-23284,1913,25197,907,FALSE,NA,"0.1.4"
"39979","646",2023-10-22 10:30:00,-23476,1913,25389,907,FALSE,NA,"0.1.4"
"39980","646",2023-10-22 10:45:00,-23047,1913,24960,907,FALSE,NA,"0.1.4"
"39981","646",2023-10-22 11:00:00,-23025,1913,24938,907,FALSE,NA,"0.1.4"
"39982","646",2023-10-22 11:15:00,-23358,1913,25271,907,FALSE,NA,"0.1.4"
"39983","646",2023-10-22 11:30:00,-23210,1913,25123,907,FALSE,NA,"0.1.4"
"39984","646",2023-10-22 11:45:00,-23238,1913,25151,907,FALSE,NA,"0.1.4"
"39985","646",2023-10-22 12:00:00,-23247,1913,25160,907,FALSE,NA,"0.1.4"
"39986","646",2023-10-22 12:15:00,-23137,1913,25050,907,FALSE,NA,"0.1.4"
"39987","646",2023-10-22 12:30:00,-22856,1913,24769,907,FALSE,NA,"0.1.4"
"39988","646",2023-10-22 12:45:00,-23250,1913,25163,907,FALSE,NA,"0.1.4"
"39989","646",2023-10-22 13:00:00,-23250,1913,25163,907,FALSE,"jump1","0.1.4"
"39990","646",2023-10-22 13:15:00,-23703,1913,25616,907,FALSE,NA,"0.1.4"
"39991","646",2023-10-22 13:30:00,-23742,1913,25655,907,FALSE,NA,"0.1.4"
"39992","646",2023-10-22 13:45:00,-23884,1913,25797,907,FALSE,NA,"0.1.4"
"39993","646",2023-10-22 14:00:00,-23801,1913,25714,907,FALSE,NA,"0.1.4"
"39994","646",2023-10-22 14:15:00,-23852,1913,25765,907,FALSE,NA,"0.1.4"
"39995","646",2023-10-22 14:30:00,-23830,1913,25743,907,FALSE,NA,"0.1.4"
"39996","646",2023-10-22 14:45:00,-23790,1913,25703,907,FALSE,NA,"0.1.4"
"39997","646",2023-10-22 15:00:00,-23707,1913,25620,907,FALSE,NA,"0.1.4"
"39998","646",2023-10-22 15:15:00,-23783,1913,25696,907,FALSE,NA,"0.1.4"
"39999","646",2023-10-22 15:30:00,-23614,1913,25527,907,FALSE,NA,"0.1.4"
"40000","646",2023-10-22 15:45:00,-23597,1913,25510,907,FALSE,NA,"0.1.4"
"40001","646",2023-10-22 16:00:00,-23730,1913,25643,907,FALSE,NA,"0.1.4"
"40002","646",2023-10-22 16:15:00,-23646,1913,25559,907,FALSE,NA,"0.1.4"
"40003","646",2023-10-22 16:30:00,-23682,1913,25595,907,FALSE,NA,"0.1.4"
"40004","646",2023-10-22 16:45:00,-23549,1913,25462,907,FALSE,NA,"0.1.4"
"40005","646",2023-10-22 17:00:00,-23087,1913,25000,907,FALSE,NA,"0.1.4"
"40006","646",2023-10-22 17:15:00,-23117,1913,25030,907,FALSE,NA,"0.1.4"
"40007","646",2023-10-22 17:30:00,-23146,1913,25059,907,FALSE,NA,"0.1.4"
"40008","646",2023-10-22 17:45:00,-23129,1913,25042,907,FALSE,NA,"0.1.4"
"40009","646",2023-10-22 18:00:00,-23104,1913,25017,907,FALSE,NA,"0.1.4"
"40010","646",2023-10-22 18:15:00,-23231,1913,25144,907,FALSE,NA,"0.1.4"
"40011","646",2023-10-22 18:30:00,-23173,1913,25086,907,FALSE,NA,"0.1.4"
"40012","646",2023-10-22 18:45:00,-23156,1913,25069,907,FALSE,NA,"0.1.4"
"40013","646",2023-10-22 19:00:00,-23149,1913,25062,907,FALSE,NA,"0.1.4"
"40014","646",2023-10-22 19:15:00,-23164,1913,25077,907,FALSE,NA,"0.1.4"
"40015","646",2023-10-22 19:30:00,-23176,1913,25089,907,FALSE,NA,"0.1.4"
"40016","646",2023-10-22 19:45:00,-23137,1913,25050,907,FALSE,NA,"0.1.4"
"40017","646",2023-10-22 20:00:00,-23146,1913,25059,907,FALSE,NA,"0.1.4"
"40018","646",2023-10-22 20:15:00,-23373,1913,25286,907,FALSE,NA,"0.1.4"
"40019","646",2023-10-22 20:30:00,-23228,1913,25141,907,FALSE,NA,"0.1.4"
"40020","646",2023-10-22 20:45:00,-23236,1913,25149,907,FALSE,NA,"0.1.4"
"40021","646",2023-10-22 21:00:00,-23228,1913,25141,907,FALSE,NA,"0.1.4"
"40022","646",2023-10-22 21:15:00,-23231,1913,25144,907,FALSE,NA,"0.1.4"
"40023","646",2023-10-22 21:30:00,-23254,1913,25167,907,FALSE,NA,"0.1.4"
"40024","646",2023-10-22 21:45:00,-23252,1913,25165,907,FALSE,NA,"0.1.4"
"40025","646",2023-10-22 22:00:00,-23244,1913,25157,907,FALSE,NA,"0.1.4"
"40026","646",2023-10-22 22:15:00,-23244,1913,25157,907,FALSE,NA,"0.1.4"
"40027","646",2023-10-22 22:30:00,-23244,1913,25157,907,FALSE,NA,"0.1.4"
"40028","646",2023-10-22 22:45:00,-23236,1913,25149,907,FALSE,NA,"0.1.4"
"40029","646",2023-10-22 23:00:00,-23234,1913,25147,907,FALSE,NA,"0.1.4"
"40030","646",2023-10-22 23:15:00,-23211,1913,25124,907,FALSE,NA,"0.1.4"
"40031","646",2023-10-22 23:30:00,-23208,1913,25121,907,FALSE,NA,"0.1.4"
"40032","646",2023-10-22 23:45:00,-23210,1913,25123,907,FALSE,NA,"0.1.4"
"40033","646",2023-10-23,-23203,1913,25116,907,FALSE,NA,"0.1.4"
"40034","646",2023-10-23 00:15:00,-23215,1913,25128,907,FALSE,NA,"0.1.4"
"40035","646",2023-10-23 00:30:00,-23264,1913,25177,907,FALSE,NA,"0.1.4"
"40036","646",2023-10-23 00:45:00,-23250,1913,25163,907,FALSE,NA,"0.1.4"
"40037","646",2023-10-23 01:00:00,-23333,1913,25246,907,FALSE,NA,"0.1.4"
"40038","646",2023-10-23 01:15:00,-23356,1913,25269,907,FALSE,NA,"0.1.4"
"40039","646",2023-10-23 01:30:00,-23345,1913,25258,907,FALSE,NA,"0.1.4"
"40040","646",2023-10-23 01:45:00,-23352,1913,25265,907,FALSE,NA,"0.1.4"
"40041","646",2023-10-23 02:00:00,-23308,1913,25221,907,FALSE,NA,"0.1.4"
"40042","646",2023-10-23 02:15:00,-23407,1913,25320,907,FALSE,NA,"0.1.4"
"40043","646",2023-10-23 02:30:00,-23407,1913,25320,907,FALSE,"jump1","0.1.4"
"40044","646",2023-10-23 02:45:00,-23262,1913,25175,907,FALSE,NA,"0.1.4"
"40045","646",2023-10-23 03:00:00,-23229,1913,25142,907,FALSE,NA,"0.1.4"
"40046","646",2023-10-23 03:15:00,-23172,1913,25085,907,FALSE,NA,"0.1.4"
"40047","646",2023-10-23 03:30:00,-23394,1913,25307,907,FALSE,NA,"0.1.4"
"40048","646",2023-10-23 03:45:00,-23209,1913,25122,907,FALSE,NA,"0.1.4"
"40049","646",2023-10-23 04:00:00,-23322,1913,25235,907,FALSE,NA,"0.1.4"
"40050","646",2023-10-23 04:15:00,-22857,1913,24770,907,FALSE,NA,"0.1.4"
"40051","646",2023-10-23 04:30:00,-23058,1913,24971,907,FALSE,NA,"0.1.4"
"40052","646",2023-10-23 04:45:00,-23027,1913,24940,907,FALSE,NA,"0.1.4"
"40053","646",2023-10-23 05:00:00,-22642,1913,24555,907,FALSE,NA,"0.1.4"
"40054","646",2023-10-23 05:15:00,-22642,1913,24555,907,FALSE,NA,"0.1.4"
"40055","646",2023-10-23 05:30:00,-22642,1913,24555,907,FALSE,NA,"0.1.4"
"40056","646",2023-10-23 05:45:00,-22642,1913,24555,907,FALSE,"jump1","0.1.4"
"40057","646",2023-10-23 06:00:00,-22642,1913,24555,907,FALSE,"jump1","0.1.4"
"40058","646",2023-10-23 06:15:00,-22642,1913,24555,907,FALSE,NA,"0.1.4"
"40059","646",2023-10-23 06:30:00,-22889,1913,24802,907,FALSE,NA,"0.1.4"
"40060","646",2023-10-23 06:45:00,-22644,1913,24557,907,FALSE,NA,"0.1.4"
"40061","646",2023-10-23 07:00:00,-22905,1913,24818,907,FALSE,NA,"0.1.4"
"40062","646",2023-10-23 07:15:00,-22891,1913,24804,907,FALSE,NA,"0.1.4"
"40063","646",2023-10-23 07:30:00,-23247,1913,25160,907,FALSE,NA,"0.1.4"
"40064","646",2023-10-23 07:45:00,-22978,1913,24891,907,FALSE,NA,"0.1.4"
"40065","646",2023-10-23 08:00:00,-22735,1913,24648,907,FALSE,NA,"0.1.4"
"40066","646",2023-10-23 08:15:00,-22976,1913,24889,907,FALSE,NA,"0.1.4"
"40067","646",2023-10-23 08:30:00,-23234,1913,25147,907,FALSE,NA,"0.1.4"
"40068","646",2023-10-23 08:45:00,-23305,1913,25218,907,FALSE,NA,"0.1.4"
"40069","646",2023-10-23 09:00:00,-23307,1913,25220,907,FALSE,NA,"0.1.4"
"40070","646",2023-10-23 09:15:00,-23165,1913,25078,907,FALSE,NA,"0.1.4"
"40071","646",2023-10-23 09:30:00,-23125,1913,25038,907,FALSE,NA,"0.1.4"
"40072","646",2023-10-23 09:45:00,-22639,1913,24552,907,FALSE,NA,"0.1.4"
"40073","646",2023-10-23 10:00:00,-22640,1913,24553,907,FALSE,NA,"0.1.4"
"40074","646",2023-10-23 10:15:00,-22640,1913,24553,907,FALSE,NA,"0.1.4"
"40075","646",2023-10-23 10:30:00,-22640,1913,24553,907,FALSE,NA,"0.1.4"
"40076","646",2023-10-23 10:45:00,-22643,1913,24556,907,FALSE,NA,"0.1.4"
"40077","646",2023-10-23 11:00:00,-22720,1913,24633,907,FALSE,NA,"0.1.4"
"40078","646",2023-10-23 11:15:00,-22675,1913,24588,907,FALSE,NA,"0.1.4"
"40079","646",2023-10-23 11:30:00,-22664,1913,24577,907,FALSE,NA,"0.1.4"
"40080","646",2023-10-23 11:45:00,-22675,1913,24588,907,FALSE,NA,"0.1.4"
"40081","646",2023-10-23 12:00:00,-22669,1913,24582,907,FALSE,NA,"0.1.4"
"40082","646",2023-10-23 12:15:00,-22674,1913,24587,907,FALSE,NA,"0.1.4"
"40083","646",2023-10-23 12:30:00,-22672,1913,24585,907,FALSE,NA,"0.1.4"
"40084","646",2023-10-23 12:45:00,-22706,1913,24619,907,FALSE,NA,"0.1.4"
"40085","646",2023-10-23 13:00:00,-22710,1913,24623,907,FALSE,NA,"0.1.4"
"40086","646",2023-10-23 13:15:00,-22960,1913,24873,907,FALSE,NA,"0.1.4"
"40087","646",2023-10-23 13:30:00,-23408,1913,25321,907,FALSE,NA,"0.1.4"
"40088","646",2023-10-23 13:45:00,-23255,1913,25168,907,FALSE,NA,"0.1.4"
"40089","646",2023-10-23 14:00:00,-23050,1913,24963,907,FALSE,NA,"0.1.4"
"40090","646",2023-10-23 14:15:00,-23419,1913,25332,907,FALSE,NA,"0.1.4"
"40091","646",2023-10-23 14:30:00,-23419,1913,25332,907,FALSE,"jump1","0.1.4"
"40092","646",2023-10-23 14:45:00,-23706,1913,25619,907,FALSE,NA,"0.1.4"
"40093","646",2023-10-23 15:00:00,-23657,1913,25570,907,FALSE,NA,"0.1.4"
"40094","646",2023-10-23 15:15:00,-23605,1913,25518,907,FALSE,NA,"0.1.4"
"40095","646",2023-10-23 15:30:00,-23611,1913,25524,907,FALSE,NA,"0.1.4"
"40096","646",2023-10-23 15:45:00,-23639,1913,25552,907,FALSE,NA,"0.1.4"
"40097","646",2023-10-23 16:00:00,-23704,1913,25617,907,FALSE,NA,"0.1.4"
"40098","646",2023-10-23 16:15:00,-23607,1913,25520,907,FALSE,NA,"0.1.4"
"40099","646",2023-10-23 16:30:00,-23310,1913,25223,907,FALSE,NA,"0.1.4"
"40100","646",2023-10-23 16:45:00,-23271,1913,25184,907,FALSE,NA,"0.1.4"
"40101","646",2023-10-23 17:00:00,-23225,1913,25138,907,FALSE,NA,"0.1.4"
"40102","646",2023-10-23 17:15:00,-23250,1913,25163,907,FALSE,NA,"0.1.4"
"40103","646",2023-10-23 17:30:00,-23728,1913,25641,907,FALSE,NA,"0.1.4"
"40104","646",2023-10-23 17:45:00,-23392,1913,25305,907,FALSE,NA,"0.1.4"
"40105","646",2023-10-23 18:00:00,-23481,1913,25394,907,FALSE,NA,"0.1.4"
"40106","646",2023-10-23 18:15:00,-23374,1913,25287,907,FALSE,NA,"0.1.4"
"40107","646",2023-10-23 18:30:00,-23298,1913,25211,907,FALSE,NA,"0.1.4"
"40108","646",2023-10-23 18:45:00,-23419,1913,25332,907,FALSE,NA,"0.1.4"
"40109","646",2023-10-23 19:00:00,-23288,1913,25201,907,FALSE,NA,"0.1.4"
"40110","646",2023-10-23 19:15:00,-23277,1913,25190,907,FALSE,NA,"0.1.4"
"40111","646",2023-10-23 19:30:00,-23277,1913,25190,907,FALSE,NA,"0.1.4"
"40112","646",2023-10-23 19:45:00,-23278,1913,25191,907,FALSE,NA,"0.1.4"
"40113","646",2023-10-23 20:00:00,-23307,1913,25220,907,FALSE,NA,"0.1.4"
"40114","646",2023-10-23 20:15:00,-23304,1913,25217,907,FALSE,NA,"0.1.4"
"40115","646",2023-10-23 20:30:00,-23284,1913,25197,907,FALSE,NA,"0.1.4"
"40116","646",2023-10-23 20:45:00,-23283,1913,25196,907,FALSE,NA,"0.1.4"
"40117","646",2023-10-23 21:00:00,-23282,1913,25195,907,FALSE,NA,"0.1.4"
"40118","646",2023-10-23 21:15:00,-23284,1913,25197,907,FALSE,NA,"0.1.4"
"40119","646",2023-10-23 21:30:00,-23284,1913,25197,907,FALSE,NA,"0.1.4"
"40120","646",2023-10-23 21:45:00,-23278,1913,25191,907,FALSE,NA,"0.1.4"
"40121","646",2023-10-23 22:00:00,-23277,1913,25190,907,FALSE,NA,"0.1.4"
"40122","646",2023-10-23 22:15:00,-23288,1913,25201,907,FALSE,NA,"0.1.4"
"40123","646",2023-10-23 22:30:00,-23278,1913,25191,907,FALSE,NA,"0.1.4"
"40124","646",2023-10-23 22:45:00,-23279,1913,25192,907,FALSE,NA,"0.1.4"
"40125","646",2023-10-23 23:00:00,-23279,1913,25192,907,FALSE,NA,"0.1.4"
"40126","646",2023-10-23 23:15:00,-23278,1913,25191,907,FALSE,NA,"0.1.4"
"40127","646",2023-10-23 23:30:00,-23278,1913,25191,907,FALSE,NA,"0.1.4"
"40128","646",2023-10-23 23:45:00,-23278,1913,25191,907,FALSE,NA,"0.1.4"
"40129","646",2023-10-24,-23278,1913,25191,907,FALSE,NA,"0.1.4"
"40130","646",2023-10-24 00:15:00,-23278,1913,25191,907,FALSE,NA,"0.1.4"
"40131","646",2023-10-24 00:30:00,-23278,1913,25191,907,FALSE,NA,"0.1.4"
"40132","646",2023-10-24 00:45:00,-23324,1913,25237,907,FALSE,NA,"0.1.4"
"40133","646",2023-10-24 01:00:00,-23689,1913,25602,907,FALSE,NA,"0.1.4"
"40134","646",2023-10-24 01:15:00,-23281,1913,25194,907,FALSE,NA,"0.1.4"
"40135","646",2023-10-24 01:30:00,-23493,1913,25406,907,FALSE,NA,"0.1.4"
"40136","646",2023-10-24 01:45:00,-23325,1913,25238,907,FALSE,NA,"0.1.4"
"40137","646",2023-10-24 02:00:00,-23358,1913,25271,907,FALSE,NA,"0.1.4"
"40138","646",2023-10-24 02:15:00,-23767,1913,25680,907,FALSE,NA,"0.1.4"
"40139","646",2023-10-24 02:30:00,-23570,1913,25483,907,FALSE,NA,"0.1.4"
"40140","646",2023-10-24 02:45:00,-23407,1913,25320,907,FALSE,NA,"0.1.4"
"40141","646",2023-10-24 03:00:00,-23373,1913,25286,907,FALSE,NA,"0.1.4"
"40142","646",2023-10-24 03:15:00,-23528,1913,25441,907,FALSE,NA,"0.1.4"
"40143","646",2023-10-24 03:30:00,-23591,1913,25504,907,FALSE,NA,"0.1.4"
"40144","646",2023-10-24 03:45:00,-23960,1913,25873,907,FALSE,NA,"0.1.4"
"40145","646",2023-10-24 04:00:00,-23960,1913,25873,907,FALSE,"jump1","0.1.4"
"40146","646",2023-10-24 04:15:00,-24322,1913,26235,907,FALSE,"out1, fill","0.1.4"
"40147","646",2023-10-24 04:30:00,-24684,1913,26597,907,FALSE,NA,"0.1.4"
"40148","646",2023-10-24 04:45:00,-24609,1913,26522,907,FALSE,NA,"0.1.4"
"40149","646",2023-10-24 05:00:00,-24655,1913,26568,907,FALSE,NA,"0.1.4"
"40150","646",2023-10-24 05:15:00,-24744,1913,26657,907,FALSE,NA,"0.1.4"
"40151","646",2023-10-24 05:30:00,-24685,1913,26598,907,FALSE,NA,"0.1.4"
"40152","646",2023-10-24 05:45:00,-24474,1913,26387,907,FALSE,NA,"0.1.4"
"40153","646",2023-10-24 06:00:00,-24393,1913,26306,907,FALSE,NA,"0.1.4"
"40154","646",2023-10-24 06:15:00,-23975,1913,25888,907,FALSE,NA,"0.1.4"
"40155","646",2023-10-24 06:30:00,-23982,1913,25895,907,FALSE,NA,"0.1.4"
"40156","646",2023-10-24 06:45:00,-24425,1913,26338,907,FALSE,NA,"0.1.4"
"40157","646",2023-10-24 07:00:00,-24078,1913,25991,907,FALSE,NA,"0.1.4"
"40158","646",2023-10-24 07:15:00,-24174,1913,26087,907,FALSE,NA,"0.1.4"
"40159","646",2023-10-24 07:30:00,-24267,1913,26180,907,FALSE,NA,"0.1.4"
"40160","646",2023-10-24 07:45:00,-24233,1913,26146,907,FALSE,NA,"0.1.4"
"40161","646",2023-10-24 08:00:00,-24154,1913,26067,907,FALSE,NA,"0.1.4"
"40162","646",2023-10-24 08:15:00,-24146,1913,26059,907,FALSE,NA,"0.1.4"
"40163","646",2023-10-24 08:30:00,-24143,1913,26056,907,FALSE,NA,"0.1.4"
"40164","646",2023-10-24 08:45:00,-24132,1913,26045,907,FALSE,NA,"0.1.4"
"40165","646",2023-10-24 09:00:00,-24172,1913,26085,907,FALSE,NA,"0.1.4"
"40166","646",2023-10-24 09:15:00,-24187,1913,26100,907,FALSE,NA,"0.1.4"
"40167","646",2023-10-24 09:30:00,-24172,1913,26085,907,FALSE,NA,"0.1.4"
"40168","646",2023-10-24 09:45:00,-24167,1913,26080,907,FALSE,NA,"0.1.4"
"40169","646",2023-10-24 10:00:00,-24130,1913,26043,907,FALSE,NA,"0.1.4"
"40170","646",2023-10-24 10:15:00,-24099,1913,26012,907,FALSE,NA,"0.1.4"
"40171","646",2023-10-24 10:30:00,-24101,1913,26014,907,FALSE,NA,"0.1.4"
"40172","646",2023-10-24 10:45:00,-24098,1913,26011,907,FALSE,NA,"0.1.4"
"40173","646",2023-10-24 11:00:00,-24010,1913,25923,907,FALSE,NA,"0.1.4"
"40174","646",2023-10-24 11:15:00,-24017,1913,25930,907,FALSE,NA,"0.1.4"
"40175","646",2023-10-24 11:30:00,-24014,1913,25927,907,FALSE,NA,"0.1.4"
"40176","646",2023-10-24 11:45:00,-24019,1913,25932,907,FALSE,NA,"0.1.4"
"40177","646",2023-10-24 12:00:00,-23953,1913,25866,907,FALSE,NA,"0.1.4"
"40178","646",2023-10-24 12:15:00,-23958,1913,25871,907,FALSE,NA,"0.1.4"
"40179","646",2023-10-24 12:30:00,-23960,1913,25873,907,FALSE,NA,"0.1.4"
"40180","646",2023-10-24 12:45:00,-24023,1913,25936,907,FALSE,NA,"0.1.4"
"40181","646",2023-10-24 13:00:00,-23960,1913,25873,907,FALSE,NA,"0.1.4"
"40182","646",2023-10-24 13:15:00,-23959,1913,25872,907,FALSE,NA,"0.1.4"
"40183","646",2023-10-24 13:30:00,-23978,1913,25891,907,FALSE,NA,"0.1.4"
"40184","646",2023-10-24 13:45:00,-24022,1913,25935,907,FALSE,NA,"0.1.4"
"40185","646",2023-10-24 14:00:00,-24005,1913,25918,907,FALSE,NA,"0.1.4"
"40186","646",2023-10-24 14:15:00,-24103,1913,26016,907,FALSE,NA,"0.1.4"
"40187","646",2023-10-24 14:30:00,-23970,1913,25883,907,FALSE,NA,"0.1.4"
"40188","646",2023-10-24 14:45:00,-23959,1913,25872,907,FALSE,NA,"0.1.4"
"40189","646",2023-10-24 15:00:00,-23959,1913,25872,907,FALSE,NA,"0.1.4"
"40190","646",2023-10-24 15:15:00,-23959,1913,25872,907,FALSE,NA,"0.1.4"
"40191","646",2023-10-24 15:30:00,-23959,1913,25872,907,FALSE,NA,"0.1.4"
"40192","646",2023-10-24 15:45:00,-23959,1913,25872,907,FALSE,NA,"0.1.4"
"40193","646",2023-10-24 16:00:00,-23959,1913,25872,907,FALSE,NA,"0.1.4"
"40194","646",2023-10-24 16:15:00,-23959,1913,25872,907,FALSE,NA,"0.1.4"
"40195","646",2023-10-24 16:30:00,-23960,1913,25873,907,FALSE,NA,"0.1.4"
"40196","646",2023-10-24 16:45:00,-23960,1913,25873,907,FALSE,NA,"0.1.4"
"40197","646",2023-10-24 17:00:00,-23963,1913,25876,907,FALSE,NA,"0.1.4"
"40198","646",2023-10-24 17:15:00,-23959,1913,25872,907,FALSE,NA,"0.1.4"
"40199","646",2023-10-24 17:30:00,-23960,1913,25873,907,FALSE,NA,"0.1.4"
"40200","646",2023-10-24 17:45:00,-23959,1913,25872,907,FALSE,NA,"0.1.4"
"40201","646",2023-10-24 18:00:00,-23960,1913,25873,907,FALSE,NA,"0.1.4"
"40202","646",2023-10-24 18:15:00,-24039,1913,25952,907,FALSE,NA,"0.1.4"
"40203","646",2023-10-24 18:30:00,-23984,1913,25897,907,FALSE,NA,"0.1.4"
"40204","646",2023-10-24 18:45:00,-23955,1913,25868,907,FALSE,NA,"0.1.4"
"40205","646",2023-10-24 19:00:00,-23960,1913,25873,907,FALSE,NA,"0.1.4"
"40206","646",2023-10-24 19:15:00,-23953,1913,25866,907,FALSE,NA,"0.1.4"
"40207","646",2023-10-24 19:30:00,-23953,1913,25866,907,FALSE,NA,"0.1.4"
"40208","646",2023-10-24 19:45:00,-23956,1913,25869,907,FALSE,NA,"0.1.4"
"40209","646",2023-10-24 20:00:00,-23984,1913,25897,907,FALSE,NA,"0.1.4"
"40210","646",2023-10-24 20:15:00,-24163,1913,26076,907,FALSE,NA,"0.1.4"
"40211","646",2023-10-24 20:30:00,-23959,1913,25872,907,FALSE,NA,"0.1.4"
"40212","646",2023-10-24 20:45:00,-23960,1913,25873,907,FALSE,NA,"0.1.4"
"40213","646",2023-10-24 21:00:00,-23960,1913,25873,907,FALSE,NA,"0.1.4"
"40214","646",2023-10-24 21:15:00,-23959,1913,25872,907,FALSE,NA,"0.1.4"
"40215","646",2023-10-24 21:30:00,-23959,1913,25872,907,FALSE,NA,"0.1.4"
"40216","646",2023-10-24 21:45:00,-23960,1913,25873,907,FALSE,NA,"0.1.4"
"40217","646",2023-10-24 22:00:00,-23960,1913,25873,907,FALSE,NA,"0.1.4"
"40218","646",2023-10-24 22:15:00,-24085,1913,25998,907,FALSE,NA,"0.1.4"
"40219","646",2023-10-24 22:30:00,-24211,1913,26124,907,FALSE,NA,"0.1.4"
"40220","646",2023-10-24 22:45:00,-24598,1913,26511,907,FALSE,NA,"0.1.4"
"40221","646",2023-10-24 23:00:00,-24622,1913,26535,907,FALSE,NA,"0.1.4"
"40222","646",2023-10-24 23:15:00,-24622,1913,26535,907,FALSE,"jump1","0.1.4"
"40223","646",2023-10-24 23:30:00,-24571,1913,26484,907,FALSE,NA,"0.1.4"
"40224","646",2023-10-24 23:45:00,-25024,1913,26937,907,FALSE,NA,"0.1.4"
"40225","646",2023-10-25,-24881,1913,26794,907,FALSE,NA,"0.1.4"
"40226","646",2023-10-25 00:15:00,-25154,1913,27067,907,FALSE,NA,"0.1.4"
"40227","646",2023-10-25 00:30:00,-25154,1913,27067,907,FALSE,"jump1","0.1.4"
"40228","646",2023-10-25 00:45:00,-25051,1913,26964,907,FALSE,NA,"0.1.4"
"40229","646",2023-10-25 01:00:00,-25037,1913,26950,907,FALSE,NA,"0.1.4"
"40230","646",2023-10-25 01:15:00,-25051,1913,26964,907,FALSE,NA,"0.1.4"
"40231","646",2023-10-25 01:30:00,-25025,1913,26938,907,FALSE,NA,"0.1.4"
"40232","646",2023-10-25 01:45:00,-25025,1913,26938,907,FALSE,NA,"0.1.4"
"40233","646",2023-10-25 02:00:00,-25024,1913,26937,907,FALSE,NA,"0.1.4"
"40234","646",2023-10-25 02:15:00,-25024,1913,26937,907,FALSE,NA,"0.1.4"
"40235","646",2023-10-25 02:30:00,-25057,1913,26970,907,FALSE,NA,"0.1.4"
"40236","646",2023-10-25 02:45:00,-25058,1913,26971,907,FALSE,NA,"0.1.4"
"40237","646",2023-10-25 03:00:00,-25056,1913,26969,907,FALSE,NA,"0.1.4"
"40238","646",2023-10-25 03:15:00,-25052,1913,26965,907,FALSE,NA,"0.1.4"
"40239","646",2023-10-25 03:30:00,-25053,1913,26966,907,FALSE,NA,"0.1.4"
"40240","646",2023-10-25 03:45:00,-25058,1913,26971,907,FALSE,NA,"0.1.4"
"40241","646",2023-10-25 04:00:00,-25058,1913,26971,907,FALSE,NA,"0.1.4"
"40242","646",2023-10-25 04:15:00,-25060,1913,26973,907,FALSE,NA,"0.1.4"
"40243","646",2023-10-25 04:30:00,-25056,1913,26969,907,FALSE,NA,"0.1.4"
"40244","646",2023-10-25 04:45:00,-25050,1913,26963,907,FALSE,NA,"0.1.4"
"40245","646",2023-10-25 05:00:00,-25057,1913,26970,907,FALSE,NA,"0.1.4"
"40246","646",2023-10-25 05:15:00,-25056,1913,26969,907,FALSE,NA,"0.1.4"
"40247","646",2023-10-25 05:30:00,-25058,1913,26971,907,FALSE,NA,"0.1.4"
"40248","646",2023-10-25 05:45:00,-25058,1913,26971,907,FALSE,NA,"0.1.4"
"40249","646",2023-10-25 06:00:00,-25059,1913,26972,907,FALSE,NA,"0.1.4"
"40250","646",2023-10-25 06:15:00,-25059,1913,26972,907,FALSE,NA,"0.1.4"
"40251","646",2023-10-25 06:30:00,-25060,1913,26973,907,FALSE,NA,"0.1.4"
"40252","646",2023-10-25 06:45:00,-25059,1913,26972,907,FALSE,NA,"0.1.4"
"40253","646",2023-10-25 07:00:00,-25059,1913,26972,907,FALSE,NA,"0.1.4"
"40254","646",2023-10-25 07:15:00,-25058,1913,26971,907,FALSE,NA,"0.1.4"
"40255","646",2023-10-25 07:30:00,-25058,1913,26971,907,FALSE,NA,"0.1.4"
"40256","646",2023-10-25 07:45:00,-25059,1913,26972,907,FALSE,NA,"0.1.4"
"40257","646",2023-10-25 08:00:00,-25058,1913,26971,907,FALSE,NA,"0.1.4"
"40258","646",2023-10-25 08:15:00,-25058,1913,26971,907,FALSE,NA,"0.1.4"
"40259","646",2023-10-25 08:30:00,-25058,1913,26971,907,FALSE,NA,"0.1.4"
"40260","646",2023-10-25 08:45:00,-25058,1913,26971,907,FALSE,NA,"0.1.4"
"40261","646",2023-10-25 09:00:00,-25058,1913,26971,907,FALSE,NA,"0.1.4"
"40262","646",2023-10-25 09:15:00,-25059,1913,26972,907,FALSE,NA,"0.1.4"
"40263","646",2023-10-25 09:30:00,-25055,1913,26968,907,FALSE,NA,"0.1.4"
"40264","646",2023-10-25 09:45:00,-25065,1913,26978,907,FALSE,NA,"0.1.4"
"40265","646",2023-10-25 10:00:00,-25091,1913,27004,907,FALSE,NA,"0.1.4"
"40266","646",2023-10-25 10:15:00,-25064,1913,26977,907,FALSE,NA,"0.1.4"
"40267","646",2023-10-25 10:30:00,-25061,1913,26974,907,TRUE,NA,"0.1.4"
"40268","646",2023-10-25 10:45:00,-25065,1913,26978,907,TRUE,NA,"0.1.4"
"40269","646",2023-10-25 11:00:00,-25065,1913,26978,907,TRUE,NA,"0.1.4"
"40270","646",2023-10-25 11:15:00,-25065,1913,26978,907,TRUE,NA,"0.1.4"
"40271","646",2023-10-25 11:30:00,-25065,1913,26978,907,TRUE,NA,"0.1.4"
"40272","646",2023-10-25 11:45:00,-25065,1913,26978,907,TRUE,NA,"0.1.4"
"40273","646",2023-10-25 12:00:00,-25065,1913,26978,907,TRUE,NA,"0.1.4"
"40274","646",2023-10-25 12:15:00,-25065,1913,26978,907,TRUE,NA,"0.1.4"
"40275","646",2023-10-25 12:30:00,-25064,1913,26977,907,TRUE,NA,"0.1.4"
"40276","646",2023-10-25 12:45:00,-25064,1913,26977,907,TRUE,NA,"0.1.4"
"40277","646",2023-10-25 13:00:00,-25063,1913,26976,907,TRUE,NA,"0.1.4"
"40278","646",2023-10-25 13:15:00,-25063,1913,26976,907,TRUE,NA,"0.1.4"
"40279","646",2023-10-25 13:30:00,-25063,1913,26976,907,TRUE,NA,"0.1.4"
"40280","646",2023-10-25 13:45:00,-25064,1913,26977,907,TRUE,NA,"0.1.4"
"40281","646",2023-10-25 14:00:00,-25064,1913,26977,907,TRUE,NA,"0.1.4"
"40282","646",2023-10-25 14:15:00,-25064,1913,26977,907,TRUE,NA,"0.1.4"
"40283","646",2023-10-25 14:30:00,-25064,1913,26977,907,TRUE,NA,"0.1.4"
"40284","646",2023-10-25 14:45:00,-25064,1913,26977,907,TRUE,NA,"0.1.4"
"40285","646",2023-10-25 15:00:00,-25064,1913,26977,907,TRUE,NA,"0.1.4"
"40286","646",2023-10-25 15:15:00,-25064,1913,26977,907,TRUE,NA,"0.1.4"
"40287","646",2023-10-25 15:30:00,-25064,1913,26977,907,TRUE,NA,"0.1.4"
"40288","646",2023-10-25 15:45:00,-25064,1913,26977,907,TRUE,NA,"0.1.4"
"40289","646",2023-10-25 16:00:00,-25064,1913,26977,907,TRUE,NA,"0.1.4"
"40290","646",2023-10-25 16:15:00,-25064,1913,26977,907,TRUE,NA,"0.1.4"
"40291","646",2023-10-25 16:30:00,-25062,1913,26975,907,TRUE,NA,"0.1.4"
"40292","646",2023-10-25 16:45:00,-25060,1913,26973,907,TRUE,NA,"0.1.4"
"40293","646",2023-10-25 17:00:00,-25061,1913,26974,907,TRUE,NA,"0.1.4"
"40294","646",2023-10-25 17:15:00,-25061,1913,26974,907,TRUE,NA,"0.1.4"
"40295","646",2023-10-25 17:30:00,-25063,1913,26976,907,TRUE,NA,"0.1.4"
"40296","646",2023-10-25 17:45:00,-25064,1913,26977,907,FALSE,NA,"0.1.4"
"40297","646",2023-10-25 18:00:00,-25060,1913,26973,907,FALSE,NA,"0.1.4"
"40298","646",2023-10-25 18:15:00,-25064,1913,26977,907,FALSE,NA,"0.1.4"
"40299","646",2023-10-25 18:30:00,-25064,1913,26977,907,FALSE,NA,"0.1.4"
"40300","646",2023-10-25 18:45:00,-25065,1913,26978,907,FALSE,NA,"0.1.4"
"40301","646",2023-10-25 19:00:00,-25064,1913,26977,907,FALSE,NA,"0.1.4"
"40302","646",2023-10-25 19:15:00,-25064,1913,26977,907,FALSE,NA,"0.1.4"
"40303","646",2023-10-25 19:30:00,-25064,1913,26977,907,FALSE,NA,"0.1.4"
"40304","646",2023-10-25 19:45:00,-25065,1913,26978,907,FALSE,NA,"0.1.4"
"40305","646",2023-10-25 20:00:00,-25065,1913,26978,907,FALSE,NA,"0.1.4"
"40306","646",2023-10-25 20:15:00,-25065,1913,26978,907,FALSE,NA,"0.1.4"
"40307","646",2023-10-25 20:30:00,-25066,1913,26979,907,TRUE,NA,"0.1.4"
"40308","646",2023-10-25 20:45:00,-25065,1913,26978,907,FALSE,NA,"0.1.4"
"40309","646",2023-10-25 21:00:00,-25064,1913,26977,907,FALSE,NA,"0.1.4"
"40310","646",2023-10-25 21:15:00,-25065,1913,26978,907,FALSE,NA,"0.1.4"
"40311","646",2023-10-25 21:30:00,-25065,1913,26978,907,FALSE,NA,"0.1.4"
"40312","646",2023-10-25 21:45:00,-25065,1913,26978,907,FALSE,NA,"0.1.4"
"40313","646",2023-10-25 22:00:00,-25063,1913,26976,907,FALSE,NA,"0.1.4"
"40314","646",2023-10-25 22:15:00,-25063,1913,26976,907,FALSE,NA,"0.1.4"
"40315","646",2023-10-25 22:30:00,-25066,1913,26979,907,TRUE,NA,"0.1.4"
"40316","646",2023-10-25 22:45:00,-25069,1913,26982,907,TRUE,NA,"0.1.4"
"40317","646",2023-10-25 23:00:00,-25067,1913,26980,907,TRUE,NA,"0.1.4"
"40318","646",2023-10-25 23:15:00,-25070,1913,26983,907,TRUE,NA,"0.1.4"
"40319","646",2023-10-25 23:30:00,-25074,1913,26987,907,TRUE,NA,"0.1.4"
"40320","646",2023-10-25 23:45:00,-25062,1913,26975,907,TRUE,NA,"0.1.4"
"40321","646",2023-10-26,-25065,1913,26978,907,TRUE,NA,"0.1.4"
"40322","646",2023-10-26 00:15:00,-25063,1913,26976,907,TRUE,NA,"0.1.4"
"40323","646",2023-10-26 00:30:00,-25066,1913,26979,907,TRUE,NA,"0.1.4"
"40324","646",2023-10-26 00:45:00,-25063,1913,26976,907,TRUE,NA,"0.1.4"
"40325","646",2023-10-26 01:00:00,-25062,1913,26975,907,TRUE,NA,"0.1.4"
"40326","646",2023-10-26 01:15:00,-25060,1913,26973,907,TRUE,NA,"0.1.4"
"40327","646",2023-10-26 01:30:00,-25062,1913,26975,907,TRUE,NA,"0.1.4"
"40328","646",2023-10-26 01:45:00,-25061,1913,26974,907,TRUE,NA,"0.1.4"
"40329","646",2023-10-26 02:00:00,-25061,1913,26974,907,TRUE,NA,"0.1.4"
"40330","646",2023-10-26 02:15:00,-25063,1913,26976,907,TRUE,NA,"0.1.4"
"40331","646",2023-10-26 02:30:00,-25062,1913,26975,907,TRUE,NA,"0.1.4"
"40332","646",2023-10-26 02:45:00,-25063,1913,26976,907,TRUE,NA,"0.1.4"
"40333","646",2023-10-26 03:00:00,-25064,1913,26977,907,TRUE,NA,"0.1.4"
"40334","646",2023-10-26 03:15:00,-25064,1913,26977,907,TRUE,NA,"0.1.4"
"40335","646",2023-10-26 03:30:00,-25063,1913,26976,907,TRUE,NA,"0.1.4"
"40336","646",2023-10-26 03:45:00,-25061,1913,26974,907,TRUE,NA,"0.1.4"
"40337","646",2023-10-26 04:00:00,-25065,1913,26978,907,TRUE,NA,"0.1.4"
"40338","646",2023-10-26 04:15:00,-25062,1913,26975,907,TRUE,NA,"0.1.4"
"40339","646",2023-10-26 04:30:00,-25061,1913,26974,907,TRUE,NA,"0.1.4"
"40340","646",2023-10-26 04:45:00,-25061,1913,26974,907,TRUE,NA,"0.1.4"
"40341","646",2023-10-26 05:00:00,-25062,1913,26975,907,TRUE,NA,"0.1.4"
"40342","646",2023-10-26 05:15:00,-25063,1913,26976,907,TRUE,NA,"0.1.4"
"40343","646",2023-10-26 05:30:00,-25062,1913,26975,907,TRUE,NA,"0.1.4"
"40344","646",2023-10-26 05:45:00,-25062,1913,26975,907,TRUE,NA,"0.1.4"
"40345","646",2023-10-26 06:00:00,-25062,1913,26975,907,TRUE,NA,"0.1.4"
"40346","646",2023-10-26 06:15:00,-25061,1913,26974,907,TRUE,NA,"0.1.4"
"40347","646",2023-10-26 06:30:00,-25061,1913,26974,907,TRUE,NA,"0.1.4"
"40348","646",2023-10-26 06:45:00,-25062,1913,26975,907,TRUE,NA,"0.1.4"
"40349","646",2023-10-26 07:00:00,-25062,1913,26975,907,TRUE,NA,"0.1.4"
"40350","646",2023-10-26 07:15:00,-25062,1913,26975,907,TRUE,NA,"0.1.4"
"40351","646",2023-10-26 07:30:00,-25062,1913,26975,907,TRUE,NA,"0.1.4"
"40352","646",2023-10-26 07:45:00,-25062,1913,26975,907,TRUE,NA,"0.1.4"
"40353","646",2023-10-26 08:00:00,-25061,1913,26974,907,TRUE,NA,"0.1.4"
"40354","646",2023-10-26 08:15:00,-25061,1913,26974,907,TRUE,NA,"0.1.4"
"40355","646",2023-10-26 08:30:00,-25062,1913,26975,907,TRUE,NA,"0.1.4"
"40356","646",2023-10-26 08:45:00,-25061,1913,26974,907,TRUE,NA,"0.1.4"
"40357","646",2023-10-26 09:00:00,-25061,1913,26974,907,TRUE,NA,"0.1.4"
"40358","646",2023-10-26 09:15:00,-25061,1913,26974,907,TRUE,NA,"0.1.4"
"40359","646",2023-10-26 09:30:00,-25062,1913,26975,907,TRUE,NA,"0.1.4"
"40360","646",2023-10-26 09:45:00,-25062,1913,26975,907,TRUE,NA,"0.1.4"
"40361","646",2023-10-26 10:00:00,-25063,1913,26976,907,TRUE,NA,"0.1.4"
"40362","646",2023-10-26 10:15:00,-25063,1913,26976,907,TRUE,NA,"0.1.4"
"40363","646",2023-10-26 10:30:00,-25063,1913,26976,907,TRUE,NA,"0.1.4"
"40364","646",2023-10-26 10:45:00,-25063,1913,26976,907,TRUE,NA,"0.1.4"
"40365","646",2023-10-26 11:00:00,-25063,1913,26976,907,TRUE,NA,"0.1.4"
"40366","646",2023-10-26 11:15:00,-25063,1913,26976,907,TRUE,NA,"0.1.4"
"40367","646",2023-10-26 11:30:00,-25063,1913,26976,907,TRUE,NA,"0.1.4"
"40368","646",2023-10-26 11:45:00,-25063,1913,26976,907,TRUE,NA,"0.1.4"
"40369","646",2023-10-26 12:00:00,-25063,1913,26976,907,TRUE,NA,"0.1.4"
"40370","646",2023-10-26 12:15:00,-25063,1913,26976,907,TRUE,NA,"0.1.4"
"40371","646",2023-10-26 12:30:00,-25063,1913,26976,907,TRUE,NA,"0.1.4"
"40372","646",2023-10-26 12:45:00,-25063,1913,26976,907,TRUE,NA,"0.1.4"
"40373","646",2023-10-26 13:00:00,-25063,1913,26976,907,TRUE,NA,"0.1.4"
"40374","646",2023-10-26 13:15:00,-25063,1913,26976,907,TRUE,NA,"0.1.4"
"40375","646",2023-10-26 13:30:00,-25063,1913,26976,907,TRUE,NA,"0.1.4"
"40376","646",2023-10-26 13:45:00,-25063,1913,26976,907,TRUE,NA,"0.1.4"
"40377","646",2023-10-26 14:00:00,-25063,1913,26976,907,TRUE,NA,"0.1.4"
"40378","646",2023-10-26 14:15:00,-25063,1913,26976,907,TRUE,NA,"0.1.4"
"40379","646",2023-10-26 14:30:00,-25064,1913,26977,907,TRUE,NA,"0.1.4"
"40380","646",2023-10-26 14:45:00,-25063,1913,26976,907,TRUE,NA,"0.1.4"
"40381","646",2023-10-26 15:00:00,-25063,1913,26976,907,TRUE,NA,"0.1.4"
"40382","646",2023-10-26 15:15:00,-25063,1913,26976,907,TRUE,NA,"0.1.4"
"40383","646",2023-10-26 15:30:00,-25063,1913,26976,907,TRUE,NA,"0.1.4"
"40384","646",2023-10-26 15:45:00,-25063,1913,26976,907,TRUE,NA,"0.1.4"
"40385","646",2023-10-26 16:00:00,-25063,1913,26976,907,TRUE,NA,"0.1.4"
"40386","646",2023-10-26 16:15:00,-25064,1913,26977,907,TRUE,NA,"0.1.4"
"40387","646",2023-10-26 16:30:00,-25063,1913,26976,907,TRUE,NA,"0.1.4"
"40388","646",2023-10-26 16:45:00,-25063,1913,26976,907,TRUE,NA,"0.1.4"
"40389","646",2023-10-26 17:00:00,-25062,1913,26975,907,TRUE,NA,"0.1.4"
"40390","646",2023-10-26 17:15:00,-25063,1913,26976,907,TRUE,NA,"0.1.4"
"40391","646",2023-10-26 17:30:00,-25065,1913,26978,907,TRUE,NA,"0.1.4"
"40392","646",2023-10-26 17:45:00,-25057,1913,26970,907,TRUE,NA,"0.1.4"
"40393","646",2023-10-26 18:00:00,-25061,1913,26974,907,TRUE,NA,"0.1.4"
"40394","646",2023-10-26 18:15:00,-25062,1913,26975,907,TRUE,NA,"0.1.4"
"40395","646",2023-10-26 18:30:00,-25062,1913,26975,907,TRUE,NA,"0.1.4"
"40396","646",2023-10-26 18:45:00,-25061,1913,26974,907,TRUE,NA,"0.1.4"
"40397","646",2023-10-26 19:00:00,-25061,1913,26974,907,TRUE,NA,"0.1.4"
"40398","646",2023-10-26 19:15:00,-25064,1913,26977,907,FALSE,NA,"0.1.4"
"40399","646",2023-10-26 19:30:00,-25072,1913,26985,907,FALSE,NA,"0.1.4"
"40400","646",2023-10-26 19:45:00,-25079,1913,26992,907,FALSE,NA,"0.1.4"
"40401","646",2023-10-26 20:00:00,-25082,1913,26995,907,FALSE,NA,"0.1.4"
"40402","646",2023-10-26 20:15:00,-25064,1913,26977,907,FALSE,NA,"0.1.4"
"40403","646",2023-10-26 20:30:00,-25065,1913,26978,907,FALSE,NA,"0.1.4"
"40404","646",2023-10-26 20:45:00,-25065,1913,26978,907,FALSE,NA,"0.1.4"
"40405","646",2023-10-26 21:00:00,-25064,1913,26977,907,FALSE,NA,"0.1.4"
"40406","646",2023-10-26 21:15:00,-25082,1913,26995,907,FALSE,NA,"0.1.4"
"40407","646",2023-10-26 21:30:00,-25066,1913,26979,907,FALSE,NA,"0.1.4"
"40408","646",2023-10-26 21:45:00,-25068,1913,26981,907,FALSE,NA,"0.1.4"
"40409","646",2023-10-26 22:00:00,-25065,1913,26978,907,FALSE,NA,"0.1.4"
"40410","646",2023-10-26 22:15:00,-25065,1913,26978,907,FALSE,NA,"0.1.4"
"40411","646",2023-10-26 22:30:00,-25065,1913,26978,907,FALSE,NA,"0.1.4"
"40412","646",2023-10-26 22:45:00,-25065,1913,26978,907,FALSE,NA,"0.1.4"
"40413","646",2023-10-26 23:00:00,-25065,1913,26978,907,FALSE,NA,"0.1.4"
"40414","646",2023-10-26 23:15:00,-25065,1913,26978,907,FALSE,NA,"0.1.4"
"40415","646",2023-10-26 23:30:00,-25065,1913,26978,907,FALSE,NA,"0.1.4"
"40416","646",2023-10-26 23:45:00,-25065,1913,26978,907,FALSE,NA,"0.1.4"
"40417","646",2023-10-27,-25065,1913,26978,907,FALSE,NA,"0.1.4"
"40418","646",2023-10-27 00:15:00,-25065,1913,26978,907,FALSE,NA,"0.1.4"
"40419","646",2023-10-27 00:30:00,-25065,1913,26978,907,FALSE,NA,"0.1.4"
"40420","646",2023-10-27 00:45:00,-25065,1913,26978,907,FALSE,NA,"0.1.4"
"40421","646",2023-10-27 01:00:00,-25065,1913,26978,907,FALSE,NA,"0.1.4"
"40422","646",2023-10-27 01:15:00,-25065,1913,26978,907,FALSE,NA,"0.1.4"
"40423","646",2023-10-27 01:30:00,-25075,1913,26988,907,FALSE,NA,"0.1.4"
"40424","646",2023-10-27 01:45:00,-25072,1913,26985,907,TRUE,NA,"0.1.4"
"40425","646",2023-10-27 02:00:00,-25385,1913,27298,907,TRUE,NA,"0.1.4"
"40426","646",2023-10-27 02:15:00,-25420,1913,27333,907,TRUE,NA,"0.1.4"
"40427","646",2023-10-27 02:30:00,-25117,1913,27030,907,TRUE,NA,"0.1.4"
"40428","646",2023-10-27 02:45:00,-25131,1913,27044,907,TRUE,NA,"0.1.4"
"40429","646",2023-10-27 03:00:00,-25066,1913,26979,907,TRUE,NA,"0.1.4"
"40430","646",2023-10-27 03:15:00,-25255.5,1913,27168.5,907,TRUE,"out1, fill","0.1.4"
"40431","646",2023-10-27 03:30:00,-25445,1913,27358,907,TRUE,NA,"0.1.4"
"40432","646",2023-10-27 03:45:00,-25534,1913,27447,907,TRUE,NA,"0.1.4"
"40433","646",2023-10-27 04:00:00,-25674,1913,27587,907,TRUE,NA,"0.1.4"
"40434","646",2023-10-27 04:15:00,-25716.3333333333,1913,27629.3333333333,907,TRUE,"out1, fill","0.1.4"
"40435","646",2023-10-27 04:30:00,-25758.6666666667,1913,27671.6666666667,907,TRUE,"out1, fill","0.1.4"
"40436","646",2023-10-27 04:45:00,-25801,1913,27714,907,TRUE,"out1, fill","0.1.4"
"40437","646",2023-10-27 05:00:00,-25843.3333333333,1913,27756.3333333333,907,TRUE,"out1, fill","0.1.4"
"40438","646",2023-10-27 05:15:00,-25885.6666666667,1913,27798.6666666667,907,TRUE,"out1, fill","0.1.4"
"40439","646",2023-10-27 05:30:00,-25928,1913,27841,907,TRUE,"out1, fill","0.1.4"
"40440","646",2023-10-27 05:45:00,-25970.3333333333,1913,27883.3333333333,907,TRUE,"out1, fill","0.1.4"
"40441","646",2023-10-27 06:00:00,-26012.6666666667,1913,27925.6666666667,907,TRUE,"out1, fill","0.1.4"
"40442","646",2023-10-27 06:15:00,-26055,1913,27968,907,TRUE,"out1, fill","0.1.4"
"40443","646",2023-10-27 06:30:00,-26097.3333333333,1913,28010.3333333333,907,TRUE,"out1, fill","0.1.4"
"40444","646",2023-10-27 06:45:00,-26139.6666666667,1913,28052.6666666667,907,TRUE,"out1, fill","0.1.4"
"40445","646",2023-10-27 07:00:00,-26182,1913,28095,907,TRUE,NA,"0.1.4"
"40446","646",2023-10-27 07:15:00,-25872,1913,27785,907,TRUE,NA,"0.1.4"
"40447","646",2023-10-27 07:30:00,-25852,1913,27765,907,TRUE,NA,"0.1.4"
"40448","646",2023-10-27 07:45:00,-25804.2857142857,1913,27717.2857142857,907,TRUE,"out1, fill","0.1.4"
"40449","646",2023-10-27 08:00:00,-25756.5714285714,1913,27669.5714285714,907,TRUE,"out1, fill","0.1.4"
"40450","646",2023-10-27 08:15:00,-25708.8571428571,1913,27621.8571428571,907,TRUE,"out1, fill","0.1.4"
"40451","646",2023-10-27 08:30:00,-25661.1428571429,1913,27574.1428571429,907,TRUE,"out1, fill","0.1.4"
"40452","646",2023-10-27 08:45:00,-25613.4285714286,1913,27526.4285714286,907,TRUE,"out1, fill","0.1.4"
"40453","646",2023-10-27 09:00:00,-25565.7142857143,1913,27478.7142857143,907,TRUE,"out1, fill","0.1.4"
"40454","646",2023-10-27 09:15:00,-25518,1913,27431,907,TRUE,NA,"0.1.4"
"40455","646",2023-10-27 09:30:00,-25393,1913,27306,907,TRUE,NA,"0.1.4"
"40456","646",2023-10-27 09:45:00,-25696,1913,27609,907,TRUE,NA,"0.1.4"
"40457","646",2023-10-27 10:00:00,-25572,1913,27485,907,TRUE,NA,"0.1.4"
"40458","646",2023-10-27 10:15:00,-25737,1913,27650,907,TRUE,NA,"0.1.4"
"40459","646",2023-10-27 10:30:00,-25647,1913,27560,907,TRUE,NA,"0.1.4"
"40460","646",2023-10-27 10:45:00,-25782.5,1913,27695.5,907,TRUE,"out1, fill","0.1.4"
"40461","646",2023-10-27 11:00:00,-25918,1913,27831,907,TRUE,NA,"0.1.4"
"40462","646",2023-10-27 11:15:00,-26002,1913,27915,907,TRUE,NA,"0.1.4"
"40463","646",2023-10-27 11:30:00,-25950,1913,27863,907,TRUE,NA,"0.1.4"
"40464","646",2023-10-27 11:45:00,-25865,1913,27778,907,TRUE,NA,"0.1.4"
"40465","646",2023-10-27 12:00:00,-25967,1913,27880,907,TRUE,NA,"0.1.4"
"40466","646",2023-10-27 12:15:00,-25846,1913,27759,907,TRUE,NA,"0.1.4"
"40467","646",2023-10-27 12:30:00,-25964,1913,27877,907,TRUE,NA,"0.1.4"
"40468","646",2023-10-27 12:45:00,-25913,1913,27826,907,TRUE,NA,"0.1.4"
"40469","646",2023-10-27 13:00:00,-26109,1913,28022,907,TRUE,NA,"0.1.4"
"40470","646",2023-10-27 13:15:00,-26298,1913,28211,907,TRUE,NA,"0.1.4"
"40471","646",2023-10-27 13:30:00,-25981,1913,27894,907,TRUE,NA,"0.1.4"
"40472","646",2023-10-27 13:45:00,-26199,1913,28112,907,TRUE,NA,"0.1.4"
"40473","646",2023-10-27 14:00:00,-26055,1913,27968,907,TRUE,NA,"0.1.4"
"40474","646",2023-10-27 14:15:00,-26234,1913,28147,907,TRUE,NA,"0.1.4"
"40475","646",2023-10-27 14:30:00,-26398.5,1913,28311.5,907,TRUE,"out1, fill","0.1.4"
"40476","646",2023-10-27 14:45:00,-26563,1913,28476,907,TRUE,NA,"0.1.4"
"40477","646",2023-10-27 15:00:00,-26549,1913,28462,907,TRUE,NA,"0.1.4"
"40478","646",2023-10-27 15:15:00,-26356,1913,28269,907,TRUE,NA,"0.1.4"
"40479","646",2023-10-27 15:30:00,-26624,1913,28537,907,TRUE,NA,"0.1.4"
"40480","646",2023-10-27 15:45:00,-26773,1913,28686,907,TRUE,NA,"0.1.4"
"40481","646",2023-10-27 16:00:00,-26566,1913,28479,907,TRUE,"out1, fill","0.1.4"
"40482","646",2023-10-27 16:15:00,-26359,1913,28272,907,TRUE,NA,"0.1.4"
"40483","646",2023-10-27 16:30:00,-26363,1913,28276,907,TRUE,NA,"0.1.4"
"40484","646",2023-10-27 16:45:00,-26270,1913,28183,907,TRUE,NA,"0.1.4"
"40485","646",2023-10-27 17:00:00,-26413,1913,28326,907,TRUE,NA,"0.1.4"
"40486","646",2023-10-27 17:15:00,-26147,1913,28060,907,TRUE,NA,"0.1.4"
"40487","646",2023-10-27 17:30:00,-26079.5833333333,1913,27992.5833333333,907,TRUE,"out1, fill","0.1.4"
"40488","646",2023-10-27 17:45:00,-26012.1666666667,1913,27925.1666666667,907,TRUE,"out1, fill","0.1.4"
"40489","646",2023-10-27 18:00:00,-25944.75,1913,27857.75,907,TRUE,"out1, fill","0.1.4"
"40490","646",2023-10-27 18:15:00,-25877.3333333333,1913,27790.3333333333,907,TRUE,"out1, fill","0.1.4"
"40491","646",2023-10-27 18:30:00,-25809.9166666667,1913,27722.9166666667,907,TRUE,"out1, fill","0.1.4"
"40492","646",2023-10-27 18:45:00,-25742.5,1913,27655.5,907,TRUE,"out1, fill","0.1.4"
"40493","646",2023-10-27 19:00:00,-25675.0833333333,1913,27588.0833333333,907,TRUE,"out1, fill","0.1.4"
"40494","646",2023-10-27 19:15:00,-25607.6666666667,1913,27520.6666666667,907,TRUE,"out1, fill","0.1.4"
"40495","646",2023-10-27 19:30:00,-25540.25,1913,27453.25,907,TRUE,"out1, fill","0.1.4"
"40496","646",2023-10-27 19:45:00,-25472.8333333333,1913,27385.8333333333,907,TRUE,"out1, fill","0.1.4"
"40497","646",2023-10-27 20:00:00,-25405.4166666667,1913,27318.4166666667,907,TRUE,"out1, fill","0.1.4"
"40498","646",2023-10-27 20:15:00,-25338,1913,27251,907,TRUE,NA,"0.1.4"
"40499","646",2023-10-27 20:30:00,-25078,1913,26991,907,TRUE,NA,"0.1.4"
"40500","646",2023-10-27 20:45:00,-25142,1913,27055,907,TRUE,NA,"0.1.4"
"40501","646",2023-10-27 21:00:00,-25247,1913,27160,907,TRUE,"out1, fill","0.1.4"
"40502","646",2023-10-27 21:15:00,-25352,1913,27265,907,TRUE,"out1, fill","0.1.4"
"40503","646",2023-10-27 21:30:00,-25457,1913,27370,907,TRUE,"out1, fill","0.1.4"
"40504","646",2023-10-27 21:45:00,-25562,1913,27475,907,TRUE,"out1, fill","0.1.4"
"40505","646",2023-10-27 22:00:00,-25667,1913,27580,907,TRUE,"out1, fill","0.1.4"
"40506","646",2023-10-27 22:15:00,-25772,1913,27685,907,TRUE,"out1, fill","0.1.4"
"40507","646",2023-10-27 22:30:00,-25877,1913,27790,907,TRUE,"out1, fill","0.1.4"
"40508","646",2023-10-27 22:45:00,-25982,1913,27895,907,TRUE,NA,"0.1.4"
"40509","646",2023-10-27 23:00:00,-26015,1913,27928,907,TRUE,NA,"0.1.4"
"40510","646",2023-10-27 23:15:00,-26099,1913,28012,907,TRUE,NA,"0.1.4"
"40511","646",2023-10-27 23:30:00,-25750.5,1913,27663.5,907,TRUE,"out1, fill","0.1.4"
"40512","646",2023-10-27 23:45:00,-25402,1913,27315,907,TRUE,NA,"0.1.4"
"40513","646",2023-10-28,-25384,1913,27297,907,TRUE,NA,"0.1.4"
"40514","646",2023-10-28 00:15:00,-25389,1913,27302,907,TRUE,NA,"0.1.4"
"40515","646",2023-10-28 00:30:00,-25365,1913,27278,907,TRUE,NA,"0.1.4"
"40516","646",2023-10-28 00:45:00,-25280,1913,27193,907,TRUE,NA,"0.1.4"
"40517","646",2023-10-28 01:00:00,-25101,1913,27014,907,TRUE,NA,"0.1.4"
"40518","646",2023-10-28 01:15:00,-25082,1913,26995,907,TRUE,NA,"0.1.4"
"40519","646",2023-10-28 01:30:00,-25148,1913,27061,907,TRUE,"out1, fill","0.1.4"
"40520","646",2023-10-28 01:45:00,-25214,1913,27127,907,TRUE,"out1, fill","0.1.4"
"40521","646",2023-10-28 02:00:00,-25280,1913,27193,907,TRUE,"out1, fill","0.1.4"
"40522","646",2023-10-28 02:15:00,-25346,1913,27259,907,TRUE,"out1, fill","0.1.4"
"40523","646",2023-10-28 02:30:00,-25412,1913,27325,907,TRUE,"out1, fill","0.1.4"
"40524","646",2023-10-28 02:45:00,-25478,1913,27391,907,TRUE,"out1, fill","0.1.4"
"40525","646",2023-10-28 03:00:00,-25544,1913,27457,907,TRUE,NA,"0.1.4"
"40526","646",2023-10-28 03:15:00,-25186,1913,27099,907,TRUE,NA,"0.1.4"
"40527","646",2023-10-28 03:30:00,-25554,1913,27467,907,TRUE,NA,"0.1.4"
"40528","646",2023-10-28 03:45:00,-25750,1913,27663,907,TRUE,NA,"0.1.4"
"40529","646",2023-10-28 04:00:00,-26235,1913,28148,907,TRUE,"out1, fill","0.1.4"
"40530","646",2023-10-28 04:15:00,-26720,1913,28633,907,TRUE,NA,"0.1.4"
"40531","646",2023-10-28 04:30:00,-26791,1913,28704,907,TRUE,NA,"0.1.4"
"40532","646",2023-10-28 04:45:00,-26945,1913,28858,907,TRUE,NA,"0.1.4"
"40533","646",2023-10-28 05:00:00,-26754,1913,28667,907,TRUE,NA,"0.1.4"
"40534","646",2023-10-28 05:15:00,-26917,1913,28830,907,TRUE,NA,"0.1.4"
"40535","646",2023-10-28 05:30:00,-26558,1913,28471,907,TRUE,NA,"0.1.4"
"40536","646",2023-10-28 05:45:00,-26180,1913,28093,907,TRUE,NA,"0.1.4"
"40537","646",2023-10-28 06:00:00,-26555,1913,28468,907,TRUE,"out1, fill","0.1.4"
"40538","646",2023-10-28 06:15:00,-26930,1913,28843,907,TRUE,NA,"0.1.4"
"40539","646",2023-10-28 06:30:00,-26709,1913,28622,907,TRUE,NA,"0.1.4"
"40540","646",2023-10-28 06:45:00,-26352,1913,28265,907,TRUE,NA,"0.1.4"
"40541","646",2023-10-28 07:00:00,-26043,1913,27956,907,TRUE,NA,"0.1.4"
"40542","646",2023-10-28 07:15:00,-26116,1913,28029,907,TRUE,NA,"0.1.4"
"40543","646",2023-10-28 07:30:00,-26242,1913,28155,907,TRUE,NA,"0.1.4"
"40544","646",2023-10-28 07:45:00,-26387,1913,28300,907,TRUE,NA,"0.1.4"
"40545","646",2023-10-28 08:00:00,-26519,1913,28432,907,TRUE,NA,"0.1.4"
"40546","646",2023-10-28 08:15:00,-26820,1913,28733,907,TRUE,NA,"0.1.4"
"40547","646",2023-10-28 08:30:00,-26748,1913,28661,907,TRUE,NA,"0.1.4"
"40548","646",2023-10-28 08:45:00,-26817,1913,28730,907,TRUE,NA,"0.1.4"
"40549","646",2023-10-28 09:00:00,-26654,1913,28567,907,TRUE,NA,"0.1.4"
"40550","646",2023-10-28 09:15:00,-26732,1913,28645,907,TRUE,NA,"0.1.4"
"40551","646",2023-10-28 09:30:00,-26807,1913,28720,907,TRUE,NA,"0.1.4"
"40552","646",2023-10-28 09:45:00,-26779,1913,28692,907,TRUE,NA,"0.1.4"
"40553","646",2023-10-28 10:00:00,-26729,1913,28642,907,TRUE,NA,"0.1.4"
"40554","646",2023-10-28 10:15:00,-26735,1913,28648,907,TRUE,NA,"0.1.4"
"40555","646",2023-10-28 10:30:00,-26721,1913,28634,907,TRUE,NA,"0.1.4"
"40556","646",2023-10-28 10:45:00,-26391,1913,28304,907,TRUE,NA,"0.1.4"
"40557","646",2023-10-28 11:00:00,-26575,1913,28488,907,TRUE,NA,"0.1.4"
"40558","646",2023-10-28 11:15:00,-26255.5,1913,28168.5,907,TRUE,"out1, fill","0.1.4"
"40559","646",2023-10-28 11:30:00,-25936,1913,27849,907,TRUE,NA,"0.1.4"
"40560","646",2023-10-28 11:45:00,-26317,1913,28230,907,TRUE,NA,"0.1.4"
"40561","646",2023-10-28 12:00:00,-26589,1913,28502,907,TRUE,NA,"0.1.4"
"40562","646",2023-10-28 12:15:00,-26291,1913,28204,907,TRUE,NA,"0.1.4"
"40563","646",2023-10-28 12:30:00,-26530,1913,28443,907,TRUE,NA,"0.1.4"
"40564","646",2023-10-28 12:45:00,-26445,1913,28358,907,TRUE,NA,"0.1.4"
"40565","646",2023-10-28 13:00:00,-26773,1913,28686,907,TRUE,NA,"0.1.4"
"40566","646",2023-10-28 13:15:00,-26740,1913,28653,907,TRUE,NA,"0.1.4"
"40567","646",2023-10-28 13:30:00,-26686.3333333333,1913,28599.3333333333,907,TRUE,"out1, fill","0.1.4"
"40568","646",2023-10-28 13:45:00,-26632.6666666667,1913,28545.6666666667,907,TRUE,"out1, fill","0.1.4"
"40569","646",2023-10-28 14:00:00,-26579,1913,28492,907,TRUE,NA,"0.1.4"
"40570","646",2023-10-28 14:15:00,-26626,1913,28539,907,TRUE,NA,"0.1.4"
"40571","646",2023-10-28 14:30:00,-26886,1913,28799,907,TRUE,NA,"0.1.4"
"40572","646",2023-10-28 14:45:00,-26628,1913,28541,907,TRUE,NA,"0.1.4"
"40573","646",2023-10-28 15:00:00,-26690,1913,28603,907,TRUE,NA,"0.1.4"
"40574","646",2023-10-28 15:15:00,-26832,1913,28745,907,TRUE,NA,"0.1.4"
"40575","646",2023-10-28 15:30:00,-26617.5,1913,28530.5,907,TRUE,"out1, fill","0.1.4"
"40576","646",2023-10-28 15:45:00,-26403,1913,28316,907,TRUE,NA,"0.1.4"
"40577","646",2023-10-28 16:00:00,-26323,1913,28236,907,TRUE,NA,"0.1.4"
"40578","646",2023-10-28 16:15:00,-26226,1913,28139,907,TRUE,NA,"0.1.4"
"40579","646",2023-10-28 16:30:00,-26375,1913,28288,907,TRUE,NA,"0.1.4"
"40580","646",2023-10-28 16:45:00,-26318,1913,28231,907,TRUE,NA,"0.1.4"
"40581","646",2023-10-28 17:00:00,-26391,1913,28304,907,TRUE,NA,"0.1.4"
"40582","646",2023-10-28 17:15:00,-26353,1913,28266,907,TRUE,NA,"0.1.4"
"40583","646",2023-10-28 17:30:00,-26353,1913,28266,907,TRUE,"out1, fill","0.1.4"
"40584","646",2023-10-28 17:45:00,-26353,1913,28266,907,TRUE,"jump1","0.1.4"
"40585","646",2023-10-28 18:00:00,-26263,1913,28176,907,TRUE,NA,"0.1.4"
"40586","646",2023-10-28 18:15:00,-26266,1913,28179,907,TRUE,NA,"0.1.4"
"40587","646",2023-10-28 18:30:00,-26381,1913,28294,907,TRUE,NA,"0.1.4"
"40588","646",2023-10-28 18:45:00,-26644,1913,28557,907,TRUE,NA,"0.1.4"
"40589","646",2023-10-28 19:00:00,-26601,1913,28514,907,TRUE,NA,"0.1.4"
"40590","646",2023-10-28 19:15:00,-26596,1913,28509,907,TRUE,NA,"0.1.4"
"40591","646",2023-10-28 19:30:00,-26516,1913,28429,907,TRUE,NA,"0.1.4"
"40592","646",2023-10-28 19:45:00,-26729,1913,28642,907,TRUE,NA,"0.1.4"
"40593","646",2023-10-28 20:00:00,-26434,1913,28347,907,TRUE,NA,"0.1.4"
"40594","646",2023-10-28 20:15:00,-26297,1913,28210,907,TRUE,NA,"0.1.4"
"40595","646",2023-10-28 20:30:00,-26371.4,1913,28284.4,907,TRUE,"out1, fill","0.1.4"
"40596","646",2023-10-28 20:45:00,-26445.8,1913,28358.8,907,TRUE,"out1, fill","0.1.4"
"40597","646",2023-10-28 21:00:00,-26520.2,1913,28433.2,907,TRUE,"out1, fill","0.1.4"
"40598","646",2023-10-28 21:15:00,-26594.6,1913,28507.6,907,TRUE,"out1, fill","0.1.4"
"40599","646",2023-10-28 21:30:00,-26669,1913,28582,907,TRUE,NA,"0.1.4"
"40600","646",2023-10-28 21:45:00,-26517,1913,28430,907,TRUE,NA,"0.1.4"
"40601","646",2023-10-28 22:00:00,-26227,1913,28140,907,TRUE,NA,"0.1.4"
"40602","646",2023-10-28 22:15:00,-26225.3333333333,1913,28138.3333333333,907,TRUE,"out1, fill","0.1.4"
"40603","646",2023-10-28 22:30:00,-26223.6666666667,1913,28136.6666666667,907,TRUE,"out1, fill","0.1.4"
"40604","646",2023-10-28 22:45:00,-26222,1913,28135,907,TRUE,NA,"0.1.4"
"40605","646",2023-10-28 23:00:00,-26226,1913,28139,907,TRUE,NA,"0.1.4"
"40606","646",2023-10-28 23:15:00,-26232,1913,28145,907,TRUE,NA,"0.1.4"
"40607","646",2023-10-28 23:30:00,-26232,1913,28145,907,TRUE,NA,"0.1.4"
"40608","646",2023-10-28 23:45:00,-26229,1913,28142,907,TRUE,NA,"0.1.4"
"40609","646",2023-10-29,-26230,1913,28143,907,TRUE,NA,"0.1.4"
"40610","646",2023-10-29 00:15:00,-26231,1913,28144,907,TRUE,NA,"0.1.4"
"40611","646",2023-10-29 00:30:00,-26230,1913,28143,907,TRUE,NA,"0.1.4"
"40612","646",2023-10-29 00:45:00,-26234,1913,28147,907,TRUE,NA,"0.1.4"
"40613","646",2023-10-29 01:00:00,-26227,1913,28140,907,TRUE,NA,"0.1.4"
"40614","646",2023-10-29 01:15:00,-26227,1913,28140,907,TRUE,NA,"0.1.4"
"40615","646",2023-10-29 01:30:00,-26223,1913,28136,907,TRUE,NA,"0.1.4"
"40616","646",2023-10-29 01:45:00,-26445.7142857143,1913,28358.7142857143,907,TRUE,"out1, fill","0.1.4"
"40617","646",2023-10-29 02:00:00,-26668.4285714286,1913,28581.4285714286,907,TRUE,"out1, fill","0.1.4"
"40618","646",2023-10-29 02:15:00,-26891.1428571429,1913,28804.1428571429,907,TRUE,"out1, fill","0.1.4"
"40619","646",2023-10-29 02:30:00,-27113.8571428571,1913,29026.8571428571,907,TRUE,"out1, fill","0.1.4"
"40620","646",2023-10-29 02:45:00,-27336.5714285714,1913,29249.5714285714,907,TRUE,"out1, fill","0.1.4"
"40621","646",2023-10-29 03:00:00,-27559.2857142857,1913,29472.2857142857,907,TRUE,"out1, fill","0.1.4"
"40622","646",2023-10-29 03:15:00,-27782,1913,29695,907,TRUE,NA,"0.1.4"
"40623","646",2023-10-29 03:30:00,-27756,1913,29669,907,TRUE,NA,"0.1.4"
"40624","646",2023-10-29 03:45:00,-27745,1913,29658,907,TRUE,NA,"0.1.4"
"40625","646",2023-10-29 04:00:00,-27761.5384615385,1913,29674.5384615385,907,TRUE,"out1, fill","0.1.4"
"40626","646",2023-10-29 04:15:00,-27778.0769230769,1913,29691.0769230769,907,TRUE,"out1, fill","0.1.4"
"40627","646",2023-10-29 04:30:00,-27794.6153846154,1913,29707.6153846154,907,TRUE,"out1, fill","0.1.4"
"40628","646",2023-10-29 04:45:00,-27811.1538461538,1913,29724.1538461538,907,TRUE,"out1, fill","0.1.4"
"40629","646",2023-10-29 05:00:00,-27827.6923076923,1913,29740.6923076923,907,TRUE,"out1, fill","0.1.4"
"40630","646",2023-10-29 05:15:00,-27844.2307692308,1913,29757.2307692308,907,TRUE,"out1, fill","0.1.4"
"40631","646",2023-10-29 05:30:00,-27860.7692307692,1913,29773.7692307692,907,TRUE,"out1, fill","0.1.4"
"40632","646",2023-10-29 05:45:00,-27877.3076923077,1913,29790.3076923077,907,TRUE,"out1, fill","0.1.4"
"40633","646",2023-10-29 06:00:00,-27893.8461538462,1913,29806.8461538462,907,TRUE,"out1, fill","0.1.4"
"40634","646",2023-10-29 06:15:00,-27910.3846153846,1913,29823.3846153846,907,TRUE,"out1, fill","0.1.4"
"40635","646",2023-10-29 06:30:00,-27926.9230769231,1913,29839.9230769231,907,TRUE,"out1, fill","0.1.4"
"40636","646",2023-10-29 06:45:00,-27943.4615384615,1913,29856.4615384615,907,TRUE,"out1, fill","0.1.4"
"40637","646",2023-10-29 07:00:00,-27960,1913,29873,907,TRUE,NA,"0.1.4"
"40638","646",2023-10-29 07:15:00,-28011,1913,29924,907,TRUE,NA,"0.1.4"
"40639","646",2023-10-29 07:30:00,-28002,1913,29915,907,TRUE,NA,"0.1.4"
"40640","646",2023-10-29 07:45:00,-27970,1913,29883,907,TRUE,NA,"0.1.4"
"40641","646",2023-10-29 08:00:00,-27982,1913,29895,907,TRUE,NA,"0.1.4"
"40642","646",2023-10-29 08:15:00,-27864,1913,29777,907,TRUE,NA,"0.1.4"
"40643","646",2023-10-29 08:30:00,-27776,1913,29689,907,TRUE,NA,"0.1.4"
"40644","646",2023-10-29 08:45:00,-27789,1913,29702,907,TRUE,NA,"0.1.4"
"40645","646",2023-10-29 09:00:00,-27521.5,1913,29434.5,907,TRUE,"out1, fill","0.1.4"
"40646","646",2023-10-29 09:15:00,-27254,1913,29167,907,TRUE,NA,"0.1.4"
"40647","646",2023-10-29 09:30:00,-27436,1913,29349,907,TRUE,NA,"0.1.4"
"40648","646",2023-10-29 09:45:00,-27440,1913,29353,907,TRUE,NA,"0.1.4"
"40649","646",2023-10-29 10:00:00,-27749,1913,29662,907,TRUE,NA,"0.1.4"
"40650","646",2023-10-29 10:15:00,-27877,1913,29790,907,TRUE,NA,"0.1.4"
"40651","646",2023-10-29 10:30:00,-27802,1913,29715,907,TRUE,NA,"0.1.4"
"40652","646",2023-10-29 10:45:00,-27631,1913,29544,907,TRUE,NA,"0.1.4"
"40653","646",2023-10-29 11:00:00,-27952,1913,29865,907,TRUE,NA,"0.1.4"
"40654","646",2023-10-29 11:15:00,-27911.2857142857,1913,29824.2857142857,907,TRUE,"out1, fill","0.1.4"
"40655","646",2023-10-29 11:30:00,-27870.5714285714,1913,29783.5714285714,907,TRUE,"out1, fill","0.1.4"
"40656","646",2023-10-29 11:45:00,-27829.8571428571,1913,29742.8571428571,907,TRUE,"out1, fill","0.1.4"
"40657","646",2023-10-29 12:00:00,-27789.1428571429,1913,29702.1428571429,907,TRUE,"out1, fill","0.1.4"
"40658","646",2023-10-29 12:15:00,-27748.4285714286,1913,29661.4285714286,907,TRUE,"out1, fill","0.1.4"
"40659","646",2023-10-29 12:30:00,-27707.7142857143,1913,29620.7142857143,907,TRUE,"out1, fill","0.1.4"
"40660","646",2023-10-29 12:45:00,-27667,1913,29580,907,TRUE,NA,"0.1.4"
"40661","646",2023-10-29 13:00:00,-27938,1913,29851,907,TRUE,NA,"0.1.4"
"40662","646",2023-10-29 13:15:00,-27847,1913,29760,907,TRUE,NA,"0.1.4"
"40663","646",2023-10-29 13:30:00,-27954,1913,29867,907,TRUE,NA,"0.1.4"
"40664","646",2023-10-29 13:45:00,-27891.5833333333,1913,29804.5833333333,907,TRUE,"out1, fill","0.1.4"
"40665","646",2023-10-29 14:00:00,-27829.1666666667,1913,29742.1666666667,907,TRUE,"out1, fill","0.1.4"
"40666","646",2023-10-29 14:15:00,-27766.75,1913,29679.75,907,TRUE,"out1, fill","0.1.4"
"40667","646",2023-10-29 14:30:00,-27704.3333333333,1913,29617.3333333333,907,TRUE,"out1, fill","0.1.4"
"40668","646",2023-10-29 14:45:00,-27641.9166666667,1913,29554.9166666667,907,TRUE,"out1, fill","0.1.4"
"40669","646",2023-10-29 15:00:00,-27579.5,1913,29492.5,907,TRUE,"out1, fill","0.1.4"
"40670","646",2023-10-29 15:15:00,-27517.0833333333,1913,29430.0833333333,907,TRUE,"out1, fill","0.1.4"
"40671","646",2023-10-29 15:30:00,-27454.6666666667,1913,29367.6666666667,907,TRUE,"out1, fill","0.1.4"
"40672","646",2023-10-29 15:45:00,-27392.25,1913,29305.25,907,TRUE,"out1, fill","0.1.4"
"40673","646",2023-10-29 16:00:00,-27329.8333333333,1913,29242.8333333333,907,TRUE,"out1, fill","0.1.4"
"40674","646",2023-10-29 16:15:00,-27267.4166666667,1913,29180.4166666667,907,TRUE,"out1, fill","0.1.4"
"40675","646",2023-10-29 16:30:00,-27205,1913,29118,907,TRUE,NA,"0.1.4"
"40676","646",2023-10-29 16:45:00,-27205,1913,29118,907,TRUE,NA,"0.1.4"
"40677","646",2023-10-29 17:00:00,-27142,1913,29055,907,TRUE,NA,"0.1.4"
"40678","646",2023-10-29 17:15:00,-27316,1913,29229,907,TRUE,NA,"0.1.4"
"40679","646",2023-10-29 17:30:00,-27105.2,1913,29018.2,907,TRUE,"out1, fill","0.1.4"
"40680","646",2023-10-29 17:45:00,-26894.4,1913,28807.4,907,TRUE,"out1, fill","0.1.4"
"40681","646",2023-10-29 18:00:00,-26683.6,1913,28596.6,907,TRUE,"out1, fill","0.1.4"
"40682","646",2023-10-29 18:15:00,-26472.8,1913,28385.8,907,TRUE,"out1, fill","0.1.4"
"40683","646",2023-10-29 18:30:00,-26262,1913,28175,907,TRUE,NA,"0.1.4"
"40684","646",2023-10-29 18:45:00,-26251,1913,28164,907,TRUE,NA,"0.1.4"
"40685","646",2023-10-29 19:00:00,-26241,1913,28154,907,TRUE,NA,"0.1.4"
"40686","646",2023-10-29 19:15:00,-26279,1913,28192,907,TRUE,NA,"0.1.4"
"40687","646",2023-10-29 19:30:00,-26289.875,1913,28202.875,907,TRUE,"out1, fill","0.1.4"
"40688","646",2023-10-29 19:45:00,-26300.75,1913,28213.75,907,TRUE,"out1, fill","0.1.4"
"40689","646",2023-10-29 20:00:00,-26311.625,1913,28224.625,907,TRUE,"out1, fill","0.1.4"
"40690","646",2023-10-29 20:15:00,-26322.5,1913,28235.5,907,TRUE,"out1, fill","0.1.4"
"40691","646",2023-10-29 20:30:00,-26333.375,1913,28246.375,907,TRUE,"out1, fill","0.1.4"
"40692","646",2023-10-29 20:45:00,-26344.25,1913,28257.25,907,TRUE,"out1, fill","0.1.4"
"40693","646",2023-10-29 21:00:00,-26355.125,1913,28268.125,907,TRUE,"out1, fill","0.1.4"
"40694","646",2023-10-29 21:15:00,-26366,1913,28279,907,TRUE,NA,"0.1.4"
"40695","646",2023-10-29 21:30:00,-26221,1913,28134,907,TRUE,NA,"0.1.4"
"40696","646",2023-10-29 21:45:00,-26221,1913,28134,907,TRUE,NA,"0.1.4"
"40697","646",2023-10-29 22:00:00,-26222,1913,28135,907,TRUE,NA,"0.1.4"
"40698","646",2023-10-29 22:15:00,-26222,1913,28135,907,TRUE,NA,"0.1.4"
"40699","646",2023-10-29 22:30:00,-26501,1913,28414,907,FALSE,NA,"0.1.4"
"40700","646",2023-10-29 22:45:00,-26865.5,1913,28778.5,907,FALSE,"out1, fill","0.1.4"
"40701","646",2023-10-29 23:00:00,-27230,1913,29143,907,FALSE,NA,"0.1.4"
"40702","646",2023-10-29 23:15:00,-27394,1913,29307,907,FALSE,NA,"0.1.4"
"40703","646",2023-10-29 23:30:00,-27437,1913,29350,907,TRUE,NA,"0.1.4"
"40704","646",2023-10-29 23:45:00,-27308,1913,29221,907,TRUE,NA,"0.1.4"
"40705","646",2023-10-30,-27272.6,1913,29185.6,907,TRUE,"out1, fill","0.1.4"
"40706","646",2023-10-30 00:15:00,-27237.2,1913,29150.2,907,TRUE,"out1, fill","0.1.4"
"40707","646",2023-10-30 00:30:00,-27201.8,1913,29114.8,907,TRUE,"out1, fill","0.1.4"
"40708","646",2023-10-30 00:45:00,-27166.4,1913,29079.4,907,TRUE,"out1, fill","0.1.4"
"40709","646",2023-10-30 01:00:00,-27131,1913,29044,907,TRUE,NA,"0.1.4"
"40710","646",2023-10-30 01:15:00,-27095,1913,29008,907,TRUE,NA,"0.1.4"
"40711","646",2023-10-30 01:30:00,-27153,1913,29066,907,TRUE,NA,"0.1.4"
"40712","646",2023-10-30 01:45:00,-27453,1913,29366,907,TRUE,NA,"0.1.4"
"40713","646",2023-10-30 02:00:00,-27324,1913,29237,907,TRUE,NA,"0.1.4"
"40714","646",2023-10-30 02:15:00,-27621,1913,29534,907,TRUE,NA,"0.1.4"
"40715","646",2023-10-30 02:30:00,-27618,1913,29531,907,TRUE,"out1, fill","0.1.4"
"40716","646",2023-10-30 02:45:00,-27615,1913,29528,907,TRUE,"out1, fill","0.1.4"
"40717","646",2023-10-30 03:00:00,-27612,1913,29525,907,TRUE,NA,"0.1.4"
"40718","646",2023-10-30 03:15:00,-27284,1913,29197,907,TRUE,NA,"0.1.4"
"40719","646",2023-10-30 03:30:00,-27062,1913,28975,907,TRUE,NA,"0.1.4"
"40720","646",2023-10-30 03:45:00,-27239.25,1913,29152.25,907,TRUE,"out1, fill","0.1.4"
"40721","646",2023-10-30 04:00:00,-27416.5,1913,29329.5,907,TRUE,"out1, fill","0.1.4"
"40722","646",2023-10-30 04:15:00,-27593.75,1913,29506.75,907,TRUE,"out1, fill","0.1.4"
"40723","646",2023-10-30 04:30:00,-27771,1913,29684,907,TRUE,NA,"0.1.4"
"40724","646",2023-10-30 04:45:00,-27539,1913,29452,907,TRUE,NA,"0.1.4"
"40725","646",2023-10-30 05:00:00,-27577,1913,29490,907,TRUE,NA,"0.1.4"
"40726","646",2023-10-30 05:15:00,-27823,1913,29736,907,TRUE,NA,"0.1.4"
"40727","646",2023-10-30 05:30:00,-27645.8888888889,1913,29558.8888888889,907,TRUE,"out1, fill","0.1.4"
"40728","646",2023-10-30 05:45:00,-27468.7777777778,1913,29381.7777777778,907,TRUE,"out1, fill","0.1.4"
"40729","646",2023-10-30 06:00:00,-27291.6666666667,1913,29204.6666666667,907,TRUE,"out1, fill","0.1.4"
"40730","646",2023-10-30 06:15:00,-27114.5555555556,1913,29027.5555555556,907,TRUE,"out1, fill","0.1.4"
"40731","646",2023-10-30 06:30:00,-26937.4444444444,1913,28850.4444444444,907,TRUE,"out1, fill","0.1.4"
"40732","646",2023-10-30 06:45:00,-26760.3333333333,1913,28673.3333333333,907,TRUE,"out1, fill","0.1.4"
"40733","646",2023-10-30 07:00:00,-26583.2222222222,1913,28496.2222222222,907,TRUE,"out1, fill","0.1.4"
"40734","646",2023-10-30 07:15:00,-26406.1111111111,1913,28319.1111111111,907,TRUE,"out1, fill","0.1.4"
"40735","646",2023-10-30 07:30:00,-26229,1913,28142,907,TRUE,NA,"0.1.4"
"40736","646",2023-10-30 07:45:00,-26276,1913,28189,907,TRUE,NA,"0.1.4"
"40737","646",2023-10-30 08:00:00,-26282,1913,28195,907,TRUE,NA,"0.1.4"
"40738","646",2023-10-30 08:15:00,-26289,1913,28202,907,TRUE,NA,"0.1.4"
"40739","646",2023-10-30 08:30:00,-26327,1913,28240,907,TRUE,NA,"0.1.4"
"40740","646",2023-10-30 08:45:00,-26284,1913,28197,907,TRUE,NA,"0.1.4"
"40741","646",2023-10-30 09:00:00,-26251,1913,28164,907,TRUE,NA,"0.1.4"
"40742","646",2023-10-30 09:15:00,-26591,1913,28504,907,TRUE,NA,"0.1.4"
"40743","646",2023-10-30 09:30:00,-26527,1913,28440,907,TRUE,"out1, fill","0.1.4"
"40744","646",2023-10-30 09:45:00,-26463,1913,28376,907,TRUE,"out1, fill","0.1.4"
"40745","646",2023-10-30 10:00:00,-26399,1913,28312,907,TRUE,"out1, fill","0.1.4"
"40746","646",2023-10-30 10:15:00,-26335,1913,28248,907,TRUE,"out1, fill","0.1.4"
"40747","646",2023-10-30 10:30:00,-26271,1913,28184,907,TRUE,NA,"0.1.4"
"40748","646",2023-10-30 10:45:00,-26272,1913,28185,907,TRUE,NA,"0.1.4"
"40749","646",2023-10-30 11:00:00,-26241,1913,28154,907,TRUE,NA,"0.1.4"
"40750","646",2023-10-30 11:15:00,-26265,1913,28178,907,TRUE,NA,"0.1.4"
"40751","646",2023-10-30 11:30:00,-26268,1913,28181,907,TRUE,NA,"0.1.4"
"40752","646",2023-10-30 11:45:00,-26245,1913,28158,907,TRUE,NA,"0.1.4"
"40753","646",2023-10-30 12:00:00,-26230,1913,28143,907,TRUE,NA,"0.1.4"
"40754","646",2023-10-30 12:15:00,-26229,1913,28142,907,TRUE,NA,"0.1.4"
"40755","646",2023-10-30 12:30:00,-26253,1913,28166,907,TRUE,"out1, fill","0.1.4"
"40756","646",2023-10-30 12:45:00,-26277,1913,28190,907,TRUE,NA,"0.1.4"
"40757","646",2023-10-30 13:00:00,-26276,1913,28189,907,TRUE,NA,"0.1.4"
"40758","646",2023-10-30 13:15:00,-26236,1913,28149,907,TRUE,NA,"0.1.4"
"40759","646",2023-10-30 13:30:00,-26293,1913,28206,907,TRUE,NA,"0.1.4"
"40760","646",2023-10-30 13:45:00,-26474,1913,28387,907,TRUE,NA,"0.1.4"
"40761","646",2023-10-30 14:00:00,-26470,1913,28383,907,TRUE,NA,"0.1.4"
"40762","646",2023-10-30 14:15:00,-26432,1913,28345,907,TRUE,"out1, fill","0.1.4"
"40763","646",2023-10-30 14:30:00,-26394,1913,28307,907,TRUE,"out1, fill","0.1.4"
"40764","646",2023-10-30 14:45:00,-26356,1913,28269,907,TRUE,"out1, fill","0.1.4"
"40765","646",2023-10-30 15:00:00,-26318,1913,28231,907,TRUE,"out1, fill","0.1.4"
"40766","646",2023-10-30 15:15:00,-26280,1913,28193,907,TRUE,NA,"0.1.4"
"40767","646",2023-10-30 15:30:00,-26282,1913,28195,907,TRUE,NA,"0.1.4"
"40768","646",2023-10-30 15:45:00,-26279,1913,28192,907,TRUE,NA,"0.1.4"
"40769","646",2023-10-30 16:00:00,-26278,1913,28191,907,TRUE,NA,"0.1.4"
"40770","646",2023-10-30 16:15:00,-26282,1913,28195,907,TRUE,NA,"0.1.4"
"40771","646",2023-10-30 16:30:00,-26278,1913,28191,907,TRUE,NA,"0.1.4"
"40772","646",2023-10-30 16:45:00,-26267,1913,28180,907,TRUE,NA,"0.1.4"
"40773","646",2023-10-30 17:00:00,-26253,1913,28166,907,TRUE,NA,"0.1.4"
"40774","646",2023-10-30 17:15:00,-26254,1913,28167,907,TRUE,NA,"0.1.4"
"40775","646",2023-10-30 17:30:00,-26247,1913,28160,907,TRUE,NA,"0.1.4"
"40776","646",2023-10-30 17:45:00,-26228,1913,28141,907,TRUE,NA,"0.1.4"
"40777","646",2023-10-30 18:00:00,-26228,1913,28141,907,TRUE,NA,"0.1.4"
"40778","646",2023-10-30 18:15:00,-26242,1913,28155,907,TRUE,NA,"0.1.4"
"40779","646",2023-10-30 18:30:00,-26236,1913,28149,907,TRUE,NA,"0.1.4"
"40780","646",2023-10-30 18:45:00,-26230,1913,28143,907,TRUE,NA,"0.1.4"
"40781","646",2023-10-30 19:00:00,-26244,1913,28157,907,TRUE,NA,"0.1.4"
"40782","646",2023-10-30 19:15:00,-26242,1913,28155,907,TRUE,NA,"0.1.4"
"40783","646",2023-10-30 19:30:00,-26299,1913,28212,907,TRUE,NA,"0.1.4"
"40784","646",2023-10-30 19:45:00,-26598,1913,28511,907,TRUE,NA,"0.1.4"
"40785","646",2023-10-30 20:00:00,-27060,1913,28973,907,TRUE,"out1, fill","0.1.4"
"40786","646",2023-10-30 20:15:00,-27522,1913,29435,907,TRUE,NA,"0.1.4"
"40787","646",2023-10-30 20:30:00,-27308,1913,29221,907,TRUE,NA,"0.1.4"
"40788","646",2023-10-30 20:45:00,-27330,1913,29243,907,FALSE,NA,"0.1.4"
"40789","646",2023-10-30 21:00:00,-27184,1913,29097,907,FALSE,NA,"0.1.4"
"40790","646",2023-10-30 21:15:00,-26861,1913,28774,907,FALSE,NA,"0.1.4"
"40791","646",2023-10-30 21:30:00,-26919,1913,28832,907,FALSE,NA,"0.1.4"
"40792","646",2023-10-30 21:45:00,-26893,1913,28806,907,FALSE,NA,"0.1.4"
"40793","646",2023-10-30 22:00:00,-26631,1913,28544,907,FALSE,NA,"0.1.4"
"40794","646",2023-10-30 22:15:00,-26844,1913,28757,907,FALSE,NA,"0.1.4"
"40795","646",2023-10-30 22:30:00,-26844,1913,28757,907,FALSE,"jump1","0.1.4"
"40796","646",2023-10-30 22:45:00,-26843,1913,28756,907,FALSE,NA,"0.1.4"
"40797","646",2023-10-30 23:00:00,-26843,1913,28756,907,FALSE,NA,"0.1.4"
"40798","646",2023-10-30 23:15:00,-26843,1913,28756,907,FALSE,NA,"0.1.4"
"40799","646",2023-10-30 23:30:00,-26843,1913,28756,907,FALSE,NA,"0.1.4"
"40800","646",2023-10-30 23:45:00,-26843,1913,28756,907,FALSE,NA,"0.1.4"
"40801","646",2023-10-31,-27301,1913,29214,907,FALSE,NA,"0.1.4"
"40802","646",2023-10-31 00:15:00,-27248,1913,29161,907,FALSE,NA,"0.1.4"
"40803","646",2023-10-31 00:30:00,-27248,1913,29161,907,FALSE,"jump1","0.1.4"
"40804","646",2023-10-31 00:45:00,-27536,1913,29449,907,FALSE,NA,"0.1.4"
"40805","646",2023-10-31 01:00:00,-27100.5,1913,29013.5,907,FALSE,"out1, fill","0.1.4"
"40806","646",2023-10-31 01:15:00,-26665,1913,28578,907,FALSE,NA,"0.1.4"
"40807","646",2023-10-31 01:30:00,-27107,1913,29020,907,FALSE,NA,"0.1.4"
"40808","646",2023-10-31 01:45:00,-27107,1913,29020,907,FALSE,"jump1","0.1.4"
"40809","646",2023-10-31 02:00:00,-27405,1913,29318,907,FALSE,"out1, fill","0.1.4"
"40810","646",2023-10-31 02:15:00,-27703,1913,29616,907,FALSE,NA,"0.1.4"
"40811","646",2023-10-31 02:30:00,-27768,1913,29681,907,TRUE,NA,"0.1.4"
"40812","646",2023-10-31 02:45:00,-27749,1913,29662,907,TRUE,NA,"0.1.4"
"40813","646",2023-10-31 03:00:00,-27782,1913,29695,907,TRUE,NA,"0.1.4"
"40814","646",2023-10-31 03:15:00,-27690,1913,29603,907,TRUE,NA,"0.1.4"
"40815","646",2023-10-31 03:30:00,-27956,1913,29869,907,TRUE,NA,"0.1.4"
"40816","646",2023-10-31 03:45:00,-28231,1913,30144,907,TRUE,NA,"0.1.4"
"40817","646",2023-10-31 04:00:00,-28231,1913,30144,907,TRUE,"out1, fill","0.1.4"
"40818","646",2023-10-31 04:15:00,-28231,1913,30144,907,TRUE,"jump1","0.1.4"
"40819","646",2023-10-31 04:30:00,-28231,1913,30144,907,TRUE,NA,"0.1.4"
"40820","646",2023-10-31 04:45:00,-28410,1913,30323,907,TRUE,NA,"0.1.4"
"40821","646",2023-10-31 05:00:00,-28395.6666666667,1913,30308.6666666667,907,TRUE,"out1, fill","0.1.4"
"40822","646",2023-10-31 05:15:00,-28381.3333333333,1913,30294.3333333333,907,TRUE,"out1, fill","0.1.4"
"40823","646",2023-10-31 05:30:00,-28367,1913,30280,907,TRUE,"out1, fill","0.1.4"
"40824","646",2023-10-31 05:45:00,-28352.6666666667,1913,30265.6666666667,907,TRUE,"out1, fill","0.1.4"
"40825","646",2023-10-31 06:00:00,-28338.3333333333,1913,30251.3333333333,907,TRUE,"out1, fill","0.1.4"
"40826","646",2023-10-31 06:15:00,-28324,1913,30237,907,TRUE,"out1, fill","0.1.4"
"40827","646",2023-10-31 06:30:00,-28309.6666666667,1913,30222.6666666667,907,TRUE,"out1, fill","0.1.4"
"40828","646",2023-10-31 06:45:00,-28295.3333333333,1913,30208.3333333333,907,TRUE,"out1, fill","0.1.4"
"40829","646",2023-10-31 07:00:00,-28281,1913,30194,907,TRUE,"out1, fill","0.1.4"
"40830","646",2023-10-31 07:15:00,-28266.6666666667,1913,30179.6666666667,907,TRUE,"out1, fill","0.1.4"
"40831","646",2023-10-31 07:30:00,-28252.3333333333,1913,30165.3333333333,907,TRUE,"out1, fill","0.1.4"
"40832","646",2023-10-31 07:45:00,-28238,1913,30151,907,TRUE,NA,"0.1.4"
"40833","646",2023-10-31 08:00:00,-28234,1913,30147,907,TRUE,NA,"0.1.4"
"40834","646",2023-10-31 08:15:00,-28353,1913,30266,907,TRUE,NA,"0.1.4"
"40835","646",2023-10-31 08:30:00,-28446,1913,30359,907,TRUE,NA,"0.1.4"
"40836","646",2023-10-31 08:45:00,-28624.2857142857,1913,30537.2857142857,907,TRUE,"out1, fill","0.1.4"
"40837","646",2023-10-31 09:00:00,-28802.5714285714,1913,30715.5714285714,907,TRUE,"out1, fill","0.1.4"
"40838","646",2023-10-31 09:15:00,-28980.8571428571,1913,30893.8571428571,907,TRUE,"out1, fill","0.1.4"
"40839","646",2023-10-31 09:30:00,-29159.1428571429,1913,31072.1428571429,907,TRUE,"out1, fill","0.1.4"
"40840","646",2023-10-31 09:45:00,-29337.4285714286,1913,31250.4285714286,907,TRUE,"out1, fill","0.1.4"
"40841","646",2023-10-31 10:00:00,-29515.7142857143,1913,31428.7142857143,907,TRUE,"out1, fill","0.1.4"
"40842","646",2023-10-31 10:15:00,-29694,1913,31607,907,TRUE,NA,"0.1.4"
"40843","646",2023-10-31 10:30:00,-29639,1913,31552,907,TRUE,NA,"0.1.4"
"40844","646",2023-10-31 10:45:00,-29817,1913,31730,907,TRUE,NA,"0.1.4"
"40845","646",2023-10-31 11:00:00,-29833.6,1913,31746.6,907,TRUE,"out1, fill","0.1.4"
"40846","646",2023-10-31 11:15:00,-29850.2,1913,31763.2,907,TRUE,"out1, fill","0.1.4"
"40847","646",2023-10-31 11:30:00,-29866.8,1913,31779.8,907,TRUE,"out1, fill","0.1.4"
"40848","646",2023-10-31 11:45:00,-29883.4,1913,31796.4,907,TRUE,"out1, fill","0.1.4"
"40849","646",2023-10-31 12:00:00,-29900,1913,31813,907,TRUE,NA,"0.1.4"
"40850","646",2023-10-31 12:15:00,-29788,1913,31701,907,TRUE,NA,"0.1.4"
"40851","646",2023-10-31 12:30:00,-29726,1913,31639,907,TRUE,NA,"0.1.4"
"40852","646",2023-10-31 12:45:00,-29877,1913,31790,907,TRUE,NA,"0.1.4"
"40853","646",2023-10-31 13:00:00,-29639,1913,31552,907,TRUE,NA,"0.1.4"
"40854","646",2023-10-31 13:15:00,-29398,1913,31311,907,TRUE,NA,"0.1.4"
"40855","646",2023-10-31 13:30:00,-29611,1913,31524,907,TRUE,NA,"0.1.4"
"40856","646",2023-10-31 13:45:00,-29611,1913,31524,907,TRUE,NA,"0.1.4"
"40857","646",2023-10-31 14:00:00,-29781,1913,31694,907,TRUE,NA,"0.1.4"
"40858","646",2023-10-31 14:15:00,-29686,1913,31599,907,TRUE,NA,"0.1.4"
"40859","646",2023-10-31 14:30:00,-29659,1913,31572,907,TRUE,NA,"0.1.4"
"40860","646",2023-10-31 14:45:00,-29638,1913,31551,907,TRUE,NA,"0.1.4"
"40861","646",2023-10-31 15:00:00,-29720,1913,31633,907,TRUE,NA,"0.1.4"
"40862","646",2023-10-31 15:15:00,-29617,1913,31530,907,TRUE,NA,"0.1.4"
"40863","646",2023-10-31 15:30:00,-29667,1913,31580,907,TRUE,NA,"0.1.4"
"40864","646",2023-10-31 15:45:00,-29658,1913,31571,907,TRUE,NA,"0.1.4"
"40865","646",2023-10-31 16:00:00,-29700,1913,31613,907,TRUE,NA,"0.1.4"
"40866","646",2023-10-31 16:15:00,-29593,1913,31506,907,TRUE,NA,"0.1.4"
"40867","646",2023-10-31 16:30:00,-29351,1913,31264,907,TRUE,NA,"0.1.4"
"40868","646",2023-10-31 16:45:00,-29154,1913,31067,907,TRUE,NA,"0.1.4"
"40869","646",2023-10-31 17:00:00,-28785,1913,30698,907,TRUE,NA,"0.1.4"
"40870","646",2023-10-31 17:15:00,-28731.75,1913,30644.75,907,TRUE,"out1, fill","0.1.4"
"40871","646",2023-10-31 17:30:00,-28678.5,1913,30591.5,907,TRUE,"out1, fill","0.1.4"
"40872","646",2023-10-31 17:45:00,-28625.25,1913,30538.25,907,TRUE,"out1, fill","0.1.4"
"40873","646",2023-10-31 18:00:00,-28572,1913,30485,907,TRUE,"out1, fill","0.1.4"
"40874","646",2023-10-31 18:15:00,-28518.75,1913,30431.75,907,TRUE,"out1, fill","0.1.4"
"40875","646",2023-10-31 18:30:00,-28465.5,1913,30378.5,907,TRUE,"out1, fill","0.1.4"
"40876","646",2023-10-31 18:45:00,-28412.25,1913,30325.25,907,TRUE,"out1, fill","0.1.4"
"40877","646",2023-10-31 19:00:00,-28359,1913,30272,907,TRUE,NA,"0.1.4"
"40878","646",2023-10-31 19:15:00,-28156,1913,30069,907,FALSE,NA,"0.1.4"
"40879","646",2023-10-31 19:30:00,-28156,1913,30069,907,FALSE,NA,"0.1.4"
"40880","646",2023-10-31 19:45:00,-28142,1913,30055,907,FALSE,NA,"0.1.4"
"40881","646",2023-10-31 20:00:00,-28186.6666666667,1913,30099.6666666667,907,FALSE,"out1, fill","0.1.4"
"40882","646",2023-10-31 20:15:00,-28231.3333333333,1913,30144.3333333333,907,FALSE,"out1, fill","0.1.4"
"40883","646",2023-10-31 20:30:00,-28276,1913,30189,907,FALSE,NA,"0.1.4"
"40884","646",2023-10-31 20:45:00,-28286,1913,30199,907,FALSE,NA,"0.1.4"
"40885","646",2023-10-31 21:00:00,-28461,1913,30374,907,FALSE,NA,"0.1.4"
"40886","646",2023-10-31 21:15:00,-28302,1913,30215,907,FALSE,NA,"0.1.4"
"40887","646",2023-10-31 21:30:00,-28443,1913,30356,907,FALSE,NA,"0.1.4"
"40888","646",2023-10-31 21:45:00,-28475,1913,30388,907,FALSE,NA,"0.1.4"
"40889","646",2023-10-31 22:00:00,-28415,1913,30328,907,FALSE,NA,"0.1.4"
"40890","646",2023-10-31 22:15:00,-28637,1913,30550,907,FALSE,NA,"0.1.4"
"40891","646",2023-10-31 22:30:00,-28673,1913,30586,907,FALSE,NA,"0.1.4"
"40892","646",2023-10-31 22:45:00,-28920,1913,30833,907,FALSE,NA,"0.1.4"
"40893","646",2023-10-31 23:00:00,-28444,1913,30357,907,FALSE,NA,"0.1.4"
"40894","646",2023-10-31 23:15:00,-28884,1913,30797,907,FALSE,NA,"0.1.4"
"40895","646",2023-10-31 23:30:00,-28996,1913,30909,907,FALSE,NA,"0.1.4"
"40896","646",2023-10-31 23:45:00,-29046,1913,30959,907,FALSE,NA,"0.1.4"
"40897","646",2023-11-01,-29048,1913,30961,907,FALSE,NA,"0.1.4"
"40898","646",2023-11-01 00:15:00,-29004,1913,30917,907,FALSE,NA,"0.1.4"
"40899","646",2023-11-01 00:30:00,-28918,1913,30831,907,FALSE,NA,"0.1.4"
"40900","646",2023-11-01 00:45:00,-28898,1913,30811,907,FALSE,NA,"0.1.4"
"40901","646",2023-11-01 01:00:00,-28756,1913,30669,907,FALSE,NA,"0.1.4"
"40902","646",2023-11-01 01:15:00,-28608,1913,30521,907,FALSE,NA,"0.1.4"
"40903","646",2023-11-01 01:30:00,-28314,1913,30227,907,FALSE,NA,"0.1.4"
"40904","646",2023-11-01 01:45:00,-28387,1913,30300,907,FALSE,NA,"0.1.4"
"40905","646",2023-11-01 02:00:00,-28387,1913,30300,907,FALSE,"jump1","0.1.4"
"40906","646",2023-11-01 02:15:00,-28387,1913,30300,907,FALSE,"jump1","0.1.4"
"40907","646",2023-11-01 02:30:00,-28302,1913,30215,907,FALSE,NA,"0.1.4"
"40908","646",2023-11-01 02:45:00,-28675,1913,30588,907,FALSE,NA,"0.1.4"
"40909","646",2023-11-01 03:00:00,-29093,1913,31006,907,FALSE,NA,"0.1.4"
"40910","646",2023-11-01 03:15:00,-29231,1913,31144,907,FALSE,NA,"0.1.4"
"40911","646",2023-11-01 03:30:00,-28962,1913,30875,907,FALSE,"out1, fill","0.1.4"
"40912","646",2023-11-01 03:45:00,-28693,1913,30606,907,FALSE,NA,"0.1.4"
"40913","646",2023-11-01 04:00:00,-28693,1913,30606,907,FALSE,"jump1","0.1.4"
"40914","646",2023-11-01 04:15:00,-28735,1913,30648,907,FALSE,NA,"0.1.4"
"40915","646",2023-11-01 04:30:00,-28723,1913,30636,907,FALSE,NA,"0.1.4"
"40916","646",2023-11-01 04:45:00,-28522,1913,30435,907,FALSE,NA,"0.1.4"
"40917","646",2023-11-01 05:00:00,-28924,1913,30837,907,FALSE,NA,"0.1.4"
"40918","646",2023-11-01 05:15:00,-28485,1913,30398,907,FALSE,NA,"0.1.4"
"40919","646",2023-11-01 05:30:00,-28352,1913,30265,907,FALSE,NA,"0.1.4"
"40920","646",2023-11-01 05:45:00,-28672,1913,30585,907,FALSE,NA,"0.1.4"
"40921","646",2023-11-01 06:00:00,-28907,1913,30820,907,FALSE,NA,"0.1.4"
"40922","646",2023-11-01 06:15:00,-28691,1913,30604,907,FALSE,NA,"0.1.4"
"40923","646",2023-11-01 06:30:00,-28355,1913,30268,907,FALSE,NA,"0.1.4"
"40924","646",2023-11-01 06:45:00,-28246,1913,30159,907,FALSE,NA,"0.1.4"
"40925","646",2023-11-01 07:00:00,-28581,1913,30494,907,FALSE,NA,"0.1.4"
"40926","646",2023-11-01 07:15:00,-28603.5714285714,1913,30516.5714285714,907,FALSE,"out1, fill","0.1.4"
"40927","646",2023-11-01 07:30:00,-28626.1428571429,1913,30539.1428571429,907,FALSE,"out1, fill","0.1.4"
"40928","646",2023-11-01 07:45:00,-28648.7142857143,1913,30561.7142857143,907,TRUE,"out1, fill","0.1.4"
"40929","646",2023-11-01 08:00:00,-28671.2857142857,1913,30584.2857142857,907,TRUE,"out1, fill","0.1.4"
"40930","646",2023-11-01 08:15:00,-28693.8571428571,1913,30606.8571428571,907,TRUE,"out1, fill","0.1.4"
"40931","646",2023-11-01 08:30:00,-28716.4285714286,1913,30629.4285714286,907,TRUE,"out1, fill","0.1.4"
"40932","646",2023-11-01 08:45:00,-28739,1913,30652,907,TRUE,NA,"0.1.4"
"40933","646",2023-11-01 09:00:00,-28591,1913,30504,907,TRUE,NA,"0.1.4"
"40934","646",2023-11-01 09:15:00,-28943,1913,30856,907,TRUE,NA,"0.1.4"
"40935","646",2023-11-01 09:30:00,-29006,1913,30919,907,TRUE,NA,"0.1.4"
"40936","646",2023-11-01 09:45:00,-28950,1913,30863,907,TRUE,NA,"0.1.4"
"40937","646",2023-11-01 10:00:00,-29044,1913,30957,907,TRUE,NA,"0.1.4"
"40938","646",2023-11-01 10:15:00,-28669,1913,30582,907,TRUE,NA,"0.1.4"
"40939","646",2023-11-01 10:30:00,-28487,1913,30400,907,TRUE,NA,"0.1.4"
"40940","646",2023-11-01 10:45:00,-28728,1913,30641,907,TRUE,NA,"0.1.4"
"40941","646",2023-11-01 11:00:00,-28756,1913,30669,907,TRUE,NA,"0.1.4"
"40942","646",2023-11-01 11:15:00,-28700,1913,30613,907,TRUE,NA,"0.1.4"
"40943","646",2023-11-01 11:30:00,-28663,1913,30576,907,TRUE,NA,"0.1.4"
"40944","646",2023-11-01 11:45:00,-28523.5,1913,30436.5,907,TRUE,"out1, fill","0.1.4"
"40945","646",2023-11-01 12:00:00,-28384,1913,30297,907,TRUE,NA,"0.1.4"
"40946","646",2023-11-01 12:15:00,-28394,1913,30307,907,TRUE,NA,"0.1.4"
"40947","646",2023-11-01 12:30:00,-28362,1913,30275,907,TRUE,NA,"0.1.4"
"40948","646",2023-11-01 12:45:00,-28591,1913,30504,907,TRUE,NA,"0.1.4"
"40949","646",2023-11-01 13:00:00,-28196,1913,30109,907,TRUE,NA,"0.1.4"
"40950","646",2023-11-01 13:15:00,-27803,1913,29716,907,TRUE,NA,"0.1.4"
"40951","646",2023-11-01 13:30:00,-27744,1913,29657,907,TRUE,NA,"0.1.4"
"40952","646",2023-11-01 13:45:00,-27928,1913,29841,907,TRUE,NA,"0.1.4"
"40953","646",2023-11-01 14:00:00,-28003.5,1913,29916.5,907,TRUE,"out1, fill","0.1.4"
"40954","646",2023-11-01 14:15:00,-28079,1913,29992,907,TRUE,NA,"0.1.4"
"40955","646",2023-11-01 14:30:00,-27967,1913,29880,907,TRUE,NA,"0.1.4"
"40956","646",2023-11-01 14:45:00,-27943,1913,29856,907,TRUE,NA,"0.1.4"
"40957","646",2023-11-01 15:00:00,-28045,1913,29958,907,TRUE,NA,"0.1.4"
"40958","646",2023-11-01 15:15:00,-27983,1913,29896,907,TRUE,NA,"0.1.4"
"40959","646",2023-11-01 15:30:00,-27718,1913,29631,907,FALSE,NA,"0.1.4"
"40960","646",2023-11-01 15:45:00,-27588,1913,29501,907,FALSE,NA,"0.1.4"
"40961","646",2023-11-01 16:00:00,-27657,1913,29570,907,FALSE,NA,"0.1.4"
"40962","646",2023-11-01 16:15:00,-27657,1913,29570,907,FALSE,"jump1","0.1.4"
"40963","646",2023-11-01 16:30:00,-27657,1913,29570,907,FALSE,"jump1","0.1.4"
"40964","646",2023-11-01 16:45:00,-27841,1913,29754,907,FALSE,NA,"0.1.4"
"40965","646",2023-11-01 17:00:00,-27657,1913,29570,907,FALSE,NA,"0.1.4"
"40966","646",2023-11-01 17:15:00,-27657,1913,29570,907,FALSE,NA,"0.1.4"
"40967","646",2023-11-01 17:30:00,-27662,1913,29575,907,FALSE,NA,"0.1.4"
"40968","646",2023-11-01 17:45:00,-27715,1913,29628,907,FALSE,NA,"0.1.4"
"40969","646",2023-11-01 18:00:00,-27692,1913,29605,907,FALSE,NA,"0.1.4"
"40970","646",2023-11-01 18:15:00,-27692,1913,29605,907,FALSE,"jump1","0.1.4"
"40971","646",2023-11-01 18:30:00,-27975,1913,29888,907,FALSE,NA,"0.1.4"
"40972","646",2023-11-01 18:45:00,-27622,1913,29535,907,FALSE,NA,"0.1.4"
"40973","646",2023-11-01 19:00:00,-27320,1913,29233,907,FALSE,NA,"0.1.4"
"40974","646",2023-11-01 19:15:00,-27755,1913,29668,907,FALSE,NA,"0.1.4"
"40975","646",2023-11-01 19:30:00,-27282,1913,29195,907,FALSE,NA,"0.1.4"
"40976","646",2023-11-01 19:45:00,-27179,1913,29092,907,FALSE,NA,"0.1.4"
"40977","646",2023-11-01 20:00:00,-27256,1913,29169,907,FALSE,NA,"0.1.4"
"40978","646",2023-11-01 20:15:00,-27207,1913,29120,907,FALSE,NA,"0.1.4"
"40979","646",2023-11-01 20:30:00,-27240,1913,29153,907,FALSE,NA,"0.1.4"
"40980","646",2023-11-01 20:45:00,-27317,1913,29230,907,FALSE,NA,"0.1.4"
"40981","646",2023-11-01 21:00:00,-27309,1913,29222,907,FALSE,NA,"0.1.4"
"40982","646",2023-11-01 21:15:00,-27259,1913,29172,907,FALSE,NA,"0.1.4"
"40983","646",2023-11-01 21:30:00,-27259,1913,29172,907,FALSE,NA,"0.1.4"
"40984","646",2023-11-01 21:45:00,-27282,1913,29195,907,FALSE,NA,"0.1.4"
"40985","646",2023-11-01 22:00:00,-27294,1913,29207,907,FALSE,NA,"0.1.4"
"40986","646",2023-11-01 22:15:00,-27293,1913,29206,907,FALSE,NA,"0.1.4"
"40987","646",2023-11-01 22:30:00,-27212,1913,29125,907,FALSE,NA,"0.1.4"
"40988","646",2023-11-01 22:45:00,-27207,1913,29120,907,FALSE,NA,"0.1.4"
"40989","646",2023-11-01 23:00:00,-27213,1913,29126,907,FALSE,NA,"0.1.4"
"40990","646",2023-11-01 23:15:00,-27213,1913,29126,907,FALSE,NA,"0.1.4"
"40991","646",2023-11-01 23:30:00,-27438,1913,29351,907,FALSE,NA,"0.1.4"
"40992","646",2023-11-01 23:45:00,-27385,1913,29298,907,FALSE,NA,"0.1.4"
"40993","646",2023-11-02,-27347,1913,29260,907,FALSE,NA,"0.1.4"
"40994","646",2023-11-02 00:15:00,-27232,1913,29145,907,FALSE,NA,"0.1.4"
"40995","646",2023-11-02 00:30:00,-27184,1913,29097,907,FALSE,NA,"0.1.4"
"40996","646",2023-11-02 00:45:00,-27172,1913,29085,907,FALSE,NA,"0.1.4"
"40997","646",2023-11-02 01:00:00,-27166,1913,29079,907,FALSE,NA,"0.1.4"
"40998","646",2023-11-02 01:15:00,-27351,1913,29264,907,FALSE,NA,"0.1.4"
"40999","646",2023-11-02 01:30:00,-27344,1913,29257,907,FALSE,NA,"0.1.4"
"41000","646",2023-11-02 01:45:00,-27398,1913,29311,907,FALSE,NA,"0.1.4"
"41001","646",2023-11-02 02:00:00,-27436,1913,29349,907,FALSE,NA,"0.1.4"
"41002","646",2023-11-02 02:15:00,-27355,1913,29268,907,FALSE,NA,"0.1.4"
"41003","646",2023-11-02 02:30:00,-27140,1913,29053,907,FALSE,NA,"0.1.4"
"41004","646",2023-11-02 02:45:00,-27139,1913,29052,907,FALSE,NA,"0.1.4"
"41005","646",2023-11-02 03:00:00,-27140,1913,29053,907,FALSE,NA,"0.1.4"
"41006","646",2023-11-02 03:15:00,-27140,1913,29053,907,FALSE,NA,"0.1.4"
"41007","646",2023-11-02 03:30:00,-27123,1913,29036,907,FALSE,NA,"0.1.4"
"41008","646",2023-11-02 03:45:00,-27122,1913,29035,907,FALSE,NA,"0.1.4"
"41009","646",2023-11-02 04:00:00,-27121,1913,29034,907,FALSE,NA,"0.1.4"
"41010","646",2023-11-02 04:15:00,-27122,1913,29035,907,FALSE,NA,"0.1.4"
"41011","646",2023-11-02 04:30:00,-27123,1913,29036,907,FALSE,NA,"0.1.4"
"41012","646",2023-11-02 04:45:00,-27124,1913,29037,907,FALSE,NA,"0.1.4"
"41013","646",2023-11-02 05:00:00,-27123,1913,29036,907,FALSE,NA,"0.1.4"
"41014","646",2023-11-02 05:15:00,-27127,1913,29040,907,FALSE,NA,"0.1.4"
"41015","646",2023-11-02 05:30:00,-27131,1913,29044,907,FALSE,NA,"0.1.4"
"41016","646",2023-11-02 05:45:00,-27146,1913,29059,907,FALSE,NA,"0.1.4"
"41017","646",2023-11-02 06:00:00,-27148,1913,29061,907,FALSE,NA,"0.1.4"
"41018","646",2023-11-02 06:15:00,-27157,1913,29070,907,FALSE,NA,"0.1.4"
"41019","646",2023-11-02 06:30:00,-27156,1913,29069,907,FALSE,NA,"0.1.4"
"41020","646",2023-11-02 06:45:00,-27158,1913,29071,907,FALSE,NA,"0.1.4"
"41021","646",2023-11-02 07:00:00,-27158,1913,29071,907,FALSE,"jump1","0.1.4"
"41022","646",2023-11-02 07:15:00,-27163,1913,29076,907,FALSE,NA,"0.1.4"
"41023","646",2023-11-02 07:30:00,-27111,1913,29024,907,FALSE,NA,"0.1.4"
"41024","646",2023-11-02 07:45:00,-27303,1913,29216,907,FALSE,NA,"0.1.4"
"41025","646",2023-11-02 08:00:00,-27254,1913,29167,907,FALSE,NA,"0.1.4"
"41026","646",2023-11-02 08:15:00,-27348,1913,29261,907,FALSE,NA,"0.1.4"
"41027","646",2023-11-02 08:30:00,-27221,1913,29134,907,FALSE,NA,"0.1.4"
"41028","646",2023-11-02 08:45:00,-27324,1913,29237,907,FALSE,NA,"0.1.4"
"41029","646",2023-11-02 09:00:00,-27162,1913,29075,907,FALSE,NA,"0.1.4"
"41030","646",2023-11-02 09:15:00,-27205,1913,29118,907,FALSE,NA,"0.1.4"
"41031","646",2023-11-02 09:30:00,-27392,1913,29305,907,FALSE,NA,"0.1.4"
"41032","646",2023-11-02 09:45:00,-27063,1913,28976,907,FALSE,NA,"0.1.4"
"41033","646",2023-11-02 10:00:00,-27443,1913,29356,907,FALSE,NA,"0.1.4"
"41034","646",2023-11-02 10:15:00,-27384,1913,29297,907,FALSE,NA,"0.1.4"
"41035","646",2023-11-02 10:30:00,-27409,1913,29322,907,FALSE,NA,"0.1.4"
"41036","646",2023-11-02 10:45:00,-27413,1913,29326,907,FALSE,NA,"0.1.4"
"41037","646",2023-11-02 11:00:00,-27436,1913,29349,907,FALSE,NA,"0.1.4"
"41038","646",2023-11-02 11:15:00,-27537,1913,29450,907,FALSE,NA,"0.1.4"
"41039","646",2023-11-02 11:30:00,-27565,1913,29478,907,FALSE,NA,"0.1.4"
"41040","646",2023-11-02 11:45:00,-27499,1913,29412,907,FALSE,NA,"0.1.4"
"41041","646",2023-11-02 12:00:00,-27493,1913,29406,907,FALSE,NA,"0.1.4"
"41042","646",2023-11-02 12:15:00,-27388,1913,29301,907,FALSE,NA,"0.1.4"
"41043","646",2023-11-02 12:30:00,-27341,1913,29254,907,FALSE,NA,"0.1.4"
"41044","646",2023-11-02 12:45:00,-27400,1913,29313,907,FALSE,NA,"0.1.4"
"41045","646",2023-11-02 13:00:00,-27400,1913,29313,907,FALSE,"jump1","0.1.4"
"41046","646",2023-11-02 13:15:00,-27371,1913,29284,907,FALSE,NA,"0.1.4"
"41047","646",2023-11-02 13:30:00,-27511,1913,29424,907,FALSE,NA,"0.1.4"
"41048","646",2023-11-02 13:45:00,-27513,1913,29426,907,FALSE,NA,"0.1.4"
"41049","646",2023-11-02 14:00:00,-27284,1913,29197,907,FALSE,NA,"0.1.4"
"41050","646",2023-11-02 14:15:00,-27245,1913,29158,907,FALSE,NA,"0.1.4"
"41051","646",2023-11-02 14:30:00,-27242,1913,29155,907,FALSE,NA,"0.1.4"
"41052","646",2023-11-02 14:45:00,-27243,1913,29156,907,FALSE,NA,"0.1.4"
"41053","646",2023-11-02 15:00:00,-27243,1913,29156,907,FALSE,NA,"0.1.4"
"41054","646",2023-11-02 15:15:00,-27242,1913,29155,907,FALSE,NA,"0.1.4"
"41055","646",2023-11-02 15:30:00,-27241,1913,29154,907,FALSE,NA,"0.1.4"
"41056","646",2023-11-02 15:45:00,-27245,1913,29158,907,FALSE,NA,"0.1.4"
"41057","646",2023-11-02 16:00:00,-27244,1913,29157,907,FALSE,NA,"0.1.4"
"41058","646",2023-11-02 16:15:00,-27244,1913,29157,907,FALSE,NA,"0.1.4"
"41059","646",2023-11-02 16:30:00,-27241,1913,29154,907,FALSE,NA,"0.1.4"
"41060","646",2023-11-02 16:45:00,-27247,1913,29160,907,FALSE,NA,"0.1.4"
"41061","646",2023-11-02 17:00:00,-27247,1913,29160,907,FALSE,NA,"0.1.4"
"41062","646",2023-11-02 17:15:00,-27245,1913,29158,907,FALSE,NA,"0.1.4"
"41063","646",2023-11-02 17:30:00,-27245,1913,29158,907,FALSE,NA,"0.1.4"
"41064","646",2023-11-02 17:45:00,-27246,1913,29159,907,FALSE,NA,"0.1.4"
"41065","646",2023-11-02 18:00:00,-27247,1913,29160,907,FALSE,NA,"0.1.4"
"41066","646",2023-11-02 18:15:00,-27250,1913,29163,907,FALSE,"out1, fill","0.1.4"
"41067","646",2023-11-02 18:30:00,-27253,1913,29166,907,FALSE,"out1, fill","0.1.4"
"41068","646",2023-11-02 18:45:00,-27256,1913,29169,907,FALSE,NA,"0.1.4"
"41069","646",2023-11-02 19:00:00,-27256,1913,29169,907,FALSE,NA,"0.1.4"
"41070","646",2023-11-02 19:15:00,-27252,1913,29165,907,FALSE,NA,"0.1.4"
"41071","646",2023-11-02 19:30:00,-27314,1913,29227,907,FALSE,NA,"0.1.4"
"41072","646",2023-11-02 19:45:00,-27254,1913,29167,907,FALSE,NA,"0.1.4"
"41073","646",2023-11-02 20:00:00,-27254,1913,29167,907,FALSE,NA,"0.1.4"
"41074","646",2023-11-02 20:15:00,-27348,1913,29261,907,FALSE,NA,"0.1.4"
"41075","646",2023-11-02 20:30:00,-27498,1913,29411,907,FALSE,NA,"0.1.4"
"41076","646",2023-11-02 20:45:00,-27279,1913,29192,907,FALSE,NA,"0.1.4"
"41077","646",2023-11-02 21:00:00,-27276,1913,29189,907,FALSE,NA,"0.1.4"
"41078","646",2023-11-02 21:15:00,-27275,1913,29188,907,FALSE,NA,"0.1.4"
"41079","646",2023-11-02 21:30:00,-27246,1913,29159,907,FALSE,NA,"0.1.4"
"41080","646",2023-11-02 21:45:00,-27247,1913,29160,907,FALSE,NA,"0.1.4"
"41081","646",2023-11-02 22:00:00,-27247,1913,29160,907,FALSE,NA,"0.1.4"
"41082","646",2023-11-02 22:15:00,-27248,1913,29161,907,FALSE,NA,"0.1.4"
"41083","646",2023-11-02 22:30:00,-27248,1913,29161,907,FALSE,NA,"0.1.4"
"41084","646",2023-11-02 22:45:00,-27248,1913,29161,907,FALSE,NA,"0.1.4"
"41085","646",2023-11-02 23:00:00,-27248,1913,29161,907,FALSE,NA,"0.1.4"
"41086","646",2023-11-02 23:15:00,-27248,1913,29161,907,FALSE,NA,"0.1.4"
"41087","646",2023-11-02 23:30:00,-27247,1913,29160,907,FALSE,NA,"0.1.4"
"41088","646",2023-11-02 23:45:00,-27248,1913,29161,907,FALSE,NA,"0.1.4"
"41089","646",2023-11-03,-27248,1913,29161,907,FALSE,"jump1","0.1.4"
"41090","646",2023-11-03 00:15:00,-27248,1913,29161,907,FALSE,"jump1","0.1.4"
"41091","646",2023-11-03 00:30:00,-27683.5,1913,29596.5,907,FALSE,"out1, fill","0.1.4"
"41092","646",2023-11-03 00:45:00,-28119,1913,30032,907,FALSE,NA,"0.1.4"
"41093","646",2023-11-03 01:00:00,-28237,1913,30150,907,FALSE,NA,"0.1.4"
"41094","646",2023-11-03 01:15:00,-27804,1913,29717,907,FALSE,NA,"0.1.4"
"41095","646",2023-11-03 01:30:00,-27987,1913,29900,907,FALSE,NA,"0.1.4"
"41096","646",2023-11-03 01:45:00,-28200,1913,30113,907,FALSE,NA,"0.1.4"
"41097","646",2023-11-03 02:00:00,-28472,1913,30385,907,FALSE,NA,"0.1.4"
"41098","646",2023-11-03 02:15:00,-28086,1913,29999,907,FALSE,NA,"0.1.4"
"41099","646",2023-11-03 02:30:00,-28212,1913,30125,907,FALSE,NA,"0.1.4"
"41100","646",2023-11-03 02:45:00,-28074,1913,29987,907,FALSE,NA,"0.1.4"
"41101","646",2023-11-03 03:00:00,-28334,1913,30247,907,FALSE,NA,"0.1.4"
"41102","646",2023-11-03 03:15:00,-28385,1913,30298,907,FALSE,NA,"0.1.4"
"41103","646",2023-11-03 03:30:00,-28485,1913,30398,907,FALSE,NA,"0.1.4"
"41104","646",2023-11-03 03:45:00,-28436,1913,30349,907,FALSE,NA,"0.1.4"
"41105","646",2023-11-03 04:00:00,-28380,1913,30293,907,FALSE,NA,"0.1.4"
"41106","646",2023-11-03 04:15:00,-28304,1913,30217,907,FALSE,NA,"0.1.4"
"41107","646",2023-11-03 04:30:00,-28426,1913,30339,907,FALSE,NA,"0.1.4"
"41108","646",2023-11-03 04:45:00,-28255,1913,30168,907,FALSE,NA,"0.1.4"
"41109","646",2023-11-03 05:00:00,-28308,1913,30221,907,FALSE,NA,"0.1.4"
"41110","646",2023-11-03 05:15:00,-28079,1913,29992,907,FALSE,NA,"0.1.4"
"41111","646",2023-11-03 05:30:00,-28385,1913,30298,907,FALSE,NA,"0.1.4"
"41112","646",2023-11-03 05:45:00,-28491,1913,30404,907,FALSE,NA,"0.1.4"
"41113","646",2023-11-03 06:00:00,-28105,1913,30018,907,FALSE,NA,"0.1.4"
"41114","646",2023-11-03 06:15:00,-28396,1913,30309,907,FALSE,NA,"0.1.4"
"41115","646",2023-11-03 06:30:00,-28334,1913,30247,907,FALSE,NA,"0.1.4"
"41116","646",2023-11-03 06:45:00,-28275,1913,30188,907,FALSE,NA,"0.1.4"
"41117","646",2023-11-03 07:00:00,-28124,1913,30037,907,FALSE,NA,"0.1.4"
"41118","646",2023-11-03 07:15:00,-28078,1913,29991,907,FALSE,NA,"0.1.4"
"41119","646",2023-11-03 07:30:00,-28078,1913,29991,907,FALSE,"jump1","0.1.4"
"41120","646",2023-11-03 07:45:00,-28192,1913,30105,907,FALSE,NA,"0.1.4"
"41121","646",2023-11-03 08:00:00,-28571,1913,30484,907,FALSE,NA,"0.1.4"
"41122","646",2023-11-03 08:15:00,-28494,1913,30407,907,FALSE,NA,"0.1.4"
"41123","646",2023-11-03 08:30:00,-28585,1913,30498,907,FALSE,NA,"0.1.4"
"41124","646",2023-11-03 08:45:00,-28930,1913,30843,907,FALSE,NA,"0.1.4"
"41125","646",2023-11-03 09:00:00,-29051,1913,30964,907,FALSE,NA,"0.1.4"
"41126","646",2023-11-03 09:15:00,-28942,1913,30855,907,FALSE,NA,"0.1.4"
"41127","646",2023-11-03 09:30:00,-28841,1913,30754,907,FALSE,NA,"0.1.4"
"41128","646",2023-11-03 09:45:00,-28973,1913,30886,907,FALSE,NA,"0.1.4"
"41129","646",2023-11-03 10:00:00,-29076,1913,30989,907,FALSE,NA,"0.1.4"
"41130","646",2023-11-03 10:15:00,-28907,1913,30820,907,FALSE,NA,"0.1.4"
"41131","646",2023-11-03 10:30:00,-28740,1913,30653,907,FALSE,NA,"0.1.4"
"41132","646",2023-11-03 10:45:00,-28907,1913,30820,907,FALSE,NA,"0.1.4"
"41133","646",2023-11-03 11:00:00,-28920,1913,30833,907,FALSE,NA,"0.1.4"
"41134","646",2023-11-03 11:15:00,-29075,1913,30988,907,FALSE,NA,"0.1.4"
"41135","646",2023-11-03 11:30:00,-28650,1913,30563,907,FALSE,NA,"0.1.4"
"41136","646",2023-11-03 11:45:00,-28904,1913,30817,907,FALSE,NA,"0.1.4"
"41137","646",2023-11-03 12:00:00,-28738,1913,30651,907,FALSE,NA,"0.1.4"
"41138","646",2023-11-03 12:15:00,-28721,1913,30634,907,FALSE,NA,"0.1.4"
"41139","646",2023-11-03 12:30:00,-28986,1913,30899,907,FALSE,NA,"0.1.4"
"41140","646",2023-11-03 12:45:00,-29092,1913,31005,907,FALSE,NA,"0.1.4"
"41141","646",2023-11-03 13:00:00,-28866,1913,30779,907,FALSE,NA,"0.1.4"
"41142","646",2023-11-03 13:15:00,-28779,1913,30692,907,FALSE,NA,"0.1.4"
"41143","646",2023-11-03 13:30:00,-28929,1913,30842,907,FALSE,NA,"0.1.4"
"41144","646",2023-11-03 13:45:00,-28877,1913,30790,907,FALSE,NA,"0.1.4"
"41145","646",2023-11-03 14:00:00,-28896,1913,30809,907,FALSE,NA,"0.1.4"
"41146","646",2023-11-03 14:15:00,-29049,1913,30962,907,FALSE,NA,"0.1.4"
"41147","646",2023-11-03 14:30:00,-29024,1913,30937,907,FALSE,NA,"0.1.4"
"41148","646",2023-11-03 14:45:00,-29019,1913,30932,907,FALSE,NA,"0.1.4"
"41149","646",2023-11-03 15:00:00,-29016,1913,30929,907,FALSE,NA,"0.1.4"
"41150","646",2023-11-03 15:15:00,-28988,1913,30901,907,FALSE,NA,"0.1.4"
"41151","646",2023-11-03 15:30:00,-29006,1913,30919,907,FALSE,NA,"0.1.4"
"41152","646",2023-11-03 15:45:00,-29017,1913,30930,907,FALSE,NA,"0.1.4"
"41153","646",2023-11-03 16:00:00,-28955,1913,30868,907,FALSE,NA,"0.1.4"
"41154","646",2023-11-03 16:15:00,-28970,1913,30883,907,FALSE,NA,"0.1.4"
"41155","646",2023-11-03 16:30:00,-28912,1913,30825,907,FALSE,NA,"0.1.4"
"41156","646",2023-11-03 16:45:00,-28913,1913,30826,907,FALSE,NA,"0.1.4"
"41157","646",2023-11-03 17:00:00,-28682,1913,30595,907,FALSE,NA,"0.1.4"
"41158","646",2023-11-03 17:15:00,-28559,1913,30472,907,FALSE,NA,"0.1.4"
"41159","646",2023-11-03 17:30:00,-28665,1913,30578,907,FALSE,NA,"0.1.4"
"41160","646",2023-11-03 17:45:00,-28640,1913,30553,907,FALSE,NA,"0.1.4"
"41161","646",2023-11-03 18:00:00,-28569.3333333333,1913,30482.3333333333,907,FALSE,"out1, fill","0.1.4"
"41162","646",2023-11-03 18:15:00,-28498.6666666667,1913,30411.6666666667,907,FALSE,"out1, fill","0.1.4"
"41163","646",2023-11-03 18:30:00,-28428,1913,30341,907,FALSE,NA,"0.1.4"
"41164","646",2023-11-03 18:45:00,-28733,1913,30646,907,FALSE,NA,"0.1.4"
"41165","646",2023-11-03 19:00:00,-28720,1913,30633,907,FALSE,NA,"0.1.4"
"41166","646",2023-11-03 19:15:00,-28857,1913,30770,907,FALSE,NA,"0.1.4"
"41167","646",2023-11-03 19:30:00,-28810,1913,30723,907,FALSE,NA,"0.1.4"
"41168","646",2023-11-03 19:45:00,-28881,1913,30794,907,FALSE,NA,"0.1.4"
"41169","646",2023-11-03 20:00:00,-28884,1913,30797,907,FALSE,NA,"0.1.4"
"41170","646",2023-11-03 20:15:00,-28904,1913,30817,907,FALSE,NA,"0.1.4"
"41171","646",2023-11-03 20:30:00,-28896,1913,30809,907,FALSE,NA,"0.1.4"
"41172","646",2023-11-03 20:45:00,-28947,1913,30860,907,FALSE,NA,"0.1.4"
"41173","646",2023-11-03 21:00:00,-28667,1913,30580,907,FALSE,NA,"0.1.4"
"41174","646",2023-11-03 21:15:00,-28813,1913,30726,907,FALSE,NA,"0.1.4"
"41175","646",2023-11-03 21:30:00,-28827,1913,30740,907,FALSE,NA,"0.1.4"
"41176","646",2023-11-03 21:45:00,-28750,1913,30663,907,FALSE,NA,"0.1.4"
"41177","646",2023-11-03 22:00:00,-28820,1913,30733,907,FALSE,NA,"0.1.4"
"41178","646",2023-11-03 22:15:00,-28722,1913,30635,907,FALSE,NA,"0.1.4"
"41179","646",2023-11-03 22:30:00,-28665,1913,30578,907,FALSE,NA,"0.1.4"
"41180","646",2023-11-03 22:45:00,-28758,1913,30671,907,FALSE,NA,"0.1.4"
"41181","646",2023-11-03 23:00:00,-28848,1913,30761,907,FALSE,NA,"0.1.4"
"41182","646",2023-11-03 23:15:00,-28794,1913,30707,907,FALSE,NA,"0.1.4"
"41183","646",2023-11-03 23:30:00,-28782,1913,30695,907,FALSE,NA,"0.1.4"
"41184","646",2023-11-03 23:45:00,-28715,1913,30628,907,FALSE,NA,"0.1.4"
"41185","646",2023-11-04,-28699,1913,30612,907,FALSE,NA,"0.1.4"
"41186","646",2023-11-04 00:15:00,-28612,1913,30525,907,FALSE,NA,"0.1.4"
"41187","646",2023-11-04 00:30:00,-28878,1913,30791,907,FALSE,NA,"0.1.4"
"41188","646",2023-11-04 00:45:00,-28657,1913,30570,907,FALSE,NA,"0.1.4"
"41189","646",2023-11-04 01:00:00,-28878,1913,30791,907,FALSE,NA,"0.1.4"
"41190","646",2023-11-04 01:15:00,-28914,1913,30827,907,FALSE,NA,"0.1.4"
"41191","646",2023-11-04 01:30:00,-28510,1913,30423,907,FALSE,NA,"0.1.4"
"41192","646",2023-11-04 01:45:00,-28680,1913,30593,907,FALSE,NA,"0.1.4"
"41193","646",2023-11-04 02:00:00,-28555,1913,30468,907,FALSE,NA,"0.1.4"
"41194","646",2023-11-04 02:15:00,-28555,1913,30468,907,FALSE,"jump1","0.1.4"
"41195","646",2023-11-04 02:30:00,-28489,1913,30402,907,FALSE,NA,"0.1.4"
"41196","646",2023-11-04 02:45:00,-28509,1913,30422,907,FALSE,NA,"0.1.4"
"41197","646",2023-11-04 03:00:00,-28330,1913,30243,907,FALSE,NA,"0.1.4"
"41198","646",2023-11-04 03:15:00,-28279,1913,30192,907,FALSE,NA,"0.1.4"
"41199","646",2023-11-04 03:30:00,-28427,1913,30340,907,FALSE,NA,"0.1.4"
"41200","646",2023-11-04 03:45:00,-28283,1913,30196,907,FALSE,NA,"0.1.4"
"41201","646",2023-11-04 04:00:00,-28277,1913,30190,907,FALSE,NA,"0.1.4"
"41202","646",2023-11-04 04:15:00,-28075,1913,29988,907,FALSE,NA,"0.1.4"
"41203","646",2023-11-04 04:30:00,-28075,1913,29988,907,FALSE,"jump1","0.1.4"
"41204","646",2023-11-04 04:45:00,-28530,1913,30443,907,FALSE,NA,"0.1.4"
"41205","646",2023-11-04 05:00:00,-28076,1913,29989,907,FALSE,NA,"0.1.4"
"41206","646",2023-11-04 05:15:00,-28300,1913,30213,907,FALSE,NA,"0.1.4"
"41207","646",2023-11-04 05:30:00,-28355,1913,30268,907,FALSE,NA,"0.1.4"
"41208","646",2023-11-04 05:45:00,-28560,1913,30473,907,FALSE,NA,"0.1.4"
"41209","646",2023-11-04 06:00:00,-28487,1913,30400,907,FALSE,NA,"0.1.4"
"41210","646",2023-11-04 06:15:00,-28223,1913,30136,907,FALSE,NA,"0.1.4"
"41211","646",2023-11-04 06:30:00,-28224,1913,30137,907,FALSE,NA,"0.1.4"
"41212","646",2023-11-04 06:45:00,-28196,1913,30109,907,FALSE,NA,"0.1.4"
"41213","646",2023-11-04 07:00:00,-28220,1913,30133,907,FALSE,NA,"0.1.4"
"41214","646",2023-11-04 07:15:00,-28184,1913,30097,907,FALSE,NA,"0.1.4"
"41215","646",2023-11-04 07:30:00,-28283,1913,30196,907,FALSE,NA,"0.1.4"
"41216","646",2023-11-04 07:45:00,-28298,1913,30211,907,FALSE,NA,"0.1.4"
"41217","646",2023-11-04 08:00:00,-28337,1913,30250,907,FALSE,NA,"0.1.4"
"41218","646",2023-11-04 08:15:00,-28437,1913,30350,907,FALSE,NA,"0.1.4"
"41219","646",2023-11-04 08:30:00,-28178,1913,30091,907,FALSE,NA,"0.1.4"
"41220","646",2023-11-04 08:45:00,-28535,1913,30448,907,FALSE,NA,"0.1.4"
"41221","646",2023-11-04 09:00:00,-28302,1913,30215,907,FALSE,NA,"0.1.4"
"41222","646",2023-11-04 09:15:00,-28008,1913,29921,907,FALSE,NA,"0.1.4"
"41223","646",2023-11-04 09:30:00,-28005,1913,29918,907,FALSE,NA,"0.1.4"
"41224","646",2023-11-04 09:45:00,-28005,1913,29918,907,FALSE,NA,"0.1.4"
"41225","646",2023-11-04 10:00:00,-28005,1913,29918,907,FALSE,NA,"0.1.4"
"41226","646",2023-11-04 10:15:00,-28005,1913,29918,907,FALSE,NA,"0.1.4"
"41227","646",2023-11-04 10:30:00,-28005,1913,29918,907,FALSE,NA,"0.1.4"
"41228","646",2023-11-04 10:45:00,-28006,1913,29919,907,FALSE,NA,"0.1.4"
"41229","646",2023-11-04 11:00:00,-28006,1913,29919,907,FALSE,"jump1","0.1.4"
"41230","646",2023-11-04 11:15:00,-27997,1913,29910,907,FALSE,NA,"0.1.4"
"41231","646",2023-11-04 11:30:00,-27996,1913,29909,907,FALSE,NA,"0.1.4"
"41232","646",2023-11-04 11:45:00,-27966,1913,29879,907,FALSE,NA,"0.1.4"
"41233","646",2023-11-04 12:00:00,-27977,1913,29890,907,FALSE,NA,"0.1.4"
"41234","646",2023-11-04 12:15:00,-27977,1913,29890,907,FALSE,"jump1","0.1.4"
"41235","646",2023-11-04 12:30:00,-27977,1913,29890,907,FALSE,NA,"0.1.4"
"41236","646",2023-11-04 12:45:00,-27977,1913,29890,907,FALSE,NA,"0.1.4"
"41237","646",2023-11-04 13:00:00,-27977,1913,29890,907,FALSE,NA,"0.1.4"
"41238","646",2023-11-04 13:15:00,-27977,1913,29890,907,FALSE,NA,"0.1.4"
"41239","646",2023-11-04 13:30:00,-27977,1913,29890,907,FALSE,NA,"0.1.4"
"41240","646",2023-11-04 13:45:00,-27977,1913,29890,907,FALSE,NA,"0.1.4"
"41241","646",2023-11-04 14:00:00,-27977,1913,29890,907,FALSE,NA,"0.1.4"
"41242","646",2023-11-04 14:15:00,-27977,1913,29890,907,FALSE,NA,"0.1.4"
"41243","646",2023-11-04 14:30:00,-27977,1913,29890,907,FALSE,NA,"0.1.4"
"41244","646",2023-11-04 14:45:00,-27976,1913,29889,907,FALSE,NA,"0.1.4"
"41245","646",2023-11-04 15:00:00,-27976,1913,29889,907,FALSE,NA,"0.1.4"
"41246","646",2023-11-04 15:15:00,-27976,1913,29889,907,FALSE,NA,"0.1.4"
"41247","646",2023-11-04 15:30:00,-27977,1913,29890,907,FALSE,NA,"0.1.4"
"41248","646",2023-11-04 15:45:00,-27977,1913,29890,907,FALSE,NA,"0.1.4"
"41249","646",2023-11-04 16:00:00,-27977,1913,29890,907,FALSE,NA,"0.1.4"
"41250","646",2023-11-04 16:15:00,-27977,1913,29890,907,FALSE,NA,"0.1.4"
"41251","646",2023-11-04 16:30:00,-27977,1913,29890,907,FALSE,NA,"0.1.4"
"41252","646",2023-11-04 16:45:00,-27977,1913,29890,907,FALSE,NA,"0.1.4"
"41253","646",2023-11-04 17:00:00,-27977,1913,29890,907,FALSE,NA,"0.1.4"
"41254","646",2023-11-04 17:15:00,-27977,1913,29890,907,FALSE,NA,"0.1.4"
"41255","646",2023-11-04 17:30:00,-27977,1913,29890,907,FALSE,NA,"0.1.4"
"41256","646",2023-11-04 17:45:00,-27977,1913,29890,907,FALSE,NA,"0.1.4"
"41257","646",2023-11-04 18:00:00,-27976,1913,29889,907,FALSE,NA,"0.1.4"
"41258","646",2023-11-04 18:15:00,-27977,1913,29890,907,FALSE,NA,"0.1.4"
"41259","646",2023-11-04 18:30:00,-27977,1913,29890,907,FALSE,NA,"0.1.4"
"41260","646",2023-11-04 18:45:00,-27977,1913,29890,907,FALSE,NA,"0.1.4"
"41261","646",2023-11-04 19:00:00,-27972,1913,29885,907,FALSE,NA,"0.1.4"
"41262","646",2023-11-04 19:15:00,-27932,1913,29845,907,FALSE,NA,"0.1.4"
"41263","646",2023-11-04 19:30:00,-28087,1913,30000,907,FALSE,NA,"0.1.4"
"41264","646",2023-11-04 19:45:00,-28165,1913,30078,907,FALSE,NA,"0.1.4"
"41265","646",2023-11-04 20:00:00,-28361,1913,30274,907,FALSE,NA,"0.1.4"
"41266","646",2023-11-04 20:15:00,-28065,1913,29978,907,FALSE,NA,"0.1.4"
"41267","646",2023-11-04 20:30:00,-28065,1913,29978,907,FALSE,"jump1","0.1.4"
"41268","646",2023-11-04 20:45:00,-27890,1913,29803,907,FALSE,NA,"0.1.4"
"41269","646",2023-11-04 21:00:00,-27890,1913,29803,907,FALSE,"jump1","0.1.4"
"41270","646",2023-11-04 21:15:00,-27958,1913,29871,907,FALSE,NA,"0.1.4"
"41271","646",2023-11-04 21:30:00,-28349,1913,30262,907,FALSE,NA,"0.1.4"
"41272","646",2023-11-04 21:45:00,-27963,1913,29876,907,FALSE,NA,"0.1.4"
"41273","646",2023-11-04 22:00:00,-27973,1913,29886,907,FALSE,NA,"0.1.4"
"41274","646",2023-11-04 22:15:00,-27859,1913,29772,907,FALSE,NA,"0.1.4"
"41275","646",2023-11-04 22:30:00,-27915,1913,29828,907,FALSE,NA,"0.1.4"
"41276","646",2023-11-04 22:45:00,-27835,1913,29748,907,FALSE,NA,"0.1.4"
"41277","646",2023-11-04 23:00:00,-27832,1913,29745,907,FALSE,NA,"0.1.4"
"41278","646",2023-11-04 23:15:00,-27840,1913,29753,907,FALSE,NA,"0.1.4"
"41279","646",2023-11-04 23:30:00,-27832,1913,29745,907,FALSE,NA,"0.1.4"
"41280","646",2023-11-04 23:45:00,-27832,1913,29745,907,FALSE,NA,"0.1.4"
"41281","646",2023-11-05,-27943,1913,29856,907,FALSE,NA,"0.1.4"
"41282","646",2023-11-05 00:15:00,-27887,1913,29800,907,FALSE,NA,"0.1.4"
"41283","646",2023-11-05 00:30:00,-27932,1913,29845,907,FALSE,NA,"0.1.4"
"41284","646",2023-11-05 00:45:00,-27955,1913,29868,907,FALSE,NA,"0.1.4"
"41285","646",2023-11-05 01:00:00,-28336,1913,30249,907,FALSE,NA,"0.1.4"
"41286","646",2023-11-05 01:15:00,-28246,1913,30159,907,FALSE,NA,"0.1.4"
"41287","646",2023-11-05 01:30:00,-28524,1913,30437,907,FALSE,NA,"0.1.4"
"41288","646",2023-11-05 01:45:00,-28524,1913,30437,907,FALSE,"jump1","0.1.4"
"41289","646",2023-11-05 02:00:00,-28528,1913,30441,907,FALSE,NA,"0.1.4"
"41290","646",2023-11-05 02:15:00,-28528,1913,30441,907,FALSE,NA,"0.1.4"
"41291","646",2023-11-05 02:30:00,-28528,1913,30441,907,FALSE,NA,"0.1.4"
"41292","646",2023-11-05 02:45:00,-28528,1913,30441,907,FALSE,NA,"0.1.4"
"41293","646",2023-11-05 03:00:00,-28524,1913,30437,907,FALSE,NA,"0.1.4"
"41294","646",2023-11-05 03:15:00,-28522,1913,30435,907,FALSE,NA,"0.1.4"
"41295","646",2023-11-05 03:30:00,-28527,1913,30440,907,FALSE,NA,"0.1.4"
"41296","646",2023-11-05 03:45:00,-28526,1913,30439,907,FALSE,NA,"0.1.4"
"41297","646",2023-11-05 04:00:00,-28522,1913,30435,907,FALSE,NA,"0.1.4"
"41298","646",2023-11-05 04:15:00,-28505,1913,30418,907,FALSE,NA,"0.1.4"
"41299","646",2023-11-05 04:30:00,-28504,1913,30417,907,FALSE,NA,"0.1.4"
"41300","646",2023-11-05 04:45:00,-28438,1913,30351,907,FALSE,NA,"0.1.4"
"41301","646",2023-11-05 05:00:00,-28444,1913,30357,907,FALSE,NA,"0.1.4"
"41302","646",2023-11-05 05:15:00,-28486,1913,30399,907,FALSE,NA,"0.1.4"
"41303","646",2023-11-05 05:30:00,-28438,1913,30351,907,FALSE,NA,"0.1.4"
"41304","646",2023-11-05 05:45:00,-28438,1913,30351,907,FALSE,NA,"0.1.4"
"41305","646",2023-11-05 06:00:00,-28467,1913,30380,907,FALSE,NA,"0.1.4"
"41306","646",2023-11-05 06:15:00,-28436,1913,30349,907,FALSE,NA,"0.1.4"
"41307","646",2023-11-05 06:30:00,-28479,1913,30392,907,FALSE,NA,"0.1.4"
"41308","646",2023-11-05 06:45:00,-28480,1913,30393,907,FALSE,NA,"0.1.4"
"41309","646",2023-11-05 07:00:00,-28473,1913,30386,907,FALSE,NA,"0.1.4"
"41310","646",2023-11-05 07:15:00,-28472,1913,30385,907,FALSE,NA,"0.1.4"
"41311","646",2023-11-05 07:30:00,-28468,1913,30381,907,FALSE,NA,"0.1.4"
"41312","646",2023-11-05 07:45:00,-28467,1913,30380,907,FALSE,NA,"0.1.4"
"41313","646",2023-11-05 08:00:00,-28471,1913,30384,907,FALSE,NA,"0.1.4"
"41314","646",2023-11-05 08:15:00,-28473,1913,30386,907,FALSE,NA,"0.1.4"
"41315","646",2023-11-05 08:30:00,-28469,1913,30382,907,FALSE,NA,"0.1.4"
"41316","646",2023-11-05 08:45:00,-28468,1913,30381,907,FALSE,NA,"0.1.4"
"41317","646",2023-11-05 09:00:00,-28517,1913,30430,907,FALSE,NA,"0.1.4"
"41318","646",2023-11-05 09:15:00,-28508,1913,30421,907,FALSE,NA,"0.1.4"
"41319","646",2023-11-05 09:30:00,-28627,1913,30540,907,FALSE,NA,"0.1.4"
"41320","646",2023-11-05 09:45:00,-28689,1913,30602,907,FALSE,NA,"0.1.4"
"41321","646",2023-11-05 10:00:00,-28710,1913,30623,907,FALSE,NA,"0.1.4"
"41322","646",2023-11-05 10:15:00,-28726,1913,30639,907,FALSE,NA,"0.1.4"
"41323","646",2023-11-05 10:30:00,-28708,1913,30621,907,FALSE,NA,"0.1.4"
"41324","646",2023-11-05 10:45:00,-28559,1913,30472,907,FALSE,NA,"0.1.4"
"41325","646",2023-11-05 11:00:00,-28739,1913,30652,907,FALSE,NA,"0.1.4"
"41326","646",2023-11-05 11:15:00,-28774,1913,30687,907,FALSE,NA,"0.1.4"
"41327","646",2023-11-05 11:30:00,-28545,1913,30458,907,FALSE,NA,"0.1.4"
"41328","646",2023-11-05 11:45:00,-28553,1913,30466,907,FALSE,NA,"0.1.4"
"41329","646",2023-11-05 12:00:00,-28542,1913,30455,907,FALSE,NA,"0.1.4"
"41330","646",2023-11-05 12:15:00,-28546,1913,30459,907,FALSE,NA,"0.1.4"
"41331","646",2023-11-05 12:30:00,-28548,1913,30461,907,FALSE,NA,"0.1.4"
"41332","646",2023-11-05 12:45:00,-28541,1913,30454,907,FALSE,NA,"0.1.4"
"41333","646",2023-11-05 13:00:00,-28529,1913,30442,907,FALSE,NA,"0.1.4"
"41334","646",2023-11-05 13:15:00,-28525,1913,30438,907,FALSE,NA,"0.1.4"
"41335","646",2023-11-05 13:30:00,-28525,1913,30438,907,FALSE,NA,"0.1.4"
"41336","646",2023-11-05 13:45:00,-28525,1913,30438,907,FALSE,NA,"0.1.4"
"41337","646",2023-11-05 14:00:00,-28525,1913,30438,907,FALSE,NA,"0.1.4"
"41338","646",2023-11-05 14:15:00,-28525,1913,30438,907,FALSE,NA,"0.1.4"
"41339","646",2023-11-05 14:30:00,-28654,1913,30567,907,FALSE,NA,"0.1.4"
"41340","646",2023-11-05 14:45:00,-28925,1913,30838,907,FALSE,NA,"0.1.4"
"41341","646",2023-11-05 15:00:00,-28841,1913,30754,907,FALSE,NA,"0.1.4"
"41342","646",2023-11-05 15:15:00,-28845,1913,30758,907,FALSE,NA,"0.1.4"
"41343","646",2023-11-05 15:30:00,-28796,1913,30709,907,FALSE,NA,"0.1.4"
"41344","646",2023-11-05 15:45:00,-28795,1913,30708,907,FALSE,NA,"0.1.4"
"41345","646",2023-11-05 16:00:00,-28690,1913,30603,907,FALSE,NA,"0.1.4"
"41346","646",2023-11-05 16:15:00,-28760,1913,30673,907,FALSE,NA,"0.1.4"
"41347","646",2023-11-05 16:30:00,-28762,1913,30675,907,FALSE,NA,"0.1.4"
"41348","646",2023-11-05 16:45:00,-28712,1913,30625,907,FALSE,NA,"0.1.4"
"41349","646",2023-11-05 17:00:00,-28719,1913,30632,907,FALSE,NA,"0.1.4"
"41350","646",2023-11-05 17:15:00,-28725,1913,30638,907,FALSE,NA,"0.1.4"
"41351","646",2023-11-05 17:30:00,-28530,1913,30443,907,FALSE,NA,"0.1.4"
"41352","646",2023-11-05 17:45:00,-28533,1913,30446,907,FALSE,NA,"0.1.4"
"41353","646",2023-11-05 18:00:00,-28528,1913,30441,907,FALSE,NA,"0.1.4"
"41354","646",2023-11-05 18:15:00,-28527,1913,30440,907,FALSE,NA,"0.1.4"
"41355","646",2023-11-05 18:30:00,-28527,1913,30440,907,FALSE,NA,"0.1.4"
"41356","646",2023-11-05 18:45:00,-28527,1913,30440,907,FALSE,NA,"0.1.4"
"41357","646",2023-11-05 19:00:00,-28527,1913,30440,907,FALSE,NA,"0.1.4"
"41358","646",2023-11-05 19:15:00,-28527,1913,30440,907,FALSE,NA,"0.1.4"
"41359","646",2023-11-05 19:30:00,-28526,1913,30439,907,FALSE,NA,"0.1.4"
"41360","646",2023-11-05 19:45:00,-28527,1913,30440,907,FALSE,NA,"0.1.4"
"41361","646",2023-11-05 20:00:00,-28526,1913,30439,907,FALSE,NA,"0.1.4"
"41362","646",2023-11-05 20:15:00,-28526,1913,30439,907,FALSE,NA,"0.1.4"
"41363","646",2023-11-05 20:30:00,-28526,1913,30439,907,FALSE,NA,"0.1.4"
"41364","646",2023-11-05 20:45:00,-28526,1913,30439,907,FALSE,NA,"0.1.4"
"41365","646",2023-11-05 21:00:00,-28526,1913,30439,907,FALSE,NA,"0.1.4"
"41366","646",2023-11-05 21:15:00,-28526,1913,30439,907,FALSE,NA,"0.1.4"
"41367","646",2023-11-05 21:30:00,-28526,1913,30439,907,FALSE,NA,"0.1.4"
"41368","646",2023-11-05 21:45:00,-28526,1913,30439,907,FALSE,NA,"0.1.4"
"41369","646",2023-11-05 22:00:00,-28520,1913,30433,907,FALSE,NA,"0.1.4"
"41370","646",2023-11-05 22:15:00,-28520,1913,30433,907,FALSE,NA,"0.1.4"
"41371","646",2023-11-05 22:30:00,-28519,1913,30432,907,FALSE,NA,"0.1.4"
"41372","646",2023-11-05 22:45:00,-28520,1913,30433,907,FALSE,NA,"0.1.4"
"41373","646",2023-11-05 23:00:00,-28520,1913,30433,907,FALSE,NA,"0.1.4"
"41374","646",2023-11-05 23:15:00,-28524,1913,30437,907,FALSE,NA,"0.1.4"
"41375","646",2023-11-05 23:30:00,-28523,1913,30436,907,FALSE,NA,"0.1.4"
"41376","646",2023-11-05 23:45:00,-28524,1913,30437,907,FALSE,NA,"0.1.4"
"41377","646",2023-11-06,-28550,1913,30463,907,FALSE,NA,"0.1.4"
"41378","646",2023-11-06 00:15:00,-28575,1913,30488,907,FALSE,NA,"0.1.4"
"41379","646",2023-11-06 00:30:00,-28552,1913,30465,907,FALSE,NA,"0.1.4"
"41380","646",2023-11-06 00:45:00,-28629,1913,30542,907,FALSE,NA,"0.1.4"
"41381","646",2023-11-06 01:00:00,-28655,1913,30568,907,FALSE,NA,"0.1.4"
"41382","646",2023-11-06 01:15:00,-28672,1913,30585,907,FALSE,NA,"0.1.4"
"41383","646",2023-11-06 01:30:00,-28854,1913,30767,907,FALSE,NA,"0.1.4"
"41384","646",2023-11-06 01:45:00,-28694,1913,30607,907,FALSE,NA,"0.1.4"
"41385","646",2023-11-06 02:00:00,-28842,1913,30755,907,FALSE,NA,"0.1.4"
"41386","646",2023-11-06 02:15:00,-28821,1913,30734,907,FALSE,NA,"0.1.4"
"41387","646",2023-11-06 02:30:00,-29169,1913,31082,907,FALSE,NA,"0.1.4"
"41388","646",2023-11-06 02:45:00,-29071,1913,30984,907,FALSE,NA,"0.1.4"
"41389","646",2023-11-06 03:00:00,-28776,1913,30689,907,FALSE,NA,"0.1.4"
"41390","646",2023-11-06 03:15:00,-28739,1913,30652,907,FALSE,NA,"0.1.4"
"41391","646",2023-11-06 03:30:00,-28744,1913,30657,907,FALSE,NA,"0.1.4"
"41392","646",2023-11-06 03:45:00,-28774,1913,30687,907,FALSE,NA,"0.1.4"
"41393","646",2023-11-06 04:00:00,-28691,1913,30604,907,FALSE,NA,"0.1.4"
"41394","646",2023-11-06 04:15:00,-28992,1913,30905,907,FALSE,NA,"0.1.4"
"41395","646",2023-11-06 04:30:00,-29233,1913,31146,907,FALSE,NA,"0.1.4"
"41396","646",2023-11-06 04:45:00,-29233,1913,31146,907,FALSE,"jump1","0.1.4"
"41397","646",2023-11-06 05:00:00,-29290,1913,31203,907,FALSE,NA,"0.1.4"
"41398","646",2023-11-06 05:15:00,-29201,1913,31114,907,FALSE,NA,"0.1.4"
"41399","646",2023-11-06 05:30:00,-29201,1913,31114,907,FALSE,"jump1","0.1.4"
"41400","646",2023-11-06 05:45:00,-29214,1913,31127,907,FALSE,NA,"0.1.4"
"41401","646",2023-11-06 06:00:00,-29149,1913,31062,907,FALSE,NA,"0.1.4"
"41402","646",2023-11-06 06:15:00,-29149,1913,31062,907,FALSE,"jump1","0.1.4"
"41403","646",2023-11-06 06:30:00,-29618,1913,31531,907,FALSE,NA,"0.1.4"
"41404","646",2023-11-06 06:45:00,-29766,1913,31679,907,FALSE,NA,"0.1.4"
"41405","646",2023-11-06 07:00:00,-29462,1913,31375,907,FALSE,NA,"0.1.4"
"41406","646",2023-11-06 07:15:00,-29936,1913,31849,907,FALSE,NA,"0.1.4"
"41407","646",2023-11-06 07:30:00,-30076,1913,31989,907,FALSE,NA,"0.1.4"
"41408","646",2023-11-06 07:45:00,-30051,1913,31964,907,FALSE,NA,"0.1.4"
"41409","646",2023-11-06 08:00:00,-30233,1913,32146,907,FALSE,NA,"0.1.4"
"41410","646",2023-11-06 08:15:00,-30240,1913,32153,907,FALSE,NA,"0.1.4"
"41411","646",2023-11-06 08:30:00,-30084,1913,31997,907,FALSE,NA,"0.1.4"
"41412","646",2023-11-06 08:45:00,-29799,1913,31712,907,FALSE,"out1, fill","0.1.4"
"41413","646",2023-11-06 09:00:00,-29514,1913,31427,907,FALSE,NA,"0.1.4"
"41414","646",2023-11-06 09:15:00,-29431,1913,31344,907,FALSE,NA,"0.1.4"
"41415","646",2023-11-06 09:30:00,-29776,1913,31689,907,FALSE,NA,"0.1.4"
"41416","646",2023-11-06 09:45:00,-29583.5,1913,31496.5,907,FALSE,"out1, fill","0.1.4"
"41417","646",2023-11-06 10:00:00,-29391,1913,31304,907,FALSE,NA,"0.1.4"
"41418","646",2023-11-06 10:15:00,-29102,1913,31015,907,FALSE,NA,"0.1.4"
"41419","646",2023-11-06 10:30:00,-29030,1913,30943,907,FALSE,NA,"0.1.4"
"41420","646",2023-11-06 10:45:00,-29023,1913,30936,907,FALSE,NA,"0.1.4"
"41421","646",2023-11-06 11:00:00,-28974,1913,30887,907,FALSE,NA,"0.1.4"
"41422","646",2023-11-06 11:15:00,-29285.75,1913,31198.75,907,FALSE,"out1, fill","0.1.4"
"41423","646",2023-11-06 11:30:00,-29597.5,1913,31510.5,907,FALSE,"out1, fill","0.1.4"
"41424","646",2023-11-06 11:45:00,-29909.25,1913,31822.25,907,FALSE,"out1, fill","0.1.4"
"41425","646",2023-11-06 12:00:00,-30221,1913,32134,907,FALSE,NA,"0.1.4"
"41426","646",2023-11-06 12:15:00,-29741,1913,31654,907,FALSE,NA,"0.1.4"
"41427","646",2023-11-06 12:30:00,-30146,1913,32059,907,FALSE,NA,"0.1.4"
"41428","646",2023-11-06 12:45:00,-30146,1913,32059,907,FALSE,"out1, fill","0.1.4"
"41429","646",2023-11-06 13:00:00,-30146,1913,32059,907,FALSE,"jump1","0.1.4"
"41430","646",2023-11-06 13:15:00,-30161,1913,32074,907,FALSE,NA,"0.1.4"
"41431","646",2023-11-06 13:30:00,-30170,1913,32083,907,FALSE,NA,"0.1.4"
"41432","646",2023-11-06 13:45:00,-30159,1913,32072,907,FALSE,NA,"0.1.4"
"41433","646",2023-11-06 14:00:00,-30161,1913,32074,907,FALSE,NA,"0.1.4"
"41434","646",2023-11-06 14:15:00,-30161,1913,32074,907,FALSE,"jump1","0.1.4"
"41435","646",2023-11-06 14:30:00,-30109,1913,32022,907,FALSE,NA,"0.1.4"
"41436","646",2023-11-06 14:45:00,-29660,1913,31573,907,FALSE,NA,"0.1.4"
"41437","646",2023-11-06 15:00:00,-29678,1913,31591,907,FALSE,NA,"0.1.4"
"41438","646",2023-11-06 15:15:00,-29671,1913,31584,907,FALSE,NA,"0.1.4"
"41439","646",2023-11-06 15:30:00,-29746,1913,31659,907,FALSE,NA,"0.1.4"
"41440","646",2023-11-06 15:45:00,-29789,1913,31702,907,FALSE,NA,"0.1.4"
"41441","646",2023-11-06 16:00:00,-29716,1913,31629,907,FALSE,NA,"0.1.4"
"41442","646",2023-11-06 16:15:00,-29723,1913,31636,907,FALSE,NA,"0.1.4"
"41443","646",2023-11-06 16:30:00,-29708,1913,31621,907,FALSE,NA,"0.1.4"
"41444","646",2023-11-06 16:45:00,-29644,1913,31557,907,FALSE,NA,"0.1.4"
"41445","646",2023-11-06 17:00:00,-29726,1913,31639,907,FALSE,NA,"0.1.4"
"41446","646",2023-11-06 17:15:00,-29718,1913,31631,907,FALSE,NA,"0.1.4"
"41447","646",2023-11-06 17:30:00,-29815,1913,31728,907,FALSE,NA,"0.1.4"
"41448","646",2023-11-06 17:45:00,-29649,1913,31562,907,FALSE,NA,"0.1.4"
"41449","646",2023-11-06 18:00:00,-29627,1913,31540,907,FALSE,NA,"0.1.4"
"41450","646",2023-11-06 18:15:00,-29634,1913,31547,907,FALSE,NA,"0.1.4"
"41451","646",2023-11-06 18:30:00,-29629,1913,31542,907,FALSE,NA,"0.1.4"
"41452","646",2023-11-06 18:45:00,-29631,1913,31544,907,FALSE,NA,"0.1.4"
"41453","646",2023-11-06 19:00:00,-29621,1913,31534,907,FALSE,NA,"0.1.4"
"41454","646",2023-11-06 19:15:00,-29626,1913,31539,907,FALSE,NA,"0.1.4"
"41455","646",2023-11-06 19:30:00,-29621,1913,31534,907,FALSE,NA,"0.1.4"
"41456","646",2023-11-06 19:45:00,-29616,1913,31529,907,FALSE,NA,"0.1.4"
"41457","646",2023-11-06 20:00:00,-29620,1913,31533,907,FALSE,NA,"0.1.4"
"41458","646",2023-11-06 20:15:00,-29635,1913,31548,907,FALSE,NA,"0.1.4"
"41459","646",2023-11-06 20:30:00,-29631,1913,31544,907,FALSE,NA,"0.1.4"
"41460","646",2023-11-06 20:45:00,-29622,1913,31535,907,FALSE,NA,"0.1.4"
"41461","646",2023-11-06 21:00:00,-29939,1913,31852,907,FALSE,"out1, fill","0.1.4"
"41462","646",2023-11-06 21:15:00,-30256,1913,32169,907,FALSE,NA,"0.1.4"
"41463","646",2023-11-06 21:30:00,-30673,1913,32586,907,FALSE,NA,"0.1.4"
"41464","646",2023-11-06 21:45:00,-30700,1913,32613,907,FALSE,NA,"0.1.4"
"41465","646",2023-11-06 22:00:00,-30700,1913,32613,907,FALSE,"jump1","0.1.4"
"41466","646",2023-11-06 22:15:00,-30585,1913,32498,907,FALSE,NA,"0.1.4"
"41467","646",2023-11-06 22:30:00,-30320,1913,32233,907,FALSE,NA,"0.1.4"
"41468","646",2023-11-06 22:45:00,-30444,1913,32357,907,FALSE,NA,"0.1.4"
"41469","646",2023-11-06 23:00:00,-30347,1913,32260,907,FALSE,NA,"0.1.4"
"41470","646",2023-11-06 23:15:00,-30317,1913,32230,907,FALSE,NA,"0.1.4"
"41471","646",2023-11-06 23:30:00,-30572,1913,32485,907,FALSE,NA,"0.1.4"
"41472","646",2023-11-06 23:45:00,-30620,1913,32533,907,FALSE,NA,"0.1.4"
"41473","646",2023-11-07,-30411,1913,32324,907,FALSE,NA,"0.1.4"
"41474","646",2023-11-07 00:15:00,-30319,1913,32232,907,FALSE,NA,"0.1.4"
"41475","646",2023-11-07 00:30:00,-30283,1913,32196,907,FALSE,NA,"0.1.4"
"41476","646",2023-11-07 00:45:00,-30280,1913,32193,907,FALSE,NA,"0.1.4"
"41477","646",2023-11-07 01:00:00,-30287,1913,32200,907,FALSE,NA,"0.1.4"
"41478","646",2023-11-07 01:15:00,-30276,1913,32189,907,FALSE,NA,"0.1.4"
"41479","646",2023-11-07 01:30:00,-30318,1913,32231,907,FALSE,NA,"0.1.4"
"41480","646",2023-11-07 01:45:00,-30334,1913,32247,907,FALSE,NA,"0.1.4"
"41481","646",2023-11-07 02:00:00,-30281,1913,32194,907,FALSE,NA,"0.1.4"
"41482","646",2023-11-07 02:15:00,-30304,1913,32217,907,FALSE,NA,"0.1.4"
"41483","646",2023-11-07 02:30:00,-30474,1913,32387,907,FALSE,NA,"0.1.4"
"41484","646",2023-11-07 02:45:00,-30558,1913,32471,907,FALSE,"out1, fill","0.1.4"
"41485","646",2023-11-07 03:00:00,-30642,1913,32555,907,FALSE,"out1, fill","0.1.4"
"41486","646",2023-11-07 03:15:00,-30726,1913,32639,907,FALSE,NA,"0.1.4"
"41487","646",2023-11-07 03:30:00,-30659,1913,32572,907,FALSE,NA,"0.1.4"
"41488","646",2023-11-07 03:45:00,-30704,1913,32617,907,FALSE,NA,"0.1.4"
"41489","646",2023-11-07 04:00:00,-30584,1913,32497,907,FALSE,NA,"0.1.4"
"41490","646",2023-11-07 04:15:00,-30685,1913,32598,907,FALSE,NA,"0.1.4"
"41491","646",2023-11-07 04:30:00,-30496,1913,32409,907,FALSE,NA,"0.1.4"
"41492","646",2023-11-07 04:45:00,-30496,1913,32409,907,FALSE,"jump1","0.1.4"
"41493","646",2023-11-07 05:00:00,-30361,1913,32274,907,FALSE,NA,"0.1.4"
"41494","646",2023-11-07 05:15:00,-30314,1913,32227,907,FALSE,NA,"0.1.4"
"41495","646",2023-11-07 05:30:00,-30331,1913,32244,907,FALSE,NA,"0.1.4"
"41496","646",2023-11-07 05:45:00,-30319,1913,32232,907,FALSE,NA,"0.1.4"
"41497","646",2023-11-07 06:00:00,-30306,1913,32219,907,FALSE,NA,"0.1.4"
"41498","646",2023-11-07 06:15:00,-30295,1913,32208,907,FALSE,NA,"0.1.4"
"41499","646",2023-11-07 06:30:00,-30327,1913,32240,907,FALSE,NA,"0.1.4"
"41500","646",2023-11-07 06:45:00,-30327,1913,32240,907,FALSE,"jump1","0.1.4"
"41501","646",2023-11-07 07:00:00,-30373,1913,32286,907,FALSE,NA,"0.1.4"
"41502","646",2023-11-07 07:15:00,-30346,1913,32259,907,FALSE,NA,"0.1.4"
"41503","646",2023-11-07 07:30:00,-30350,1913,32263,907,FALSE,NA,"0.1.4"
"41504","646",2023-11-07 07:45:00,-30350,1913,32263,907,FALSE,"jump1","0.1.4"
"41505","646",2023-11-07 08:00:00,-30450.3333333333,1913,32363.3333333333,907,FALSE,"out1, fill","0.1.4"
"41506","646",2023-11-07 08:15:00,-30550.6666666667,1913,32463.6666666667,907,FALSE,"out1, fill","0.1.4"
"41507","646",2023-11-07 08:30:00,-30651,1913,32564,907,FALSE,NA,"0.1.4"
"41508","646",2023-11-07 08:45:00,-30464,1913,32377,907,FALSE,NA,"0.1.4"
"41509","646",2023-11-07 09:00:00,-30696,1913,32609,907,FALSE,NA,"0.1.4"
"41510","646",2023-11-07 09:15:00,-30854,1913,32767,907,FALSE,NA,"0.1.4"
"41511","646",2023-11-07 09:30:00,-30854,1913,32767,907,FALSE,"jump1","0.1.4"
"41512","646",2023-11-07 09:45:00,-30832,1913,32745,907,FALSE,NA,"0.1.4"
"41513","646",2023-11-07 10:00:00,-31090,1913,33003,907,FALSE,NA,"0.1.4"
"41514","646",2023-11-07 10:15:00,-31176,1913,33089,907,FALSE,NA,"0.1.4"
"41515","646",2023-11-07 10:30:00,-31123,1913,33036,907,FALSE,NA,"0.1.4"
"41516","646",2023-11-07 10:45:00,-31185,1913,33098,907,FALSE,NA,"0.1.4"
"41517","646",2023-11-07 11:00:00,-31321,1913,33234,907,FALSE,NA,"0.1.4"
"41518","646",2023-11-07 11:15:00,-31241,1913,33154,907,FALSE,NA,"0.1.4"
"41519","646",2023-11-07 11:30:00,-31270,1913,33183,907,FALSE,NA,"0.1.4"
"41520","646",2023-11-07 11:45:00,-31292,1913,33205,907,FALSE,NA,"0.1.4"
"41521","646",2023-11-07 12:00:00,-31372,1913,33285,907,FALSE,NA,"0.1.4"
"41522","646",2023-11-07 12:15:00,-31446,1913,33359,907,FALSE,NA,"0.1.4"
"41523","646",2023-11-07 12:30:00,-31446,1913,33359,907,FALSE,"jump1","0.1.4"
"41524","646",2023-11-07 12:45:00,-31691,1913,33604,907,FALSE,NA,"0.1.4"
"41525","646",2023-11-07 13:00:00,-31555,1913,33468,907,FALSE,NA,"0.1.4"
"41526","646",2023-11-07 13:15:00,-31447,1913,33360,907,FALSE,NA,"0.1.4"
"41527","646",2023-11-07 13:30:00,-31016,1913,32929,907,FALSE,NA,"0.1.4"
"41528","646",2023-11-07 13:45:00,-30985,1913,32898,907,FALSE,NA,"0.1.4"
"41529","646",2023-11-07 14:00:00,-30971,1913,32884,907,FALSE,NA,"0.1.4"
"41530","646",2023-11-07 14:15:00,-30971,1913,32884,907,FALSE,"out1, fill","0.1.4"
"41531","646",2023-11-07 14:30:00,-30971,1913,32884,907,FALSE,"jump1","0.1.4"
"41532","646",2023-11-07 14:45:00,-30922,1913,32835,907,FALSE,NA,"0.1.4"
"41533","646",2023-11-07 15:00:00,-30866,1913,32779,907,FALSE,NA,"0.1.4"
"41534","646",2023-11-07 15:15:00,-30922,1913,32835,907,FALSE,NA,"0.1.4"
"41535","646",2023-11-07 15:30:00,-30544,1913,32457,907,FALSE,"out1, fill","0.1.4"
"41536","646",2023-11-07 15:45:00,-30166,1913,32079,907,FALSE,NA,"0.1.4"
"41537","646",2023-11-07 16:00:00,-30461,1913,32374,907,FALSE,NA,"0.1.4"
"41538","646",2023-11-07 16:15:00,-30049,1913,31962,907,FALSE,NA,"0.1.4"
"41539","646",2023-11-07 16:30:00,-30108,1913,32021,907,FALSE,NA,"0.1.4"
"41540","646",2023-11-07 16:45:00,-29938,1913,31851,907,FALSE,NA,"0.1.4"
"41541","646",2023-11-07 17:00:00,-29941,1913,31854,907,FALSE,NA,"0.1.4"
"41542","646",2023-11-07 17:15:00,-29936,1913,31849,907,FALSE,NA,"0.1.4"
"41543","646",2023-11-07 17:30:00,-29929,1913,31842,907,FALSE,NA,"0.1.4"
"41544","646",2023-11-07 17:45:00,-29917,1913,31830,907,FALSE,NA,"0.1.4"
"41545","646",2023-11-07 18:00:00,-29917,1913,31830,907,FALSE,NA,"0.1.4"
"41546","646",2023-11-07 18:15:00,-29923,1913,31836,907,FALSE,NA,"0.1.4"
"41547","646",2023-11-07 18:30:00,-29927,1913,31840,907,FALSE,NA,"0.1.4"
"41548","646",2023-11-07 18:45:00,-29919,1913,31832,907,FALSE,NA,"0.1.4"
"41549","646",2023-11-07 19:00:00,-29914,1913,31827,907,FALSE,NA,"0.1.4"
"41550","646",2023-11-07 19:15:00,-29909,1913,31822,907,FALSE,NA,"0.1.4"
"41551","646",2023-11-07 19:30:00,-29908,1913,31821,907,FALSE,NA,"0.1.4"
"41552","646",2023-11-07 19:45:00,-29917,1913,31830,907,FALSE,NA,"0.1.4"
"41553","646",2023-11-07 20:00:00,-29916,1913,31829,907,FALSE,NA,"0.1.4"
"41554","646",2023-11-07 20:15:00,-29925,1913,31838,907,FALSE,NA,"0.1.4"
"41555","646",2023-11-07 20:30:00,-29921,1913,31834,907,FALSE,NA,"0.1.4"
"41556","646",2023-11-07 20:45:00,-29899,1913,31812,907,FALSE,NA,"0.1.4"
"41557","646",2023-11-07 21:00:00,-29899,1913,31812,907,FALSE,NA,"0.1.4"
"41558","646",2023-11-07 21:15:00,-29898,1913,31811,907,FALSE,NA,"0.1.4"
"41559","646",2023-11-07 21:30:00,-29948,1913,31861,907,FALSE,NA,"0.1.4"
"41560","646",2023-11-07 21:45:00,-29979,1913,31892,907,FALSE,NA,"0.1.4"
"41561","646",2023-11-07 22:00:00,-29972,1913,31885,907,FALSE,NA,"0.1.4"
"41562","646",2023-11-07 22:15:00,-29955,1913,31868,907,FALSE,NA,"0.1.4"
"41563","646",2023-11-07 22:30:00,-29913,1913,31826,907,FALSE,NA,"0.1.4"
"41564","646",2023-11-07 22:45:00,-29911,1913,31824,907,FALSE,NA,"0.1.4"
"41565","646",2023-11-07 23:00:00,-29934,1913,31847,907,FALSE,NA,"0.1.4"
"41566","646",2023-11-07 23:15:00,-29936,1913,31849,907,FALSE,NA,"0.1.4"
"41567","646",2023-11-07 23:30:00,-29943,1913,31856,907,FALSE,NA,"0.1.4"
"41568","646",2023-11-07 23:45:00,-29930,1913,31843,907,FALSE,NA,"0.1.4"
"41569","646",2023-11-08,-29925,1913,31838,907,FALSE,NA,"0.1.4"
"41570","646",2023-11-08 00:15:00,-30140,1913,32053,907,FALSE,NA,"0.1.4"
"41571","646",2023-11-08 00:30:00,-30062,1913,31975,907,FALSE,NA,"0.1.4"
"41572","646",2023-11-08 00:45:00,-30312,1913,32225,907,FALSE,NA,"0.1.4"
"41573","646",2023-11-08 01:00:00,-30244,1913,32157,907,FALSE,NA,"0.1.4"
"41574","646",2023-11-08 01:15:00,-30522,1913,32435,907,FALSE,NA,"0.1.4"
"41575","646",2023-11-08 01:30:00,-30434,1913,32347,907,FALSE,NA,"0.1.4"
"41576","646",2023-11-08 01:45:00,-30585,1913,32498,907,FALSE,NA,"0.1.4"
"41577","646",2023-11-08 02:00:00,-30690,1913,32603,907,FALSE,NA,"0.1.4"
"41578","646",2023-11-08 02:15:00,-30402,1913,32315,907,FALSE,NA,"0.1.4"
"41579","646",2023-11-08 02:30:00,-30377,1913,32290,907,FALSE,NA,"0.1.4"
"41580","646",2023-11-08 02:45:00,-30364,1913,32277,907,FALSE,NA,"0.1.4"
"41581","646",2023-11-08 03:00:00,-29974,1913,31887,907,FALSE,NA,"0.1.4"
"41582","646",2023-11-08 03:15:00,-30392,1913,32305,907,FALSE,"out1, fill","0.1.4"
"41583","646",2023-11-08 03:30:00,-30810,1913,32723,907,FALSE,"out1, fill","0.1.4"
"41584","646",2023-11-08 03:45:00,-31228,1913,33141,907,FALSE,NA,"0.1.4"
"41585","646",2023-11-08 04:00:00,-31564,1913,33477,907,FALSE,NA,"0.1.4"
"41586","646",2023-11-08 04:15:00,-31336,1913,33249,907,FALSE,NA,"0.1.4"
"41587","646",2023-11-08 04:30:00,-31192,1913,33105,907,FALSE,NA,"0.1.4"
"41588","646",2023-11-08 04:45:00,-31122,1913,33035,907,FALSE,NA,"0.1.4"
"41589","646",2023-11-08 05:00:00,-30848,1913,32761,907,FALSE,NA,"0.1.4"
"41590","646",2023-11-08 05:15:00,-31079,1913,32992,907,FALSE,NA,"0.1.4"
"41591","646",2023-11-08 05:30:00,-31201,1913,33114,907,FALSE,NA,"0.1.4"
"41592","646",2023-11-08 05:45:00,-31127,1913,33040,907,FALSE,NA,"0.1.4"
"41593","646",2023-11-08 06:00:00,-31160,1913,33073,907,FALSE,NA,"0.1.4"
"41594","646",2023-11-08 06:15:00,-31039,1913,32952,907,FALSE,NA,"0.1.4"
"41595","646",2023-11-08 06:30:00,-31310,1913,33223,907,FALSE,NA,"0.1.4"
"41596","646",2023-11-08 06:45:00,-31262,1913,33175,907,FALSE,NA,"0.1.4"
"41597","646",2023-11-08 07:00:00,-31599,1913,33512,907,FALSE,NA,"0.1.4"
"41598","646",2023-11-08 07:15:00,-31174,1913,33087,907,FALSE,NA,"0.1.4"
"41599","646",2023-11-08 07:30:00,-31174,1913,33087,907,FALSE,"jump1","0.1.4"
"41600","646",2023-11-08 07:45:00,-31471,1913,33384,907,FALSE,NA,"0.1.4"
"41601","646",2023-11-08 08:00:00,-31471,1913,33384,907,FALSE,"jump1","0.1.4"
"41602","646",2023-11-08 08:15:00,-31471,1913,33384,907,FALSE,"jump1","0.1.4"
"41603","646",2023-11-08 08:30:00,-31618.5,1913,33531.5,907,FALSE,"out1, fill","0.1.4"
"41604","646",2023-11-08 08:45:00,-31766,1913,33679,907,FALSE,NA,"0.1.4"
"41605","646",2023-11-08 09:00:00,-31766,1913,33679,907,FALSE,"jump1","0.1.4"
"41606","646",2023-11-08 09:15:00,-31946,1913,33859,907,FALSE,NA,"0.1.4"
"41607","646",2023-11-08 09:30:00,-31938,1913,33851,907,FALSE,NA,"0.1.4"
"41608","646",2023-11-08 09:45:00,-31856,1913,33769,907,FALSE,NA,"0.1.4"
"41609","646",2023-11-08 10:00:00,-31952,1913,33865,907,FALSE,NA,"0.1.4"
"41610","646",2023-11-08 10:15:00,-31882,1913,33795,907,FALSE,NA,"0.1.4"
"41611","646",2023-11-08 10:30:00,-31845,1913,33758,907,FALSE,NA,"0.1.4"
"41612","646",2023-11-08 10:45:00,-31742,1913,33655,907,FALSE,NA,"0.1.4"
"41613","646",2023-11-08 11:00:00,-31798,1913,33711,907,FALSE,NA,"0.1.4"
"41614","646",2023-11-08 11:15:00,-31756,1913,33669,907,FALSE,NA,"0.1.4"
"41615","646",2023-11-08 11:30:00,-31696,1913,33609,907,FALSE,NA,"0.1.4"
"41616","646",2023-11-08 11:45:00,-31860,1913,33773,907,FALSE,NA,"0.1.4"
"41617","646",2023-11-08 12:00:00,-31636,1913,33549,907,FALSE,NA,"0.1.4"
"41618","646",2023-11-08 12:15:00,-31633,1913,33546,907,FALSE,NA,"0.1.4"
"41619","646",2023-11-08 12:30:00,-31613,1913,33526,907,FALSE,NA,"0.1.4"
"41620","646",2023-11-08 12:45:00,-31646,1913,33559,907,FALSE,NA,"0.1.4"
"41621","646",2023-11-08 13:00:00,-31681,1913,33594,907,FALSE,NA,"0.1.4"
"41622","646",2023-11-08 13:15:00,-31652,1913,33565,907,FALSE,NA,"0.1.4"
"41623","646",2023-11-08 13:30:00,-31788,1913,33701,907,FALSE,NA,"0.1.4"
"41624","646",2023-11-08 13:45:00,-31934,1913,33847,907,TRUE,NA,"0.1.4"
"41625","646",2023-11-08 14:00:00,-31957.1666666667,1913,33870.1666666667,907,TRUE,"out1, fill","0.1.4"
"41626","646",2023-11-08 14:15:00,-31980.3333333333,1913,33893.3333333333,907,TRUE,"out1, fill","0.1.4"
"41627","646",2023-11-08 14:30:00,-32003.5,1913,33916.5,907,TRUE,"out1, fill","0.1.4"
"41628","646",2023-11-08 14:45:00,-32026.6666666667,1913,33939.6666666667,907,TRUE,"out1, fill","0.1.4"
"41629","646",2023-11-08 15:00:00,-32049.8333333333,1913,33962.8333333333,907,TRUE,"out1, fill","0.1.4"
"41630","646",2023-11-08 15:15:00,-32073,1913,33986,907,TRUE,NA,"0.1.4"
"41631","646",2023-11-08 15:30:00,-32056,1913,33969,907,TRUE,NA,"0.1.4"
"41632","646",2023-11-08 15:45:00,-32039,1913,33952,907,TRUE,NA,"0.1.4"
"41633","646",2023-11-08 16:00:00,-32013,1913,33926,907,TRUE,NA,"0.1.4"
"41634","646",2023-11-08 16:15:00,-32015,1913,33928,907,TRUE,NA,"0.1.4"
"41635","646",2023-11-08 16:30:00,-32041,1913,33954,907,TRUE,NA,"0.1.4"
"41636","646",2023-11-08 16:45:00,-32026,1913,33939,907,TRUE,NA,"0.1.4"
"41637","646",2023-11-08 17:00:00,-32007,1913,33920,907,TRUE,NA,"0.1.4"
"41638","646",2023-11-08 17:15:00,-32008,1913,33921,907,TRUE,NA,"0.1.4"
"41639","646",2023-11-08 17:30:00,-31930,1913,33843,907,TRUE,NA,"0.1.4"
"41640","646",2023-11-08 17:45:00,-31930,1913,33843,907,TRUE,NA,"0.1.4"
"41641","646",2023-11-08 18:00:00,-31863,1913,33776,907,FALSE,NA,"0.1.4"
"41642","646",2023-11-08 18:15:00,-31699,1913,33612,907,TRUE,NA,"0.1.4"
"41643","646",2023-11-08 18:30:00,-31926,1913,33839,907,TRUE,NA,"0.1.4"
"41644","646",2023-11-08 18:45:00,-32007,1913,33920,907,TRUE,NA,"0.1.4"
"41645","646",2023-11-08 19:00:00,-32000,1913,33913,907,TRUE,NA,"0.1.4"
"41646","646",2023-11-08 19:15:00,-31952,1913,33865,907,FALSE,NA,"0.1.4"
"41647","646",2023-11-08 19:30:00,-31967,1913,33880,907,FALSE,NA,"0.1.4"
"41648","646",2023-11-08 19:45:00,-31940,1913,33853,907,FALSE,NA,"0.1.4"
"41649","646",2023-11-08 20:00:00,-31942,1913,33855,907,FALSE,NA,"0.1.4"
"41650","646",2023-11-08 20:15:00,-31930,1913,33843,907,FALSE,NA,"0.1.4"
"41651","646",2023-11-08 20:30:00,-31971,1913,33884,907,FALSE,NA,"0.1.4"
"41652","646",2023-11-08 20:45:00,-31968,1913,33881,907,FALSE,NA,"0.1.4"
"41653","646",2023-11-08 21:00:00,-31982,1913,33895,907,FALSE,NA,"0.1.4"
"41654","646",2023-11-08 21:15:00,-31971,1913,33884,907,FALSE,NA,"0.1.4"
"41655","646",2023-11-08 21:30:00,-31963,1913,33876,907,FALSE,NA,"0.1.4"
"41656","646",2023-11-08 21:45:00,-31969,1913,33882,907,FALSE,NA,"0.1.4"
"41657","646",2023-11-08 22:00:00,-31967,1913,33880,907,FALSE,NA,"0.1.4"
"41658","646",2023-11-08 22:15:00,-31970,1913,33883,907,FALSE,NA,"0.1.4"
"41659","646",2023-11-08 22:30:00,-31995,1913,33908,907,FALSE,NA,"0.1.4"
"41660","646",2023-11-08 22:45:00,-31994,1913,33907,907,FALSE,NA,"0.1.4"
"41661","646",2023-11-08 23:00:00,-31982,1913,33895,907,FALSE,NA,"0.1.4"
"41662","646",2023-11-08 23:15:00,-31978,1913,33891,907,FALSE,NA,"0.1.4"
"41663","646",2023-11-08 23:30:00,-31980,1913,33893,907,FALSE,NA,"0.1.4"
"41664","646",2023-11-08 23:45:00,-32006,1913,33919,907,FALSE,NA,"0.1.4"
"41665","646",2023-11-09,-32001,1913,33914,907,FALSE,NA,"0.1.4"
"41666","646",2023-11-09 00:15:00,-31992,1913,33905,907,FALSE,NA,"0.1.4"
"41667","646",2023-11-09 00:30:00,-32026,1913,33939,907,FALSE,NA,"0.1.4"
"41668","646",2023-11-09 00:45:00,-32024,1913,33937,907,FALSE,NA,"0.1.4"
"41669","646",2023-11-09 01:00:00,-31999,1913,33912,907,FALSE,NA,"0.1.4"
"41670","646",2023-11-09 01:15:00,-32077,1913,33990,907,FALSE,NA,"0.1.4"
"41671","646",2023-11-09 01:30:00,-32053,1913,33966,907,FALSE,NA,"0.1.4"
"41672","646",2023-11-09 01:45:00,-32034,1913,33947,907,FALSE,NA,"0.1.4"
"41673","646",2023-11-09 02:00:00,-31950,1913,33863,907,FALSE,NA,"0.1.4"
"41674","646",2023-11-09 02:15:00,-31825,1913,33738,907,TRUE,"out1, fill","0.1.4"
"41675","646",2023-11-09 02:30:00,-31700,1913,33613,907,TRUE,"out1, fill","0.1.4"
"41676","646",2023-11-09 02:45:00,-31575,1913,33488,907,TRUE,NA,"0.1.4"
"41677","646",2023-11-09 03:00:00,-31425,1913,33338,907,TRUE,NA,"0.1.4"
"41678","646",2023-11-09 03:15:00,-31300,1913,33213,907,TRUE,NA,"0.1.4"
"41679","646",2023-11-09 03:30:00,-31624,1913,33537,907,TRUE,NA,"0.1.4"
"41680","646",2023-11-09 03:45:00,-31462.6666666667,1913,33375.6666666667,907,TRUE,"out1, fill","0.1.4"
"41681","646",2023-11-09 04:00:00,-31301.3333333333,1913,33214.3333333333,907,TRUE,"out1, fill","0.1.4"
"41682","646",2023-11-09 04:15:00,-31140,1913,33053,907,TRUE,NA,"0.1.4"
"41683","646",2023-11-09 04:30:00,-31285,1913,33198,907,TRUE,NA,"0.1.4"
"41684","646",2023-11-09 04:45:00,-31174,1913,33087,907,TRUE,NA,"0.1.4"
"41685","646",2023-11-09 05:00:00,-31498,1913,33411,907,TRUE,NA,"0.1.4"
"41686","646",2023-11-09 05:15:00,-31302,1913,33215,907,TRUE,NA,"0.1.4"
"41687","646",2023-11-09 05:30:00,-30904,1913,32817,907,TRUE,NA,"0.1.4"
"41688","646",2023-11-09 05:45:00,-31244,1913,33157,907,TRUE,NA,"0.1.4"
"41689","646",2023-11-09 06:00:00,-30908,1913,32821,907,TRUE,NA,"0.1.4"
"41690","646",2023-11-09 06:15:00,-31201,1913,33114,907,TRUE,"out1, fill","0.1.4"
"41691","646",2023-11-09 06:30:00,-31494,1913,33407,907,TRUE,NA,"0.1.4"
"41692","646",2023-11-09 06:45:00,-31259,1913,33172,907,TRUE,NA,"0.1.4"
"41693","646",2023-11-09 07:00:00,-31455,1913,33368,907,TRUE,NA,"0.1.4"
"41694","646",2023-11-09 07:15:00,-31454,1913,33367,907,TRUE,NA,"0.1.4"
"41695","646",2023-11-09 07:30:00,-31452,1913,33365,907,TRUE,NA,"0.1.4"
"41696","646",2023-11-09 07:45:00,-31081,1913,32994,907,TRUE,NA,"0.1.4"
"41697","646",2023-11-09 08:00:00,-31253,1913,33166,907,TRUE,NA,"0.1.4"
"41698","646",2023-11-09 08:15:00,-31287,1913,33200,907,TRUE,NA,"0.1.4"
"41699","646",2023-11-09 08:30:00,-31481,1913,33394,907,TRUE,NA,"0.1.4"
"41700","646",2023-11-09 08:45:00,-31518,1913,33431,907,TRUE,NA,"0.1.4"
"41701","646",2023-11-09 09:00:00,-31159,1913,33072,907,TRUE,NA,"0.1.4"
"41702","646",2023-11-09 09:15:00,-31315,1913,33228,907,TRUE,NA,"0.1.4"
"41703","646",2023-11-09 09:30:00,-31328,1913,33241,907,TRUE,NA,"0.1.4"
"41704","646",2023-11-09 09:45:00,-31453,1913,33366,907,TRUE,NA,"0.1.4"
"41705","646",2023-11-09 10:00:00,-31613,1913,33526,907,TRUE,NA,"0.1.4"
"41706","646",2023-11-09 10:15:00,-31446,1913,33359,907,TRUE,NA,"0.1.4"
"41707","646",2023-11-09 10:30:00,-31462.6666666667,1913,33375.6666666667,907,TRUE,"out1, fill","0.1.4"
"41708","646",2023-11-09 10:45:00,-31479.3333333333,1913,33392.3333333333,907,TRUE,"out1, fill","0.1.4"
"41709","646",2023-11-09 11:00:00,-31496,1913,33409,907,TRUE,NA,"0.1.4"
"41710","646",2023-11-09 11:15:00,-31341,1913,33254,907,TRUE,NA,"0.1.4"
"41711","646",2023-11-09 11:30:00,-31572,1913,33485,907,TRUE,NA,"0.1.4"
"41712","646",2023-11-09 11:45:00,-31426,1913,33339,907,TRUE,NA,"0.1.4"
"41713","646",2023-11-09 12:00:00,-31423.3333333333,1913,33336.3333333333,907,TRUE,"out1, fill","0.1.4"
"41714","646",2023-11-09 12:15:00,-31420.6666666667,1913,33333.6666666667,907,TRUE,"out1, fill","0.1.4"
"41715","646",2023-11-09 12:30:00,-31418,1913,33331,907,TRUE,NA,"0.1.4"
"41716","646",2023-11-09 12:45:00,-31484,1913,33397,907,TRUE,NA,"0.1.4"
"41717","646",2023-11-09 13:00:00,-31410,1913,33323,907,TRUE,NA,"0.1.4"
"41718","646",2023-11-09 13:15:00,-31448,1913,33361,907,TRUE,NA,"0.1.4"
"41719","646",2023-11-09 13:30:00,-31438,1913,33351,907,TRUE,NA,"0.1.4"
"41720","646",2023-11-09 13:45:00,-31468,1913,33381,907,TRUE,NA,"0.1.4"
"41721","646",2023-11-09 14:00:00,-31434,1913,33347,907,TRUE,NA,"0.1.4"
"41722","646",2023-11-09 14:15:00,-31357,1913,33270,907,TRUE,NA,"0.1.4"
"41723","646",2023-11-09 14:30:00,-31397,1913,33310,907,TRUE,NA,"0.1.4"
"41724","646",2023-11-09 14:45:00,-31447,1913,33360,907,TRUE,NA,"0.1.4"
"41725","646",2023-11-09 15:00:00,-31402,1913,33315,907,TRUE,NA,"0.1.4"
"41726","646",2023-11-09 15:15:00,-31749,1913,33662,907,TRUE,NA,"0.1.4"
"41727","646",2023-11-09 15:30:00,-31661,1913,33574,907,TRUE,NA,"0.1.4"
"41728","646",2023-11-09 15:45:00,-31532,1913,33445,907,TRUE,NA,"0.1.4"
"41729","646",2023-11-09 16:00:00,-31524,1913,33437,907,TRUE,NA,"0.1.4"
"41730","646",2023-11-09 16:15:00,-31578,1913,33491,907,TRUE,NA,"0.1.4"
"41731","646",2023-11-09 16:30:00,-31688,1913,33601,907,TRUE,NA,"0.1.4"
"41732","646",2023-11-09 16:45:00,-31667,1913,33580,907,TRUE,NA,"0.1.4"
"41733","646",2023-11-09 17:00:00,-31644,1913,33557,907,TRUE,NA,"0.1.4"
"41734","646",2023-11-09 17:15:00,-31656,1913,33569,907,TRUE,NA,"0.1.4"
"41735","646",2023-11-09 17:30:00,-31695,1913,33608,907,TRUE,NA,"0.1.4"
"41736","646",2023-11-09 17:45:00,-31604,1913,33517,907,TRUE,NA,"0.1.4"
"41737","646",2023-11-09 18:00:00,-31624,1913,33537,907,TRUE,NA,"0.1.4"
"41738","646",2023-11-09 18:15:00,-31560,1913,33473,907,TRUE,NA,"0.1.4"
"41739","646",2023-11-09 18:30:00,-31544,1913,33457,907,TRUE,NA,"0.1.4"
"41740","646",2023-11-09 18:45:00,-31447,1913,33360,907,TRUE,NA,"0.1.4"
"41741","646",2023-11-09 19:00:00,-31259,1913,33172,907,TRUE,NA,"0.1.4"
"41742","646",2023-11-09 19:15:00,-31358,1913,33271,907,TRUE,NA,"0.1.4"
"41743","646",2023-11-09 19:30:00,-31357,1913,33270,907,TRUE,NA,"0.1.4"
"41744","646",2023-11-09 19:45:00,-31406,1913,33319,907,TRUE,NA,"0.1.4"
"41745","646",2023-11-09 20:00:00,-31602,1913,33515,907,TRUE,NA,"0.1.4"
"41746","646",2023-11-09 20:15:00,-31424,1913,33337,907,TRUE,NA,"0.1.4"
"41747","646",2023-11-09 20:30:00,-31295,1913,33208,907,FALSE,NA,"0.1.4"
"41748","646",2023-11-09 20:45:00,-31268,1913,33181,907,FALSE,NA,"0.1.4"
"41749","646",2023-11-09 21:00:00,-31215,1913,33128,907,FALSE,NA,"0.1.4"
"41750","646",2023-11-09 21:15:00,-31131,1913,33044,907,FALSE,NA,"0.1.4"
"41751","646",2023-11-09 21:30:00,-31121,1913,33034,907,FALSE,NA,"0.1.4"
"41752","646",2023-11-09 21:45:00,-31112,1913,33025,907,FALSE,NA,"0.1.4"
"41753","646",2023-11-09 22:00:00,-31124,1913,33037,907,FALSE,NA,"0.1.4"
"41754","646",2023-11-09 22:15:00,-31084,1913,32997,907,FALSE,NA,"0.1.4"
"41755","646",2023-11-09 22:30:00,-31217,1913,33130,907,FALSE,NA,"0.1.4"
"41756","646",2023-11-09 22:45:00,-31172,1913,33085,907,FALSE,NA,"0.1.4"
"41757","646",2023-11-09 23:00:00,-31322,1913,33235,907,FALSE,NA,"0.1.4"
"41758","646",2023-11-09 23:15:00,-31333,1913,33246,907,FALSE,NA,"0.1.4"
"41759","646",2023-11-09 23:30:00,-31281,1913,33194,907,FALSE,NA,"0.1.4"
"41760","646",2023-11-09 23:45:00,-31298,1913,33211,907,FALSE,NA,"0.1.4"
"41761","646",2023-11-10,-31249,1913,33162,907,FALSE,NA,"0.1.4"
"41762","646",2023-11-10 00:15:00,-31257,1913,33170,907,FALSE,NA,"0.1.4"
"41763","646",2023-11-10 00:30:00,-31220,1913,33133,907,FALSE,NA,"0.1.4"
"41764","646",2023-11-10 00:45:00,-31305,1913,33218,907,FALSE,NA,"0.1.4"
"41765","646",2023-11-10 01:00:00,-31235,1913,33148,907,FALSE,NA,"0.1.4"
"41766","646",2023-11-10 01:15:00,-31263,1913,33176,907,FALSE,NA,"0.1.4"
"41767","646",2023-11-10 01:30:00,-30984,1913,32897,907,FALSE,NA,"0.1.4"
"41768","646",2023-11-10 01:45:00,-31022,1913,32935,907,FALSE,NA,"0.1.4"
"41769","646",2023-11-10 02:00:00,-30944,1913,32857,907,FALSE,NA,"0.1.4"
"41770","646",2023-11-10 02:15:00,-30947,1913,32860,907,FALSE,NA,"0.1.4"
"41771","646",2023-11-10 02:30:00,-31100,1913,33013,907,FALSE,NA,"0.1.4"
"41772","646",2023-11-10 02:45:00,-31262,1913,33175,907,FALSE,NA,"0.1.4"
"41773","646",2023-11-10 03:00:00,-31294,1913,33207,907,FALSE,NA,"0.1.4"
"41774","646",2023-11-10 03:15:00,-31202,1913,33115,907,FALSE,NA,"0.1.4"
"41775","646",2023-11-10 03:30:00,-31232,1913,33145,907,FALSE,NA,"0.1.4"
"41776","646",2023-11-10 03:45:00,-31203,1913,33116,907,FALSE,NA,"0.1.4"
"41777","646",2023-11-10 04:00:00,-31127,1913,33040,907,FALSE,NA,"0.1.4"
"41778","646",2023-11-10 04:15:00,-31253,1913,33166,907,FALSE,NA,"0.1.4"
"41779","646",2023-11-10 04:30:00,-31170,1913,33083,907,FALSE,NA,"0.1.4"
"41780","646",2023-11-10 04:45:00,-31135,1913,33048,907,FALSE,NA,"0.1.4"
"41781","646",2023-11-10 05:00:00,-31176,1913,33089,907,FALSE,NA,"0.1.4"
"41782","646",2023-11-10 05:15:00,-31114,1913,33027,907,FALSE,NA,"0.1.4"
"41783","646",2023-11-10 05:30:00,-31093,1913,33006,907,FALSE,NA,"0.1.4"
"41784","646",2023-11-10 05:45:00,-31075,1913,32988,907,FALSE,NA,"0.1.4"
"41785","646",2023-11-10 06:00:00,-31116,1913,33029,907,FALSE,NA,"0.1.4"
"41786","646",2023-11-10 06:15:00,-31075,1913,32988,907,FALSE,NA,"0.1.4"
"41787","646",2023-11-10 06:30:00,-30992,1913,32905,907,FALSE,NA,"0.1.4"
"41788","646",2023-11-10 06:45:00,-31187,1913,33100,907,FALSE,NA,"0.1.4"
"41789","646",2023-11-10 07:00:00,-31001,1913,32914,907,FALSE,NA,"0.1.4"
"41790","646",2023-11-10 07:15:00,-31084,1913,32997,907,FALSE,NA,"0.1.4"
"41791","646",2023-11-10 07:30:00,-31008,1913,32921,907,FALSE,NA,"0.1.4"
"41792","646",2023-11-10 07:45:00,-30884,1913,32797,907,FALSE,NA,"0.1.4"
"41793","646",2023-11-10 08:00:00,-31062,1913,32975,907,FALSE,NA,"0.1.4"
"41794","646",2023-11-10 08:15:00,-31112,1913,33025,907,FALSE,NA,"0.1.4"
"41795","646",2023-11-10 08:30:00,-31097,1913,33010,907,FALSE,NA,"0.1.4"
"41796","646",2023-11-10 08:45:00,-31252,1913,33165,907,FALSE,NA,"0.1.4"
"41797","646",2023-11-10 09:00:00,-31136,1913,33049,907,FALSE,NA,"0.1.4"
"41798","646",2023-11-10 09:15:00,-31107,1913,33020,907,FALSE,NA,"0.1.4"
"41799","646",2023-11-10 09:30:00,-31142,1913,33055,907,FALSE,NA,"0.1.4"
"41800","646",2023-11-10 09:45:00,-31238,1913,33151,907,FALSE,NA,"0.1.4"
"41801","646",2023-11-10 10:00:00,-31167,1913,33080,907,FALSE,NA,"0.1.4"
"41802","646",2023-11-10 10:15:00,-31223,1913,33136,907,FALSE,NA,"0.1.4"
"41803","646",2023-11-10 10:30:00,-31097,1913,33010,907,FALSE,NA,"0.1.4"
"41804","646",2023-11-10 10:45:00,-31231,1913,33144,907,FALSE,NA,"0.1.4"
"41805","646",2023-11-10 11:00:00,-31181,1913,33094,907,FALSE,NA,"0.1.4"
"41806","646",2023-11-10 11:15:00,-31152,1913,33065,907,FALSE,NA,"0.1.4"
"41807","646",2023-11-10 11:30:00,-31143,1913,33056,907,FALSE,NA,"0.1.4"
"41808","646",2023-11-10 11:45:00,-30996,1913,32909,907,FALSE,NA,"0.1.4"
"41809","646",2023-11-10 12:00:00,-31119,1913,33032,907,FALSE,NA,"0.1.4"
"41810","646",2023-11-10 12:15:00,-31086,1913,32999,907,FALSE,NA,"0.1.4"
"41811","646",2023-11-10 12:30:00,-31103,1913,33016,907,FALSE,NA,"0.1.4"
"41812","646",2023-11-10 12:45:00,-31051,1913,32964,907,FALSE,NA,"0.1.4"
"41813","646",2023-11-10 13:00:00,-30951,1913,32864,907,FALSE,NA,"0.1.4"
"41814","646",2023-11-10 13:15:00,-30937,1913,32850,907,FALSE,NA,"0.1.4"
"41815","646",2023-11-10 13:30:00,-30924,1913,32837,907,FALSE,NA,"0.1.4"
"41816","646",2023-11-10 13:45:00,-30883,1913,32796,907,FALSE,NA,"0.1.4"
"41817","646",2023-11-10 14:00:00,-30947,1913,32860,907,FALSE,NA,"0.1.4"
"41818","646",2023-11-10 14:15:00,-30880,1913,32793,907,FALSE,NA,"0.1.4"
"41819","646",2023-11-10 14:30:00,-30887,1913,32800,907,FALSE,NA,"0.1.4"
"41820","646",2023-11-10 14:45:00,-30848,1913,32761,907,FALSE,NA,"0.1.4"
"41821","646",2023-11-10 15:00:00,-30874,1913,32787,907,FALSE,NA,"0.1.4"
"41822","646",2023-11-10 15:15:00,-30819,1913,32732,907,FALSE,NA,"0.1.4"
"41823","646",2023-11-10 15:30:00,-30981,1913,32894,907,FALSE,NA,"0.1.4"
"41824","646",2023-11-10 15:45:00,-30949,1913,32862,907,FALSE,NA,"0.1.4"
"41825","646",2023-11-10 16:00:00,-30946,1913,32859,907,FALSE,NA,"0.1.4"
"41826","646",2023-11-10 16:15:00,-30971,1913,32884,907,FALSE,NA,"0.1.4"
"41827","646",2023-11-10 16:30:00,-30931,1913,32844,907,FALSE,NA,"0.1.4"
"41828","646",2023-11-10 16:45:00,-30646,1913,32559,907,FALSE,NA,"0.1.4"
"41829","646",2023-11-10 17:00:00,-30746,1913,32659,907,FALSE,NA,"0.1.4"
"41830","646",2023-11-10 17:15:00,-30913,1913,32826,907,FALSE,NA,"0.1.4"
"41831","646",2023-11-10 17:30:00,-30927,1913,32840,907,FALSE,NA,"0.1.4"
"41832","646",2023-11-10 17:45:00,-30935,1913,32848,907,FALSE,NA,"0.1.4"
"41833","646",2023-11-10 18:00:00,-30823,1913,32736,907,FALSE,NA,"0.1.4"
"41834","646",2023-11-10 18:15:00,-30816,1913,32729,907,FALSE,NA,"0.1.4"
"41835","646",2023-11-10 18:30:00,-30849,1913,32762,907,FALSE,NA,"0.1.4"
"41836","646",2023-11-10 18:45:00,-30839,1913,32752,907,FALSE,NA,"0.1.4"
"41837","646",2023-11-10 19:00:00,-30815,1913,32728,907,FALSE,NA,"0.1.4"
"41838","646",2023-11-10 19:15:00,-30872,1913,32785,907,FALSE,NA,"0.1.4"
"41839","646",2023-11-10 19:30:00,-30734,1913,32647,907,FALSE,NA,"0.1.4"
"41840","646",2023-11-10 19:45:00,-31027,1913,32940,907,FALSE,NA,"0.1.4"
"41841","646",2023-11-10 20:00:00,-31065,1913,32978,907,FALSE,NA,"0.1.4"
"41842","646",2023-11-10 20:15:00,-31068,1913,32981,907,FALSE,NA,"0.1.4"
"41843","646",2023-11-10 20:30:00,-31108,1913,33021,907,FALSE,NA,"0.1.4"
"41844","646",2023-11-10 20:45:00,-31091,1913,33004,907,FALSE,NA,"0.1.4"
"41845","646",2023-11-10 21:00:00,-31132,1913,33045,907,FALSE,NA,"0.1.4"
"41846","646",2023-11-10 21:15:00,-31156,1913,33069,907,FALSE,NA,"0.1.4"
"41847","646",2023-11-10 21:30:00,-30972,1913,32885,907,FALSE,NA,"0.1.4"
"41848","646",2023-11-10 21:45:00,-31081,1913,32994,907,FALSE,NA,"0.1.4"
"41849","646",2023-11-10 22:00:00,-30984,1913,32897,907,FALSE,NA,"0.1.4"
"41850","646",2023-11-10 22:15:00,-31051,1913,32964,907,FALSE,NA,"0.1.4"
"41851","646",2023-11-10 22:30:00,-30959,1913,32872,907,FALSE,NA,"0.1.4"
"41852","646",2023-11-10 22:45:00,-30993,1913,32906,907,FALSE,NA,"0.1.4"
"41853","646",2023-11-10 23:00:00,-31010,1913,32923,907,FALSE,NA,"0.1.4"
"41854","646",2023-11-10 23:15:00,-31034,1913,32947,907,FALSE,NA,"0.1.4"
"41855","646",2023-11-10 23:30:00,-31031,1913,32944,907,FALSE,NA,"0.1.4"
"41856","646",2023-11-10 23:45:00,-30986,1913,32899,907,FALSE,NA,"0.1.4"
"41857","646",2023-11-11,-31014,1913,32927,907,FALSE,NA,"0.1.4"
"41858","646",2023-11-11 00:15:00,-30989,1913,32902,907,FALSE,NA,"0.1.4"
"41859","646",2023-11-11 00:30:00,-31037,1913,32950,907,FALSE,NA,"0.1.4"
"41860","646",2023-11-11 00:45:00,-31035,1913,32948,907,FALSE,NA,"0.1.4"
"41861","646",2023-11-11 01:00:00,-31026,1913,32939,907,FALSE,NA,"0.1.4"
"41862","646",2023-11-11 01:15:00,-31007,1913,32920,907,FALSE,NA,"0.1.4"
"41863","646",2023-11-11 01:30:00,-30842,1913,32755,907,FALSE,NA,"0.1.4"
"41864","646",2023-11-11 01:45:00,-30926,1913,32839,907,FALSE,NA,"0.1.4"
"41865","646",2023-11-11 02:00:00,-31148,1913,33061,907,FALSE,NA,"0.1.4"
"41866","646",2023-11-11 02:15:00,-31067,1913,32980,907,FALSE,NA,"0.1.4"
"41867","646",2023-11-11 02:30:00,-31162,1913,33075,907,FALSE,NA,"0.1.4"
"41868","646",2023-11-11 02:45:00,-31209,1913,33122,907,FALSE,NA,"0.1.4"
"41869","646",2023-11-11 03:00:00,-31185,1913,33098,907,FALSE,NA,"0.1.4"
"41870","646",2023-11-11 03:15:00,-31258,1913,33171,907,FALSE,NA,"0.1.4"
"41871","646",2023-11-11 03:30:00,-31436,1913,33349,907,FALSE,NA,"0.1.4"
"41872","646",2023-11-11 03:45:00,-31117,1913,33030,907,FALSE,NA,"0.1.4"
"41873","646",2023-11-11 04:00:00,-31112,1913,33025,907,FALSE,NA,"0.1.4"
"41874","646",2023-11-11 04:15:00,-31084,1913,32997,907,FALSE,NA,"0.1.4"
"41875","646",2023-11-11 04:30:00,-31000,1913,32913,907,FALSE,NA,"0.1.4"
"41876","646",2023-11-11 04:45:00,-31167,1913,33080,907,FALSE,NA,"0.1.4"
"41877","646",2023-11-11 05:00:00,-31243,1913,33156,907,FALSE,NA,"0.1.4"
"41878","646",2023-11-11 05:15:00,-31104,1913,33017,907,FALSE,NA,"0.1.4"
"41879","646",2023-11-11 05:30:00,-31017,1913,32930,907,FALSE,NA,"0.1.4"
"41880","646",2023-11-11 05:45:00,-31110,1913,33023,907,FALSE,NA,"0.1.4"
"41881","646",2023-11-11 06:00:00,-31094,1913,33007,907,FALSE,NA,"0.1.4"
"41882","646",2023-11-11 06:15:00,-31560.5,1913,33473.5,907,FALSE,"out1, fill","0.1.4"
"41883","646",2023-11-11 06:30:00,-32027,1913,33940,907,FALSE,NA,"0.1.4"
"41884","646",2023-11-11 06:45:00,-32030,1913,33943,907,FALSE,NA,"0.1.4"
"41885","646",2023-11-11 07:00:00,-32050,1913,33963,907,FALSE,NA,"0.1.4"
"41886","646",2023-11-11 07:15:00,-32068,1913,33981,907,FALSE,NA,"0.1.4"
"41887","646",2023-11-11 07:30:00,-31924,1913,33837,907,FALSE,NA,"0.1.4"
"41888","646",2023-11-11 07:45:00,-31924,1913,33837,907,FALSE,"jump1","0.1.4"
"41889","646",2023-11-11 08:00:00,-31980.7272727273,1913,33893.7272727273,907,FALSE,"out1, fill","0.1.4"
"41890","646",2023-11-11 08:15:00,-32037.4545454545,1913,33950.4545454545,907,FALSE,"out1, fill","0.1.4"
"41891","646",2023-11-11 08:30:00,-32094.1818181818,1913,34007.1818181818,907,FALSE,"out1, fill","0.1.4"
"41892","646",2023-11-11 08:45:00,-32150.9090909091,1913,34063.9090909091,907,FALSE,"out1, fill","0.1.4"
"41893","646",2023-11-11 09:00:00,-32207.6363636364,1913,34120.6363636364,907,FALSE,"out1, fill","0.1.4"
"41894","646",2023-11-11 09:15:00,-32264.3636363636,1913,34177.3636363636,907,FALSE,"out1, fill","0.1.4"
"41895","646",2023-11-11 09:30:00,-32321.0909090909,1913,34234.0909090909,907,FALSE,"out1, fill","0.1.4"
"41896","646",2023-11-11 09:45:00,-32377.8181818182,1913,34290.8181818182,907,FALSE,"out1, fill","0.1.4"
"41897","646",2023-11-11 10:00:00,-32434.5454545455,1913,34347.5454545455,907,FALSE,"out1, fill","0.1.4"
"41898","646",2023-11-11 10:15:00,-32491.2727272727,1913,34404.2727272727,907,FALSE,"out1, fill","0.1.4"
"41899","646",2023-11-11 10:30:00,-32548,1913,34461,907,FALSE,NA,"0.1.4"
"41900","646",2023-11-11 10:45:00,-32421,1913,34334,907,FALSE,NA,"0.1.4"
"41901","646",2023-11-11 11:00:00,-32467,1913,34380,907,FALSE,NA,"0.1.4"
"41902","646",2023-11-11 11:15:00,-32476,1913,34389,907,FALSE,NA,"0.1.4"
"41903","646",2023-11-11 11:30:00,-32438,1913,34351,907,FALSE,NA,"0.1.4"
"41904","646",2023-11-11 11:45:00,-32385,1913,34298,907,FALSE,NA,"0.1.4"
"41905","646",2023-11-11 12:00:00,-32544,1913,34457,907,FALSE,NA,"0.1.4"
"41906","646",2023-11-11 12:15:00,-32417,1913,34330,907,FALSE,NA,"0.1.4"
"41907","646",2023-11-11 12:30:00,-32442,1913,34355,907,FALSE,NA,"0.1.4"
"41908","646",2023-11-11 12:45:00,-32432,1913,34345,907,TRUE,NA,"0.1.4"
"41909","646",2023-11-11 13:00:00,-32081,1913,33994,907,TRUE,NA,"0.1.4"
"41910","646",2023-11-11 13:15:00,-32391,1913,34304,907,TRUE,"out1, fill","0.1.4"
"41911","646",2023-11-11 13:30:00,-32701,1913,34614,907,TRUE,NA,"0.1.4"
"41912","646",2023-11-11 13:45:00,-32697,1913,34610,907,FALSE,NA,"0.1.4"
"41913","646",2023-11-11 14:00:00,-32547,1913,34460,907,FALSE,NA,"0.1.4"
"41914","646",2023-11-11 14:15:00,-32500,1913,34413,907,FALSE,NA,"0.1.4"
"41915","646",2023-11-11 14:30:00,-32620,1913,34533,907,FALSE,NA,"0.1.4"
"41916","646",2023-11-11 14:45:00,-32601,1913,34514,907,FALSE,NA,"0.1.4"
"41917","646",2023-11-11 15:00:00,-32631,1913,34544,907,FALSE,NA,"0.1.4"
"41918","646",2023-11-11 15:15:00,-32631,1913,34544,907,FALSE,NA,"0.1.4"
"41919","646",2023-11-11 15:30:00,-32609,1913,34522,907,FALSE,NA,"0.1.4"
"41920","646",2023-11-11 15:45:00,-32639,1913,34552,907,FALSE,NA,"0.1.4"
"41921","646",2023-11-11 16:00:00,-32493,1913,34406,907,FALSE,NA,"0.1.4"
"41922","646",2023-11-11 16:15:00,-32479,1913,34392,907,FALSE,NA,"0.1.4"
"41923","646",2023-11-11 16:30:00,-32513,1913,34426,907,FALSE,NA,"0.1.4"
"41924","646",2023-11-11 16:45:00,-32473,1913,34386,907,FALSE,NA,"0.1.4"
"41925","646",2023-11-11 17:00:00,-32410,1913,34323,907,FALSE,NA,"0.1.4"
"41926","646",2023-11-11 17:15:00,-32338,1913,34251,907,FALSE,NA,"0.1.4"
"41927","646",2023-11-11 17:30:00,-32498,1913,34411,907,FALSE,NA,"0.1.4"
"41928","646",2023-11-11 17:45:00,-32405,1913,34318,907,FALSE,NA,"0.1.4"
"41929","646",2023-11-11 18:00:00,-32370,1913,34283,907,FALSE,NA,"0.1.4"
"41930","646",2023-11-11 18:15:00,-32401,1913,34314,907,FALSE,NA,"0.1.4"
"41931","646",2023-11-11 18:30:00,-32410,1913,34323,907,FALSE,NA,"0.1.4"
"41932","646",2023-11-11 18:45:00,-32464,1913,34377,907,FALSE,NA,"0.1.4"
"41933","646",2023-11-11 19:00:00,-32510,1913,34423,907,FALSE,NA,"0.1.4"
"41934","646",2023-11-11 19:15:00,-32493,1913,34406,907,FALSE,NA,"0.1.4"
"41935","646",2023-11-11 19:30:00,-32502,1913,34415,907,FALSE,NA,"0.1.4"
"41936","646",2023-11-11 19:45:00,-32478,1913,34391,907,FALSE,NA,"0.1.4"
"41937","646",2023-11-11 20:00:00,-32406,1913,34319,907,FALSE,NA,"0.1.4"
"41938","646",2023-11-11 20:15:00,-32499,1913,34412,907,FALSE,NA,"0.1.4"
"41939","646",2023-11-11 20:30:00,-32483,1913,34396,907,FALSE,NA,"0.1.4"
"41940","646",2023-11-11 20:45:00,-32082,1913,33995,907,FALSE,NA,"0.1.4"
"41941","646",2023-11-11 21:00:00,-32478,1913,34391,907,FALSE,NA,"0.1.4"
"41942","646",2023-11-11 21:15:00,-32424,1913,34337,907,FALSE,NA,"0.1.4"
"41943","646",2023-11-11 21:30:00,-32329,1913,34242,907,FALSE,NA,"0.1.4"
"41944","646",2023-11-11 21:45:00,-32501,1913,34414,907,FALSE,NA,"0.1.4"
"41945","646",2023-11-11 22:00:00,-32482,1913,34395,907,FALSE,NA,"0.1.4"
"41946","646",2023-11-11 22:15:00,-32464,1913,34377,907,FALSE,NA,"0.1.4"
"41947","646",2023-11-11 22:30:00,-32440,1913,34353,907,FALSE,NA,"0.1.4"
"41948","646",2023-11-11 22:45:00,-32430,1913,34343,907,FALSE,NA,"0.1.4"
"41949","646",2023-11-11 23:00:00,-32406,1913,34319,907,FALSE,NA,"0.1.4"
"41950","646",2023-11-11 23:15:00,-32452,1913,34365,907,FALSE,NA,"0.1.4"
"41951","646",2023-11-11 23:30:00,-32470,1913,34383,907,FALSE,NA,"0.1.4"
"41952","646",2023-11-11 23:45:00,-32424,1913,34337,907,FALSE,NA,"0.1.4"
"41953","646",2023-11-12,-32528,1913,34441,907,FALSE,NA,"0.1.4"
"41954","646",2023-11-12 00:15:00,-32499,1913,34412,907,FALSE,NA,"0.1.4"
"41955","646",2023-11-12 00:30:00,-32545,1913,34458,907,FALSE,NA,"0.1.4"
"41956","646",2023-11-12 00:45:00,-32162,1913,34075,907,FALSE,"out1, fill","0.1.4"
"41957","646",2023-11-12 01:00:00,-31779,1913,33692,907,FALSE,NA,"0.1.4"
"41958","646",2023-11-12 01:15:00,-32027,1913,33940,907,FALSE,NA,"0.1.4"
"41959","646",2023-11-12 01:30:00,-31688,1913,33601,907,FALSE,NA,"0.1.4"
"41960","646",2023-11-12 01:45:00,-31880,1913,33793,907,FALSE,NA,"0.1.4"
"41961","646",2023-11-12 02:00:00,-31661,1913,33574,907,FALSE,NA,"0.1.4"
"41962","646",2023-11-12 02:15:00,-31661,1913,33574,907,FALSE,"jump1","0.1.4"
"41963","646",2023-11-12 02:30:00,-31241,1913,33154,907,FALSE,NA,"0.1.4"
"41964","646",2023-11-12 02:45:00,-31194,1913,33107,907,FALSE,NA,"0.1.4"
"41965","646",2023-11-12 03:00:00,-31194,1913,33107,907,FALSE,"out1, fill","0.1.4"
"41966","646",2023-11-12 03:15:00,-31194,1913,33107,907,FALSE,"jump1","0.1.4"
"41967","646",2023-11-12 03:30:00,-31238,1913,33151,907,FALSE,NA,"0.1.4"
"41968","646",2023-11-12 03:45:00,-31200,1913,33113,907,FALSE,NA,"0.1.4"
"41969","646",2023-11-12 04:00:00,-31179,1913,33092,907,FALSE,NA,"0.1.4"
"41970","646",2023-11-12 04:15:00,-31408,1913,33321,907,FALSE,NA,"0.1.4"
"41971","646",2023-11-12 04:30:00,-31674,1913,33587,907,FALSE,NA,"0.1.4"
"41972","646",2023-11-12 04:45:00,-31807,1913,33720,907,FALSE,NA,"0.1.4"
"41973","646",2023-11-12 05:00:00,-32009,1913,33922,907,FALSE,NA,"0.1.4"
"41974","646",2023-11-12 05:15:00,-32101,1913,34014,907,FALSE,NA,"0.1.4"
"41975","646",2023-11-12 05:30:00,-32106,1913,34019,907,FALSE,NA,"0.1.4"
"41976","646",2023-11-12 05:45:00,-32209,1913,34122,907,FALSE,NA,"0.1.4"
"41977","646",2023-11-12 06:00:00,-32149,1913,34062,907,FALSE,NA,"0.1.4"
"41978","646",2023-11-12 06:15:00,-32263,1913,34176,907,FALSE,NA,"0.1.4"
"41979","646",2023-11-12 06:30:00,-32170,1913,34083,907,FALSE,NA,"0.1.4"
"41980","646",2023-11-12 06:45:00,-32096,1913,34009,907,FALSE,NA,"0.1.4"
"41981","646",2023-11-12 07:00:00,-31782,1913,33695,907,FALSE,NA,"0.1.4"
"41982","646",2023-11-12 07:15:00,-31782,1913,33695,907,FALSE,"jump1","0.1.4"
"41983","646",2023-11-12 07:30:00,-31757,1913,33670,907,FALSE,NA,"0.1.4"
"41984","646",2023-11-12 07:45:00,-31759,1913,33672,907,FALSE,NA,"0.1.4"
"41985","646",2023-11-12 08:00:00,-31767,1913,33680,907,FALSE,NA,"0.1.4"
"41986","646",2023-11-12 08:15:00,-31766,1913,33679,907,FALSE,NA,"0.1.4"
"41987","646",2023-11-12 08:30:00,-31766,1913,33679,907,FALSE,"out1, fill","0.1.4"
"41988","646",2023-11-12 08:45:00,-31766,1913,33679,907,FALSE,"jump1","0.1.4"
"41989","646",2023-11-12 09:00:00,-31766,1913,33679,907,FALSE,"jump1","0.1.4"
"41990","646",2023-11-12 09:15:00,-31766,1913,33679,907,FALSE,"jump1","0.1.4"
"41991","646",2023-11-12 09:30:00,-31388,1913,33301,907,FALSE,NA,"0.1.4"
"41992","646",2023-11-12 09:45:00,-31648,1913,33561,907,FALSE,NA,"0.1.4"
"41993","646",2023-11-12 10:00:00,-31397,1913,33310,907,FALSE,NA,"0.1.4"
"41994","646",2023-11-12 10:15:00,-31517,1913,33430,907,FALSE,NA,"0.1.4"
"41995","646",2023-11-12 10:30:00,-31234,1913,33147,907,FALSE,NA,"0.1.4"
"41996","646",2023-11-12 10:45:00,-31336,1913,33249,907,FALSE,NA,"0.1.4"
"41997","646",2023-11-12 11:00:00,-31295,1913,33208,907,FALSE,NA,"0.1.4"
"41998","646",2023-11-12 11:15:00,-31309,1913,33222,907,FALSE,NA,"0.1.4"
"41999","646",2023-11-12 11:30:00,-31179,1913,33092,907,FALSE,NA,"0.1.4"
"42000","646",2023-11-12 11:45:00,-31026,1913,32939,907,FALSE,NA,"0.1.4"
"42001","646",2023-11-12 12:00:00,-31249,1913,33162,907,FALSE,NA,"0.1.4"
"42002","646",2023-11-12 12:15:00,-31310.25,1913,33223.25,907,FALSE,"out1, fill","0.1.4"
"42003","646",2023-11-12 12:30:00,-31371.5,1913,33284.5,907,FALSE,"out1, fill","0.1.4"
"42004","646",2023-11-12 12:45:00,-31432.75,1913,33345.75,907,FALSE,"out1, fill","0.1.4"
"42005","646",2023-11-12 13:00:00,-31494,1913,33407,907,FALSE,NA,"0.1.4"
"42006","646",2023-11-12 13:15:00,-31609,1913,33522,907,FALSE,NA,"0.1.4"
"42007","646",2023-11-12 13:30:00,-31644,1913,33557,907,FALSE,NA,"0.1.4"
"42008","646",2023-11-12 13:45:00,-31887,1913,33800,907,FALSE,NA,"0.1.4"
"42009","646",2023-11-12 14:00:00,-31823,1913,33736,907,FALSE,NA,"0.1.4"
"42010","646",2023-11-12 14:15:00,-32002,1913,33915,907,FALSE,NA,"0.1.4"
"42011","646",2023-11-12 14:30:00,-31987,1913,33900,907,FALSE,NA,"0.1.4"
"42012","646",2023-11-12 14:45:00,-31924,1913,33837,907,FALSE,NA,"0.1.4"
"42013","646",2023-11-12 15:00:00,-32019,1913,33932,907,FALSE,NA,"0.1.4"
"42014","646",2023-11-12 15:15:00,-31918,1913,33831,907,FALSE,NA,"0.1.4"
"42015","646",2023-11-12 15:30:00,-32115,1913,34028,907,FALSE,NA,"0.1.4"
"42016","646",2023-11-12 15:45:00,-32045.6666666667,1913,33958.6666666667,907,FALSE,"out1, fill","0.1.4"
"42017","646",2023-11-12 16:00:00,-31976.3333333333,1913,33889.3333333333,907,FALSE,"out1, fill","0.1.4"
"42018","646",2023-11-12 16:15:00,-31907,1913,33820,907,FALSE,NA,"0.1.4"
"42019","646",2023-11-12 16:30:00,-31905,1913,33818,907,FALSE,NA,"0.1.4"
"42020","646",2023-11-12 16:45:00,-31921,1913,33834,907,FALSE,NA,"0.1.4"
"42021","646",2023-11-12 17:00:00,-31955,1913,33868,907,FALSE,NA,"0.1.4"
"42022","646",2023-11-12 17:15:00,-31902,1913,33815,907,FALSE,NA,"0.1.4"
"42023","646",2023-11-12 17:30:00,-31950,1913,33863,907,FALSE,NA,"0.1.4"
"42024","646",2023-11-12 17:45:00,-31925,1913,33838,907,FALSE,NA,"0.1.4"
"42025","646",2023-11-12 18:00:00,-31801,1913,33714,907,FALSE,NA,"0.1.4"
"42026","646",2023-11-12 18:15:00,-31697,1913,33610,907,FALSE,NA,"0.1.4"
"42027","646",2023-11-12 18:30:00,-31765,1913,33678,907,FALSE,NA,"0.1.4"
"42028","646",2023-11-12 18:45:00,-31703,1913,33616,907,FALSE,NA,"0.1.4"
"42029","646",2023-11-12 19:00:00,-31601,1913,33514,907,FALSE,NA,"0.1.4"
"42030","646",2023-11-12 19:15:00,-31601,1913,33514,907,FALSE,"jump1","0.1.4"
"42031","646",2023-11-12 19:30:00,-32079,1913,33992,907,FALSE,NA,"0.1.4"
"42032","646",2023-11-12 19:45:00,-31616,1913,33529,907,FALSE,NA,"0.1.4"
"42033","646",2023-11-12 20:00:00,-31871,1913,33784,907,FALSE,NA,"0.1.4"
"42034","646",2023-11-12 20:15:00,-31522,1913,33435,907,FALSE,NA,"0.1.4"
"42035","646",2023-11-12 20:30:00,-31522,1913,33435,907,FALSE,"jump1","0.1.4"
"42036","646",2023-11-12 20:45:00,-31389,1913,33302,907,FALSE,NA,"0.1.4"
"42037","646",2023-11-12 21:00:00,-31543,1913,33456,907,FALSE,NA,"0.1.4"
"42038","646",2023-11-12 21:15:00,-31378,1913,33291,907,FALSE,NA,"0.1.4"
"42039","646",2023-11-12 21:30:00,-31420,1913,33333,907,FALSE,NA,"0.1.4"
"42040","646",2023-11-12 21:45:00,-31724,1913,33637,907,FALSE,NA,"0.1.4"
"42041","646",2023-11-12 22:00:00,-31566,1913,33479,907,FALSE,NA,"0.1.4"
"42042","646",2023-11-12 22:15:00,-31486,1913,33399,907,FALSE,NA,"0.1.4"
"42043","646",2023-11-12 22:30:00,-31465,1913,33378,907,FALSE,NA,"0.1.4"
"42044","646",2023-11-12 22:45:00,-31478,1913,33391,907,FALSE,NA,"0.1.4"
"42045","646",2023-11-12 23:00:00,-31440,1913,33353,907,FALSE,NA,"0.1.4"
"42046","646",2023-11-12 23:15:00,-31414,1913,33327,907,FALSE,NA,"0.1.4"
"42047","646",2023-11-12 23:30:00,-31377,1913,33290,907,FALSE,NA,"0.1.4"
"42048","646",2023-11-12 23:45:00,-31389,1913,33302,907,FALSE,NA,"0.1.4"
"42049","646",2023-11-13,-31493,1913,33406,907,FALSE,NA,"0.1.4"
"42050","646",2023-11-13 00:15:00,-31611,1913,33524,907,FALSE,NA,"0.1.4"
"42051","646",2023-11-13 00:30:00,-31611,1913,33524,907,FALSE,"jump1","0.1.4"
"42052","646",2023-11-13 00:45:00,-31708.5,1913,33621.5,907,FALSE,"out1, fill","0.1.4"
"42053","646",2023-11-13 01:00:00,-31806,1913,33719,907,FALSE,NA,"0.1.4"
"42054","646",2023-11-13 01:15:00,-32124,1913,34037,907,FALSE,NA,"0.1.4"
"42055","646",2023-11-13 01:30:00,-32118,1913,34031,907,FALSE,NA,"0.1.4"
"42056","646",2023-11-13 01:45:00,-32118,1913,34031,907,FALSE,"jump1","0.1.4"
"42057","646",2023-11-13 02:00:00,-32588,1913,34501,907,FALSE,"out1, fill","0.1.4"
"42058","646",2023-11-13 02:15:00,-33058,1913,34971,907,FALSE,NA,"0.1.4"
"42059","646",2023-11-13 02:30:00,-32893,1913,34806,907,FALSE,NA,"0.1.4"
"42060","646",2023-11-13 02:45:00,-33160,1913,35073,907,FALSE,NA,"0.1.4"
"42061","646",2023-11-13 03:00:00,-33205,1913,35118,907,FALSE,NA,"0.1.4"
"42062","646",2023-11-13 03:15:00,-33105,1913,35018,907,FALSE,NA,"0.1.4"
"42063","646",2023-11-13 03:30:00,-32917,1913,34830,907,FALSE,NA,"0.1.4"
"42064","646",2023-11-13 03:45:00,-32985,1913,34898,907,FALSE,NA,"0.1.4"
"42065","646",2023-11-13 04:00:00,-33003,1913,34916,907,FALSE,NA,"0.1.4"
"42066","646",2023-11-13 04:15:00,-33003,1913,34916,907,FALSE,"jump1","0.1.4"
"42067","646",2023-11-13 04:30:00,-32932.3333333333,1913,34845.3333333333,907,FALSE,"out1, fill","0.1.4"
"42068","646",2023-11-13 04:45:00,-32861.6666666667,1913,34774.6666666667,907,FALSE,"out1, fill","0.1.4"
"42069","646",2023-11-13 05:00:00,-32791,1913,34704,907,FALSE,"out1, fill","0.1.4"
"42070","646",2023-11-13 05:15:00,-32720.3333333333,1913,34633.3333333333,907,FALSE,"out1, fill","0.1.4"
"42071","646",2023-11-13 05:30:00,-32649.6666666667,1913,34562.6666666667,907,FALSE,"out1, fill","0.1.4"
"42072","646",2023-11-13 05:45:00,-32579,1913,34492,907,FALSE,"out1, fill","0.1.4"
"42073","646",2023-11-13 06:00:00,-32508.3333333333,1913,34421.3333333333,907,FALSE,"out1, fill","0.1.4"
"42074","646",2023-11-13 06:15:00,-32437.6666666667,1913,34350.6666666667,907,FALSE,"out1, fill","0.1.4"
"42075","646",2023-11-13 06:30:00,-32367,1913,34280,907,FALSE,"out1, fill","0.1.4"
"42076","646",2023-11-13 06:45:00,-32296.3333333333,1913,34209.3333333333,907,FALSE,"out1, fill","0.1.4"
"42077","646",2023-11-13 07:00:00,-32225.6666666667,1913,34138.6666666667,907,FALSE,"out1, fill","0.1.4"
"42078","646",2023-11-13 07:15:00,-32155,1913,34068,907,FALSE,NA,"0.1.4"
"42079","646",2023-11-13 07:30:00,-31816,1913,33729,907,FALSE,NA,"0.1.4"
"42080","646",2023-11-13 07:45:00,-31805,1913,33718,907,FALSE,NA,"0.1.4"
"42081","646",2023-11-13 08:00:00,-31759,1913,33672,907,FALSE,NA,"0.1.4"
"42082","646",2023-11-13 08:15:00,-31936,1913,33849,907,FALSE,NA,"0.1.4"
"42083","646",2023-11-13 08:30:00,-31783,1913,33696,907,FALSE,NA,"0.1.4"
"42084","646",2023-11-13 08:45:00,-31722,1913,33635,907,FALSE,NA,"0.1.4"
"42085","646",2023-11-13 09:00:00,-31640,1913,33553,907,FALSE,NA,"0.1.4"
"42086","646",2023-11-13 09:15:00,-31618,1913,33531,907,FALSE,NA,"0.1.4"
"42087","646",2023-11-13 09:30:00,-31806,1913,33719,907,FALSE,NA,"0.1.4"
"42088","646",2023-11-13 09:45:00,-31561,1913,33474,907,FALSE,NA,"0.1.4"
"42089","646",2023-11-13 10:00:00,-31564,1913,33477,907,FALSE,NA,"0.1.4"
"42090","646",2023-11-13 10:15:00,-31564,1913,33477,907,FALSE,NA,"0.1.4"
"42091","646",2023-11-13 10:30:00,-31610,1913,33523,907,FALSE,NA,"0.1.4"
"42092","646",2023-11-13 10:45:00,-31805,1913,33718,907,FALSE,NA,"0.1.4"
"42093","646",2023-11-13 11:00:00,-31922,1913,33835,907,FALSE,NA,"0.1.4"
"42094","646",2023-11-13 11:15:00,-31768,1913,33681,907,FALSE,NA,"0.1.4"
"42095","646",2023-11-13 11:30:00,-31858,1913,33771,907,FALSE,NA,"0.1.4"
"42096","646",2023-11-13 11:45:00,-31780,1913,33693,907,FALSE,NA,"0.1.4"
"42097","646",2023-11-13 12:00:00,-31744,1913,33657,907,FALSE,NA,"0.1.4"
"42098","646",2023-11-13 12:15:00,-31800,1913,33713,907,FALSE,NA,"0.1.4"
"42099","646",2023-11-13 12:30:00,-31749,1913,33662,907,FALSE,NA,"0.1.4"
"42100","646",2023-11-13 12:45:00,-31805,1913,33718,907,FALSE,NA,"0.1.4"
"42101","646",2023-11-13 13:00:00,-31699,1913,33612,907,FALSE,NA,"0.1.4"
"42102","646",2023-11-13 13:15:00,-31727,1913,33640,907,FALSE,NA,"0.1.4"
"42103","646",2023-11-13 13:30:00,-31703,1913,33616,907,FALSE,NA,"0.1.4"
"42104","646",2023-11-13 13:45:00,-31715,1913,33628,907,FALSE,NA,"0.1.4"
"42105","646",2023-11-13 14:00:00,-31744,1913,33657,907,FALSE,NA,"0.1.4"
"42106","646",2023-11-13 14:15:00,-31706,1913,33619,907,FALSE,NA,"0.1.4"
"42107","646",2023-11-13 14:30:00,-31687,1913,33600,907,FALSE,NA,"0.1.4"
"42108","646",2023-11-13 14:45:00,-31740,1913,33653,907,FALSE,NA,"0.1.4"
"42109","646",2023-11-13 15:00:00,-31760,1913,33673,907,FALSE,NA,"0.1.4"
"42110","646",2023-11-13 15:15:00,-31821,1913,33734,907,FALSE,NA,"0.1.4"
"42111","646",2023-11-13 15:30:00,-31869,1913,33782,907,FALSE,NA,"0.1.4"
"42112","646",2023-11-13 15:45:00,-31880,1913,33793,907,FALSE,NA,"0.1.4"
"42113","646",2023-11-13 16:00:00,-31598,1913,33511,907,FALSE,NA,"0.1.4"
"42114","646",2023-11-13 16:15:00,-31573,1913,33486,907,FALSE,NA,"0.1.4"
"42115","646",2023-11-13 16:30:00,-31577,1913,33490,907,FALSE,NA,"0.1.4"
"42116","646",2023-11-13 16:45:00,-31644,1913,33557,907,FALSE,NA,"0.1.4"
"42117","646",2023-11-13 17:00:00,-31570,1913,33483,907,FALSE,NA,"0.1.4"
"42118","646",2023-11-13 17:15:00,-31685,1913,33598,907,FALSE,NA,"0.1.4"
"42119","646",2023-11-13 17:30:00,-31719,1913,33632,907,FALSE,NA,"0.1.4"
"42120","646",2023-11-13 17:45:00,-31644,1913,33557,907,FALSE,NA,"0.1.4"
"42121","646",2023-11-13 18:00:00,-31777,1913,33690,907,FALSE,NA,"0.1.4"
"42122","646",2023-11-13 18:15:00,-31665,1913,33578,907,FALSE,NA,"0.1.4"
"42123","646",2023-11-13 18:30:00,-31612,1913,33525,907,FALSE,NA,"0.1.4"
"42124","646",2023-11-13 18:45:00,-31752,1913,33665,907,FALSE,NA,"0.1.4"
"42125","646",2023-11-13 19:00:00,-31739,1913,33652,907,FALSE,NA,"0.1.4"
"42126","646",2023-11-13 19:15:00,-31768,1913,33681,907,FALSE,NA,"0.1.4"
"42127","646",2023-11-13 19:30:00,-31787,1913,33700,907,FALSE,NA,"0.1.4"
"42128","646",2023-11-13 19:45:00,-31705,1913,33618,907,FALSE,NA,"0.1.4"
"42129","646",2023-11-13 20:00:00,-31760,1913,33673,907,FALSE,NA,"0.1.4"
"42130","646",2023-11-13 20:15:00,-31737,1913,33650,907,FALSE,NA,"0.1.4"
"42131","646",2023-11-13 20:30:00,-31723,1913,33636,907,FALSE,NA,"0.1.4"
"42132","646",2023-11-13 20:45:00,-31739,1913,33652,907,FALSE,NA,"0.1.4"
"42133","646",2023-11-13 21:00:00,-31689,1913,33602,907,FALSE,NA,"0.1.4"
"42134","646",2023-11-13 21:15:00,-31671,1913,33584,907,FALSE,NA,"0.1.4"
"42135","646",2023-11-13 21:30:00,-31700,1913,33613,907,FALSE,NA,"0.1.4"
"42136","646",2023-11-13 21:45:00,-31695,1913,33608,907,FALSE,NA,"0.1.4"
"42137","646",2023-11-13 22:00:00,-31698,1913,33611,907,FALSE,NA,"0.1.4"
"42138","646",2023-11-13 22:15:00,-31708,1913,33621,907,FALSE,NA,"0.1.4"
"42139","646",2023-11-13 22:30:00,-31677,1913,33590,907,FALSE,NA,"0.1.4"
"42140","646",2023-11-13 22:45:00,-31688,1913,33601,907,FALSE,NA,"0.1.4"
"42141","646",2023-11-13 23:00:00,-31703,1913,33616,907,FALSE,NA,"0.1.4"
"42142","646",2023-11-13 23:15:00,-31709,1913,33622,907,FALSE,NA,"0.1.4"
"42143","646",2023-11-13 23:30:00,-31726,1913,33639,907,FALSE,NA,"0.1.4"
"42144","646",2023-11-13 23:45:00,-31746,1913,33659,907,FALSE,NA,"0.1.4"
"42145","646",2023-11-14,-31822,1913,33735,907,FALSE,NA,"0.1.4"
"42146","646",2023-11-14 00:15:00,-31794,1913,33707,907,FALSE,NA,"0.1.4"
"42147","646",2023-11-14 00:30:00,-31845,1913,33758,907,FALSE,NA,"0.1.4"
"42148","646",2023-11-14 00:45:00,-31964,1913,33877,907,FALSE,NA,"0.1.4"
"42149","646",2023-11-14 01:00:00,-31743,1913,33656,907,FALSE,NA,"0.1.4"
"42150","646",2023-11-14 01:15:00,-32019,1913,33932,907,FALSE,NA,"0.1.4"
"42151","646",2023-11-14 01:30:00,-31763,1913,33676,907,FALSE,NA,"0.1.4"
"42152","646",2023-11-14 01:45:00,-31730,1913,33643,907,FALSE,NA,"0.1.4"
"42153","646",2023-11-14 02:00:00,-31768,1913,33681,907,FALSE,NA,"0.1.4"
"42154","646",2023-11-14 02:15:00,-31765,1913,33678,907,FALSE,NA,"0.1.4"
"42155","646",2023-11-14 02:30:00,-31780,1913,33693,907,FALSE,NA,"0.1.4"
"42156","646",2023-11-14 02:45:00,-31646,1913,33559,907,FALSE,NA,"0.1.4"
"42157","646",2023-11-14 03:00:00,-31559,1913,33472,907,FALSE,NA,"0.1.4"
"42158","646",2023-11-14 03:15:00,-31849,1913,33762,907,FALSE,NA,"0.1.4"
"42159","646",2023-11-14 03:30:00,-31829,1913,33742,907,FALSE,NA,"0.1.4"
"42160","646",2023-11-14 03:45:00,-31952,1913,33865,907,FALSE,NA,"0.1.4"
"42161","646",2023-11-14 04:00:00,-31952,1913,33865,907,FALSE,"jump1","0.1.4"
"42162","646",2023-11-14 04:15:00,-31530.5,1913,33443.5,907,FALSE,"out1, fill","0.1.4"
"42163","646",2023-11-14 04:30:00,-31109,1913,33022,907,FALSE,NA,"0.1.4"
"42164","646",2023-11-14 04:45:00,-31010,1913,32923,907,FALSE,NA,"0.1.4"
"42165","646",2023-11-14 05:00:00,-30956,1913,32869,907,FALSE,NA,"0.1.4"
"42166","646",2023-11-14 05:15:00,-30956,1913,32869,907,FALSE,"jump1","0.1.4"
"42167","646",2023-11-14 05:30:00,-30882,1913,32795,907,FALSE,NA,"0.1.4"
"42168","646",2023-11-14 05:45:00,-30595,1913,32508,907,FALSE,NA,"0.1.4"
"42169","646",2023-11-14 06:00:00,-30208,1913,32121,907,FALSE,NA,"0.1.4"
"42170","646",2023-11-14 06:15:00,-30217,1913,32130,907,FALSE,NA,"0.1.4"
"42171","646",2023-11-14 06:30:00,-30197,1913,32110,907,FALSE,NA,"0.1.4"
"42172","646",2023-11-14 06:45:00,-30208,1913,32121,907,FALSE,"out1, fill","0.1.4"
"42173","646",2023-11-14 07:00:00,-30219,1913,32132,907,TRUE,"out1, fill","0.1.4"
"42174","646",2023-11-14 07:15:00,-30230,1913,32143,907,TRUE,"out1, fill","0.1.4"
"42175","646",2023-11-14 07:30:00,-30241,1913,32154,907,TRUE,"out1, fill","0.1.4"
"42176","646",2023-11-14 07:45:00,-30252,1913,32165,907,TRUE,"out1, fill","0.1.4"
"42177","646",2023-11-14 08:00:00,-30263,1913,32176,907,TRUE,"out1, fill","0.1.4"
"42178","646",2023-11-14 08:15:00,-30274,1913,32187,907,TRUE,"out1, fill","0.1.4"
"42179","646",2023-11-14 08:30:00,-30285,1913,32198,907,TRUE,NA,"0.1.4"
"42180","646",2023-11-14 08:45:00,-30344,1913,32257,907,TRUE,NA,"0.1.4"
"42181","646",2023-11-14 09:00:00,-30604,1913,32517,907,TRUE,NA,"0.1.4"
"42182","646",2023-11-14 09:15:00,-30623,1913,32536,907,TRUE,NA,"0.1.4"
"42183","646",2023-11-14 09:30:00,-30419,1913,32332,907,TRUE,NA,"0.1.4"
"42184","646",2023-11-14 09:45:00,-30837.75,1913,32750.75,907,TRUE,"out1, fill","0.1.4"
"42185","646",2023-11-14 10:00:00,-31256.5,1913,33169.5,907,TRUE,"out1, fill","0.1.4"
"42186","646",2023-11-14 10:15:00,-31675.25,1913,33588.25,907,TRUE,"out1, fill","0.1.4"
"42187","646",2023-11-14 10:30:00,-32094,1913,34007,907,TRUE,NA,"0.1.4"
"42188","646",2023-11-14 10:45:00,-32117,1913,34030,907,TRUE,NA,"0.1.4"
"42189","646",2023-11-14 11:00:00,-31865,1913,33778,907,TRUE,NA,"0.1.4"
"42190","646",2023-11-14 11:15:00,-32038,1913,33951,907,TRUE,NA,"0.1.4"
"42191","646",2023-11-14 11:30:00,-32020,1913,33933,907,TRUE,NA,"0.1.4"
"42192","646",2023-11-14 11:45:00,-32152,1913,34065,907,TRUE,NA,"0.1.4"
"42193","646",2023-11-14 12:00:00,-32170.1666666667,1913,34083.1666666667,907,TRUE,"out1, fill","0.1.4"
"42194","646",2023-11-14 12:15:00,-32188.3333333333,1913,34101.3333333333,907,TRUE,"out1, fill","0.1.4"
"42195","646",2023-11-14 12:30:00,-32206.5,1913,34119.5,907,TRUE,"out1, fill","0.1.4"
"42196","646",2023-11-14 12:45:00,-32224.6666666667,1913,34137.6666666667,907,TRUE,"out1, fill","0.1.4"
"42197","646",2023-11-14 13:00:00,-32242.8333333333,1913,34155.8333333333,907,TRUE,"out1, fill","0.1.4"
"42198","646",2023-11-14 13:15:00,-32261,1913,34174,907,TRUE,NA,"0.1.4"
"42199","646",2023-11-14 13:30:00,-32181,1913,34094,907,TRUE,NA,"0.1.4"
"42200","646",2023-11-14 13:45:00,-32198,1913,34111,907,TRUE,NA,"0.1.4"
"42201","646",2023-11-14 14:00:00,-32179,1913,34092,907,TRUE,NA,"0.1.4"
"42202","646",2023-11-14 14:15:00,-32382,1913,34295,907,TRUE,NA,"0.1.4"
"42203","646",2023-11-14 14:30:00,-32322,1913,34235,907,TRUE,NA,"0.1.4"
"42204","646",2023-11-14 14:45:00,-32384,1913,34297,907,TRUE,NA,"0.1.4"
"42205","646",2023-11-14 15:00:00,-32346,1913,34259,907,TRUE,NA,"0.1.4"
"42206","646",2023-11-14 15:15:00,-32032.2,1913,33945.2,907,TRUE,"out1, fill","0.1.4"
"42207","646",2023-11-14 15:30:00,-31718.4,1913,33631.4,907,TRUE,"out1, fill","0.1.4"
"42208","646",2023-11-14 15:45:00,-31404.6,1913,33317.6,907,TRUE,"out1, fill","0.1.4"
"42209","646",2023-11-14 16:00:00,-31090.8,1913,33003.8,907,TRUE,"out1, fill","0.1.4"
"42210","646",2023-11-14 16:15:00,-30777,1913,32690,907,TRUE,NA,"0.1.4"
"42211","646",2023-11-14 16:30:00,-30808,1913,32721,907,TRUE,NA,"0.1.4"
"42212","646",2023-11-14 16:45:00,-31028,1913,32941,907,TRUE,NA,"0.1.4"
"42213","646",2023-11-14 17:00:00,-30767,1913,32680,907,TRUE,"out1, fill","0.1.4"
"42214","646",2023-11-14 17:15:00,-30506,1913,32419,907,TRUE,NA,"0.1.4"
"42215","646",2023-11-14 17:30:00,-30451,1913,32364,907,TRUE,NA,"0.1.4"
"42216","646",2023-11-14 17:45:00,-30339,1913,32252,907,TRUE,NA,"0.1.4"
"42217","646",2023-11-14 18:00:00,-30640,1913,32553,907,TRUE,NA,"0.1.4"
"42218","646",2023-11-14 18:15:00,-30640,1913,32553,907,TRUE,NA,"0.1.4"
"42219","646",2023-11-14 18:30:00,-30686,1913,32599,907,FALSE,NA,"0.1.4"
"42220","646",2023-11-14 18:45:00,-30760,1913,32673,907,FALSE,NA,"0.1.4"
"42221","646",2023-11-14 19:00:00,-30683,1913,32596,907,FALSE,NA,"0.1.4"
"42222","646",2023-11-14 19:15:00,-30362,1913,32275,907,FALSE,NA,"0.1.4"
"42223","646",2023-11-14 19:30:00,-30753,1913,32666,907,FALSE,NA,"0.1.4"
"42224","646",2023-11-14 19:45:00,-30471,1913,32384,907,FALSE,NA,"0.1.4"
"42225","646",2023-11-14 20:00:00,-30600,1913,32513,907,FALSE,NA,"0.1.4"
"42226","646",2023-11-14 20:15:00,-30662,1913,32575,907,FALSE,NA,"0.1.4"
"42227","646",2023-11-14 20:30:00,-30465,1913,32378,907,FALSE,NA,"0.1.4"
"42228","646",2023-11-14 20:45:00,-30536,1913,32449,907,FALSE,NA,"0.1.4"
"42229","646",2023-11-14 21:00:00,-30459,1913,32372,907,FALSE,NA,"0.1.4"
"42230","646",2023-11-14 21:15:00,-30480,1913,32393,907,FALSE,NA,"0.1.4"
"42231","646",2023-11-14 21:30:00,-30510,1913,32423,907,FALSE,NA,"0.1.4"
"42232","646",2023-11-14 21:45:00,-30488,1913,32401,907,FALSE,NA,"0.1.4"
"42233","646",2023-11-14 22:00:00,-30521,1913,32434,907,FALSE,NA,"0.1.4"
"42234","646",2023-11-14 22:15:00,-30496,1913,32409,907,FALSE,NA,"0.1.4"
"42235","646",2023-11-14 22:30:00,-30416,1913,32329,907,FALSE,NA,"0.1.4"
"42236","646",2023-11-14 22:45:00,-30441,1913,32354,907,FALSE,NA,"0.1.4"
"42237","646",2023-11-14 23:00:00,-30406,1913,32319,907,FALSE,NA,"0.1.4"
"42238","646",2023-11-14 23:15:00,-30427,1913,32340,907,FALSE,NA,"0.1.4"
"42239","646",2023-11-14 23:30:00,-30462,1913,32375,907,FALSE,NA,"0.1.4"
"42240","646",2023-11-14 23:45:00,-30430,1913,32343,907,FALSE,NA,"0.1.4"
"42241","646",2023-11-15,-30467,1913,32380,907,FALSE,NA,"0.1.4"
"42242","646",2023-11-15 00:15:00,-30482,1913,32395,907,FALSE,NA,"0.1.4"
"42243","646",2023-11-15 00:30:00,-30476,1913,32389,907,FALSE,NA,"0.1.4"
"42244","646",2023-11-15 00:45:00,-30549,1913,32462,907,FALSE,NA,"0.1.4"
"42245","646",2023-11-15 01:00:00,-30575,1913,32488,907,FALSE,NA,"0.1.4"
"42246","646",2023-11-15 01:15:00,-30542,1913,32455,907,FALSE,NA,"0.1.4"
"42247","646",2023-11-15 01:30:00,-30549,1913,32462,907,FALSE,NA,"0.1.4"
"42248","646",2023-11-15 01:45:00,-30461,1913,32374,907,FALSE,NA,"0.1.4"
"42249","646",2023-11-15 02:00:00,-30409,1913,32322,907,FALSE,NA,"0.1.4"
"42250","646",2023-11-15 02:15:00,-30416,1913,32329,907,FALSE,NA,"0.1.4"
"42251","646",2023-11-15 02:30:00,-30600,1913,32513,907,FALSE,NA,"0.1.4"
"42252","646",2023-11-15 02:45:00,-30484,1913,32397,907,FALSE,NA,"0.1.4"
"42253","646",2023-11-15 03:00:00,-30510,1913,32423,907,FALSE,NA,"0.1.4"
"42254","646",2023-11-15 03:15:00,-30512,1913,32425,907,FALSE,NA,"0.1.4"
"42255","646",2023-11-15 03:30:00,-30370,1913,32283,907,FALSE,NA,"0.1.4"
"42256","646",2023-11-15 03:45:00,-30516,1913,32429,907,FALSE,NA,"0.1.4"
"42257","646",2023-11-15 04:00:00,-30521,1913,32434,907,FALSE,NA,"0.1.4"
"42258","646",2023-11-15 04:15:00,-30562,1913,32475,907,FALSE,NA,"0.1.4"
"42259","646",2023-11-15 04:30:00,-30503,1913,32416,907,FALSE,NA,"0.1.4"
"42260","646",2023-11-15 04:45:00,-30592,1913,32505,907,FALSE,NA,"0.1.4"
"42261","646",2023-11-15 05:00:00,-30503,1913,32416,907,FALSE,NA,"0.1.4"
"42262","646",2023-11-15 05:15:00,-30561,1913,32474,907,FALSE,NA,"0.1.4"
"42263","646",2023-11-15 05:30:00,-30537,1913,32450,907,FALSE,NA,"0.1.4"
"42264","646",2023-11-15 05:45:00,-30683,1913,32596,907,FALSE,NA,"0.1.4"
"42265","646",2023-11-15 06:00:00,-30645,1913,32558,907,FALSE,NA,"0.1.4"
"42266","646",2023-11-15 06:15:00,-30552,1913,32465,907,FALSE,NA,"0.1.4"
"42267","646",2023-11-15 06:30:00,-30485,1913,32398,907,FALSE,NA,"0.1.4"
"42268","646",2023-11-15 06:45:00,-30355,1913,32268,907,FALSE,NA,"0.1.4"
"42269","646",2023-11-15 07:00:00,-30377,1913,32290,907,FALSE,NA,"0.1.4"
"42270","646",2023-11-15 07:15:00,-30479,1913,32392,907,FALSE,NA,"0.1.4"
"42271","646",2023-11-15 07:30:00,-30380,1913,32293,907,FALSE,NA,"0.1.4"
"42272","646",2023-11-15 07:45:00,-30375,1913,32288,907,FALSE,NA,"0.1.4"
"42273","646",2023-11-15 08:00:00,-30373,1913,32286,907,FALSE,NA,"0.1.4"
"42274","646",2023-11-15 08:15:00,-30259,1913,32172,907,FALSE,NA,"0.1.4"
"42275","646",2023-11-15 08:30:00,-30258,1913,32171,907,FALSE,NA,"0.1.4"
"42276","646",2023-11-15 08:45:00,-30520,1913,32433,907,FALSE,NA,"0.1.4"
"42277","646",2023-11-15 09:00:00,-30509,1913,32422,907,FALSE,"out1, fill","0.1.4"
"42278","646",2023-11-15 09:15:00,-30498,1913,32411,907,FALSE,"out1, fill","0.1.4"
"42279","646",2023-11-15 09:30:00,-30487,1913,32400,907,FALSE,"out1, fill","0.1.4"
"42280","646",2023-11-15 09:45:00,-30476,1913,32389,907,FALSE,"out1, fill","0.1.4"
"42281","646",2023-11-15 10:00:00,-30465,1913,32378,907,FALSE,NA,"0.1.4"
"42282","646",2023-11-15 10:15:00,-30441,1913,32354,907,FALSE,NA,"0.1.4"
"42283","646",2023-11-15 10:30:00,-30299,1913,32212,907,FALSE,NA,"0.1.4"
"42284","646",2023-11-15 10:45:00,-30362,1913,32275,907,FALSE,NA,"0.1.4"
"42285","646",2023-11-15 11:00:00,-30385,1913,32298,907,FALSE,NA,"0.1.4"
"42286","646",2023-11-15 11:15:00,-30349,1913,32262,907,FALSE,NA,"0.1.4"
"42287","646",2023-11-15 11:30:00,-30381,1913,32294,907,FALSE,NA,"0.1.4"
"42288","646",2023-11-15 11:45:00,-30277,1913,32190,907,FALSE,NA,"0.1.4"
"42289","646",2023-11-15 12:00:00,-30298,1913,32211,907,FALSE,NA,"0.1.4"
"42290","646",2023-11-15 12:15:00,-30219,1913,32132,907,FALSE,NA,"0.1.4"
"42291","646",2023-11-15 12:30:00,-30289,1913,32202,907,FALSE,NA,"0.1.4"
"42292","646",2023-11-15 12:45:00,-30264,1913,32177,907,FALSE,NA,"0.1.4"
"42293","646",2023-11-15 13:00:00,-30503,1913,32416,907,FALSE,NA,"0.1.4"
"42294","646",2023-11-15 13:15:00,-30512,1913,32425,907,FALSE,NA,"0.1.4"
"42295","646",2023-11-15 13:30:00,-30590,1913,32503,907,FALSE,NA,"0.1.4"
"42296","646",2023-11-15 13:45:00,-30590,1913,32503,907,FALSE,"jump1","0.1.4"
"42297","646",2023-11-15 14:00:00,-30566,1913,32479,907,FALSE,NA,"0.1.4"
"42298","646",2023-11-15 14:15:00,-30603.75,1913,32516.75,907,FALSE,"out1, fill","0.1.4"
"42299","646",2023-11-15 14:30:00,-30641.5,1913,32554.5,907,FALSE,"out1, fill","0.1.4"
"42300","646",2023-11-15 14:45:00,-30679.25,1913,32592.25,907,FALSE,"out1, fill","0.1.4"
"42301","646",2023-11-15 15:00:00,-30717,1913,32630,907,FALSE,NA,"0.1.4"
"42302","646",2023-11-15 15:15:00,-30718,1913,32631,907,FALSE,NA,"0.1.4"
"42303","646",2023-11-15 15:30:00,-30725,1913,32638,907,FALSE,NA,"0.1.4"
"42304","646",2023-11-15 15:45:00,-30712,1913,32625,907,FALSE,NA,"0.1.4"
"42305","646",2023-11-15 16:00:00,-30637,1913,32550,907,FALSE,NA,"0.1.4"
"42306","646",2023-11-15 16:15:00,-30656,1913,32569,907,FALSE,NA,"0.1.4"
"42307","646",2023-11-15 16:30:00,-30567,1913,32480,907,FALSE,NA,"0.1.4"
"42308","646",2023-11-15 16:45:00,-30635,1913,32548,907,FALSE,NA,"0.1.4"
"42309","646",2023-11-15 17:00:00,-30605,1913,32518,907,FALSE,NA,"0.1.4"
"42310","646",2023-11-15 17:15:00,-30577,1913,32490,907,FALSE,NA,"0.1.4"
"42311","646",2023-11-15 17:30:00,-30498,1913,32411,907,FALSE,NA,"0.1.4"
"42312","646",2023-11-15 17:45:00,-30198,1913,32111,907,FALSE,NA,"0.1.4"
"42313","646",2023-11-15 18:00:00,-30093,1913,32006,907,FALSE,NA,"0.1.4"
"42314","646",2023-11-15 18:15:00,-30015,1913,31928,907,FALSE,NA,"0.1.4"
"42315","646",2023-11-15 18:30:00,-29686,1913,31599,907,FALSE,NA,"0.1.4"
"42316","646",2023-11-15 18:45:00,-29704,1913,31617,907,FALSE,NA,"0.1.4"
"42317","646",2023-11-15 19:00:00,-29910,1913,31823,907,FALSE,NA,"0.1.4"
"42318","646",2023-11-15 19:15:00,-29829,1913,31742,907,FALSE,NA,"0.1.4"
"42319","646",2023-11-15 19:30:00,-29634,1913,31547,907,FALSE,NA,"0.1.4"
"42320","646",2023-11-15 19:45:00,-29634,1913,31547,907,FALSE,NA,"0.1.4"
"42321","646",2023-11-15 20:00:00,-29634,1913,31547,907,FALSE,NA,"0.1.4"
"42322","646",2023-11-15 20:15:00,-29629,1913,31542,907,FALSE,NA,"0.1.4"
"42323","646",2023-11-15 20:30:00,-29631,1913,31544,907,FALSE,NA,"0.1.4"
"42324","646",2023-11-15 20:45:00,-29635,1913,31548,907,FALSE,NA,"0.1.4"
"42325","646",2023-11-15 21:00:00,-29643,1913,31556,907,FALSE,NA,"0.1.4"
"42326","646",2023-11-15 21:15:00,-29638,1913,31551,907,FALSE,NA,"0.1.4"
"42327","646",2023-11-15 21:30:00,-29640,1913,31553,907,FALSE,NA,"0.1.4"
"42328","646",2023-11-15 21:45:00,-29636,1913,31549,907,FALSE,NA,"0.1.4"
"42329","646",2023-11-15 22:00:00,-29636,1913,31549,907,FALSE,NA,"0.1.4"
"42330","646",2023-11-15 22:15:00,-29635,1913,31548,907,FALSE,NA,"0.1.4"
"42331","646",2023-11-15 22:30:00,-29638,1913,31551,907,FALSE,NA,"0.1.4"
"42332","646",2023-11-15 22:45:00,-29636,1913,31549,907,FALSE,NA,"0.1.4"
"42333","646",2023-11-15 23:00:00,-29639,1913,31552,907,FALSE,NA,"0.1.4"
"42334","646",2023-11-15 23:15:00,-29640,1913,31553,907,FALSE,NA,"0.1.4"
"42335","646",2023-11-15 23:30:00,-29641,1913,31554,907,FALSE,NA,"0.1.4"
"42336","646",2023-11-15 23:45:00,-29636,1913,31549,907,FALSE,NA,"0.1.4"
"42337","646",2023-11-16,-29635,1913,31548,907,FALSE,NA,"0.1.4"
"42338","646",2023-11-16 00:15:00,-29633,1913,31546,907,FALSE,NA,"0.1.4"
"42339","646",2023-11-16 00:30:00,-29635,1913,31548,907,FALSE,NA,"0.1.4"
"42340","646",2023-11-16 00:45:00,-29633,1913,31546,907,FALSE,NA,"0.1.4"
"42341","646",2023-11-16 01:00:00,-29634,1913,31547,907,FALSE,NA,"0.1.4"
"42342","646",2023-11-16 01:15:00,-29851,1913,31764,907,FALSE,NA,"0.1.4"
"42343","646",2023-11-16 01:30:00,-29763,1913,31676,907,FALSE,NA,"0.1.4"
"42344","646",2023-11-16 01:45:00,-29720,1913,31633,907,FALSE,NA,"0.1.4"
"42345","646",2023-11-16 02:00:00,-29845,1913,31758,907,FALSE,NA,"0.1.4"
"42346","646",2023-11-16 02:15:00,-29815,1913,31728,907,FALSE,NA,"0.1.4"
"42347","646",2023-11-16 02:30:00,-29844,1913,31757,907,FALSE,NA,"0.1.4"
"42348","646",2023-11-16 02:45:00,-30029,1913,31942,907,FALSE,NA,"0.1.4"
"42349","646",2023-11-16 03:00:00,-30114,1913,32027,907,FALSE,NA,"0.1.4"
"42350","646",2023-11-16 03:15:00,-29629,1913,31542,907,FALSE,NA,"0.1.4"
"42351","646",2023-11-16 03:30:00,-30104,1913,32017,907,FALSE,NA,"0.1.4"
"42352","646",2023-11-16 03:45:00,-29690,1913,31603,907,FALSE,NA,"0.1.4"
"42353","646",2023-11-16 04:00:00,-29638,1913,31551,907,FALSE,NA,"0.1.4"
"42354","646",2023-11-16 04:15:00,-30132,1913,32045,907,FALSE,"out1, fill","0.1.4"
"42355","646",2023-11-16 04:30:00,-30626,1913,32539,907,FALSE,NA,"0.1.4"
"42356","646",2023-11-16 04:45:00,-30533,1913,32446,907,FALSE,NA,"0.1.4"
"42357","646",2023-11-16 05:00:00,-30331,1913,32244,907,FALSE,NA,"0.1.4"
"42358","646",2023-11-16 05:15:00,-30331,1913,32244,907,FALSE,"jump1","0.1.4"
"42359","646",2023-11-16 05:30:00,-30817,1913,32730,907,FALSE,"out1, fill","0.1.4"
"42360","646",2023-11-16 05:45:00,-31303,1913,33216,907,FALSE,NA,"0.1.4"
"42361","646",2023-11-16 06:00:00,-31244,1913,33157,907,FALSE,NA,"0.1.4"
"42362","646",2023-11-16 06:15:00,-31060,1913,32973,907,FALSE,NA,"0.1.4"
"42363","646",2023-11-16 06:30:00,-31338,1913,33251,907,FALSE,NA,"0.1.4"
"42364","646",2023-11-16 06:45:00,-31338,1913,33251,907,FALSE,"jump1","0.1.4"
"42365","646",2023-11-16 07:00:00,-30880,1913,32793,907,FALSE,NA,"0.1.4"
"42366","646",2023-11-16 07:15:00,-30886,1913,32799,907,FALSE,NA,"0.1.4"
"42367","646",2023-11-16 07:30:00,-30881,1913,32794,907,FALSE,NA,"0.1.4"
"42368","646",2023-11-16 07:45:00,-30881,1913,32794,907,FALSE,"jump1","0.1.4"
"42369","646",2023-11-16 08:00:00,-31190,1913,33103,907,FALSE,NA,"0.1.4"
"42370","646",2023-11-16 08:15:00,-31205,1913,33118,907,FALSE,NA,"0.1.4"
"42371","646",2023-11-16 08:30:00,-31208,1913,33121,907,FALSE,NA,"0.1.4"
"42372","646",2023-11-16 08:45:00,-31054.6666666667,1913,32967.6666666667,907,FALSE,"out1, fill","0.1.4"
"42373","646",2023-11-16 09:00:00,-30901.3333333333,1913,32814.3333333333,907,TRUE,"out1, fill","0.1.4"
"42374","646",2023-11-16 09:15:00,-30748,1913,32661,907,TRUE,"out1, fill","0.1.4"
"42375","646",2023-11-16 09:30:00,-30594.6666666667,1913,32507.6666666667,907,TRUE,"out1, fill","0.1.4"
"42376","646",2023-11-16 09:45:00,-30441.3333333333,1913,32354.3333333333,907,TRUE,"out1, fill","0.1.4"
"42377","646",2023-11-16 10:00:00,-30288,1913,32201,907,TRUE,NA,"0.1.4"
"42378","646",2023-11-16 10:15:00,-30379,1913,32292,907,TRUE,NA,"0.1.4"
"42379","646",2023-11-16 10:30:00,-30281,1913,32194,907,TRUE,NA,"0.1.4"
"42380","646",2023-11-16 10:45:00,-30490.8,1913,32403.8,907,TRUE,"out1, fill","0.1.4"
"42381","646",2023-11-16 11:00:00,-30700.6,1913,32613.6,907,TRUE,"out1, fill","0.1.4"
"42382","646",2023-11-16 11:15:00,-30910.4,1913,32823.4,907,TRUE,"out1, fill","0.1.4"
"42383","646",2023-11-16 11:30:00,-31120.2,1913,33033.2,907,TRUE,"out1, fill","0.1.4"
"42384","646",2023-11-16 11:45:00,-31330,1913,33243,907,TRUE,NA,"0.1.4"
"42385","646",2023-11-16 12:00:00,-31451,1913,33364,907,TRUE,NA,"0.1.4"
"42386","646",2023-11-16 12:15:00,-31345,1913,33258,907,TRUE,NA,"0.1.4"
"42387","646",2023-11-16 12:30:00,-31553,1913,33466,907,TRUE,NA,"0.1.4"
"42388","646",2023-11-16 12:45:00,-31335,1913,33248,907,TRUE,NA,"0.1.4"
"42389","646",2023-11-16 13:00:00,-31065,1913,32978,907,TRUE,NA,"0.1.4"
"42390","646",2023-11-16 13:15:00,-31119.3333333333,1913,33032.3333333333,907,TRUE,"out1, fill","0.1.4"
"42391","646",2023-11-16 13:30:00,-31173.6666666667,1913,33086.6666666667,907,TRUE,"out1, fill","0.1.4"
"42392","646",2023-11-16 13:45:00,-31228,1913,33141,907,TRUE,"out1, fill","0.1.4"
"42393","646",2023-11-16 14:00:00,-31282.3333333333,1913,33195.3333333333,907,TRUE,"out1, fill","0.1.4"
"42394","646",2023-11-16 14:15:00,-31336.6666666667,1913,33249.6666666667,907,TRUE,"out1, fill","0.1.4"
"42395","646",2023-11-16 14:30:00,-31391,1913,33304,907,TRUE,NA,"0.1.4"
"42396","646",2023-11-16 14:45:00,-31171,1913,33084,907,TRUE,NA,"0.1.4"
"42397","646",2023-11-16 15:00:00,-31176,1913,33089,907,TRUE,NA,"0.1.4"
"42398","646",2023-11-16 15:15:00,-31085,1913,32998,907,TRUE,NA,"0.1.4"
"42399","646",2023-11-16 15:30:00,-30968,1913,32881,907,TRUE,NA,"0.1.4"
"42400","646",2023-11-16 15:45:00,-31065,1913,32978,907,TRUE,NA,"0.1.4"
"42401","646",2023-11-16 16:00:00,-30865,1913,32778,907,TRUE,"out1, fill","0.1.4"
"42402","646",2023-11-16 16:15:00,-30665,1913,32578,907,TRUE,NA,"0.1.4"
"42403","646",2023-11-16 16:30:00,-30656,1913,32569,907,TRUE,NA,"0.1.4"
"42404","646",2023-11-16 16:45:00,-30775,1913,32688,907,TRUE,NA,"0.1.4"
"42405","646",2023-11-16 17:00:00,-30742,1913,32655,907,TRUE,NA,"0.1.4"
"42406","646",2023-11-16 17:15:00,-30648,1913,32561,907,TRUE,NA,"0.1.4"
"42407","646",2023-11-16 17:30:00,-30644,1913,32557,907,TRUE,NA,"0.1.4"
"42408","646",2023-11-16 17:45:00,-30624,1913,32537,907,TRUE,NA,"0.1.4"
"42409","646",2023-11-16 18:00:00,-30826,1913,32739,907,TRUE,NA,"0.1.4"
"42410","646",2023-11-16 18:15:00,-30817,1913,32730,907,TRUE,NA,"0.1.4"
"42411","646",2023-11-16 18:30:00,-30970,1913,32883,907,TRUE,NA,"0.1.4"
"42412","646",2023-11-16 18:45:00,-30963,1913,32876,907,TRUE,NA,"0.1.4"
"42413","646",2023-11-16 19:00:00,-31095,1913,33008,907,TRUE,NA,"0.1.4"
"42414","646",2023-11-16 19:15:00,-31082,1913,32995,907,TRUE,NA,"0.1.4"
"42415","646",2023-11-16 19:30:00,-31138,1913,33051,907,TRUE,NA,"0.1.4"
"42416","646",2023-11-16 19:45:00,-31138,1913,33051,907,FALSE,"jump1","0.1.4"
"42417","646",2023-11-16 20:00:00,-31031,1913,32944,907,FALSE,NA,"0.1.4"
"42418","646",2023-11-16 20:15:00,-31031,1913,32944,907,FALSE,"jump1","0.1.4"
"42419","646",2023-11-16 20:30:00,-30918,1913,32831,907,FALSE,NA,"0.1.4"
"42420","646",2023-11-16 20:45:00,-30754,1913,32667,907,FALSE,NA,"0.1.4"
"42421","646",2023-11-16 21:00:00,-30749,1913,32662,907,FALSE,NA,"0.1.4"
"42422","646",2023-11-16 21:15:00,-30613,1913,32526,907,FALSE,NA,"0.1.4"
"42423","646",2023-11-16 21:30:00,-30686,1913,32599,907,FALSE,NA,"0.1.4"
"42424","646",2023-11-16 21:45:00,-30739,1913,32652,907,FALSE,NA,"0.1.4"
"42425","646",2023-11-16 22:00:00,-30820,1913,32733,907,FALSE,NA,"0.1.4"
"42426","646",2023-11-16 22:15:00,-31239,1913,33152,907,FALSE,NA,"0.1.4"
"42427","646",2023-11-16 22:30:00,-30908,1913,32821,907,FALSE,NA,"0.1.4"
"42428","646",2023-11-16 22:45:00,-31064,1913,32977,907,FALSE,NA,"0.1.4"
"42429","646",2023-11-16 23:00:00,-30876,1913,32789,907,FALSE,NA,"0.1.4"
"42430","646",2023-11-16 23:15:00,-31003,1913,32916,907,FALSE,NA,"0.1.4"
"42431","646",2023-11-16 23:30:00,-31078,1913,32991,907,FALSE,NA,"0.1.4"
"42432","646",2023-11-16 23:45:00,-31014,1913,32927,907,FALSE,NA,"0.1.4"
"42433","646",2023-11-17,-31059,1913,32972,907,FALSE,NA,"0.1.4"
"42434","646",2023-11-17 00:15:00,-30844,1913,32757,907,FALSE,NA,"0.1.4"
"42435","646",2023-11-17 00:30:00,-30898,1913,32811,907,FALSE,NA,"0.1.4"
"42436","646",2023-11-17 00:45:00,-30681,1913,32594,907,FALSE,NA,"0.1.4"
"42437","646",2023-11-17 01:00:00,-30857,1913,32770,907,FALSE,NA,"0.1.4"
"42438","646",2023-11-17 01:15:00,-30751,1913,32664,907,FALSE,NA,"0.1.4"
"42439","646",2023-11-17 01:30:00,-31011,1913,32924,907,FALSE,NA,"0.1.4"
"42440","646",2023-11-17 01:45:00,-31400,1913,33313,907,FALSE,NA,"0.1.4"
"42441","646",2023-11-17 02:00:00,-31431,1913,33344,907,FALSE,NA,"0.1.4"
"42442","646",2023-11-17 02:15:00,-31508,1913,33421,907,FALSE,NA,"0.1.4"
"42443","646",2023-11-17 02:30:00,-31347,1913,33260,907,FALSE,NA,"0.1.4"
"42444","646",2023-11-17 02:45:00,-31318.6666666667,1913,33231.6666666667,907,FALSE,"out1, fill","0.1.4"
"42445","646",2023-11-17 03:00:00,-31290.3333333333,1913,33203.3333333333,907,FALSE,"out1, fill","0.1.4"
"42446","646",2023-11-17 03:15:00,-31262,1913,33175,907,FALSE,"out1, fill","0.1.4"
"42447","646",2023-11-17 03:30:00,-31233.6666666667,1913,33146.6666666667,907,FALSE,"out1, fill","0.1.4"
"42448","646",2023-11-17 03:45:00,-31205.3333333333,1913,33118.3333333333,907,FALSE,"out1, fill","0.1.4"
"42449","646",2023-11-17 04:00:00,-31177,1913,33090,907,FALSE,NA,"0.1.4"
"42450","646",2023-11-17 04:15:00,-31366,1913,33279,907,FALSE,NA,"0.1.4"
"42451","646",2023-11-17 04:30:00,-31359,1913,33272,907,FALSE,NA,"0.1.4"
"42452","646",2023-11-17 04:45:00,-31136,1913,33049,907,FALSE,NA,"0.1.4"
"42453","646",2023-11-17 05:00:00,-31319,1913,33232,907,FALSE,NA,"0.1.4"
"42454","646",2023-11-17 05:15:00,-31539,1913,33452,907,TRUE,NA,"0.1.4"
"42455","646",2023-11-17 05:30:00,-31493,1913,33406,907,TRUE,NA,"0.1.4"
"42456","646",2023-11-17 05:45:00,-31443,1913,33356,907,TRUE,NA,"0.1.4"
"42457","646",2023-11-17 06:00:00,-31275,1913,33188,907,TRUE,NA,"0.1.4"
"42458","646",2023-11-17 06:15:00,-31524,1913,33437,907,TRUE,NA,"0.1.4"
"42459","646",2023-11-17 06:30:00,-31707,1913,33620,907,TRUE,NA,"0.1.4"
"42460","646",2023-11-17 06:45:00,-31591,1913,33504,907,TRUE,NA,"0.1.4"
"42461","646",2023-11-17 07:00:00,-31333,1913,33246,907,TRUE,NA,"0.1.4"
"42462","646",2023-11-17 07:15:00,-31087,1913,33000,907,TRUE,NA,"0.1.4"
"42463","646",2023-11-17 07:30:00,-31400,1913,33313,907,TRUE,NA,"0.1.4"
"42464","646",2023-11-17 07:45:00,-31513,1913,33426,907,TRUE,NA,"0.1.4"
"42465","646",2023-11-17 08:00:00,-31224,1913,33137,907,TRUE,NA,"0.1.4"
"42466","646",2023-11-17 08:15:00,-31499,1913,33412,907,TRUE,NA,"0.1.4"
"42467","646",2023-11-17 08:30:00,-31501,1913,33414,907,TRUE,NA,"0.1.4"
"42468","646",2023-11-17 08:45:00,-31417,1913,33330,907,TRUE,NA,"0.1.4"
"42469","646",2023-11-17 09:00:00,-31373,1913,33286,907,TRUE,NA,"0.1.4"
"42470","646",2023-11-17 09:15:00,-31510,1913,33423,907,TRUE,NA,"0.1.4"
"42471","646",2023-11-17 09:30:00,-31728,1913,33641,907,TRUE,NA,"0.1.4"
"42472","646",2023-11-17 09:45:00,-31779,1913,33692,907,TRUE,NA,"0.1.4"
"42473","646",2023-11-17 10:00:00,-31696,1913,33609,907,TRUE,NA,"0.1.4"
"42474","646",2023-11-17 10:15:00,-31720,1913,33633,907,TRUE,NA,"0.1.4"
"42475","646",2023-11-17 10:30:00,-31741,1913,33654,907,TRUE,NA,"0.1.4"
"42476","646",2023-11-17 10:45:00,-31641,1913,33554,907,TRUE,NA,"0.1.4"
"42477","646",2023-11-17 11:00:00,-31612,1913,33525,907,TRUE,NA,"0.1.4"
"42478","646",2023-11-17 11:15:00,-31568,1913,33481,907,TRUE,NA,"0.1.4"
"42479","646",2023-11-17 11:30:00,-31769,1913,33682,907,TRUE,NA,"0.1.4"
"42480","646",2023-11-17 11:45:00,-31383,1913,33296,907,TRUE,NA,"0.1.4"
"42481","646",2023-11-17 12:00:00,-31711,1913,33624,907,TRUE,NA,"0.1.4"
"42482","646",2023-11-17 12:15:00,-31776,1913,33689,907,TRUE,NA,"0.1.4"
"42483","646",2023-11-17 12:30:00,-31744,1913,33657,907,TRUE,NA,"0.1.4"
"42484","646",2023-11-17 12:45:00,-31587,1913,33500,907,TRUE,NA,"0.1.4"
"42485","646",2023-11-17 13:00:00,-31797,1913,33710,907,TRUE,NA,"0.1.4"
"42486","646",2023-11-17 13:15:00,-31918,1913,33831,907,TRUE,NA,"0.1.4"
"42487","646",2023-11-17 13:30:00,-31890,1913,33803,907,TRUE,NA,"0.1.4"
"42488","646",2023-11-17 13:45:00,-31912,1913,33825,907,TRUE,NA,"0.1.4"
"42489","646",2023-11-17 14:00:00,-32070,1913,33983,907,TRUE,NA,"0.1.4"
"42490","646",2023-11-17 14:15:00,-32308,1913,34221,907,TRUE,NA,"0.1.4"
"42491","646",2023-11-17 14:30:00,-32453,1913,34366,907,TRUE,NA,"0.1.4"
"42492","646",2023-11-17 14:45:00,-32475,1913,34388,907,TRUE,NA,"0.1.4"
"42493","646",2023-11-17 15:00:00,-32359,1913,34272,907,TRUE,NA,"0.1.4"
"42494","646",2023-11-17 15:15:00,-32051.5,1913,33964.5,907,TRUE,"out1, fill","0.1.4"
"42495","646",2023-11-17 15:30:00,-31744,1913,33657,907,TRUE,NA,"0.1.4"
"42496","646",2023-11-17 15:45:00,-31619,1913,33532,907,TRUE,NA,"0.1.4"
"42497","646",2023-11-17 16:00:00,-31563,1913,33476,907,TRUE,NA,"0.1.4"
"42498","646",2023-11-17 16:15:00,-31700,1913,33613,907,TRUE,NA,"0.1.4"
"42499","646",2023-11-17 16:30:00,-31695,1913,33608,907,TRUE,NA,"0.1.4"
"42500","646",2023-11-17 16:45:00,-31754,1913,33667,907,TRUE,NA,"0.1.4"
"42501","646",2023-11-17 17:00:00,-31744,1913,33657,907,TRUE,NA,"0.1.4"
"42502","646",2023-11-17 17:15:00,-31764,1913,33677,907,TRUE,NA,"0.1.4"
"42503","646",2023-11-17 17:30:00,-31705,1913,33618,907,TRUE,NA,"0.1.4"
"42504","646",2023-11-17 17:45:00,-31479,1913,33392,907,TRUE,NA,"0.1.4"
"42505","646",2023-11-17 18:00:00,-31505,1913,33418,907,TRUE,NA,"0.1.4"
"42506","646",2023-11-17 18:15:00,-31463,1913,33376,907,TRUE,NA,"0.1.4"
"42507","646",2023-11-17 18:30:00,-31385,1913,33298,907,TRUE,NA,"0.1.4"
"42508","646",2023-11-17 18:45:00,-31164,1913,33077,907,TRUE,"out1, fill","0.1.4"
"42509","646",2023-11-17 19:00:00,-30943,1913,32856,907,TRUE,"out1, fill","0.1.4"
"42510","646",2023-11-17 19:15:00,-30722,1913,32635,907,TRUE,"out1, fill","0.1.4"
"42511","646",2023-11-17 19:30:00,-30501,1913,32414,907,TRUE,NA,"0.1.4"
"42512","646",2023-11-17 19:45:00,-30501,1913,32414,907,FALSE,NA,"0.1.4"
"42513","646",2023-11-17 20:00:00,-30496,1913,32409,907,FALSE,NA,"0.1.4"
"42514","646",2023-11-17 20:15:00,-30498,1913,32411,907,FALSE,NA,"0.1.4"
"42515","646",2023-11-17 20:30:00,-30498,1913,32411,907,FALSE,"jump1","0.1.4"
"42516","646",2023-11-17 20:45:00,-30592,1913,32505,907,FALSE,NA,"0.1.4"
"42517","646",2023-11-17 21:00:00,-30797,1913,32710,907,FALSE,NA,"0.1.4"
"42518","646",2023-11-17 21:15:00,-30482,1913,32395,907,FALSE,NA,"0.1.4"
"42519","646",2023-11-17 21:30:00,-29987,1913,31900,907,FALSE,NA,"0.1.4"
"42520","646",2023-11-17 21:45:00,-29955,1913,31868,907,FALSE,NA,"0.1.4"
"42521","646",2023-11-17 22:00:00,-30170,1913,32083,907,FALSE,NA,"0.1.4"
"42522","646",2023-11-17 22:15:00,-30046,1913,31959,907,FALSE,NA,"0.1.4"
"42523","646",2023-11-17 22:30:00,-30067,1913,31980,907,FALSE,NA,"0.1.4"
"42524","646",2023-11-17 22:45:00,-30435,1913,32348,907,FALSE,NA,"0.1.4"
"42525","646",2023-11-17 23:00:00,-30154,1913,32067,907,FALSE,NA,"0.1.4"
"42526","646",2023-11-17 23:15:00,-30114,1913,32027,907,FALSE,NA,"0.1.4"
"42527","646",2023-11-17 23:30:00,-30086,1913,31999,907,FALSE,NA,"0.1.4"
"42528","646",2023-11-17 23:45:00,-30110,1913,32023,907,FALSE,NA,"0.1.4"
"42529","646",2023-11-18,-30230,1913,32143,907,FALSE,NA,"0.1.4"
"42530","646",2023-11-18 00:15:00,-30323,1913,32236,907,FALSE,NA,"0.1.4"
"42531","646",2023-11-18 00:30:00,-30310,1913,32223,907,FALSE,NA,"0.1.4"
"42532","646",2023-11-18 00:45:00,-30186,1913,32099,907,FALSE,NA,"0.1.4"
"42533","646",2023-11-18 01:00:00,-30010,1913,31923,907,FALSE,NA,"0.1.4"
"42534","646",2023-11-18 01:15:00,-29964,1913,31877,907,FALSE,NA,"0.1.4"
"42535","646",2023-11-18 01:30:00,-30429,1913,32342,907,FALSE,NA,"0.1.4"
"42536","646",2023-11-18 01:45:00,-30837,1913,32750,907,FALSE,NA,"0.1.4"
"42537","646",2023-11-18 02:00:00,-30644,1913,32557,907,FALSE,NA,"0.1.4"
"42538","646",2023-11-18 02:15:00,-30759,1913,32672,907,FALSE,NA,"0.1.4"
"42539","646",2023-11-18 02:30:00,-30759,1913,32672,907,FALSE,"jump1","0.1.4"
"42540","646",2023-11-18 02:45:00,-30561,1913,32474,907,FALSE,NA,"0.1.4"
"42541","646",2023-11-18 03:00:00,-30860,1913,32773,907,FALSE,NA,"0.1.4"
"42542","646",2023-11-18 03:15:00,-30548,1913,32461,907,FALSE,NA,"0.1.4"
"42543","646",2023-11-18 03:30:00,-30548,1913,32461,907,FALSE,"jump1","0.1.4"
"42544","646",2023-11-18 03:45:00,-31038,1913,32951,907,FALSE,NA,"0.1.4"
"42545","646",2023-11-18 04:00:00,-31071,1913,32984,907,FALSE,NA,"0.1.4"
"42546","646",2023-11-18 04:15:00,-31136,1913,33049,907,FALSE,NA,"0.1.4"
"42547","646",2023-11-18 04:30:00,-31390,1913,33303,907,FALSE,NA,"0.1.4"
"42548","646",2023-11-18 04:45:00,-31173,1913,33086,907,FALSE,"out1, fill","0.1.4"
"42549","646",2023-11-18 05:00:00,-30956,1913,32869,907,FALSE,NA,"0.1.4"
"42550","646",2023-11-18 05:15:00,-31062,1913,32975,907,FALSE,NA,"0.1.4"
"42551","646",2023-11-18 05:30:00,-30808,1913,32721,907,TRUE,NA,"0.1.4"
"42552","646",2023-11-18 05:45:00,-30927,1913,32840,907,TRUE,NA,"0.1.4"
"42553","646",2023-11-18 06:00:00,-30982.6,1913,32895.6,907,TRUE,"out1, fill","0.1.4"
"42554","646",2023-11-18 06:15:00,-31038.2,1913,32951.2,907,TRUE,"out1, fill","0.1.4"
"42555","646",2023-11-18 06:30:00,-31093.8,1913,33006.8,907,TRUE,"out1, fill","0.1.4"
"42556","646",2023-11-18 06:45:00,-31149.4,1913,33062.4,907,TRUE,"out1, fill","0.1.4"
"42557","646",2023-11-18 07:00:00,-31205,1913,33118,907,TRUE,NA,"0.1.4"
"42558","646",2023-11-18 07:15:00,-31071,1913,32984,907,TRUE,NA,"0.1.4"
"42559","646",2023-11-18 07:30:00,-31275,1913,33188,907,TRUE,NA,"0.1.4"
"42560","646",2023-11-18 07:45:00,-30890,1913,32803,907,TRUE,NA,"0.1.4"
"42561","646",2023-11-18 08:00:00,-30977.3333333333,1913,32890.3333333333,907,TRUE,"out1, fill","0.1.4"
"42562","646",2023-11-18 08:15:00,-31064.6666666667,1913,32977.6666666667,907,TRUE,"out1, fill","0.1.4"
"42563","646",2023-11-18 08:30:00,-31152,1913,33065,907,TRUE,NA,"0.1.4"
"42564","646",2023-11-18 08:45:00,-31116,1913,33029,907,TRUE,NA,"0.1.4"
"42565","646",2023-11-18 09:00:00,-31105,1913,33018,907,TRUE,NA,"0.1.4"
"42566","646",2023-11-18 09:15:00,-31093,1913,33006,907,TRUE,NA,"0.1.4"
"42567","646",2023-11-18 09:30:00,-30997,1913,32910,907,TRUE,NA,"0.1.4"
"42568","646",2023-11-18 09:45:00,-31179,1913,33092,907,TRUE,NA,"0.1.4"
"42569","646",2023-11-18 10:00:00,-31131,1913,33044,907,TRUE,NA,"0.1.4"
"42570","646",2023-11-18 10:15:00,-31056,1913,32969,907,TRUE,NA,"0.1.4"
"42571","646",2023-11-18 10:30:00,-31111,1913,33024,907,TRUE,NA,"0.1.4"
"42572","646",2023-11-18 10:45:00,-31148,1913,33061,907,TRUE,NA,"0.1.4"
"42573","646",2023-11-18 11:00:00,-31138,1913,33051,907,TRUE,NA,"0.1.4"
"42574","646",2023-11-18 11:15:00,-31051,1913,32964,907,TRUE,NA,"0.1.4"
"42575","646",2023-11-18 11:30:00,-31038,1913,32951,907,TRUE,NA,"0.1.4"
"42576","646",2023-11-18 11:45:00,-31007,1913,32920,907,TRUE,NA,"0.1.4"
"42577","646",2023-11-18 12:00:00,-31050,1913,32963,907,TRUE,NA,"0.1.4"
"42578","646",2023-11-18 12:15:00,-30972,1913,32885,907,TRUE,NA,"0.1.4"
"42579","646",2023-11-18 12:30:00,-30996,1913,32909,907,TRUE,NA,"0.1.4"
"42580","646",2023-11-18 12:45:00,-31038,1913,32951,907,TRUE,NA,"0.1.4"
"42581","646",2023-11-18 13:00:00,-31100,1913,33013,907,TRUE,NA,"0.1.4"
"42582","646",2023-11-18 13:15:00,-30852,1913,32765,907,TRUE,NA,"0.1.4"
"42583","646",2023-11-18 13:30:00,-31219,1913,33132,907,TRUE,NA,"0.1.4"
"42584","646",2023-11-18 13:45:00,-31160,1913,33073,907,TRUE,NA,"0.1.4"
"42585","646",2023-11-18 14:00:00,-31495,1913,33408,907,TRUE,NA,"0.1.4"
"42586","646",2023-11-18 14:15:00,-31367,1913,33280,907,TRUE,NA,"0.1.4"
"42587","646",2023-11-18 14:30:00,-31672,1913,33585,907,TRUE,"out1, fill","0.1.4"
"42588","646",2023-11-18 14:45:00,-31977,1913,33890,907,TRUE,NA,"0.1.4"
"42589","646",2023-11-18 15:00:00,-31965,1913,33878,907,TRUE,NA,"0.1.4"
"42590","646",2023-11-18 15:15:00,-31918,1913,33831,907,TRUE,NA,"0.1.4"
"42591","646",2023-11-18 15:30:00,-32099,1913,34012,907,TRUE,NA,"0.1.4"
"42592","646",2023-11-18 15:45:00,-31917,1913,33830,907,TRUE,NA,"0.1.4"
"42593","646",2023-11-18 16:00:00,-31858,1913,33771,907,TRUE,NA,"0.1.4"
"42594","646",2023-11-18 16:15:00,-31721,1913,33634,907,TRUE,NA,"0.1.4"
"42595","646",2023-11-18 16:30:00,-31574,1913,33487,907,TRUE,NA,"0.1.4"
"42596","646",2023-11-18 16:45:00,-31391,1913,33304,907,TRUE,"out1, fill","0.1.4"
"42597","646",2023-11-18 17:00:00,-31208,1913,33121,907,TRUE,NA,"0.1.4"
"42598","646",2023-11-18 17:15:00,-31195,1913,33108,907,TRUE,NA,"0.1.4"
"42599","646",2023-11-18 17:30:00,-30846,1913,32759,907,TRUE,NA,"0.1.4"
"42600","646",2023-11-18 17:45:00,-30909,1913,32822,907,TRUE,"out1, fill","0.1.4"
"42601","646",2023-11-18 18:00:00,-30972,1913,32885,907,FALSE,NA,"0.1.4"
"42602","646",2023-11-18 18:15:00,-30795,1913,32708,907,FALSE,NA,"0.1.4"
"42603","646",2023-11-18 18:30:00,-30326,1913,32239,907,FALSE,NA,"0.1.4"
"42604","646",2023-11-18 18:45:00,-29986,1913,31899,907,FALSE,NA,"0.1.4"
"42605","646",2023-11-18 19:00:00,-29948,1913,31861,907,FALSE,NA,"0.1.4"
"42606","646",2023-11-18 19:15:00,-30286,1913,32199,907,FALSE,NA,"0.1.4"
"42607","646",2023-11-18 19:30:00,-30275,1913,32188,907,FALSE,NA,"0.1.4"
"42608","646",2023-11-18 19:45:00,-29937,1913,31850,907,FALSE,NA,"0.1.4"
"42609","646",2023-11-18 20:00:00,-29937,1913,31850,907,FALSE,NA,"0.1.4"
"42610","646",2023-11-18 20:15:00,-29926.5,1913,31839.5,907,FALSE,"out1, fill","0.1.4"
"42611","646",2023-11-18 20:30:00,-29916,1913,31829,907,FALSE,"out1, fill","0.1.4"
"42612","646",2023-11-18 20:45:00,-29905.5,1913,31818.5,907,FALSE,"out1, fill","0.1.4"
"42613","646",2023-11-18 21:00:00,-29895,1913,31808,907,FALSE,NA,"0.1.4"
"42614","646",2023-11-18 21:15:00,-29866,1913,31779,907,FALSE,NA,"0.1.4"
"42615","646",2023-11-18 21:30:00,-29955,1913,31868,907,FALSE,NA,"0.1.4"
"42616","646",2023-11-18 21:45:00,-29948,1913,31861,907,FALSE,NA,"0.1.4"
"42617","646",2023-11-18 22:00:00,-29945,1913,31858,907,FALSE,NA,"0.1.4"
"42618","646",2023-11-18 22:15:00,-29946,1913,31859,907,FALSE,NA,"0.1.4"
"42619","646",2023-11-18 22:30:00,-29947,1913,31860,907,FALSE,NA,"0.1.4"
"42620","646",2023-11-18 22:45:00,-29945,1913,31858,907,FALSE,NA,"0.1.4"
"42621","646",2023-11-18 23:00:00,-29947,1913,31860,907,FALSE,NA,"0.1.4"
"42622","646",2023-11-18 23:15:00,-29946,1913,31859,907,FALSE,NA,"0.1.4"
"42623","646",2023-11-18 23:30:00,-29947,1913,31860,907,FALSE,NA,"0.1.4"
"42624","646",2023-11-18 23:45:00,-29944,1913,31857,907,FALSE,NA,"0.1.4"
"42625","646",2023-11-19,-29944,1913,31857,907,FALSE,NA,"0.1.4"
"42626","646",2023-11-19 00:15:00,-29944,1913,31857,907,FALSE,NA,"0.1.4"
"42627","646",2023-11-19 00:30:00,-29947,1913,31860,907,FALSE,NA,"0.1.4"
"42628","646",2023-11-19 00:45:00,-29947,1913,31860,907,FALSE,NA,"0.1.4"
"42629","646",2023-11-19 01:00:00,-29944,1913,31857,907,FALSE,NA,"0.1.4"
"42630","646",2023-11-19 01:15:00,-29943,1913,31856,907,FALSE,NA,"0.1.4"
"42631","646",2023-11-19 01:30:00,-29942,1913,31855,907,FALSE,NA,"0.1.4"
"42632","646",2023-11-19 01:45:00,-29943,1913,31856,907,FALSE,NA,"0.1.4"
"42633","646",2023-11-19 02:00:00,-29942,1913,31855,907,FALSE,NA,"0.1.4"
"42634","646",2023-11-19 02:15:00,-29890,1913,31803,907,FALSE,NA,"0.1.4"
"42635","646",2023-11-19 02:30:00,-29926,1913,31839,907,FALSE,NA,"0.1.4"
"42636","646",2023-11-19 02:45:00,-29919,1913,31832,907,FALSE,NA,"0.1.4"
"42637","646",2023-11-19 03:00:00,-29904,1913,31817,907,FALSE,NA,"0.1.4"
"42638","646",2023-11-19 03:15:00,-29890,1913,31803,907,FALSE,NA,"0.1.4"
"42639","646",2023-11-19 03:30:00,-29886,1913,31799,907,FALSE,NA,"0.1.4"
"42640","646",2023-11-19 03:45:00,-29885,1913,31798,907,FALSE,NA,"0.1.4"
"42641","646",2023-11-19 04:00:00,-29936,1913,31849,907,FALSE,NA,"0.1.4"
"42642","646",2023-11-19 04:15:00,-29903,1913,31816,907,FALSE,NA,"0.1.4"
"42643","646",2023-11-19 04:30:00,-29881,1913,31794,907,FALSE,NA,"0.1.4"
"42644","646",2023-11-19 04:45:00,-29959,1913,31872,907,FALSE,NA,"0.1.4"
"42645","646",2023-11-19 05:00:00,-30008,1913,31921,907,FALSE,NA,"0.1.4"
"42646","646",2023-11-19 05:15:00,-30266,1913,32179,907,FALSE,NA,"0.1.4"
"42647","646",2023-11-19 05:30:00,-29938,1913,31851,907,FALSE,NA,"0.1.4"
"42648","646",2023-11-19 05:45:00,-29938,1913,31851,907,FALSE,NA,"0.1.4"
"42649","646",2023-11-19 06:00:00,-29938,1913,31851,907,FALSE,NA,"0.1.4"
"42650","646",2023-11-19 06:15:00,-29939,1913,31852,907,FALSE,NA,"0.1.4"
"42651","646",2023-11-19 06:30:00,-29971,1913,31884,907,FALSE,NA,"0.1.4"
"42652","646",2023-11-19 06:45:00,-30006,1913,31919,907,FALSE,NA,"0.1.4"
"42653","646",2023-11-19 07:00:00,-29973,1913,31886,907,FALSE,NA,"0.1.4"
"42654","646",2023-11-19 07:15:00,-30142,1913,32055,907,FALSE,"out1, fill","0.1.4"
"42655","646",2023-11-19 07:30:00,-30311,1913,32224,907,FALSE,NA,"0.1.4"
"42656","646",2023-11-19 07:45:00,-30510,1913,32423,907,FALSE,NA,"0.1.4"
"42657","646",2023-11-19 08:00:00,-30510,1913,32423,907,FALSE,"jump1","0.1.4"
"42658","646",2023-11-19 08:15:00,-30476,1913,32389,907,FALSE,NA,"0.1.4"
"42659","646",2023-11-19 08:30:00,-30471,1913,32384,907,FALSE,NA,"0.1.4"
"42660","646",2023-11-19 08:45:00,-30464,1913,32377,907,FALSE,NA,"0.1.4"
"42661","646",2023-11-19 09:00:00,-30622.25,1913,32535.25,907,FALSE,"out1, fill","0.1.4"
"42662","646",2023-11-19 09:15:00,-30780.5,1913,32693.5,907,FALSE,"out1, fill","0.1.4"
"42663","646",2023-11-19 09:30:00,-30938.75,1913,32851.75,907,FALSE,"out1, fill","0.1.4"
"42664","646",2023-11-19 09:45:00,-31097,1913,33010,907,FALSE,"out1, fill","0.1.4"
"42665","646",2023-11-19 10:00:00,-31255.25,1913,33168.25,907,FALSE,"out1, fill","0.1.4"
"42666","646",2023-11-19 10:15:00,-31413.5,1913,33326.5,907,FALSE,"out1, fill","0.1.4"
"42667","646",2023-11-19 10:30:00,-31571.75,1913,33484.75,907,FALSE,"out1, fill","0.1.4"
"42668","646",2023-11-19 10:45:00,-31730,1913,33643,907,FALSE,"out1, fill","0.1.4"
"42669","646",2023-11-19 11:00:00,-31888.25,1913,33801.25,907,TRUE,"out1, fill","0.1.4"
"42670","646",2023-11-19 11:15:00,-32046.5,1913,33959.5,907,TRUE,"out1, fill","0.1.4"
"42671","646",2023-11-19 11:30:00,-32204.75,1913,34117.75,907,TRUE,"out1, fill","0.1.4"
"42672","646",2023-11-19 11:45:00,-32363,1913,34276,907,TRUE,NA,"0.1.4"
"42673","646",2023-11-19 12:00:00,-32267,1913,34180,907,TRUE,NA,"0.1.4"
"42674","646",2023-11-19 12:15:00,-32188,1913,34101,907,TRUE,NA,"0.1.4"
"42675","646",2023-11-19 12:30:00,-32188,1913,34101,907,TRUE,"out1, fill","0.1.4"
"42676","646",2023-11-19 12:45:00,-32188,1913,34101,907,TRUE,"jump1","0.1.4"
"42677","646",2023-11-19 13:00:00,-32188,1913,34101,907,TRUE,NA,"0.1.4"
"42678","646",2023-11-19 13:15:00,-32189,1913,34102,907,TRUE,NA,"0.1.4"
"42679","646",2023-11-19 13:30:00,-32189,1913,34102,907,TRUE,NA,"0.1.4"
"42680","646",2023-11-19 13:45:00,-32186,1913,34099,907,TRUE,NA,"0.1.4"
"42681","646",2023-11-19 14:00:00,-32186,1913,34099,907,TRUE,NA,"0.1.4"
"42682","646",2023-11-19 14:15:00,-32186,1913,34099,907,TRUE,NA,"0.1.4"
"42683","646",2023-11-19 14:30:00,-32190,1913,34103,907,TRUE,NA,"0.1.4"
"42684","646",2023-11-19 14:45:00,-32497,1913,34410,907,TRUE,"out1, fill","0.1.4"
"42685","646",2023-11-19 15:00:00,-32804,1913,34717,907,TRUE,NA,"0.1.4"
"42686","646",2023-11-19 15:15:00,-32681,1913,34594,907,TRUE,NA,"0.1.4"
"42687","646",2023-11-19 15:30:00,-32784,1913,34697,907,TRUE,NA,"0.1.4"
"42688","646",2023-11-19 15:45:00,-32941,1913,34854,907,TRUE,NA,"0.1.4"
"42689","646",2023-11-19 16:00:00,-32920,1913,34833,907,TRUE,NA,"0.1.4"
"42690","646",2023-11-19 16:15:00,-32883,1913,34796,907,TRUE,NA,"0.1.4"
"42691","646",2023-11-19 16:30:00,-32844,1913,34757,907,TRUE,NA,"0.1.4"
"42692","646",2023-11-19 16:45:00,-32611,1913,34524,907,TRUE,NA,"0.1.4"
"42693","646",2023-11-19 17:00:00,-32396,1913,34309,907,TRUE,"out1, fill","0.1.4"
"42694","646",2023-11-19 17:15:00,-32181,1913,34094,907,TRUE,NA,"0.1.4"
"42695","646",2023-11-19 17:30:00,-32182,1913,34095,907,TRUE,NA,"0.1.4"
"42696","646",2023-11-19 17:45:00,-32181,1913,34094,907,TRUE,NA,"0.1.4"
"42697","646",2023-11-19 18:00:00,-32187,1913,34100,907,TRUE,NA,"0.1.4"
"42698","646",2023-11-19 18:15:00,-32254,1913,34167,907,TRUE,NA,"0.1.4"
"42699","646",2023-11-19 18:30:00,-32175,1913,34088,907,TRUE,NA,"0.1.4"
"42700","646",2023-11-19 18:45:00,-32179,1913,34092,907,TRUE,NA,"0.1.4"
"42701","646",2023-11-19 19:00:00,-32199,1913,34112,907,TRUE,NA,"0.1.4"
"42702","646",2023-11-19 19:15:00,-32183,1913,34096,907,TRUE,NA,"0.1.4"
"42703","646",2023-11-19 19:30:00,-32184,1913,34097,907,TRUE,NA,"0.1.4"
"42704","646",2023-11-19 19:45:00,-32178,1913,34091,907,TRUE,NA,"0.1.4"
"42705","646",2023-11-19 20:00:00,-32175,1913,34088,907,TRUE,NA,"0.1.4"
"42706","646",2023-11-19 20:15:00,-32495,1913,34408,907,TRUE,"out1, fill","0.1.4"
"42707","646",2023-11-19 20:30:00,-32815,1913,34728,907,TRUE,NA,"0.1.4"
"42708","646",2023-11-19 20:45:00,-32708,1913,34621,907,TRUE,NA,"0.1.4"
"42709","646",2023-11-19 21:00:00,-32630,1913,34543,907,FALSE,NA,"0.1.4"
"42710","646",2023-11-19 21:15:00,-32253,1913,34166,907,FALSE,NA,"0.1.4"
"42711","646",2023-11-19 21:30:00,-32184,1913,34097,907,FALSE,NA,"0.1.4"
"42712","646",2023-11-19 21:45:00,-32184,1913,34097,907,FALSE,NA,"0.1.4"
"42713","646",2023-11-19 22:00:00,-32185,1913,34098,907,FALSE,NA,"0.1.4"
"42714","646",2023-11-19 22:15:00,-32187,1913,34100,907,FALSE,NA,"0.1.4"
"42715","646",2023-11-19 22:30:00,-32650.5,1913,34563.5,907,FALSE,"out1, fill","0.1.4"
"42716","646",2023-11-19 22:45:00,-33114,1913,35027,907,FALSE,NA,"0.1.4"
"42717","646",2023-11-19 23:00:00,-33093,1913,35006,907,FALSE,NA,"0.1.4"
"42718","646",2023-11-19 23:15:00,-33113,1913,35026,907,FALSE,NA,"0.1.4"
"42719","646",2023-11-19 23:30:00,-33007,1913,34920,907,FALSE,NA,"0.1.4"
"42720","646",2023-11-19 23:45:00,-32593,1913,34506,907,FALSE,"out1, fill","0.1.4"
"42721","646",2023-11-20,-32179,1913,34092,907,FALSE,NA,"0.1.4"
"42722","646",2023-11-20 00:15:00,-32171,1913,34084,907,FALSE,NA,"0.1.4"
"42723","646",2023-11-20 00:30:00,-32170,1913,34083,907,FALSE,NA,"0.1.4"
"42724","646",2023-11-20 00:45:00,-32171,1913,34084,907,TRUE,NA,"0.1.4"
"42725","646",2023-11-20 01:00:00,-32172,1913,34085,907,TRUE,NA,"0.1.4"
"42726","646",2023-11-20 01:15:00,-32172,1913,34085,907,TRUE,NA,"0.1.4"
"42727","646",2023-11-20 01:30:00,-32172,1913,34085,907,TRUE,NA,"0.1.4"
"42728","646",2023-11-20 01:45:00,-32172,1913,34085,907,TRUE,NA,"0.1.4"
"42729","646",2023-11-20 02:00:00,-32172,1913,34085,907,TRUE,NA,"0.1.4"
"42730","646",2023-11-20 02:15:00,-32173,1913,34086,907,TRUE,NA,"0.1.4"
"42731","646",2023-11-20 02:30:00,-32173,1913,34086,907,TRUE,NA,"0.1.4"
"42732","646",2023-11-20 02:45:00,-32177,1913,34090,907,TRUE,NA,"0.1.4"
"42733","646",2023-11-20 03:00:00,-32174,1913,34087,907,TRUE,NA,"0.1.4"
"42734","646",2023-11-20 03:15:00,-32199,1913,34112,907,TRUE,NA,"0.1.4"
"42735","646",2023-11-20 03:30:00,-32192,1913,34105,907,TRUE,NA,"0.1.4"
"42736","646",2023-11-20 03:45:00,-32194,1913,34107,907,TRUE,NA,"0.1.4"
"42737","646",2023-11-20 04:00:00,-32185,1913,34098,907,TRUE,NA,"0.1.4"
"42738","646",2023-11-20 04:15:00,-32190.25,1913,34103.25,907,TRUE,"out1, fill","0.1.4"
"42739","646",2023-11-20 04:30:00,-32195.5,1913,34108.5,907,TRUE,"out1, fill","0.1.4"
"42740","646",2023-11-20 04:45:00,-32200.75,1913,34113.75,907,TRUE,"out1, fill","0.1.4"
"42741","646",2023-11-20 05:00:00,-32206,1913,34119,907,TRUE,NA,"0.1.4"
"42742","646",2023-11-20 05:15:00,-32190,1913,34103,907,TRUE,NA,"0.1.4"
"42743","646",2023-11-20 05:30:00,-32194,1913,34107,907,TRUE,NA,"0.1.4"
"42744","646",2023-11-20 05:45:00,-32284.75,1913,34197.75,907,TRUE,"out1, fill","0.1.4"
"42745","646",2023-11-20 06:00:00,-32375.5,1913,34288.5,907,TRUE,"out1, fill","0.1.4"
"42746","646",2023-11-20 06:15:00,-32466.25,1913,34379.25,907,TRUE,"out1, fill","0.1.4"
"42747","646",2023-11-20 06:30:00,-32557,1913,34470,907,TRUE,NA,"0.1.4"
"42748","646",2023-11-20 06:45:00,-32174,1913,34087,907,TRUE,NA,"0.1.4"
"42749","646",2023-11-20 07:00:00,-32439,1913,34352,907,TRUE,NA,"0.1.4"
"42750","646",2023-11-20 07:15:00,NA,NA,NA,NA,NA,"out1","0.1.4"
"42751","646",2023-11-20 07:30:00,NA,NA,NA,NA,NA,"out1","0.1.4"
"42752","646",2023-11-20 07:45:00,NA,NA,NA,NA,NA,"out1","0.1.4"
"42753","646",2023-11-20 08:00:00,NA,NA,NA,NA,NA,"out1","0.1.4"
"42754","646",2023-11-20 08:15:00,NA,NA,NA,NA,NA,"out1","0.1.4"
"42755","646",2023-11-20 08:30:00,NA,NA,NA,NA,NA,"out1","0.1.4"
"42756","646",2023-11-20 08:45:00,NA,NA,NA,NA,NA,"out1","0.1.4"
"42757","646",2023-11-20 09:00:00,NA,NA,NA,NA,NA,"out1","0.1.4"
"42758","646",2023-11-20 09:15:00,NA,NA,NA,NA,NA,"out1","0.1.4"
"42759","646",2023-11-20 09:30:00,NA,NA,NA,NA,NA,"out1","0.1.4"
"42760","646",2023-11-20 09:45:00,NA,NA,NA,NA,NA,"out1","0.1.4"
"42761","646",2023-11-20 10:00:00,NA,NA,NA,NA,NA,"out1","0.1.4"
"42762","646",2023-11-20 10:15:00,NA,NA,NA,NA,NA,"out1","0.1.4"
"42763","646",2023-11-20 10:30:00,NA,NA,NA,NA,NA,"out1","0.1.4"
"42764","646",2023-11-20 10:45:00,NA,NA,NA,NA,NA,"out1","0.1.4"
"42765","646",2023-11-20 11:00:00,NA,NA,NA,NA,NA,"out1","0.1.4"
"42766","646",2023-11-20 11:15:00,NA,NA,NA,NA,NA,"out1","0.1.4"
"42767","646",2023-11-20 11:30:00,NA,NA,NA,NA,NA,"out1","0.1.4"
"42768","646",2023-11-20 11:45:00,NA,NA,NA,NA,NA,"out1","0.1.4"
"42769","646",2023-11-20 12:00:00,-33123,1913,35036,907,TRUE,NA,"0.1.4"
"42770","646",2023-11-20 12:15:00,-32803,1913,34716,907,TRUE,NA,"0.1.4"
"42771","646",2023-11-20 12:30:00,-32935,1913,34848,907,TRUE,NA,"0.1.4"
"42772","646",2023-11-20 12:45:00,-32768.5,1913,34681.5,907,TRUE,"out1, fill","0.1.4"
"42773","646",2023-11-20 13:00:00,-32602,1913,34515,907,TRUE,NA,"0.1.4"
"42774","646",2023-11-20 13:15:00,-32680,1913,34593,907,TRUE,NA,"0.1.4"
"42775","646",2023-11-20 13:30:00,-32577,1913,34490,907,TRUE,NA,"0.1.4"
"42776","646",2023-11-20 13:45:00,-32556,1913,34469,907,TRUE,NA,"0.1.4"
"42777","646",2023-11-20 14:00:00,-32503,1913,34416,907,TRUE,NA,"0.1.4"
"42778","646",2023-11-20 14:15:00,-32442,1913,34355,907,TRUE,NA,"0.1.4"
"42779","646",2023-11-20 14:30:00,-32351,1913,34264,907,TRUE,NA,"0.1.4"
"42780","646",2023-11-20 14:45:00,-32316,1913,34229,907,TRUE,NA,"0.1.4"
"42781","646",2023-11-20 15:00:00,-32182,1913,34095,907,TRUE,NA,"0.1.4"
"42782","646",2023-11-20 15:15:00,-32225,1913,34138,907,TRUE,NA,"0.1.4"
"42783","646",2023-11-20 15:30:00,-32278,1913,34191,907,TRUE,NA,"0.1.4"
"42784","646",2023-11-20 15:45:00,-32227,1913,34140,907,TRUE,NA,"0.1.4"
"42785","646",2023-11-20 16:00:00,-32213,1913,34126,907,TRUE,NA,"0.1.4"
"42786","646",2023-11-20 16:15:00,-32208,1913,34121,907,TRUE,NA,"0.1.4"
"42787","646",2023-11-20 16:30:00,-32208,1913,34121,907,TRUE,NA,"0.1.4"
"42788","646",2023-11-20 16:45:00,-32202,1913,34115,907,TRUE,NA,"0.1.4"
"42789","646",2023-11-20 17:00:00,-32203,1913,34116,907,TRUE,NA,"0.1.4"
"42790","646",2023-11-20 17:15:00,-32196,1913,34109,907,TRUE,NA,"0.1.4"
"42791","646",2023-11-20 17:30:00,-32198,1913,34111,907,TRUE,NA,"0.1.4"
"42792","646",2023-11-20 17:45:00,-32193,1913,34106,907,TRUE,NA,"0.1.4"
"42793","646",2023-11-20 18:00:00,-32219,1913,34132,907,TRUE,NA,"0.1.4"
"42794","646",2023-11-20 18:15:00,-32226,1913,34139,907,TRUE,NA,"0.1.4"
"42795","646",2023-11-20 18:30:00,-32225,1913,34138,907,TRUE,NA,"0.1.4"
"42796","646",2023-11-20 18:45:00,-32204,1913,34117,907,TRUE,NA,"0.1.4"
"42797","646",2023-11-20 19:00:00,-32188,1913,34101,907,TRUE,NA,"0.1.4"
"42798","646",2023-11-20 19:15:00,-32195,1913,34108,907,TRUE,NA,"0.1.4"
"42799","646",2023-11-20 19:30:00,-32186,1913,34099,907,TRUE,NA,"0.1.4"
"42800","646",2023-11-20 19:45:00,-32241.8,1913,34154.8,907,TRUE,"out1, fill","0.1.4"
"42801","646",2023-11-20 20:00:00,-32297.6,1913,34210.6,907,TRUE,"out1, fill","0.1.4"
"42802","646",2023-11-20 20:15:00,-32353.4,1913,34266.4,907,TRUE,"out1, fill","0.1.4"
"42803","646",2023-11-20 20:30:00,-32409.2,1913,34322.2,907,TRUE,"out1, fill","0.1.4"
"42804","646",2023-11-20 20:45:00,-32465,1913,34378,907,TRUE,NA,"0.1.4"
"42805","646",2023-11-20 21:00:00,-32222,1913,34135,907,TRUE,NA,"0.1.4"
"42806","646",2023-11-20 21:15:00,-32189,1913,34102,907,TRUE,NA,"0.1.4"
"42807","646",2023-11-20 21:30:00,-32251,1913,34164,907,TRUE,NA,"0.1.4"
"42808","646",2023-11-20 21:45:00,-32177,1913,34090,907,TRUE,NA,"0.1.4"
"42809","646",2023-11-20 22:00:00,-32187,1913,34100,907,TRUE,NA,"0.1.4"
"42810","646",2023-11-20 22:15:00,-32190,1913,34103,907,TRUE,NA,"0.1.4"
"42811","646",2023-11-20 22:30:00,-32178,1913,34091,907,TRUE,NA,"0.1.4"
"42812","646",2023-11-20 22:45:00,-32173,1913,34086,907,TRUE,NA,"0.1.4"
"42813","646",2023-11-20 23:00:00,-32176,1913,34089,907,FALSE,NA,"0.1.4"
"42814","646",2023-11-20 23:15:00,-32178,1913,34091,907,FALSE,NA,"0.1.4"
"42815","646",2023-11-20 23:30:00,-32195,1913,34108,907,FALSE,NA,"0.1.4"
"42816","646",2023-11-20 23:45:00,-32179,1913,34092,907,FALSE,NA,"0.1.4"
"42817","646",2023-11-21,-32183,1913,34096,907,TRUE,NA,"0.1.4"
"42818","646",2023-11-21 00:15:00,-32184,1913,34097,907,TRUE,NA,"0.1.4"
"42819","646",2023-11-21 00:30:00,-32181,1913,34094,907,TRUE,NA,"0.1.4"
"42820","646",2023-11-21 00:45:00,-32191,1913,34104,907,TRUE,NA,"0.1.4"
"42821","646",2023-11-21 01:00:00,-32184,1913,34097,907,TRUE,NA,"0.1.4"
"42822","646",2023-11-21 01:15:00,-32188,1913,34101,907,TRUE,NA,"0.1.4"
"42823","646",2023-11-21 01:30:00,-32181,1913,34094,907,TRUE,NA,"0.1.4"
"42824","646",2023-11-21 01:45:00,-32309,1913,34222,907,TRUE,NA,"0.1.4"
"42825","646",2023-11-21 02:00:00,-32297,1913,34210,907,TRUE,NA,"0.1.4"
"42826","646",2023-11-21 02:15:00,-32517.75,1913,34430.75,907,TRUE,"out1, fill","0.1.4"
"42827","646",2023-11-21 02:30:00,-32738.5,1913,34651.5,907,TRUE,"out1, fill","0.1.4"
"42828","646",2023-11-21 02:45:00,-32959.25,1913,34872.25,907,TRUE,"out1, fill","0.1.4"
"42829","646",2023-11-21 03:00:00,-33180,1913,35093,907,TRUE,NA,"0.1.4"
"42830","646",2023-11-21 03:15:00,-33399,1913,35312,907,TRUE,NA,"0.1.4"
"42831","646",2023-11-21 03:30:00,-33423,1913,35336,907,TRUE,NA,"0.1.4"
"42832","646",2023-11-21 03:45:00,-33313.3333333333,1913,35226.3333333333,907,TRUE,"out1, fill","0.1.4"
"42833","646",2023-11-21 04:00:00,-33203.6666666667,1913,35116.6666666667,907,TRUE,"out1, fill","0.1.4"
"42834","646",2023-11-21 04:15:00,-33094,1913,35007,907,TRUE,NA,"0.1.4"
"42835","646",2023-11-21 04:30:00,-33039,1913,34952,907,TRUE,NA,"0.1.4"
"42836","646",2023-11-21 04:45:00,-33235,1913,35148,907,TRUE,NA,"0.1.4"
"42837","646",2023-11-21 05:00:00,-33235,1913,35148,907,TRUE,"out1, fill","0.1.4"
"42838","646",2023-11-21 05:15:00,-33235,1913,35148,907,TRUE,"jump1","0.1.4"
"42839","646",2023-11-21 05:30:00,-33218,1913,35131,907,TRUE,NA,"0.1.4"
"42840","646",2023-11-21 05:45:00,-33184,1913,35097,907,TRUE,NA,"0.1.4"
"42841","646",2023-11-21 06:00:00,-33201,1913,35114,907,TRUE,NA,"0.1.4"
"42842","646",2023-11-21 06:15:00,-33188,1913,35101,907,TRUE,NA,"0.1.4"
"42843","646",2023-11-21 06:30:00,-33188,1913,35101,907,TRUE,"out1, fill","0.1.4"
"42844","646",2023-11-21 06:45:00,-33188,1913,35101,907,TRUE,"jump1","0.1.4"
"42845","646",2023-11-21 07:00:00,-33295,1913,35208,907,TRUE,NA,"0.1.4"
"42846","646",2023-11-21 07:15:00,-33170,1913,35083,907,TRUE,NA,"0.1.4"
"42847","646",2023-11-21 07:30:00,-33246,1913,35159,907,TRUE,NA,"0.1.4"
"42848","646",2023-11-21 07:45:00,-33137,1913,35050,907,TRUE,NA,"0.1.4"
"42849","646",2023-11-21 08:00:00,-33347,1913,35260,907,TRUE,NA,"0.1.4"
"42850","646",2023-11-21 08:15:00,-33257,1913,35170,907,TRUE,NA,"0.1.4"
"42851","646",2023-11-21 08:30:00,-33297,1913,35210,907,TRUE,NA,"0.1.4"
"42852","646",2023-11-21 08:45:00,-33428,1913,35341,907,TRUE,NA,"0.1.4"
"42853","646",2023-11-21 09:00:00,-33276,1913,35189,907,TRUE,NA,"0.1.4"
"42854","646",2023-11-21 09:15:00,-33426,1913,35339,907,TRUE,NA,"0.1.4"
"42855","646",2023-11-21 09:30:00,-33298,1913,35211,907,TRUE,NA,"0.1.4"
"42856","646",2023-11-21 09:45:00,-33219,1913,35132,907,TRUE,NA,"0.1.4"
"42857","646",2023-11-21 10:00:00,-33194,1913,35107,907,TRUE,NA,"0.1.4"
"42858","646",2023-11-21 10:15:00,-33324,1913,35237,907,TRUE,NA,"0.1.4"
"42859","646",2023-11-21 10:30:00,-33270,1913,35183,907,TRUE,NA,"0.1.4"
"42860","646",2023-11-21 10:45:00,-33301,1913,35214,907,TRUE,NA,"0.1.4"
"42861","646",2023-11-21 11:00:00,-33312,1913,35225,907,TRUE,NA,"0.1.4"
"42862","646",2023-11-21 11:15:00,-33312,1913,35225,907,TRUE,NA,"0.1.4"
"42863","646",2023-11-21 11:30:00,-33490,1913,35403,907,TRUE,NA,"0.1.4"
"42864","646",2023-11-21 11:45:00,-33273,1913,35186,907,TRUE,NA,"0.1.4"
"42865","646",2023-11-21 12:00:00,-33073,1913,34986,907,TRUE,NA,"0.1.4"
"42866","646",2023-11-21 12:15:00,-33257,1913,35170,907,TRUE,NA,"0.1.4"
"42867","646",2023-11-21 12:30:00,-33263,1913,35176,907,TRUE,NA,"0.1.4"
"42868","646",2023-11-21 12:45:00,-33465,1913,35378,907,TRUE,NA,"0.1.4"
"42869","646",2023-11-21 13:00:00,-33475,1913,35388,907,TRUE,NA,"0.1.4"
"42870","646",2023-11-21 13:15:00,-33394,1913,35307,907,TRUE,NA,"0.1.4"
"42871","646",2023-11-21 13:30:00,-33423,1913,35336,907,TRUE,NA,"0.1.4"
"42872","646",2023-11-21 13:45:00,-33243,1913,35156,907,TRUE,NA,"0.1.4"
"42873","646",2023-11-21 14:00:00,-33264,1913,35177,907,TRUE,NA,"0.1.4"
"42874","646",2023-11-21 14:15:00,-33308,1913,35221,907,TRUE,NA,"0.1.4"
"42875","646",2023-11-21 14:30:00,-33190,1913,35103,907,TRUE,NA,"0.1.4"
"42876","646",2023-11-21 14:45:00,-33258,1913,35171,907,TRUE,NA,"0.1.4"
"42877","646",2023-11-21 15:00:00,-33229,1913,35142,907,TRUE,NA,"0.1.4"
"42878","646",2023-11-21 15:15:00,-33295,1913,35208,907,TRUE,NA,"0.1.4"
"42879","646",2023-11-21 15:30:00,-33127,1913,35040,907,TRUE,NA,"0.1.4"
"42880","646",2023-11-21 15:45:00,-33195,1913,35108,907,TRUE,NA,"0.1.4"
"42881","646",2023-11-21 16:00:00,-33369,1913,35282,907,TRUE,NA,"0.1.4"
"42882","646",2023-11-21 16:15:00,-33192,1913,35105,907,TRUE,NA,"0.1.4"
"42883","646",2023-11-21 16:30:00,-33013,1913,34926,907,TRUE,NA,"0.1.4"
"42884","646",2023-11-21 16:45:00,-32713,1913,34626,907,TRUE,NA,"0.1.4"
"42885","646",2023-11-21 17:00:00,-33064,1913,34977,907,TRUE,NA,"0.1.4"
"42886","646",2023-11-21 17:15:00,-33011,1913,34924,907,TRUE,NA,"0.1.4"
"42887","646",2023-11-21 17:30:00,-33051,1913,34964,907,TRUE,NA,"0.1.4"
"42888","646",2023-11-21 17:45:00,-33084,1913,34997,907,TRUE,NA,"0.1.4"
"42889","646",2023-11-21 18:00:00,-33172,1913,35085,907,TRUE,NA,"0.1.4"
"42890","646",2023-11-21 18:15:00,-33076,1913,34989,907,TRUE,NA,"0.1.4"
"42891","646",2023-11-21 18:30:00,-33031,1913,34944,907,TRUE,NA,"0.1.4"
"42892","646",2023-11-21 18:45:00,-32990,1913,34903,907,TRUE,NA,"0.1.4"
"42893","646",2023-11-21 19:00:00,-32809.6,1913,34722.6,907,TRUE,"out1, fill","0.1.4"
"42894","646",2023-11-21 19:15:00,-32629.2,1913,34542.2,907,TRUE,"out1, fill","0.1.4"
"42895","646",2023-11-21 19:30:00,-32448.8,1913,34361.8,907,TRUE,"out1, fill","0.1.4"
"42896","646",2023-11-21 19:45:00,-32268.4,1913,34181.4,907,TRUE,"out1, fill","0.1.4"
"42897","646",2023-11-21 20:00:00,-32088,1913,34001,907,TRUE,NA,"0.1.4"
"42898","646",2023-11-21 20:15:00,-32094,1913,34007,907,TRUE,NA,"0.1.4"
"42899","646",2023-11-21 20:30:00,-32019,1913,33932,907,TRUE,NA,"0.1.4"
"42900","646",2023-11-21 20:45:00,-32004,1913,33917,907,TRUE,NA,"0.1.4"
"42901","646",2023-11-21 21:00:00,-32004,1913,33917,907,FALSE,"out1, fill","0.1.4"
"42902","646",2023-11-21 21:15:00,-32004,1913,33917,907,FALSE,"jump1","0.1.4"
"42903","646",2023-11-21 21:30:00,-32115,1913,34028,907,FALSE,NA,"0.1.4"
"42904","646",2023-11-21 21:45:00,-31970,1913,33883,907,FALSE,NA,"0.1.4"
"42905","646",2023-11-21 22:00:00,-31805,1913,33718,907,FALSE,NA,"0.1.4"
"42906","646",2023-11-21 22:15:00,-31938,1913,33851,907,FALSE,NA,"0.1.4"
"42907","646",2023-11-21 22:30:00,-31472,1913,33385,907,FALSE,"out1, fill","0.1.4"
"42908","646",2023-11-21 22:45:00,-31006,1913,32919,907,FALSE,NA,"0.1.4"
"42909","646",2023-11-21 23:00:00,-31006,1913,32919,907,FALSE,NA,"0.1.4"
"42910","646",2023-11-21 23:15:00,-31008,1913,32921,907,FALSE,NA,"0.1.4"
"42911","646",2023-11-21 23:30:00,-31008,1913,32921,907,FALSE,NA,"0.1.4"
"42912","646",2023-11-21 23:45:00,-31009,1913,32922,907,FALSE,NA,"0.1.4"
"42913","646",2023-11-22,-31006,1913,32919,907,FALSE,NA,"0.1.4"
"42914","646",2023-11-22 00:15:00,-31005,1913,32918,907,FALSE,NA,"0.1.4"
"42915","646",2023-11-22 00:30:00,-31005,1913,32918,907,FALSE,NA,"0.1.4"
"42916","646",2023-11-22 00:45:00,-30989,1913,32902,907,FALSE,NA,"0.1.4"
"42917","646",2023-11-22 01:00:00,-31024,1913,32937,907,FALSE,NA,"0.1.4"
"42918","646",2023-11-22 01:15:00,-31004,1913,32917,907,FALSE,NA,"0.1.4"
"42919","646",2023-11-22 01:30:00,-31182,1913,33095,907,FALSE,NA,"0.1.4"
"42920","646",2023-11-22 01:45:00,-31047,1913,32960,907,FALSE,NA,"0.1.4"
"42921","646",2023-11-22 02:00:00,-31362.5,1913,33275.5,907,TRUE,"out1, fill","0.1.4"
"42922","646",2023-11-22 02:15:00,-31678,1913,33591,907,TRUE,NA,"0.1.4"
"42923","646",2023-11-22 02:30:00,-31968,1913,33881,907,TRUE,NA,"0.1.4"
"42924","646",2023-11-22 02:45:00,-31995,1913,33908,907,TRUE,NA,"0.1.4"
"42925","646",2023-11-22 03:00:00,-32124,1913,34037,907,TRUE,NA,"0.1.4"
"42926","646",2023-11-22 03:15:00,-32187,1913,34100,907,TRUE,NA,"0.1.4"
"42927","646",2023-11-22 03:30:00,-31832,1913,33745,907,TRUE,NA,"0.1.4"
"42928","646",2023-11-22 03:45:00,-31880,1913,33793,907,TRUE,"out1, fill","0.1.4"
"42929","646",2023-11-22 04:00:00,-31928,1913,33841,907,TRUE,"out1, fill","0.1.4"
"42930","646",2023-11-22 04:15:00,-31976,1913,33889,907,TRUE,"out1, fill","0.1.4"
"42931","646",2023-11-22 04:30:00,-32024,1913,33937,907,TRUE,NA,"0.1.4"
"42932","646",2023-11-22 04:45:00,-32091,1913,34004,907,TRUE,NA,"0.1.4"
"42933","646",2023-11-22 05:00:00,-32201,1913,34114,907,TRUE,NA,"0.1.4"
"42934","646",2023-11-22 05:15:00,-31933,1913,33846,907,TRUE,NA,"0.1.4"
"42935","646",2023-11-22 05:30:00,-31830,1913,33743,907,TRUE,NA,"0.1.4"
"42936","646",2023-11-22 05:45:00,-31859,1913,33772,907,TRUE,NA,"0.1.4"
"42937","646",2023-11-22 06:00:00,-31927,1913,33840,907,TRUE,NA,"0.1.4"
"42938","646",2023-11-22 06:15:00,-31907,1913,33820,907,TRUE,NA,"0.1.4"
"42939","646",2023-11-22 06:30:00,-31933,1913,33846,907,TRUE,NA,"0.1.4"
"42940","646",2023-11-22 06:45:00,-31838,1913,33751,907,TRUE,NA,"0.1.4"
"42941","646",2023-11-22 07:00:00,-32005,1913,33918,907,TRUE,NA,"0.1.4"
"42942","646",2023-11-22 07:15:00,-31949,1913,33862,907,TRUE,NA,"0.1.4"
"42943","646",2023-11-22 07:30:00,-31853,1913,33766,907,TRUE,NA,"0.1.4"
"42944","646",2023-11-22 07:45:00,-31917,1913,33830,907,TRUE,NA,"0.1.4"
"42945","646",2023-11-22 08:00:00,-31888,1913,33801,907,TRUE,NA,"0.1.4"
"42946","646",2023-11-22 08:15:00,-31877,1913,33790,907,TRUE,NA,"0.1.4"
"42947","646",2023-11-22 08:30:00,-31823,1913,33736,907,TRUE,NA,"0.1.4"
"42948","646",2023-11-22 08:45:00,-32037,1913,33950,907,TRUE,NA,"0.1.4"
"42949","646",2023-11-22 09:00:00,-31871,1913,33784,907,TRUE,NA,"0.1.4"
"42950","646",2023-11-22 09:15:00,-31801,1913,33714,907,TRUE,NA,"0.1.4"
"42951","646",2023-11-22 09:30:00,-31640,1913,33553,907,TRUE,NA,"0.1.4"
"42952","646",2023-11-22 09:45:00,-31906,1913,33819,907,TRUE,NA,"0.1.4"
"42953","646",2023-11-22 10:00:00,-31986,1913,33899,907,TRUE,NA,"0.1.4"
"42954","646",2023-11-22 10:15:00,-32033,1913,33946,907,TRUE,NA,"0.1.4"
"42955","646",2023-11-22 10:30:00,-32017,1913,33930,907,TRUE,NA,"0.1.4"
"42956","646",2023-11-22 10:45:00,-32010,1913,33923,907,TRUE,NA,"0.1.4"
"42957","646",2023-11-22 11:00:00,-31838,1913,33751,907,TRUE,NA,"0.1.4"
"42958","646",2023-11-22 11:15:00,-31584,1913,33497,907,TRUE,NA,"0.1.4"
"42959","646",2023-11-22 11:30:00,-31405,1913,33318,907,TRUE,NA,"0.1.4"
"42960","646",2023-11-22 11:45:00,-31671,1913,33584,907,TRUE,NA,"0.1.4"
"42961","646",2023-11-22 12:00:00,-31590,1913,33503,907,TRUE,NA,"0.1.4"
"42962","646",2023-11-22 12:15:00,-31764,1913,33677,907,TRUE,NA,"0.1.4"
"42963","646",2023-11-22 12:30:00,-31764,1913,33677,907,TRUE,NA,"0.1.4"
"42964","646",2023-11-22 12:45:00,-31817,1913,33730,907,TRUE,NA,"0.1.4"
"42965","646",2023-11-22 13:00:00,-31681,1913,33594,907,TRUE,NA,"0.1.4"
"42966","646",2023-11-22 13:15:00,-31796,1913,33709,907,TRUE,NA,"0.1.4"
"42967","646",2023-11-22 13:30:00,-31642,1913,33555,907,TRUE,NA,"0.1.4"
"42968","646",2023-11-22 13:45:00,-31555,1913,33468,907,TRUE,NA,"0.1.4"
"42969","646",2023-11-22 14:00:00,-31824,1913,33737,907,TRUE,NA,"0.1.4"
"42970","646",2023-11-22 14:15:00,-31589,1913,33502,907,TRUE,NA,"0.1.4"
"42971","646",2023-11-22 14:30:00,-31545,1913,33458,907,TRUE,NA,"0.1.4"
"42972","646",2023-11-22 14:45:00,-31559,1913,33472,907,TRUE,NA,"0.1.4"
"42973","646",2023-11-22 15:00:00,-31557,1913,33470,907,TRUE,NA,"0.1.4"
"42974","646",2023-11-22 15:15:00,-31591,1913,33504,907,TRUE,NA,"0.1.4"
"42975","646",2023-11-22 15:30:00,-31894,1913,33807,907,TRUE,NA,"0.1.4"
"42976","646",2023-11-22 15:45:00,-31895,1913,33808,907,TRUE,NA,"0.1.4"
"42977","646",2023-11-22 16:00:00,-31499,1913,33412,907,TRUE,"out1, fill","0.1.4"
"42978","646",2023-11-22 16:15:00,-31103,1913,33016,907,TRUE,NA,"0.1.4"
"42979","646",2023-11-22 16:30:00,-31343,1913,33256,907,TRUE,NA,"0.1.4"
"42980","646",2023-11-22 16:45:00,-31006,1913,32919,907,TRUE,NA,"0.1.4"
"42981","646",2023-11-22 17:00:00,-31006,1913,32919,907,FALSE,"jump1","0.1.4"
"42982","646",2023-11-22 17:15:00,-31232,1913,33145,907,FALSE,NA,"0.1.4"
"42983","646",2023-11-22 17:30:00,-31237,1913,33150,907,FALSE,NA,"0.1.4"
"42984","646",2023-11-22 17:45:00,-30972,1913,32885,907,FALSE,NA,"0.1.4"
"42985","646",2023-11-22 18:00:00,-31289,1913,33202,907,FALSE,NA,"0.1.4"
"42986","646",2023-11-22 18:15:00,-31008,1913,32921,907,FALSE,NA,"0.1.4"
"42987","646",2023-11-22 18:30:00,-31201,1913,33114,907,FALSE,NA,"0.1.4"
"42988","646",2023-11-22 18:45:00,-31393,1913,33306,907,FALSE,NA,"0.1.4"
"42989","646",2023-11-22 19:00:00,-31186.5,1913,33099.5,907,FALSE,"out1, fill","0.1.4"
"42990","646",2023-11-22 19:15:00,-30980,1913,32893,907,FALSE,NA,"0.1.4"
"42991","646",2023-11-22 19:30:00,-30980,1913,32893,907,FALSE,"jump1","0.1.4"
"42992","646",2023-11-22 19:45:00,-31440,1913,33353,907,FALSE,NA,"0.1.4"
"42993","646",2023-11-22 20:00:00,-30957,1913,32870,907,FALSE,NA,"0.1.4"
"42994","646",2023-11-22 20:15:00,-30941,1913,32854,907,FALSE,NA,"0.1.4"
"42995","646",2023-11-22 20:30:00,-30937,1913,32850,907,FALSE,NA,"0.1.4"
"42996","646",2023-11-22 20:45:00,-30895,1913,32808,907,FALSE,NA,"0.1.4"
"42997","646",2023-11-22 21:00:00,-30834,1913,32747,907,FALSE,NA,"0.1.4"
"42998","646",2023-11-22 21:15:00,-30830,1913,32743,907,FALSE,NA,"0.1.4"
"42999","646",2023-11-22 21:30:00,-30835,1913,32748,907,FALSE,NA,"0.1.4"
"43000","646",2023-11-22 21:45:00,-30912,1913,32825,907,FALSE,NA,"0.1.4"
"43001","646",2023-11-22 22:00:00,-30874,1913,32787,907,FALSE,NA,"0.1.4"
"43002","646",2023-11-22 22:15:00,-30839,1913,32752,907,FALSE,NA,"0.1.4"
"43003","646",2023-11-22 22:30:00,-30840,1913,32753,907,FALSE,NA,"0.1.4"
"43004","646",2023-11-22 22:45:00,-30848,1913,32761,907,FALSE,NA,"0.1.4"
"43005","646",2023-11-22 23:00:00,-30862,1913,32775,907,FALSE,NA,"0.1.4"
"43006","646",2023-11-22 23:15:00,-30858,1913,32771,907,FALSE,NA,"0.1.4"
"43007","646",2023-11-22 23:30:00,-30854,1913,32767,907,FALSE,NA,"0.1.4"
"43008","646",2023-11-22 23:45:00,-30855,1913,32768,907,FALSE,NA,"0.1.4"
"43009","646",2023-11-23,-30866,1913,32779,907,FALSE,NA,"0.1.4"
"43010","646",2023-11-23 00:15:00,-30845,1913,32758,907,FALSE,NA,"0.1.4"
"43011","646",2023-11-23 00:30:00,-30842,1913,32755,907,FALSE,NA,"0.1.4"
"43012","646",2023-11-23 00:45:00,-30860,1913,32773,907,FALSE,NA,"0.1.4"
"43013","646",2023-11-23 01:00:00,-31009,1913,32922,907,FALSE,NA,"0.1.4"
"43014","646",2023-11-23 01:15:00,-30886,1913,32799,907,FALSE,NA,"0.1.4"
"43015","646",2023-11-23 01:30:00,-30840,1913,32753,907,FALSE,NA,"0.1.4"
"43016","646",2023-11-23 01:45:00,-30839,1913,32752,907,FALSE,NA,"0.1.4"
"43017","646",2023-11-23 02:00:00,-30990,1913,32903,907,FALSE,NA,"0.1.4"
"43018","646",2023-11-23 02:15:00,-30854,1913,32767,907,FALSE,NA,"0.1.4"
"43019","646",2023-11-23 02:30:00,-30837,1913,32750,907,FALSE,NA,"0.1.4"
"43020","646",2023-11-23 02:45:00,-30847,1913,32760,907,FALSE,NA,"0.1.4"
"43021","646",2023-11-23 03:00:00,-30967,1913,32880,907,FALSE,NA,"0.1.4"
"43022","646",2023-11-23 03:15:00,-30837,1913,32750,907,FALSE,NA,"0.1.4"
"43023","646",2023-11-23 03:30:00,-30836,1913,32749,907,FALSE,NA,"0.1.4"
"43024","646",2023-11-23 03:45:00,-31277,1913,33190,907,FALSE,NA,"0.1.4"
"43025","646",2023-11-23 04:00:00,-30937,1913,32850,907,FALSE,NA,"0.1.4"
"43026","646",2023-11-23 04:15:00,-31101,1913,33014,907,FALSE,NA,"0.1.4"
"43027","646",2023-11-23 04:30:00,-30883,1913,32796,907,FALSE,NA,"0.1.4"
"43028","646",2023-11-23 04:45:00,-30867,1913,32780,907,FALSE,NA,"0.1.4"
"43029","646",2023-11-23 05:00:00,-30881,1913,32794,907,FALSE,NA,"0.1.4"
"43030","646",2023-11-23 05:15:00,-30880,1913,32793,907,FALSE,NA,"0.1.4"
"43031","646",2023-11-23 05:30:00,-30949,1913,32862,907,FALSE,NA,"0.1.4"
"43032","646",2023-11-23 05:45:00,-30942,1913,32855,907,FALSE,NA,"0.1.4"
"43033","646",2023-11-23 06:00:00,-30944,1913,32857,907,FALSE,NA,"0.1.4"
"43034","646",2023-11-23 06:15:00,-30943,1913,32856,907,FALSE,NA,"0.1.4"
"43035","646",2023-11-23 06:30:00,-30945,1913,32858,907,FALSE,NA,"0.1.4"
"43036","646",2023-11-23 06:45:00,-30944,1913,32857,907,FALSE,NA,"0.1.4"
"43037","646",2023-11-23 07:00:00,-30944,1913,32857,907,FALSE,NA,"0.1.4"
"43038","646",2023-11-23 07:15:00,-30952,1913,32865,907,FALSE,NA,"0.1.4"
"43039","646",2023-11-23 07:30:00,-30953,1913,32866,907,FALSE,NA,"0.1.4"
"43040","646",2023-11-23 07:45:00,-30916,1913,32829,907,FALSE,NA,"0.1.4"
"43041","646",2023-11-23 08:00:00,-30945,1913,32858,907,FALSE,NA,"0.1.4"
"43042","646",2023-11-23 08:15:00,-30945,1913,32858,907,FALSE,NA,"0.1.4"
"43043","646",2023-11-23 08:30:00,-30953,1913,32866,907,FALSE,NA,"0.1.4"
"43044","646",2023-11-23 08:45:00,-30948,1913,32861,907,FALSE,NA,"0.1.4"
"43045","646",2023-11-23 09:00:00,-30953,1913,32866,907,FALSE,NA,"0.1.4"
"43046","646",2023-11-23 09:15:00,-31047.3333333333,1913,32960.3333333333,907,FALSE,"out1, fill","0.1.4"
"43047","646",2023-11-23 09:30:00,-31141.6666666667,1913,33054.6666666667,907,FALSE,"out1, fill","0.1.4"
"43048","646",2023-11-23 09:45:00,-31236,1913,33149,907,FALSE,NA,"0.1.4"
"43049","646",2023-11-23 10:00:00,-30931,1913,32844,907,FALSE,NA,"0.1.4"
"43050","646",2023-11-23 10:15:00,-30957,1913,32870,907,FALSE,NA,"0.1.4"
"43051","646",2023-11-23 10:30:00,-30940,1913,32853,907,FALSE,NA,"0.1.4"
"43052","646",2023-11-23 10:45:00,-30940,1913,32853,907,FALSE,"jump1","0.1.4"
"43053","646",2023-11-23 11:00:00,-30660.5,1913,32573.5,907,TRUE,"out1, fill","0.1.4"
"43054","646",2023-11-23 11:15:00,-30381,1913,32294,907,TRUE,NA,"0.1.4"
"43055","646",2023-11-23 11:30:00,-30356,1913,32269,907,TRUE,NA,"0.1.4"
"43056","646",2023-11-23 11:45:00,-30563,1913,32476,907,TRUE,NA,"0.1.4"
"43057","646",2023-11-23 12:00:00,-30431,1913,32344,907,TRUE,NA,"0.1.4"
"43058","646",2023-11-23 12:15:00,-30412,1913,32325,907,TRUE,NA,"0.1.4"
"43059","646",2023-11-23 12:30:00,-30529.5,1913,32442.5,907,TRUE,"out1, fill","0.1.4"
"43060","646",2023-11-23 12:45:00,-30647,1913,32560,907,TRUE,NA,"0.1.4"
"43061","646",2023-11-23 13:00:00,-30291,1913,32204,907,TRUE,NA,"0.1.4"
"43062","646",2023-11-23 13:15:00,-30246,1913,32159,907,TRUE,NA,"0.1.4"
"43063","646",2023-11-23 13:30:00,-30248,1913,32161,907,TRUE,NA,"0.1.4"
"43064","646",2023-11-23 13:45:00,-30286,1913,32199,907,TRUE,NA,"0.1.4"
"43065","646",2023-11-23 14:00:00,-30332,1913,32245,907,TRUE,NA,"0.1.4"
"43066","646",2023-11-23 14:15:00,-30505,1913,32418,907,TRUE,NA,"0.1.4"
"43067","646",2023-11-23 14:30:00,-30648,1913,32561,907,TRUE,NA,"0.1.4"
"43068","646",2023-11-23 14:45:00,-30776,1913,32689,907,TRUE,NA,"0.1.4"
"43069","646",2023-11-23 15:00:00,-30973,1913,32886,907,TRUE,NA,"0.1.4"
"43070","646",2023-11-23 15:15:00,-31110,1913,33023,907,TRUE,"out1, fill","0.1.4"
"43071","646",2023-11-23 15:30:00,-31247,1913,33160,907,TRUE,NA,"0.1.4"
"43072","646",2023-11-23 15:45:00,-31245,1913,33158,907,TRUE,NA,"0.1.4"
"43073","646",2023-11-23 16:00:00,-31113,1913,33026,907,TRUE,NA,"0.1.4"
"43074","646",2023-11-23 16:15:00,-31064,1913,32977,907,TRUE,NA,"0.1.4"
"43075","646",2023-11-23 16:30:00,-31432,1913,33345,907,TRUE,NA,"0.1.4"
"43076","646",2023-11-23 16:45:00,-31520,1913,33433,907,TRUE,NA,"0.1.4"
"43077","646",2023-11-23 17:00:00,-31394,1913,33307,907,TRUE,NA,"0.1.4"
"43078","646",2023-11-23 17:15:00,-31405,1913,33318,907,TRUE,NA,"0.1.4"
"43079","646",2023-11-23 17:30:00,-31434,1913,33347,907,TRUE,NA,"0.1.4"
"43080","646",2023-11-23 17:45:00,-31483,1913,33396,907,TRUE,NA,"0.1.4"
"43081","646",2023-11-23 18:00:00,-31453,1913,33366,907,TRUE,NA,"0.1.4"
"43082","646",2023-11-23 18:15:00,-31304,1913,33217,907,TRUE,NA,"0.1.4"
"43083","646",2023-11-23 18:30:00,-31399,1913,33312,907,TRUE,NA,"0.1.4"
"43084","646",2023-11-23 18:45:00,-31422,1913,33335,907,TRUE,NA,"0.1.4"
"43085","646",2023-11-23 19:00:00,-31415,1913,33328,907,TRUE,NA,"0.1.4"
"43086","646",2023-11-23 19:15:00,-31086,1913,32999,907,TRUE,NA,"0.1.4"
"43087","646",2023-11-23 19:30:00,-31262,1913,33175,907,TRUE,NA,"0.1.4"
"43088","646",2023-11-23 19:45:00,-30958,1913,32871,907,TRUE,NA,"0.1.4"
"43089","646",2023-11-23 20:00:00,-30826.6,1913,32739.6,907,TRUE,"out1, fill","0.1.4"
"43090","646",2023-11-23 20:15:00,-30695.2,1913,32608.2,907,TRUE,"out1, fill","0.1.4"
"43091","646",2023-11-23 20:30:00,-30563.8,1913,32476.8,907,TRUE,"out1, fill","0.1.4"
"43092","646",2023-11-23 20:45:00,-30432.4,1913,32345.4,907,TRUE,"out1, fill","0.1.4"
"43093","646",2023-11-23 21:00:00,-30301,1913,32214,907,TRUE,NA,"0.1.4"
"43094","646",2023-11-23 21:15:00,-30305,1913,32218,907,TRUE,NA,"0.1.4"
"43095","646",2023-11-23 21:30:00,-30319,1913,32232,907,TRUE,NA,"0.1.4"
"43096","646",2023-11-23 21:45:00,-30285,1913,32198,907,TRUE,NA,"0.1.4"
"43097","646",2023-11-23 22:00:00,-30467,1913,32380,907,TRUE,NA,"0.1.4"
"43098","646",2023-11-23 22:15:00,-30416,1913,32329,907,TRUE,NA,"0.1.4"
"43099","646",2023-11-23 22:30:00,-30248,1913,32161,907,TRUE,NA,"0.1.4"
"43100","646",2023-11-23 22:45:00,-30242,1913,32155,907,TRUE,NA,"0.1.4"
"43101","646",2023-11-23 23:00:00,-30242,1913,32155,907,TRUE,NA,"0.1.4"
"43102","646",2023-11-23 23:15:00,-30242,1913,32155,907,TRUE,NA,"0.1.4"
"43103","646",2023-11-23 23:30:00,-30253,1913,32166,907,TRUE,NA,"0.1.4"
"43104","646",2023-11-23 23:45:00,-30242,1913,32155,907,TRUE,NA,"0.1.4"
"43105","646",2023-11-24,-30242,1913,32155,907,TRUE,NA,"0.1.4"
"43106","646",2023-11-24 00:15:00,-30241,1913,32154,907,TRUE,NA,"0.1.4"
"43107","646",2023-11-24 00:30:00,-30241,1913,32154,907,TRUE,"out1, fill","0.1.4"
"43108","646",2023-11-24 00:45:00,-30241,1913,32154,907,TRUE,"jump1","0.1.4"
"43109","646",2023-11-24 01:00:00,-30137,1913,32050,907,TRUE,NA,"0.1.4"
"43110","646",2023-11-24 01:15:00,-30405,1913,32318,907,TRUE,NA,"0.1.4"
"43111","646",2023-11-24 01:30:00,-30262,1913,32175,907,TRUE,NA,"0.1.4"
"43112","646",2023-11-24 01:45:00,-30621,1913,32534,907,TRUE,NA,"0.1.4"
"43113","646",2023-11-24 02:00:00,-30320,1913,32233,907,TRUE,NA,"0.1.4"
"43114","646",2023-11-24 02:15:00,-29937,1913,31850,907,TRUE,"out1, fill","0.1.4"
"43115","646",2023-11-24 02:30:00,-29554,1913,31467,907,TRUE,"out1, fill","0.1.4"
"43116","646",2023-11-24 02:45:00,-29171,1913,31084,907,TRUE,NA,"0.1.4"
"43117","646",2023-11-24 03:00:00,-29255,1913,31168,907,TRUE,NA,"0.1.4"
"43118","646",2023-11-24 03:15:00,-29208,1913,31121,907,TRUE,NA,"0.1.4"
"43119","646",2023-11-24 03:30:00,-29244,1913,31157,907,TRUE,NA,"0.1.4"
"43120","646",2023-11-24 03:45:00,-29244,1913,31157,907,TRUE,"out1, fill","0.1.4"
"43121","646",2023-11-24 04:00:00,-29244,1913,31157,907,TRUE,"jump1","0.1.4"
"43122","646",2023-11-24 04:15:00,-29158,1913,31071,907,TRUE,NA,"0.1.4"
"43123","646",2023-11-24 04:30:00,-29253,1913,31166,907,TRUE,NA,"0.1.4"
"43124","646",2023-11-24 04:45:00,-29182,1913,31095,907,TRUE,NA,"0.1.4"
"43125","646",2023-11-24 05:00:00,-29363,1913,31276,907,TRUE,NA,"0.1.4"
"43126","646",2023-11-24 05:15:00,-29404,1913,31317,907,TRUE,NA,"0.1.4"
"43127","646",2023-11-24 05:30:00,-29353,1913,31266,907,TRUE,NA,"0.1.4"
"43128","646",2023-11-24 05:45:00,-29075,1913,30988,907,TRUE,NA,"0.1.4"
"43129","646",2023-11-24 06:00:00,-29212,1913,31125,907,TRUE,NA,"0.1.4"
"43130","646",2023-11-24 06:15:00,-29054,1913,30967,907,TRUE,NA,"0.1.4"
"43131","646",2023-11-24 06:30:00,-29176,1913,31089,907,TRUE,NA,"0.1.4"
"43132","646",2023-11-24 06:45:00,-29293,1913,31206,907,TRUE,NA,"0.1.4"
"43133","646",2023-11-24 07:00:00,-29293,1913,31206,907,TRUE,"out1, fill","0.1.4"
"43134","646",2023-11-24 07:15:00,-29293,1913,31206,907,TRUE,"out1, fill","0.1.4"
"43135","646",2023-11-24 07:30:00,-29293,1913,31206,907,TRUE,"out1, fill","0.1.4"
"43136","646",2023-11-24 07:45:00,-29293,1913,31206,907,TRUE,NA,"0.1.4"
"43137","646",2023-11-24 08:00:00,-29530,1913,31443,907,TRUE,NA,"0.1.4"
"43138","646",2023-11-24 08:15:00,-29343,1913,31256,907,TRUE,NA,"0.1.4"
"43139","646",2023-11-24 08:30:00,-29316,1913,31229,907,TRUE,NA,"0.1.4"
"43140","646",2023-11-24 08:45:00,-29290,1913,31203,907,TRUE,NA,"0.1.4"
"43141","646",2023-11-24 09:00:00,-29256,1913,31169,907,TRUE,NA,"0.1.4"
"43142","646",2023-11-24 09:15:00,-29424,1913,31337,907,TRUE,NA,"0.1.4"
"43143","646",2023-11-24 09:30:00,-29399,1913,31312,907,TRUE,NA,"0.1.4"
"43144","646",2023-11-24 09:45:00,-29315,1913,31228,907,TRUE,NA,"0.1.4"
"43145","646",2023-11-24 10:00:00,-29321,1913,31234,907,TRUE,NA,"0.1.4"
"43146","646",2023-11-24 10:15:00,-29262,1913,31175,907,TRUE,NA,"0.1.4"
"43147","646",2023-11-24 10:30:00,-28949,1913,30862,907,TRUE,"out1, fill","0.1.4"
"43148","646",2023-11-24 10:45:00,-28636,1913,30549,907,TRUE,NA,"0.1.4"
"43149","646",2023-11-24 11:00:00,-28415,1913,30328,907,TRUE,NA,"0.1.4"
"43150","646",2023-11-24 11:15:00,-28138,1913,30051,907,TRUE,NA,"0.1.4"
"43151","646",2023-11-24 11:30:00,-28206,1913,30119,907,TRUE,NA,"0.1.4"
"43152","646",2023-11-24 11:45:00,-28110,1913,30023,907,TRUE,NA,"0.1.4"
"43153","646",2023-11-24 12:00:00,-28104,1913,30017,907,TRUE,NA,"0.1.4"
"43154","646",2023-11-24 12:15:00,-28104,1913,30017,907,TRUE,NA,"0.1.4"
"43155","646",2023-11-24 12:30:00,-28103,1913,30016,907,TRUE,NA,"0.1.4"
"43156","646",2023-11-24 12:45:00,-28103,1913,30016,907,TRUE,NA,"0.1.4"
"43157","646",2023-11-24 13:00:00,-28104,1913,30017,907,TRUE,NA,"0.1.4"
"43158","646",2023-11-24 13:15:00,-28103,1913,30016,907,TRUE,NA,"0.1.4"
"43159","646",2023-11-24 13:30:00,-28103,1913,30016,907,TRUE,NA,"0.1.4"
"43160","646",2023-11-24 13:45:00,-28103,1913,30016,907,TRUE,NA,"0.1.4"
"43161","646",2023-11-24 14:00:00,-28102,1913,30015,907,TRUE,NA,"0.1.4"
"43162","646",2023-11-24 14:15:00,-28103,1913,30016,907,TRUE,NA,"0.1.4"
"43163","646",2023-11-24 14:30:00,-28104,1913,30017,907,TRUE,NA,"0.1.4"
"43164","646",2023-11-24 14:45:00,-28104,1913,30017,907,TRUE,NA,"0.1.4"
"43165","646",2023-11-24 15:00:00,-28104,1913,30017,907,TRUE,NA,"0.1.4"
"43166","646",2023-11-24 15:15:00,-28104,1913,30017,907,TRUE,NA,"0.1.4"
"43167","646",2023-11-24 15:30:00,-28104,1913,30017,907,TRUE,"out1, fill","0.1.4"
"43168","646",2023-11-24 15:45:00,-28104,1913,30017,907,TRUE,"jump1","0.1.4"
"43169","646",2023-11-24 16:00:00,-28060,1913,29973,907,TRUE,NA,"0.1.4"
"43170","646",2023-11-24 16:15:00,-28000,1913,29913,907,TRUE,NA,"0.1.4"
"43171","646",2023-11-24 16:30:00,-27861,1913,29774,907,TRUE,NA,"0.1.4"
"43172","646",2023-11-24 16:45:00,-27701,1913,29614,907,TRUE,NA,"0.1.4"
"43173","646",2023-11-24 17:00:00,-27889,1913,29802,907,TRUE,NA,"0.1.4"
"43174","646",2023-11-24 17:15:00,-28085,1913,29998,907,TRUE,NA,"0.1.4"
"43175","646",2023-11-24 17:30:00,-27965,1913,29878,907,TRUE,NA,"0.1.4"
"43176","646",2023-11-24 17:45:00,-27855,1913,29768,907,TRUE,NA,"0.1.4"
"43177","646",2023-11-24 18:00:00,-27860,1913,29773,907,TRUE,NA,"0.1.4"
"43178","646",2023-11-24 18:15:00,-27443,1913,29356,907,TRUE,"out1, fill","0.1.4"
"43179","646",2023-11-24 18:30:00,-27026,1913,28939,907,TRUE,NA,"0.1.4"
"43180","646",2023-11-24 18:45:00,-26994,1913,28907,907,TRUE,NA,"0.1.4"
"43181","646",2023-11-24 19:00:00,-26878,1913,28791,907,TRUE,NA,"0.1.4"
"43182","646",2023-11-24 19:15:00,-26869,1913,28782,907,TRUE,NA,"0.1.4"
"43183","646",2023-11-24 19:30:00,-26873,1913,28786,907,TRUE,NA,"0.1.4"
"43184","646",2023-11-24 19:45:00,-26856,1913,28769,907,TRUE,NA,"0.1.4"
"43185","646",2023-11-24 20:00:00,-26921,1913,28834,907,TRUE,NA,"0.1.4"
"43186","646",2023-11-24 20:15:00,-27068,1913,28981,907,TRUE,NA,"0.1.4"
"43187","646",2023-11-24 20:30:00,-27331,1913,29244,907,TRUE,NA,"0.1.4"
"43188","646",2023-11-24 20:45:00,-27570,1913,29483,907,TRUE,"out1, fill","0.1.4"
"43189","646",2023-11-24 21:00:00,-27809,1913,29722,907,TRUE,"out1, fill","0.1.4"
"43190","646",2023-11-24 21:15:00,-28048,1913,29961,907,TRUE,NA,"0.1.4"
"43191","646",2023-11-24 21:30:00,-28133,1913,30046,907,TRUE,NA,"0.1.4"
"43192","646",2023-11-24 21:45:00,-27832,1913,29745,907,TRUE,NA,"0.1.4"
"43193","646",2023-11-24 22:00:00,-27869,1913,29782,907,TRUE,NA,"0.1.4"
"43194","646",2023-11-24 22:15:00,-27869,1913,29782,907,TRUE,"out1, fill","0.1.4"
"43195","646",2023-11-24 22:30:00,-27869,1913,29782,907,TRUE,"jump1","0.1.4"
"43196","646",2023-11-24 22:45:00,-27869,1913,29782,907,TRUE,NA,"0.1.4"
"43197","646",2023-11-24 23:00:00,-27869,1913,29782,907,TRUE,NA,"0.1.4"
"43198","646",2023-11-24 23:15:00,-27869,1913,29782,907,TRUE,NA,"0.1.4"
"43199","646",2023-11-24 23:30:00,-27869,1913,29782,907,TRUE,NA,"0.1.4"
"43200","646",2023-11-24 23:45:00,-27869,1913,29782,907,TRUE,NA,"0.1.4"
"43201","646",2023-11-25,-27869,1913,29782,907,TRUE,NA,"0.1.4"
"43202","646",2023-11-25 00:15:00,-27869,1913,29782,907,TRUE,NA,"0.1.4"
"43203","646",2023-11-25 00:30:00,-27871,1913,29784,907,TRUE,NA,"0.1.4"
"43204","646",2023-11-25 00:45:00,-27885,1913,29798,907,TRUE,NA,"0.1.4"
"43205","646",2023-11-25 01:00:00,-27870,1913,29783,907,TRUE,NA,"0.1.4"
"43206","646",2023-11-25 01:15:00,-27997,1913,29910,907,TRUE,NA,"0.1.4"
"43207","646",2023-11-25 01:30:00,-28074,1913,29987,907,TRUE,NA,"0.1.4"
"43208","646",2023-11-25 01:45:00,-28079.1428571429,1913,29992.1428571429,907,TRUE,"out1, fill","0.1.4"
"43209","646",2023-11-25 02:00:00,-28084.2857142857,1913,29997.2857142857,907,TRUE,"out1, fill","0.1.4"
"43210","646",2023-11-25 02:15:00,-28089.4285714286,1913,30002.4285714286,907,TRUE,"out1, fill","0.1.4"
"43211","646",2023-11-25 02:30:00,-28094.5714285714,1913,30007.5714285714,907,TRUE,"out1, fill","0.1.4"
"43212","646",2023-11-25 02:45:00,-28099.7142857143,1913,30012.7142857143,907,TRUE,"out1, fill","0.1.4"
"43213","646",2023-11-25 03:00:00,-28104.8571428571,1913,30017.8571428571,907,TRUE,"out1, fill","0.1.4"
"43214","646",2023-11-25 03:15:00,-28110,1913,30023,907,TRUE,NA,"0.1.4"
"43215","646",2023-11-25 03:30:00,-28211,1913,30124,907,TRUE,NA,"0.1.4"
"43216","646",2023-11-25 03:45:00,-27989,1913,29902,907,TRUE,NA,"0.1.4"
"43217","646",2023-11-25 04:00:00,-28044.3333333333,1913,29957.3333333333,907,TRUE,"out1, fill","0.1.4"
"43218","646",2023-11-25 04:15:00,-28099.6666666667,1913,30012.6666666667,907,TRUE,"out1, fill","0.1.4"
"43219","646",2023-11-25 04:30:00,-28155,1913,30068,907,TRUE,"out1, fill","0.1.4"
"43220","646",2023-11-25 04:45:00,-28210.3333333333,1913,30123.3333333333,907,TRUE,"out1, fill","0.1.4"
"43221","646",2023-11-25 05:00:00,-28265.6666666667,1913,30178.6666666667,907,TRUE,"out1, fill","0.1.4"
"43222","646",2023-11-25 05:15:00,-28321,1913,30234,907,TRUE,NA,"0.1.4"
"43223","646",2023-11-25 05:30:00,-28223,1913,30136,907,TRUE,NA,"0.1.4"
"43224","646",2023-11-25 05:45:00,-28290,1913,30203,907,TRUE,NA,"0.1.4"
"43225","646",2023-11-25 06:00:00,-28298,1913,30211,907,TRUE,NA,"0.1.4"
"43226","646",2023-11-25 06:15:00,-28722.5,1913,30635.5,907,TRUE,"out1, fill","0.1.4"
"43227","646",2023-11-25 06:30:00,-29147,1913,31060,907,TRUE,NA,"0.1.4"
"43228","646",2023-11-25 06:45:00,-29319,1913,31232,907,TRUE,NA,"0.1.4"
"43229","646",2023-11-25 07:00:00,-29085,1913,30998,907,TRUE,NA,"0.1.4"
"43230","646",2023-11-25 07:15:00,-29200,1913,31113,907,TRUE,NA,"0.1.4"
"43231","646",2023-11-25 07:30:00,-29124,1913,31037,907,TRUE,NA,"0.1.4"
"43232","646",2023-11-25 07:45:00,-29209,1913,31122,907,TRUE,NA,"0.1.4"
"43233","646",2023-11-25 08:00:00,-29124,1913,31037,907,TRUE,NA,"0.1.4"
"43234","646",2023-11-25 08:15:00,-29120,1913,31033,907,TRUE,NA,"0.1.4"
"43235","646",2023-11-25 08:30:00,-29257,1913,31170,907,TRUE,NA,"0.1.4"
"43236","646",2023-11-25 08:45:00,-29280,1913,31193,907,TRUE,NA,"0.1.4"
"43237","646",2023-11-25 09:00:00,-29378,1913,31291,907,TRUE,NA,"0.1.4"
"43238","646",2023-11-25 09:15:00,-29246,1913,31159,907,TRUE,NA,"0.1.4"
"43239","646",2023-11-25 09:30:00,-29078,1913,30991,907,TRUE,NA,"0.1.4"
"43240","646",2023-11-25 09:45:00,-29029,1913,30942,907,TRUE,NA,"0.1.4"
"43241","646",2023-11-25 10:00:00,-29012,1913,30925,907,TRUE,NA,"0.1.4"
"43242","646",2023-11-25 10:15:00,-29037,1913,30950,907,TRUE,NA,"0.1.4"
"43243","646",2023-11-25 10:30:00,-29104,1913,31017,907,TRUE,NA,"0.1.4"
"43244","646",2023-11-25 10:45:00,-29114,1913,31027,907,TRUE,NA,"0.1.4"
"43245","646",2023-11-25 11:00:00,-29146,1913,31059,907,TRUE,NA,"0.1.4"
"43246","646",2023-11-25 11:15:00,-29251,1913,31164,907,TRUE,NA,"0.1.4"
"43247","646",2023-11-25 11:30:00,-29178,1913,31091,907,TRUE,NA,"0.1.4"
"43248","646",2023-11-25 11:45:00,-29049,1913,30962,907,TRUE,NA,"0.1.4"
"43249","646",2023-11-25 12:00:00,-29119,1913,31032,907,TRUE,NA,"0.1.4"
"43250","646",2023-11-25 12:15:00,-29002,1913,30915,907,TRUE,NA,"0.1.4"
"43251","646",2023-11-25 12:30:00,-29134,1913,31047,907,TRUE,NA,"0.1.4"
"43252","646",2023-11-25 12:45:00,-29229,1913,31142,907,TRUE,NA,"0.1.4"
"43253","646",2023-11-25 13:00:00,-29196,1913,31109,907,TRUE,"out1, fill","0.1.4"
"43254","646",2023-11-25 13:15:00,-29163,1913,31076,907,TRUE,NA,"0.1.4"
"43255","646",2023-11-25 13:30:00,-29150,1913,31063,907,TRUE,NA,"0.1.4"
"43256","646",2023-11-25 13:45:00,-29242,1913,31155,907,TRUE,NA,"0.1.4"
"43257","646",2023-11-25 14:00:00,-29210,1913,31123,907,TRUE,NA,"0.1.4"
"43258","646",2023-11-25 14:15:00,-29083,1913,30996,907,TRUE,NA,"0.1.4"
"43259","646",2023-11-25 14:30:00,-29358,1913,31271,907,TRUE,NA,"0.1.4"
"43260","646",2023-11-25 14:45:00,-29353,1913,31266,907,TRUE,NA,"0.1.4"
"43261","646",2023-11-25 15:00:00,-29241,1913,31154,907,TRUE,NA,"0.1.4"
"43262","646",2023-11-25 15:15:00,-29418,1913,31331,907,TRUE,NA,"0.1.4"
"43263","646",2023-11-25 15:30:00,-29395,1913,31308,907,TRUE,NA,"0.1.4"
"43264","646",2023-11-25 15:45:00,-29303,1913,31216,907,TRUE,NA,"0.1.4"
"43265","646",2023-11-25 16:00:00,-29364,1913,31277,907,TRUE,NA,"0.1.4"
"43266","646",2023-11-25 16:15:00,-29204,1913,31117,907,TRUE,NA,"0.1.4"
"43267","646",2023-11-25 16:30:00,-29257,1913,31170,907,TRUE,NA,"0.1.4"
"43268","646",2023-11-25 16:45:00,-29182,1913,31095,907,TRUE,NA,"0.1.4"
"43269","646",2023-11-25 17:00:00,-29122,1913,31035,907,TRUE,NA,"0.1.4"
"43270","646",2023-11-25 17:15:00,-29028,1913,30941,907,TRUE,NA,"0.1.4"
"43271","646",2023-11-25 17:30:00,-29160,1913,31073,907,TRUE,NA,"0.1.4"
"43272","646",2023-11-25 17:45:00,-29103,1913,31016,907,TRUE,NA,"0.1.4"
"43273","646",2023-11-25 18:00:00,-28973,1913,30886,907,TRUE,NA,"0.1.4"
"43274","646",2023-11-25 18:15:00,-29066,1913,30979,907,TRUE,NA,"0.1.4"
"43275","646",2023-11-25 18:30:00,-28771,1913,30684,907,TRUE,NA,"0.1.4"
"43276","646",2023-11-25 18:45:00,-28850,1913,30763,907,TRUE,NA,"0.1.4"
"43277","646",2023-11-25 19:00:00,-28915,1913,30828,907,TRUE,NA,"0.1.4"
"43278","646",2023-11-25 19:15:00,-28844.75,1913,30757.75,907,TRUE,"out1, fill","0.1.4"
"43279","646",2023-11-25 19:30:00,-28774.5,1913,30687.5,907,TRUE,"out1, fill","0.1.4"
"43280","646",2023-11-25 19:45:00,-28704.25,1913,30617.25,907,TRUE,"out1, fill","0.1.4"
"43281","646",2023-11-25 20:00:00,-28634,1913,30547,907,TRUE,NA,"0.1.4"
"43282","646",2023-11-25 20:15:00,-28984,1913,30897,907,TRUE,NA,"0.1.4"
"43283","646",2023-11-25 20:30:00,-28981,1913,30894,907,TRUE,NA,"0.1.4"
"43284","646",2023-11-25 20:45:00,-28776,1913,30689,907,TRUE,NA,"0.1.4"
"43285","646",2023-11-25 21:00:00,-28788,1913,30701,907,TRUE,NA,"0.1.4"
"43286","646",2023-11-25 21:15:00,-28831,1913,30744,907,TRUE,NA,"0.1.4"
"43287","646",2023-11-25 21:30:00,-28693,1913,30606,907,TRUE,NA,"0.1.4"
"43288","646",2023-11-25 21:45:00,-28826,1913,30739,907,TRUE,NA,"0.1.4"
"43289","646",2023-11-25 22:00:00,-28878,1913,30791,907,TRUE,NA,"0.1.4"
"43290","646",2023-11-25 22:15:00,-28924,1913,30837,907,TRUE,NA,"0.1.4"
"43291","646",2023-11-25 22:30:00,-28968,1913,30881,907,TRUE,NA,"0.1.4"
"43292","646",2023-11-25 22:45:00,-28870,1913,30783,907,TRUE,NA,"0.1.4"
"43293","646",2023-11-25 23:00:00,-28974,1913,30887,907,TRUE,NA,"0.1.4"
"43294","646",2023-11-25 23:15:00,-28734,1913,30647,907,TRUE,NA,"0.1.4"
"43295","646",2023-11-25 23:30:00,-28757,1913,30670,907,TRUE,NA,"0.1.4"
"43296","646",2023-11-25 23:45:00,-28777,1913,30690,907,TRUE,NA,"0.1.4"
"43297","646",2023-11-26,-28669,1913,30582,907,TRUE,NA,"0.1.4"
"43298","646",2023-11-26 00:15:00,-28710,1913,30623,907,TRUE,NA,"0.1.4"
"43299","646",2023-11-26 00:30:00,-28635,1913,30548,907,TRUE,NA,"0.1.4"
"43300","646",2023-11-26 00:45:00,-28578,1913,30491,907,TRUE,NA,"0.1.4"
"43301","646",2023-11-26 01:00:00,-28710,1913,30623,907,TRUE,NA,"0.1.4"
"43302","646",2023-11-26 01:15:00,-28710,1913,30623,907,TRUE,NA,"0.1.4"
"43303","646",2023-11-26 01:30:00,-28802,1913,30715,907,TRUE,NA,"0.1.4"
"43304","646",2023-11-26 01:45:00,-28800,1913,30713,907,TRUE,NA,"0.1.4"
"43305","646",2023-11-26 02:00:00,-28703,1913,30616,907,TRUE,NA,"0.1.4"
"43306","646",2023-11-26 02:15:00,-28959,1913,30872,907,TRUE,NA,"0.1.4"
"43307","646",2023-11-26 02:30:00,-28771,1913,30684,907,TRUE,NA,"0.1.4"
"43308","646",2023-11-26 02:45:00,-28615,1913,30528,907,TRUE,NA,"0.1.4"
"43309","646",2023-11-26 03:00:00,-28462,1913,30375,907,TRUE,"out1, fill","0.1.4"
"43310","646",2023-11-26 03:15:00,-28309,1913,30222,907,TRUE,"out1, fill","0.1.4"
"43311","646",2023-11-26 03:30:00,-28156,1913,30069,907,TRUE,NA,"0.1.4"
"43312","646",2023-11-26 03:45:00,-27887,1913,29800,907,TRUE,NA,"0.1.4"
"43313","646",2023-11-26 04:00:00,-27882,1913,29795,907,TRUE,NA,"0.1.4"
"43314","646",2023-11-26 04:15:00,-27885,1913,29798,907,TRUE,NA,"0.1.4"
"43315","646",2023-11-26 04:30:00,-27918,1913,29831,907,TRUE,NA,"0.1.4"
"43316","646",2023-11-26 04:45:00,-27868,1913,29781,907,TRUE,NA,"0.1.4"
"43317","646",2023-11-26 05:00:00,-27869,1913,29782,907,TRUE,NA,"0.1.4"
"43318","646",2023-11-26 05:15:00,-28189,1913,30102,907,TRUE,NA,"0.1.4"
"43319","646",2023-11-26 05:30:00,-28364.6,1913,30277.6,907,TRUE,"out1, fill","0.1.4"
"43320","646",2023-11-26 05:45:00,-28540.2,1913,30453.2,907,TRUE,"out1, fill","0.1.4"
"43321","646",2023-11-26 06:00:00,-28715.8,1913,30628.8,907,TRUE,"out1, fill","0.1.4"
"43322","646",2023-11-26 06:15:00,-28891.4,1913,30804.4,907,TRUE,"out1, fill","0.1.4"
"43323","646",2023-11-26 06:30:00,-29067,1913,30980,907,TRUE,NA,"0.1.4"
"43324","646",2023-11-26 06:45:00,-29113,1913,31026,907,TRUE,NA,"0.1.4"
"43325","646",2023-11-26 07:00:00,-29021,1913,30934,907,TRUE,NA,"0.1.4"
"43326","646",2023-11-26 07:15:00,-29043,1913,30956,907,TRUE,NA,"0.1.4"
"43327","646",2023-11-26 07:30:00,-28825,1913,30738,907,TRUE,NA,"0.1.4"
"43328","646",2023-11-26 07:45:00,-28444,1913,30357,907,TRUE,NA,"0.1.4"
"43329","646",2023-11-26 08:00:00,-28429,1913,30342,907,TRUE,NA,"0.1.4"
"43330","646",2023-11-26 08:15:00,-28676,1913,30589,907,TRUE,NA,"0.1.4"
"43331","646",2023-11-26 08:30:00,-28922,1913,30835,907,TRUE,NA,"0.1.4"
"43332","646",2023-11-26 08:45:00,-28844.375,1913,30757.375,907,TRUE,"out1, fill","0.1.4"
"43333","646",2023-11-26 09:00:00,-28766.75,1913,30679.75,907,TRUE,"out1, fill","0.1.4"
"43334","646",2023-11-26 09:15:00,-28689.125,1913,30602.125,907,TRUE,"out1, fill","0.1.4"
"43335","646",2023-11-26 09:30:00,-28611.5,1913,30524.5,907,TRUE,"out1, fill","0.1.4"
"43336","646",2023-11-26 09:45:00,-28533.875,1913,30446.875,907,TRUE,"out1, fill","0.1.4"
"43337","646",2023-11-26 10:00:00,-28456.25,1913,30369.25,907,TRUE,"out1, fill","0.1.4"
"43338","646",2023-11-26 10:15:00,-28378.625,1913,30291.625,907,TRUE,"out1, fill","0.1.4"
"43339","646",2023-11-26 10:30:00,-28301,1913,30214,907,TRUE,NA,"0.1.4"
"43340","646",2023-11-26 10:45:00,-28570,1913,30483,907,TRUE,NA,"0.1.4"
"43341","646",2023-11-26 11:00:00,-28467,1913,30380,907,TRUE,NA,"0.1.4"
"43342","646",2023-11-26 11:15:00,-28312,1913,30225,907,TRUE,NA,"0.1.4"
"43343","646",2023-11-26 11:30:00,-28389,1913,30302,907,TRUE,"out1, fill","0.1.4"
"43344","646",2023-11-26 11:45:00,-28466,1913,30379,907,TRUE,NA,"0.1.4"
"43345","646",2023-11-26 12:00:00,-28478,1913,30391,907,TRUE,NA,"0.1.4"
"43346","646",2023-11-26 12:15:00,-28386,1913,30299,907,TRUE,NA,"0.1.4"
"43347","646",2023-11-26 12:30:00,-28354,1913,30267,907,TRUE,NA,"0.1.4"
"43348","646",2023-11-26 12:45:00,-28348,1913,30261,907,TRUE,NA,"0.1.4"
"43349","646",2023-11-26 13:00:00,-28344,1913,30257,907,TRUE,NA,"0.1.4"
"43350","646",2023-11-26 13:15:00,-28362,1913,30275,907,TRUE,NA,"0.1.4"
"43351","646",2023-11-26 13:30:00,-28363,1913,30276,907,TRUE,NA,"0.1.4"
"43352","646",2023-11-26 13:45:00,-28377,1913,30290,907,TRUE,NA,"0.1.4"
"43353","646",2023-11-26 14:00:00,-28000,1913,29913,907,TRUE,NA,"0.1.4"
"43354","646",2023-11-26 14:15:00,-27868,1913,29781,907,TRUE,NA,"0.1.4"
"43355","646",2023-11-26 14:30:00,-27884,1913,29797,907,TRUE,NA,"0.1.4"
"43356","646",2023-11-26 14:45:00,-28204.5,1913,30117.5,907,TRUE,"out1, fill","0.1.4"
"43357","646",2023-11-26 15:00:00,-28525,1913,30438,907,TRUE,"out1, fill","0.1.4"
"43358","646",2023-11-26 15:15:00,-28845.5,1913,30758.5,907,TRUE,"out1, fill","0.1.4"
"43359","646",2023-11-26 15:30:00,-29166,1913,31079,907,TRUE,NA,"0.1.4"
"43360","646",2023-11-26 15:45:00,-29190,1913,31103,907,TRUE,NA,"0.1.4"
"43361","646",2023-11-26 16:00:00,-28989,1913,30902,907,TRUE,NA,"0.1.4"
"43362","646",2023-11-26 16:15:00,-29017.3333333333,1913,30930.3333333333,907,TRUE,"out1, fill","0.1.4"
"43363","646",2023-11-26 16:30:00,-29045.6666666667,1913,30958.6666666667,907,TRUE,"out1, fill","0.1.4"
"43364","646",2023-11-26 16:45:00,-29074,1913,30987,907,TRUE,NA,"0.1.4"
"43365","646",2023-11-26 17:00:00,-28722,1913,30635,907,TRUE,NA,"0.1.4"
"43366","646",2023-11-26 17:15:00,-28790,1913,30703,907,TRUE,NA,"0.1.4"
"43367","646",2023-11-26 17:30:00,-28675.1428571429,1913,30588.1428571429,907,TRUE,"out1, fill","0.1.4"
"43368","646",2023-11-26 17:45:00,-28560.2857142857,1913,30473.2857142857,907,TRUE,"out1, fill","0.1.4"
"43369","646",2023-11-26 18:00:00,-28445.4285714286,1913,30358.4285714286,907,TRUE,"out1, fill","0.1.4"
"43370","646",2023-11-26 18:15:00,-28330.5714285714,1913,30243.5714285714,907,TRUE,"out1, fill","0.1.4"
"43371","646",2023-11-26 18:30:00,-28215.7142857143,1913,30128.7142857143,907,TRUE,"out1, fill","0.1.4"
"43372","646",2023-11-26 18:45:00,-28100.8571428571,1913,30013.8571428571,907,TRUE,"out1, fill","0.1.4"
"43373","646",2023-11-26 19:00:00,-27986,1913,29899,907,TRUE,NA,"0.1.4"
"43374","646",2023-11-26 19:15:00,-27974,1913,29887,907,TRUE,NA,"0.1.4"
"43375","646",2023-11-26 19:30:00,-27996,1913,29909,907,TRUE,NA,"0.1.4"
"43376","646",2023-11-26 19:45:00,-28011,1913,29924,907,TRUE,NA,"0.1.4"
"43377","646",2023-11-26 20:00:00,-28010,1913,29923,907,TRUE,NA,"0.1.4"
"43378","646",2023-11-26 20:15:00,-28150,1913,30063,907,TRUE,NA,"0.1.4"
"43379","646",2023-11-26 20:30:00,-28553,1913,30466,907,TRUE,"out1, fill","0.1.4"
"43380","646",2023-11-26 20:45:00,-28956,1913,30869,907,TRUE,NA,"0.1.4"
"43381","646",2023-11-26 21:00:00,-29088,1913,31001,907,TRUE,NA,"0.1.4"
"43382","646",2023-11-26 21:15:00,-28994,1913,30907,907,TRUE,NA,"0.1.4"
"43383","646",2023-11-26 21:30:00,-29021,1913,30934,907,TRUE,"out1, fill","0.1.4"
"43384","646",2023-11-26 21:45:00,-29048,1913,30961,907,TRUE,"out1, fill","0.1.4"
"43385","646",2023-11-26 22:00:00,-29075,1913,30988,907,TRUE,NA,"0.1.4"
"43386","646",2023-11-26 22:15:00,-28891,1913,30804,907,TRUE,NA,"0.1.4"
"43387","646",2023-11-26 22:30:00,-29227,1913,31140,907,TRUE,NA,"0.1.4"
"43388","646",2023-11-26 22:45:00,-29220,1913,31133,907,TRUE,NA,"0.1.4"
"43389","646",2023-11-26 23:00:00,-29210,1913,31123,907,TRUE,NA,"0.1.4"
"43390","646",2023-11-26 23:15:00,-29264,1913,31177,907,TRUE,NA,"0.1.4"
"43391","646",2023-11-26 23:30:00,-29276,1913,31189,907,TRUE,NA,"0.1.4"
"43392","646",2023-11-26 23:45:00,-29242,1913,31155,907,TRUE,NA,"0.1.4"
"43393","646",2023-11-27,-28966,1913,30879,907,TRUE,NA,"0.1.4"
"43394","646",2023-11-27 00:15:00,-28620,1913,30533,907,TRUE,NA,"0.1.4"
"43395","646",2023-11-27 00:30:00,-28549,1913,30462,907,TRUE,NA,"0.1.4"
"43396","646",2023-11-27 00:45:00,-28779.5,1913,30692.5,907,TRUE,"out1, fill","0.1.4"
"43397","646",2023-11-27 01:00:00,-29010,1913,30923,907,TRUE,NA,"0.1.4"
"43398","646",2023-11-27 01:15:00,-29128,1913,31041,907,TRUE,NA,"0.1.4"
"43399","646",2023-11-27 01:30:00,-29199,1913,31112,907,TRUE,NA,"0.1.4"
"43400","646",2023-11-27 01:45:00,-28952,1913,30865,907,TRUE,NA,"0.1.4"
"43401","646",2023-11-27 02:00:00,-28973,1913,30886,907,TRUE,NA,"0.1.4"
"43402","646",2023-11-27 02:15:00,-28992,1913,30905,907,TRUE,NA,"0.1.4"
"43403","646",2023-11-27 02:30:00,-29080,1913,30993,907,TRUE,NA,"0.1.4"
"43404","646",2023-11-27 02:45:00,-29184,1913,31097,907,TRUE,NA,"0.1.4"
"43405","646",2023-11-27 03:00:00,-29198,1913,31111,907,TRUE,NA,"0.1.4"
"43406","646",2023-11-27 03:15:00,-29168,1913,31081,907,TRUE,NA,"0.1.4"
"43407","646",2023-11-27 03:30:00,-29234,1913,31147,907,TRUE,NA,"0.1.4"
"43408","646",2023-11-27 03:45:00,-29160,1913,31073,907,TRUE,NA,"0.1.4"
"43409","646",2023-11-27 04:00:00,-29200,1913,31113,907,TRUE,NA,"0.1.4"
"43410","646",2023-11-27 04:15:00,-29223,1913,31136,907,TRUE,NA,"0.1.4"
"43411","646",2023-11-27 04:30:00,-29232,1913,31145,907,TRUE,NA,"0.1.4"
"43412","646",2023-11-27 04:45:00,-29182,1913,31095,907,TRUE,NA,"0.1.4"
"43413","646",2023-11-27 05:00:00,-29174,1913,31087,907,TRUE,NA,"0.1.4"
"43414","646",2023-11-27 05:15:00,-28681,1913,30594,907,TRUE,"out1, fill","0.1.4"
"43415","646",2023-11-27 05:30:00,-28188,1913,30101,907,TRUE,NA,"0.1.4"
"43416","646",2023-11-27 05:45:00,-27971,1913,29884,907,TRUE,NA,"0.1.4"
"43417","646",2023-11-27 06:00:00,-27973,1913,29886,907,TRUE,NA,"0.1.4"
"43418","646",2023-11-27 06:15:00,-28326.3333333333,1913,30239.3333333333,907,TRUE,"out1, fill","0.1.4"
"43419","646",2023-11-27 06:30:00,-28679.6666666667,1913,30592.6666666667,907,TRUE,"out1, fill","0.1.4"
"43420","646",2023-11-27 06:45:00,-29033,1913,30946,907,TRUE,NA,"0.1.4"
"43421","646",2023-11-27 07:00:00,-29151,1913,31064,907,TRUE,NA,"0.1.4"
"43422","646",2023-11-27 07:15:00,-29206,1913,31119,907,TRUE,NA,"0.1.4"
"43423","646",2023-11-27 07:30:00,-29178,1913,31091,907,TRUE,NA,"0.1.4"
"43424","646",2023-11-27 07:45:00,-29186,1913,31099,907,TRUE,NA,"0.1.4"
"43425","646",2023-11-27 08:00:00,-29227,1913,31140,907,TRUE,NA,"0.1.4"
"43426","646",2023-11-27 08:15:00,-29250,1913,31163,907,TRUE,NA,"0.1.4"
"43427","646",2023-11-27 08:30:00,-29130,1913,31043,907,TRUE,NA,"0.1.4"
"43428","646",2023-11-27 08:45:00,-29090,1913,31003,907,TRUE,NA,"0.1.4"
"43429","646",2023-11-27 09:00:00,-29082,1913,30995,907,TRUE,NA,"0.1.4"
"43430","646",2023-11-27 09:15:00,-28913,1913,30826,907,TRUE,NA,"0.1.4"
"43431","646",2023-11-27 09:30:00,-29184,1913,31097,907,TRUE,NA,"0.1.4"
"43432","646",2023-11-27 09:45:00,-29168,1913,31081,907,TRUE,NA,"0.1.4"
"43433","646",2023-11-27 10:00:00,-29181,1913,31094,907,TRUE,NA,"0.1.4"
"43434","646",2023-11-27 10:15:00,-29237,1913,31150,907,TRUE,NA,"0.1.4"
"43435","646",2023-11-27 10:30:00,-29207,1913,31120,907,TRUE,NA,"0.1.4"
"43436","646",2023-11-27 10:45:00,-29259,1913,31172,907,TRUE,NA,"0.1.4"
"43437","646",2023-11-27 11:00:00,-29297,1913,31210,907,TRUE,NA,"0.1.4"
"43438","646",2023-11-27 11:15:00,-29279,1913,31192,907,TRUE,NA,"0.1.4"
"43439","646",2023-11-27 11:30:00,-29267,1913,31180,907,TRUE,NA,"0.1.4"
"43440","646",2023-11-27 11:45:00,-29225,1913,31138,907,TRUE,NA,"0.1.4"
"43441","646",2023-11-27 12:00:00,-29289,1913,31202,907,TRUE,NA,"0.1.4"
"43442","646",2023-11-27 12:15:00,-29272,1913,31185,907,TRUE,NA,"0.1.4"
"43443","646",2023-11-27 12:30:00,-29207,1913,31120,907,TRUE,NA,"0.1.4"
"43444","646",2023-11-27 12:45:00,-29131,1913,31044,907,TRUE,NA,"0.1.4"
"43445","646",2023-11-27 13:00:00,-29100,1913,31013,907,TRUE,NA,"0.1.4"
"43446","646",2023-11-27 13:15:00,-29173,1913,31086,907,TRUE,NA,"0.1.4"
"43447","646",2023-11-27 13:30:00,-29091,1913,31004,907,TRUE,NA,"0.1.4"
"43448","646",2023-11-27 13:45:00,-28927,1913,30840,907,TRUE,NA,"0.1.4"
"43449","646",2023-11-27 14:00:00,-28966,1913,30879,907,TRUE,NA,"0.1.4"
"43450","646",2023-11-27 14:15:00,-28802,1913,30715,907,TRUE,NA,"0.1.4"
"43451","646",2023-11-27 14:30:00,-29076,1913,30989,907,TRUE,NA,"0.1.4"
"43452","646",2023-11-27 14:45:00,-28742,1913,30655,907,TRUE,NA,"0.1.4"
"43453","646",2023-11-27 15:00:00,-29127,1913,31040,907,TRUE,NA,"0.1.4"
"43454","646",2023-11-27 15:15:00,-29119,1913,31032,907,TRUE,NA,"0.1.4"
"43455","646",2023-11-27 15:30:00,-29134,1913,31047,907,TRUE,NA,"0.1.4"
"43456","646",2023-11-27 15:45:00,-29071,1913,30984,907,TRUE,NA,"0.1.4"
"43457","646",2023-11-27 16:00:00,-29038,1913,30951,907,TRUE,NA,"0.1.4"
"43458","646",2023-11-27 16:15:00,-29039,1913,30952,907,TRUE,NA,"0.1.4"
"43459","646",2023-11-27 16:30:00,-29006,1913,30919,907,TRUE,NA,"0.1.4"
"43460","646",2023-11-27 16:45:00,-29081,1913,30994,907,TRUE,NA,"0.1.4"
"43461","646",2023-11-27 17:00:00,-29072,1913,30985,907,TRUE,NA,"0.1.4"
"43462","646",2023-11-27 17:15:00,-29080,1913,30993,907,TRUE,NA,"0.1.4"
"43463","646",2023-11-27 17:30:00,-29025,1913,30938,907,TRUE,NA,"0.1.4"
"43464","646",2023-11-27 17:45:00,-29064,1913,30977,907,TRUE,NA,"0.1.4"
"43465","646",2023-11-27 18:00:00,-29078,1913,30991,907,TRUE,NA,"0.1.4"
"43466","646",2023-11-27 18:15:00,-29062.3333333333,1913,30975.3333333333,907,TRUE,"out1, fill","0.1.4"
"43467","646",2023-11-27 18:30:00,-29046.6666666667,1913,30959.6666666667,907,TRUE,"out1, fill","0.1.4"
"43468","646",2023-11-27 18:45:00,-29031,1913,30944,907,TRUE,NA,"0.1.4"
"43469","646",2023-11-27 19:00:00,-28973,1913,30886,907,TRUE,NA,"0.1.4"
"43470","646",2023-11-27 19:15:00,-28964,1913,30877,907,TRUE,NA,"0.1.4"
"43471","646",2023-11-27 19:30:00,-28493.5,1913,30406.5,907,TRUE,"out1, fill","0.1.4"
"43472","646",2023-11-27 19:45:00,-28023,1913,29936,907,TRUE,NA,"0.1.4"
"43473","646",2023-11-27 20:00:00,-28021,1913,29934,907,TRUE,NA,"0.1.4"
"43474","646",2023-11-27 20:15:00,-28031,1913,29944,907,TRUE,NA,"0.1.4"
"43475","646",2023-11-27 20:30:00,-28527.5,1913,30440.5,907,TRUE,"out1, fill","0.1.4"
"43476","646",2023-11-27 20:45:00,-29024,1913,30937,907,TRUE,NA,"0.1.4"
"43477","646",2023-11-27 21:00:00,-29138,1913,31051,907,TRUE,NA,"0.1.4"
"43478","646",2023-11-27 21:15:00,-29024,1913,30937,907,TRUE,NA,"0.1.4"
"43479","646",2023-11-27 21:30:00,-29024,1913,30937,907,TRUE,"out1, fill","0.1.4"
"43480","646",2023-11-27 21:45:00,-29024,1913,30937,907,TRUE,"jump1","0.1.4"
"43481","646",2023-11-27 22:00:00,-29023,1913,30936,907,TRUE,NA,"0.1.4"
"43482","646",2023-11-27 22:15:00,-29027,1913,30940,907,TRUE,NA,"0.1.4"
"43483","646",2023-11-27 22:30:00,-29041,1913,30954,907,TRUE,NA,"0.1.4"
"43484","646",2023-11-27 22:45:00,-29022,1913,30935,907,TRUE,NA,"0.1.4"
"43485","646",2023-11-27 23:00:00,-29025,1913,30938,907,TRUE,NA,"0.1.4"
"43486","646",2023-11-27 23:15:00,-29022,1913,30935,907,TRUE,NA,"0.1.4"
"43487","646",2023-11-27 23:30:00,-29024,1913,30937,907,TRUE,NA,"0.1.4"
"43488","646",2023-11-27 23:45:00,-29484,1913,31397,907,TRUE,"out1, fill","0.1.4"
"43489","646",2023-11-28,-29944,1913,31857,907,TRUE,NA,"0.1.4"
"43490","646",2023-11-28 00:15:00,-29991,1913,31904,907,TRUE,NA,"0.1.4"
"43491","646",2023-11-28 00:30:00,-29740,1913,31653,907,TRUE,NA,"0.1.4"
"43492","646",2023-11-28 00:45:00,-29380.5,1913,31293.5,907,TRUE,"out1, fill","0.1.4"
"43493","646",2023-11-28 01:00:00,-29021,1913,30934,907,TRUE,NA,"0.1.4"
"43494","646",2023-11-28 01:15:00,-29022,1913,30935,907,TRUE,NA,"0.1.4"
"43495","646",2023-11-28 01:30:00,-29021,1913,30934,907,TRUE,NA,"0.1.4"
"43496","646",2023-11-28 01:45:00,-29020,1913,30933,907,TRUE,NA,"0.1.4"
"43497","646",2023-11-28 02:00:00,-29022,1913,30935,907,TRUE,NA,"0.1.4"
"43498","646",2023-11-28 02:15:00,-29007,1913,30920,907,TRUE,NA,"0.1.4"
"43499","646",2023-11-28 02:30:00,-29216,1913,31129,907,TRUE,NA,"0.1.4"
"43500","646",2023-11-28 02:45:00,-29078,1913,30991,907,TRUE,NA,"0.1.4"
"43501","646",2023-11-28 03:00:00,-29009,1913,30922,907,TRUE,NA,"0.1.4"
"43502","646",2023-11-28 03:15:00,-29008,1913,30921,907,TRUE,NA,"0.1.4"
"43503","646",2023-11-28 03:30:00,-29363,1913,31276,907,TRUE,NA,"0.1.4"
"43504","646",2023-11-28 03:45:00,-29181,1913,31094,907,TRUE,NA,"0.1.4"
"43505","646",2023-11-28 04:00:00,-29181,1913,31094,907,TRUE,"out1, fill","0.1.4"
"43506","646",2023-11-28 04:15:00,-29181,1913,31094,907,TRUE,"jump1","0.1.4"
"43507","646",2023-11-28 04:30:00,-29272,1913,31185,907,TRUE,NA,"0.1.4"
"43508","646",2023-11-28 04:45:00,-29158,1913,31071,907,TRUE,NA,"0.1.4"
"43509","646",2023-11-28 05:00:00,-29096,1913,31009,907,TRUE,"out1, fill","0.1.4"
"43510","646",2023-11-28 05:15:00,-29034,1913,30947,907,TRUE,"out1, fill","0.1.4"
"43511","646",2023-11-28 05:30:00,-28972,1913,30885,907,TRUE,"out1, fill","0.1.4"
"43512","646",2023-11-28 05:45:00,-28910,1913,30823,907,TRUE,"out1, fill","0.1.4"
"43513","646",2023-11-28 06:00:00,-28848,1913,30761,907,TRUE,"out1, fill","0.1.4"
"43514","646",2023-11-28 06:15:00,-28786,1913,30699,907,TRUE,NA,"0.1.4"
"43515","646",2023-11-28 06:30:00,-28719,1913,30632,907,TRUE,NA,"0.1.4"
"43516","646",2023-11-28 06:45:00,-28731,1913,30644,907,TRUE,NA,"0.1.4"
"43517","646",2023-11-28 07:00:00,-28773,1913,30686,907,TRUE,NA,"0.1.4"
"43518","646",2023-11-28 07:15:00,-28511,1913,30424,907,TRUE,NA,"0.1.4"
"43519","646",2023-11-28 07:30:00,-28334,1913,30247,907,TRUE,NA,"0.1.4"
"43520","646",2023-11-28 07:45:00,-28430.5714285714,1913,30343.5714285714,907,TRUE,"out1, fill","0.1.4"
"43521","646",2023-11-28 08:00:00,-28527.1428571429,1913,30440.1428571429,907,TRUE,"out1, fill","0.1.4"
"43522","646",2023-11-28 08:15:00,-28623.7142857143,1913,30536.7142857143,907,TRUE,"out1, fill","0.1.4"
"43523","646",2023-11-28 08:30:00,-28720.2857142857,1913,30633.2857142857,907,TRUE,"out1, fill","0.1.4"
"43524","646",2023-11-28 08:45:00,-28816.8571428571,1913,30729.8571428571,907,TRUE,"out1, fill","0.1.4"
"43525","646",2023-11-28 09:00:00,-28913.4285714286,1913,30826.4285714286,907,TRUE,"out1, fill","0.1.4"
"43526","646",2023-11-28 09:15:00,-29010,1913,30923,907,TRUE,NA,"0.1.4"
"43527","646",2023-11-28 09:30:00,-28959,1913,30872,907,TRUE,NA,"0.1.4"
"43528","646",2023-11-28 09:45:00,-29051,1913,30964,907,TRUE,NA,"0.1.4"
"43529","646",2023-11-28 10:00:00,-28929,1913,30842,907,TRUE,NA,"0.1.4"
"43530","646",2023-11-28 10:15:00,-28793,1913,30706,907,TRUE,NA,"0.1.4"
"43531","646",2023-11-28 10:30:00,-28868,1913,30781,907,TRUE,NA,"0.1.4"
"43532","646",2023-11-28 10:45:00,-28943,1913,30856,907,TRUE,NA,"0.1.4"
"43533","646",2023-11-28 11:00:00,-28887,1913,30800,907,TRUE,NA,"0.1.4"
"43534","646",2023-11-28 11:15:00,-28875,1913,30788,907,TRUE,NA,"0.1.4"
"43535","646",2023-11-28 11:30:00,-29030,1913,30943,907,TRUE,NA,"0.1.4"
"43536","646",2023-11-28 11:45:00,-29010,1913,30923,907,TRUE,NA,"0.1.4"
"43537","646",2023-11-28 12:00:00,-28972,1913,30885,907,TRUE,NA,"0.1.4"
"43538","646",2023-11-28 12:15:00,-28930,1913,30843,907,TRUE,NA,"0.1.4"
"43539","646",2023-11-28 12:30:00,-28905,1913,30818,907,TRUE,NA,"0.1.4"
"43540","646",2023-11-28 12:45:00,-29045,1913,30958,907,TRUE,NA,"0.1.4"
"43541","646",2023-11-28 13:00:00,-28942,1913,30855,907,TRUE,NA,"0.1.4"
"43542","646",2023-11-28 13:15:00,-28885,1913,30798,907,TRUE,NA,"0.1.4"
"43543","646",2023-11-28 13:30:00,-28849,1913,30762,907,TRUE,NA,"0.1.4"
"43544","646",2023-11-28 13:45:00,-28849,1913,30762,907,TRUE,NA,"0.1.4"
"43545","646",2023-11-28 14:00:00,-28868,1913,30781,907,TRUE,NA,"0.1.4"
"43546","646",2023-11-28 14:15:00,-28934,1913,30847,907,TRUE,NA,"0.1.4"
"43547","646",2023-11-28 14:30:00,-28930,1913,30843,907,TRUE,NA,"0.1.4"
"43548","646",2023-11-28 14:45:00,-28919,1913,30832,907,TRUE,NA,"0.1.4"
"43549","646",2023-11-28 15:00:00,-28912,1913,30825,907,TRUE,NA,"0.1.4"
"43550","646",2023-11-28 15:15:00,-28848,1913,30761,907,TRUE,NA,"0.1.4"
"43551","646",2023-11-28 15:30:00,-28893,1913,30806,907,TRUE,NA,"0.1.4"
"43552","646",2023-11-28 15:45:00,-28908,1913,30821,907,TRUE,NA,"0.1.4"
"43553","646",2023-11-28 16:00:00,-28898,1913,30811,907,TRUE,NA,"0.1.4"
"43554","646",2023-11-28 16:15:00,-28846,1913,30759,907,TRUE,NA,"0.1.4"
"43555","646",2023-11-28 16:30:00,-28741,1913,30654,907,TRUE,NA,"0.1.4"
"43556","646",2023-11-28 16:45:00,-28784,1913,30697,907,TRUE,NA,"0.1.4"
"43557","646",2023-11-28 17:00:00,-28862,1913,30775,907,TRUE,NA,"0.1.4"
"43558","646",2023-11-28 17:15:00,-28857,1913,30770,907,TRUE,NA,"0.1.4"
"43559","646",2023-11-28 17:30:00,-28933,1913,30846,907,TRUE,NA,"0.1.4"
"43560","646",2023-11-28 17:45:00,-28944,1913,30857,907,TRUE,NA,"0.1.4"
"43561","646",2023-11-28 18:00:00,-28960,1913,30873,907,TRUE,NA,"0.1.4"
"43562","646",2023-11-28 18:15:00,-28940,1913,30853,907,TRUE,NA,"0.1.4"
"43563","646",2023-11-28 18:30:00,-28833,1913,30746,907,TRUE,NA,"0.1.4"
"43564","646",2023-11-28 18:45:00,-29017,1913,30930,907,TRUE,NA,"0.1.4"
"43565","646",2023-11-28 19:00:00,-28830,1913,30743,907,TRUE,NA,"0.1.4"
"43566","646",2023-11-28 19:15:00,-28683,1913,30596,907,TRUE,NA,"0.1.4"
"43567","646",2023-11-28 19:30:00,-28994,1913,30907,907,TRUE,NA,"0.1.4"
"43568","646",2023-11-28 19:45:00,-28978,1913,30891,907,TRUE,NA,"0.1.4"
"43569","646",2023-11-28 20:00:00,-28870,1913,30783,907,TRUE,NA,"0.1.4"
"43570","646",2023-11-28 20:15:00,-28835,1913,30748,907,TRUE,NA,"0.1.4"
"43571","646",2023-11-28 20:30:00,-28967,1913,30880,907,TRUE,NA,"0.1.4"
"43572","646",2023-11-28 20:45:00,-28886,1913,30799,907,TRUE,NA,"0.1.4"
"43573","646",2023-11-28 21:00:00,-28848,1913,30761,907,TRUE,NA,"0.1.4"
"43574","646",2023-11-28 21:15:00,-28807,1913,30720,907,TRUE,NA,"0.1.4"
"43575","646",2023-11-28 21:30:00,-28761,1913,30674,907,TRUE,"out1, fill","0.1.4"
"43576","646",2023-11-28 21:45:00,-28715,1913,30628,907,TRUE,NA,"0.1.4"
"43577","646",2023-11-28 22:00:00,-28543,1913,30456,907,TRUE,NA,"0.1.4"
"43578","646",2023-11-28 22:15:00,-28886,1913,30799,907,TRUE,NA,"0.1.4"
"43579","646",2023-11-28 22:30:00,-28669,1913,30582,907,TRUE,NA,"0.1.4"
"43580","646",2023-11-28 22:45:00,-28949,1913,30862,907,TRUE,NA,"0.1.4"
"43581","646",2023-11-28 23:00:00,-28914.2857142857,1913,30827.2857142857,907,TRUE,"out1, fill","0.1.4"
"43582","646",2023-11-28 23:15:00,-28879.5714285714,1913,30792.5714285714,907,TRUE,"out1, fill","0.1.4"
"43583","646",2023-11-28 23:30:00,-28844.8571428571,1913,30757.8571428571,907,TRUE,"out1, fill","0.1.4"
"43584","646",2023-11-28 23:45:00,-28810.1428571429,1913,30723.1428571429,907,TRUE,"out1, fill","0.1.4"
"43585","646",2023-11-29,-28775.4285714286,1913,30688.4285714286,907,TRUE,"out1, fill","0.1.4"
"43586","646",2023-11-29 00:15:00,-28740.7142857143,1913,30653.7142857143,907,TRUE,"out1, fill","0.1.4"
"43587","646",2023-11-29 00:30:00,-28706,1913,30619,907,TRUE,NA,"0.1.4"
"43588","646",2023-11-29 00:45:00,-28467,1913,30380,907,TRUE,NA,"0.1.4"
"43589","646",2023-11-29 01:00:00,-28533,1913,30446,907,TRUE,NA,"0.1.4"
"43590","646",2023-11-29 01:15:00,-28405,1913,30318,907,TRUE,NA,"0.1.4"
"43591","646",2023-11-29 01:30:00,-28365,1913,30278,907,TRUE,NA,"0.1.4"
"43592","646",2023-11-29 01:45:00,-28461,1913,30374,907,TRUE,NA,"0.1.4"
"43593","646",2023-11-29 02:00:00,-28688,1913,30601,907,TRUE,NA,"0.1.4"
"43594","646",2023-11-29 02:15:00,-28518,1913,30431,907,TRUE,NA,"0.1.4"
"43595","646",2023-11-29 02:30:00,-28260,1913,30173,907,TRUE,NA,"0.1.4"
"43596","646",2023-11-29 02:45:00,-28456,1913,30369,907,TRUE,NA,"0.1.4"
"43597","646",2023-11-29 03:00:00,-28418.6666666667,1913,30331.6666666667,907,TRUE,"out1, fill","0.1.4"
"43598","646",2023-11-29 03:15:00,-28381.3333333333,1913,30294.3333333333,907,TRUE,"out1, fill","0.1.4"
"43599","646",2023-11-29 03:30:00,-28344,1913,30257,907,TRUE,NA,"0.1.4"
"43600","646",2023-11-29 03:45:00,-28349,1913,30262,907,TRUE,NA,"0.1.4"
"43601","646",2023-11-29 04:00:00,-28438,1913,30351,907,TRUE,NA,"0.1.4"
"43602","646",2023-11-29 04:15:00,-28425,1913,30338,907,TRUE,NA,"0.1.4"
"43603","646",2023-11-29 04:30:00,-28496,1913,30409,907,TRUE,NA,"0.1.4"
"43604","646",2023-11-29 04:45:00,-28373,1913,30286,907,TRUE,NA,"0.1.4"
"43605","646",2023-11-29 05:00:00,-28589,1913,30502,907,TRUE,NA,"0.1.4"
"43606","646",2023-11-29 05:15:00,-28407,1913,30320,907,TRUE,NA,"0.1.4"
"43607","646",2023-11-29 05:30:00,-28579,1913,30492,907,TRUE,NA,"0.1.4"
"43608","646",2023-11-29 05:45:00,-28557,1913,30470,907,TRUE,NA,"0.1.4"
"43609","646",2023-11-29 06:00:00,-28544,1913,30457,907,TRUE,NA,"0.1.4"
"43610","646",2023-11-29 06:15:00,-28520,1913,30433,907,TRUE,NA,"0.1.4"
"43611","646",2023-11-29 06:30:00,-28501,1913,30414,907,TRUE,NA,"0.1.4"
"43612","646",2023-11-29 06:45:00,-28516,1913,30429,907,TRUE,NA,"0.1.4"
"43613","646",2023-11-29 07:00:00,-28522,1913,30435,907,TRUE,NA,"0.1.4"
"43614","646",2023-11-29 07:15:00,-28487,1913,30400,907,TRUE,NA,"0.1.4"
"43615","646",2023-11-29 07:30:00,-28554,1913,30467,907,TRUE,NA,"0.1.4"
"43616","646",2023-11-29 07:45:00,-28431,1913,30344,907,TRUE,NA,"0.1.4"
"43617","646",2023-11-29 08:00:00,-28555,1913,30468,907,TRUE,NA,"0.1.4"
"43618","646",2023-11-29 08:15:00,-28731,1913,30644,907,TRUE,NA,"0.1.4"
"43619","646",2023-11-29 08:30:00,-28854,1913,30767,907,TRUE,NA,"0.1.4"
"43620","646",2023-11-29 08:45:00,-28762,1913,30675,907,TRUE,NA,"0.1.4"
"43621","646",2023-11-29 09:00:00,-28749,1913,30662,907,TRUE,NA,"0.1.4"
"43622","646",2023-11-29 09:15:00,-28820,1913,30733,907,TRUE,NA,"0.1.4"
"43623","646",2023-11-29 09:30:00,-28781,1913,30694,907,TRUE,NA,"0.1.4"
"43624","646",2023-11-29 09:45:00,-28830,1913,30743,907,TRUE,NA,"0.1.4"
"43625","646",2023-11-29 10:00:00,-28863,1913,30776,907,TRUE,NA,"0.1.4"
"43626","646",2023-11-29 10:15:00,-28829,1913,30742,907,TRUE,NA,"0.1.4"
"43627","646",2023-11-29 10:30:00,-28858,1913,30771,907,TRUE,NA,"0.1.4"
"43628","646",2023-11-29 10:45:00,-28847,1913,30760,907,TRUE,NA,"0.1.4"
"43629","646",2023-11-29 11:00:00,-28790,1913,30703,907,TRUE,NA,"0.1.4"
"43630","646",2023-11-29 11:15:00,-28847,1913,30760,907,TRUE,NA,"0.1.4"
"43631","646",2023-11-29 11:30:00,-28866,1913,30779,907,TRUE,NA,"0.1.4"
"43632","646",2023-11-29 11:45:00,-28802,1913,30715,907,TRUE,NA,"0.1.4"
"43633","646",2023-11-29 12:00:00,-28820,1913,30733,907,TRUE,NA,"0.1.4"
"43634","646",2023-11-29 12:15:00,-28809,1913,30722,907,TRUE,NA,"0.1.4"
"43635","646",2023-11-29 12:30:00,-28765,1913,30678,907,TRUE,NA,"0.1.4"
"43636","646",2023-11-29 12:45:00,-28721,1913,30634,907,TRUE,NA,"0.1.4"
"43637","646",2023-11-29 13:00:00,-28702,1913,30615,907,TRUE,NA,"0.1.4"
"43638","646",2023-11-29 13:15:00,-28504,1913,30417,907,TRUE,NA,"0.1.4"
"43639","646",2023-11-29 13:30:00,-28609.25,1913,30522.25,907,TRUE,"out1, fill","0.1.4"
"43640","646",2023-11-29 13:45:00,-28714.5,1913,30627.5,907,TRUE,"out1, fill","0.1.4"
"43641","646",2023-11-29 14:00:00,-28819.75,1913,30732.75,907,TRUE,"out1, fill","0.1.4"
"43642","646",2023-11-29 14:15:00,-28925,1913,30838,907,TRUE,NA,"0.1.4"
"43643","646",2023-11-29 14:30:00,-28957,1913,30870,907,TRUE,NA,"0.1.4"
"43644","646",2023-11-29 14:45:00,-28958,1913,30871,907,TRUE,NA,"0.1.4"
"43645","646",2023-11-29 15:00:00,-28968,1913,30881,907,TRUE,NA,"0.1.4"
"43646","646",2023-11-29 15:15:00,-29026,1913,30939,907,TRUE,NA,"0.1.4"
"43647","646",2023-11-29 15:30:00,-29052,1913,30965,907,TRUE,NA,"0.1.4"
"43648","646",2023-11-29 15:45:00,-28989,1913,30902,907,TRUE,NA,"0.1.4"
"43649","646",2023-11-29 16:00:00,-29054,1913,30967,907,TRUE,NA,"0.1.4"
"43650","646",2023-11-29 16:15:00,-28974,1913,30887,907,TRUE,NA,"0.1.4"
"43651","646",2023-11-29 16:30:00,-29029,1913,30942,907,TRUE,NA,"0.1.4"
"43652","646",2023-11-29 16:45:00,-28977,1913,30890,907,TRUE,NA,"0.1.4"
"43653","646",2023-11-29 17:00:00,-29050,1913,30963,907,TRUE,NA,"0.1.4"
"43654","646",2023-11-29 17:15:00,-29081,1913,30994,907,TRUE,NA,"0.1.4"
"43655","646",2023-11-29 17:30:00,-29020,1913,30933,907,TRUE,NA,"0.1.4"
"43656","646",2023-11-29 17:45:00,-28990,1913,30903,907,TRUE,NA,"0.1.4"
"43657","646",2023-11-29 18:00:00,-29041,1913,30954,907,TRUE,NA,"0.1.4"
"43658","646",2023-11-29 18:15:00,-29072,1913,30985,907,TRUE,NA,"0.1.4"
"43659","646",2023-11-29 18:30:00,-28773,1913,30686,907,TRUE,NA,"0.1.4"
"43660","646",2023-11-29 18:45:00,-28848,1913,30761,907,TRUE,NA,"0.1.4"
"43661","646",2023-11-29 19:00:00,-28757,1913,30670,907,TRUE,NA,"0.1.4"
"43662","646",2023-11-29 19:15:00,-29067,1913,30980,907,TRUE,NA,"0.1.4"
"43663","646",2023-11-29 19:30:00,-28887,1913,30800,907,TRUE,NA,"0.1.4"
"43664","646",2023-11-29 19:45:00,-28861,1913,30774,907,TRUE,NA,"0.1.4"
"43665","646",2023-11-29 20:00:00,-28929,1913,30842,907,TRUE,NA,"0.1.4"
"43666","646",2023-11-29 20:15:00,-28950,1913,30863,907,TRUE,NA,"0.1.4"
"43667","646",2023-11-29 20:30:00,-28858,1913,30771,907,TRUE,NA,"0.1.4"
"43668","646",2023-11-29 20:45:00,-28920,1913,30833,907,TRUE,NA,"0.1.4"
"43669","646",2023-11-29 21:00:00,-28948,1913,30861,907,TRUE,NA,"0.1.4"
"43670","646",2023-11-29 21:15:00,-28901,1913,30814,907,TRUE,NA,"0.1.4"
"43671","646",2023-11-29 21:30:00,-28934,1913,30847,907,TRUE,NA,"0.1.4"
"43672","646",2023-11-29 21:45:00,-28914,1913,30827,907,TRUE,NA,"0.1.4"
"43673","646",2023-11-29 22:00:00,-28896,1913,30809,907,TRUE,NA,"0.1.4"
"43674","646",2023-11-29 22:15:00,-28799,1913,30712,907,TRUE,NA,"0.1.4"
"43675","646",2023-11-29 22:30:00,-28976,1913,30889,907,TRUE,NA,"0.1.4"
"43676","646",2023-11-29 22:45:00,-28627,1913,30540,907,TRUE,NA,"0.1.4"
"43677","646",2023-11-29 23:00:00,-28733,1913,30646,907,TRUE,NA,"0.1.4"
"43678","646",2023-11-29 23:15:00,-28668,1913,30581,907,TRUE,NA,"0.1.4"
"43679","646",2023-11-29 23:30:00,-28753,1913,30666,907,TRUE,NA,"0.1.4"
"43680","646",2023-11-29 23:45:00,-28713,1913,30626,907,TRUE,NA,"0.1.4"
"43681","646",2023-11-30,-28996,1913,30909,907,TRUE,NA,"0.1.4"
"43682","646",2023-11-30 00:15:00,-28611,1913,30524,907,TRUE,"out1, fill","0.1.4"
"43683","646",2023-11-30 00:30:00,-28226,1913,30139,907,TRUE,NA,"0.1.4"
"43684","646",2023-11-30 00:45:00,-28188,1913,30101,907,TRUE,NA,"0.1.4"
"43685","646",2023-11-30 01:00:00,-28073,1913,29986,907,TRUE,NA,"0.1.4"
"43686","646",2023-11-30 01:15:00,-28076,1913,29989,907,TRUE,NA,"0.1.4"
"43687","646",2023-11-30 01:30:00,-28100,1913,30013,907,TRUE,NA,"0.1.4"
"43688","646",2023-11-30 01:45:00,-28094,1913,30007,907,TRUE,NA,"0.1.4"
"43689","646",2023-11-30 02:00:00,-28216.5,1913,30129.5,907,TRUE,"out1, fill","0.1.4"
"43690","646",2023-11-30 02:15:00,-28339,1913,30252,907,TRUE,NA,"0.1.4"
"43691","646",2023-11-30 02:30:00,-28262,1913,30175,907,TRUE,NA,"0.1.4"
"43692","646",2023-11-30 02:45:00,-28364,1913,30277,907,TRUE,NA,"0.1.4"
"43693","646",2023-11-30 03:00:00,-28216,1913,30129,907,TRUE,NA,"0.1.4"
"43694","646",2023-11-30 03:15:00,-28206,1913,30119,907,TRUE,NA,"0.1.4"
"43695","646",2023-11-30 03:30:00,-28218,1913,30131,907,TRUE,NA,"0.1.4"
"43696","646",2023-11-30 03:45:00,-28161,1913,30074,907,TRUE,NA,"0.1.4"
"43697","646",2023-11-30 04:00:00,-28392,1913,30305,907,TRUE,NA,"0.1.4"
"43698","646",2023-11-30 04:15:00,-28415,1913,30328,907,TRUE,NA,"0.1.4"
"43699","646",2023-11-30 04:30:00,-28547,1913,30460,907,TRUE,NA,"0.1.4"
"43700","646",2023-11-30 04:45:00,-28387,1913,30300,907,TRUE,NA,"0.1.4"
"43701","646",2023-11-30 05:00:00,-28508,1913,30421,907,TRUE,NA,"0.1.4"
"43702","646",2023-11-30 05:15:00,-28403,1913,30316,907,TRUE,NA,"0.1.4"
"43703","646",2023-11-30 05:30:00,-28430,1913,30343,907,TRUE,NA,"0.1.4"
"43704","646",2023-11-30 05:45:00,-28397,1913,30310,907,TRUE,NA,"0.1.4"
"43705","646",2023-11-30 06:00:00,-28298,1913,30211,907,TRUE,NA,"0.1.4"
"43706","646",2023-11-30 06:15:00,-28357,1913,30270,907,TRUE,NA,"0.1.4"
"43707","646",2023-11-30 06:30:00,-28332,1913,30245,907,TRUE,NA,"0.1.4"
"43708","646",2023-11-30 06:45:00,-28323,1913,30236,907,TRUE,NA,"0.1.4"
"43709","646",2023-11-30 07:00:00,-28338,1913,30251,907,TRUE,NA,"0.1.4"
"43710","646",2023-11-30 07:15:00,-28444,1913,30357,907,TRUE,NA,"0.1.4"
"43711","646",2023-11-30 07:30:00,-28363,1913,30276,907,TRUE,NA,"0.1.4"
"43712","646",2023-11-30 07:45:00,-28345,1913,30258,907,TRUE,NA,"0.1.4"
"43713","646",2023-11-30 08:00:00,-28363,1913,30276,907,TRUE,NA,"0.1.4"
"43714","646",2023-11-30 08:15:00,-28370,1913,30283,907,TRUE,NA,"0.1.4"
"43715","646",2023-11-30 08:30:00,-28337,1913,30250,907,TRUE,NA,"0.1.4"
"43716","646",2023-11-30 08:45:00,-28335,1913,30248,907,TRUE,NA,"0.1.4"
"43717","646",2023-11-30 09:00:00,-28358,1913,30271,907,TRUE,NA,"0.1.4"
"43718","646",2023-11-30 09:15:00,-28382,1913,30295,907,TRUE,NA,"0.1.4"
"43719","646",2023-11-30 09:30:00,-28356,1913,30269,907,TRUE,NA,"0.1.4"
"43720","646",2023-11-30 09:45:00,-28396,1913,30309,907,TRUE,NA,"0.1.4"
"43721","646",2023-11-30 10:00:00,-28373,1913,30286,907,TRUE,NA,"0.1.4"
"43722","646",2023-11-30 10:15:00,-28358,1913,30271,907,TRUE,NA,"0.1.4"
"43723","646",2023-11-30 10:30:00,-28346,1913,30259,907,TRUE,NA,"0.1.4"
"43724","646",2023-11-30 10:45:00,-28376,1913,30289,907,TRUE,NA,"0.1.4"
"43725","646",2023-11-30 11:00:00,-28416,1913,30329,907,TRUE,NA,"0.1.4"
"43726","646",2023-11-30 11:15:00,-28364,1913,30277,907,TRUE,NA,"0.1.4"
"43727","646",2023-11-30 11:30:00,-28389,1913,30302,907,TRUE,NA,"0.1.4"
"43728","646",2023-11-30 11:45:00,-28353,1913,30266,907,TRUE,NA,"0.1.4"
"43729","646",2023-11-30 12:00:00,-28342,1913,30255,907,TRUE,NA,"0.1.4"
"43730","646",2023-11-30 12:15:00,-28364,1913,30277,907,TRUE,NA,"0.1.4"
"43731","646",2023-11-30 12:30:00,-28339,1913,30252,907,TRUE,NA,"0.1.4"
"43732","646",2023-11-30 12:45:00,-28372,1913,30285,907,TRUE,NA,"0.1.4"
"43733","646",2023-11-30 13:00:00,-28360,1913,30273,907,TRUE,NA,"0.1.4"
"43734","646",2023-11-30 13:15:00,-28357,1913,30270,907,TRUE,NA,"0.1.4"
"43735","646",2023-11-30 13:30:00,-28374,1913,30287,907,TRUE,NA,"0.1.4"
"43736","646",2023-11-30 13:45:00,-28356,1913,30269,907,TRUE,NA,"0.1.4"
"43737","646",2023-11-30 14:00:00,-28371,1913,30284,907,TRUE,NA,"0.1.4"
"43738","646",2023-11-30 14:15:00,-28366,1913,30279,907,TRUE,NA,"0.1.4"
"43739","646",2023-11-30 14:30:00,-28379,1913,30292,907,TRUE,NA,"0.1.4"
"43740","646",2023-11-30 14:45:00,-28370,1913,30283,907,TRUE,NA,"0.1.4"
"43741","646",2023-11-30 15:00:00,-28370,1913,30283,907,TRUE,NA,"0.1.4"
"43742","646",2023-11-30 15:15:00,-28369,1913,30282,907,TRUE,NA,"0.1.4"
"43743","646",2023-11-30 15:30:00,-28367,1913,30280,907,TRUE,NA,"0.1.4"
"43744","646",2023-11-30 15:45:00,-28358,1913,30271,907,TRUE,NA,"0.1.4"
"43745","646",2023-11-30 16:00:00,-28375,1913,30288,907,TRUE,NA,"0.1.4"
"43746","646",2023-11-30 16:15:00,-28381,1913,30294,907,TRUE,NA,"0.1.4"
"43747","646",2023-11-30 16:30:00,-28371,1913,30284,907,TRUE,NA,"0.1.4"
"43748","646",2023-11-30 16:45:00,-28363,1913,30276,907,TRUE,NA,"0.1.4"
"43749","646",2023-11-30 17:00:00,-28381,1913,30294,907,TRUE,NA,"0.1.4"
"43750","646",2023-11-30 17:15:00,-28378,1913,30291,907,TRUE,NA,"0.1.4"
"43751","646",2023-11-30 17:30:00,-28238,1913,30151,907,TRUE,NA,"0.1.4"
"43752","646",2023-11-30 17:45:00,-28432,1913,30345,907,TRUE,NA,"0.1.4"
"43753","646",2023-11-30 18:00:00,-28345,1913,30258,907,TRUE,NA,"0.1.4"
"43754","646",2023-11-30 18:15:00,-28148,1913,30061,907,TRUE,NA,"0.1.4"
"43755","646",2023-11-30 18:30:00,-28178,1913,30091,907,TRUE,"out1, fill","0.1.4"
"43756","646",2023-11-30 18:45:00,-28208,1913,30121,907,TRUE,"out1, fill","0.1.4"
"43757","646",2023-11-30 19:00:00,-28238,1913,30151,907,TRUE,NA,"0.1.4"
"43758","646",2023-11-30 19:15:00,-28195,1913,30108,907,TRUE,NA,"0.1.4"
"43759","646",2023-11-30 19:30:00,-28314,1913,30227,907,TRUE,NA,"0.1.4"
"43760","646",2023-11-30 19:45:00,-28526,1913,30439,907,TRUE,NA,"0.1.4"
"43761","646",2023-11-30 20:00:00,-28512,1913,30425,907,TRUE,NA,"0.1.4"
"43762","646",2023-11-30 20:15:00,-28551,1913,30464,907,TRUE,NA,"0.1.4"
"43763","646",2023-11-30 20:30:00,-28781,1913,30694,907,TRUE,NA,"0.1.4"
"43764","646",2023-11-30 20:45:00,-28664,1913,30577,907,TRUE,NA,"0.1.4"
"43765","646",2023-11-30 21:00:00,-28986,1913,30899,907,TRUE,NA,"0.1.4"
"43766","646",2023-11-30 21:15:00,-29102,1913,31015,907,TRUE,NA,"0.1.4"
"43767","646",2023-11-30 21:30:00,-29027,1913,30940,907,TRUE,NA,"0.1.4"
"43768","646",2023-11-30 21:45:00,-28772.25,1913,30685.25,907,TRUE,"out1, fill","0.1.4"
"43769","646",2023-11-30 22:00:00,-28517.5,1913,30430.5,907,TRUE,"out1, fill","0.1.4"
"43770","646",2023-11-30 22:15:00,-28262.75,1913,30175.75,907,TRUE,"out1, fill","0.1.4"
"43771","646",2023-11-30 22:30:00,-28008,1913,29921,907,TRUE,NA,"0.1.4"
"43772","646",2023-11-30 22:45:00,-28008,1913,29921,907,TRUE,NA,"0.1.4"
"43773","646",2023-11-30 23:00:00,-28002,1913,29915,907,TRUE,NA,"0.1.4"
"43774","646",2023-11-30 23:15:00,-28002,1913,29915,907,TRUE,NA,"0.1.4"
"43775","646",2023-11-30 23:30:00,-27919,1913,29832,907,TRUE,NA,"0.1.4"
"43776","646",2023-11-30 23:45:00,-27910,1913,29823,907,TRUE,NA,"0.1.4"
"43777","646",2023-12-01,-27895,1913,29808,907,TRUE,NA,"0.1.4"
"43778","646",2023-12-01 00:15:00,-27900,1913,29813,907,TRUE,NA,"0.1.4"
"43779","646",2023-12-01 00:30:00,-27883,1913,29796,907,TRUE,NA,"0.1.4"
"43780","646",2023-12-01 00:45:00,-27884,1913,29797,907,TRUE,NA,"0.1.4"
"43781","646",2023-12-01 01:00:00,-27906,1913,29819,907,TRUE,NA,"0.1.4"
"43782","646",2023-12-01 01:15:00,-27897,1913,29810,907,TRUE,NA,"0.1.4"
"43783","646",2023-12-01 01:30:00,-27913,1913,29826,907,TRUE,NA,"0.1.4"
"43784","646",2023-12-01 01:45:00,-28134,1913,30047,907,TRUE,NA,"0.1.4"
"43785","646",2023-12-01 02:00:00,-28138,1913,30051,907,TRUE,NA,"0.1.4"
"43786","646",2023-12-01 02:15:00,-27962,1913,29875,907,TRUE,NA,"0.1.4"
"43787","646",2023-12-01 02:30:00,-28003,1913,29916,907,TRUE,NA,"0.1.4"
"43788","646",2023-12-01 02:45:00,-27989,1913,29902,907,TRUE,NA,"0.1.4"
"43789","646",2023-12-01 03:00:00,-27982,1913,29895,907,TRUE,NA,"0.1.4"
"43790","646",2023-12-01 03:15:00,-27986,1913,29899,907,TRUE,NA,"0.1.4"
"43791","646",2023-12-01 03:30:00,-27995,1913,29908,907,TRUE,NA,"0.1.4"
"43792","646",2023-12-01 03:45:00,-28307,1913,30220,907,TRUE,NA,"0.1.4"
"43793","646",2023-12-01 04:00:00,-28486.5,1913,30399.5,907,TRUE,"out1, fill","0.1.4"
"43794","646",2023-12-01 04:15:00,-28666,1913,30579,907,TRUE,NA,"0.1.4"
"43795","646",2023-12-01 04:30:00,-28844,1913,30757,907,TRUE,NA,"0.1.4"
"43796","646",2023-12-01 04:45:00,-28840,1913,30753,907,TRUE,NA,"0.1.4"
"43797","646",2023-12-01 05:00:00,-28832,1913,30745,907,TRUE,NA,"0.1.4"
"43798","646",2023-12-01 05:15:00,-28469,1913,30382,907,TRUE,NA,"0.1.4"
"43799","646",2023-12-01 05:30:00,-28647,1913,30560,907,TRUE,NA,"0.1.4"
"43800","646",2023-12-01 05:45:00,-28723,1913,30636,907,TRUE,NA,"0.1.4"
"43801","646",2023-12-01 06:00:00,-28677,1913,30590,907,TRUE,NA,"0.1.4"
"43802","646",2023-12-01 06:15:00,-28597,1913,30510,907,TRUE,NA,"0.1.4"
"43803","646",2023-12-01 06:30:00,-28589,1913,30502,907,TRUE,NA,"0.1.4"
"43804","646",2023-12-01 06:45:00,-28504,1913,30417,907,TRUE,NA,"0.1.4"
"43805","646",2023-12-01 07:00:00,-28539,1913,30452,907,TRUE,NA,"0.1.4"
"43806","646",2023-12-01 07:15:00,-28563,1913,30476,907,TRUE,NA,"0.1.4"
"43807","646",2023-12-01 07:30:00,-28556,1913,30469,907,TRUE,NA,"0.1.4"
"43808","646",2023-12-01 07:45:00,-28552,1913,30465,907,TRUE,NA,"0.1.4"
"43809","646",2023-12-01 08:00:00,-28445,1913,30358,907,TRUE,NA,"0.1.4"
"43810","646",2023-12-01 08:15:00,-28505,1913,30418,907,TRUE,NA,"0.1.4"
"43811","646",2023-12-01 08:30:00,-28535,1913,30448,907,TRUE,NA,"0.1.4"
"43812","646",2023-12-01 08:45:00,-28432,1913,30345,907,TRUE,NA,"0.1.4"
"43813","646",2023-12-01 09:00:00,-28437,1913,30350,907,TRUE,NA,"0.1.4"
"43814","646",2023-12-01 09:15:00,-28404,1913,30317,907,TRUE,NA,"0.1.4"
"43815","646",2023-12-01 09:30:00,-28067,1913,29980,907,TRUE,NA,"0.1.4"
"43816","646",2023-12-01 09:45:00,-28069,1913,29982,907,TRUE,NA,"0.1.4"
"43817","646",2023-12-01 10:00:00,-28261,1913,30174,907,TRUE,NA,"0.1.4"
"43818","646",2023-12-01 10:15:00,-28080,1913,29993,907,TRUE,NA,"0.1.4"
"43819","646",2023-12-01 10:30:00,-28101,1913,30014,907,TRUE,NA,"0.1.4"
"43820","646",2023-12-01 10:45:00,-28041,1913,29954,907,TRUE,NA,"0.1.4"
"43821","646",2023-12-01 11:00:00,-28002,1913,29915,907,TRUE,NA,"0.1.4"
"43822","646",2023-12-01 11:15:00,-28025,1913,29938,907,TRUE,NA,"0.1.4"
"43823","646",2023-12-01 11:30:00,-28205,1913,30118,907,TRUE,NA,"0.1.4"
"43824","646",2023-12-01 11:45:00,-28205,1913,30118,907,TRUE,NA,"0.1.4"
"43825","646",2023-12-01 12:00:00,-28115,1913,30028,907,TRUE,NA,"0.1.4"
"43826","646",2023-12-01 12:15:00,-27988,1913,29901,907,TRUE,NA,"0.1.4"
"43827","646",2023-12-01 12:30:00,-28069,1913,29982,907,TRUE,NA,"0.1.4"
"43828","646",2023-12-01 12:45:00,-28328,1913,30241,907,TRUE,NA,"0.1.4"
"43829","646",2023-12-01 13:00:00,-28219.75,1913,30132.75,907,TRUE,"out1, fill","0.1.4"
"43830","646",2023-12-01 13:15:00,-28111.5,1913,30024.5,907,TRUE,"out1, fill","0.1.4"
"43831","646",2023-12-01 13:30:00,-28003.25,1913,29916.25,907,TRUE,"out1, fill","0.1.4"
"43832","646",2023-12-01 13:45:00,-27895,1913,29808,907,TRUE,NA,"0.1.4"
"43833","646",2023-12-01 14:00:00,-27883,1913,29796,907,TRUE,NA,"0.1.4"
"43834","646",2023-12-01 14:15:00,-27885,1913,29798,907,TRUE,NA,"0.1.4"
"43835","646",2023-12-01 14:30:00,-27886,1913,29799,907,TRUE,NA,"0.1.4"
"43836","646",2023-12-01 14:45:00,-27884,1913,29797,907,TRUE,NA,"0.1.4"
"43837","646",2023-12-01 15:00:00,-27885,1913,29798,907,TRUE,NA,"0.1.4"
"43838","646",2023-12-01 15:15:00,-27885,1913,29798,907,TRUE,NA,"0.1.4"
"43839","646",2023-12-01 15:30:00,-27885,1913,29798,907,TRUE,NA,"0.1.4"
"43840","646",2023-12-01 15:45:00,-27885,1913,29798,907,TRUE,NA,"0.1.4"
"43841","646",2023-12-01 16:00:00,-27885,1913,29798,907,TRUE,NA,"0.1.4"
"43842","646",2023-12-01 16:15:00,-27885,1913,29798,907,TRUE,NA,"0.1.4"
"43843","646",2023-12-01 16:30:00,-27886,1913,29799,907,TRUE,NA,"0.1.4"
"43844","646",2023-12-01 16:45:00,-27886,1913,29799,907,TRUE,NA,"0.1.4"
"43845","646",2023-12-01 17:00:00,-27887,1913,29800,907,TRUE,NA,"0.1.4"
"43846","646",2023-12-01 17:15:00,-27886,1913,29799,907,TRUE,NA,"0.1.4"
"43847","646",2023-12-01 17:30:00,-27887,1913,29800,907,TRUE,NA,"0.1.4"
"43848","646",2023-12-01 17:45:00,-27891,1913,29804,907,TRUE,NA,"0.1.4"
"43849","646",2023-12-01 18:00:00,-27898,1913,29811,907,TRUE,NA,"0.1.4"
"43850","646",2023-12-01 18:15:00,-27900,1913,29813,907,TRUE,NA,"0.1.4"
"43851","646",2023-12-01 18:30:00,-27886,1913,29799,907,TRUE,NA,"0.1.4"
"43852","646",2023-12-01 18:45:00,-27890,1913,29803,907,TRUE,NA,"0.1.4"
"43853","646",2023-12-01 19:00:00,-27884,1913,29797,907,TRUE,NA,"0.1.4"
"43854","646",2023-12-01 19:15:00,-27887,1913,29800,907,TRUE,NA,"0.1.4"
"43855","646",2023-12-01 19:30:00,-27897,1913,29810,907,TRUE,NA,"0.1.4"
"43856","646",2023-12-01 19:45:00,-27901,1913,29814,907,TRUE,NA,"0.1.4"
"43857","646",2023-12-01 20:00:00,-28052,1913,29965,907,TRUE,NA,"0.1.4"
"43858","646",2023-12-01 20:15:00,-27909,1913,29822,907,TRUE,NA,"0.1.4"
"43859","646",2023-12-01 20:30:00,-28019,1913,29932,907,TRUE,NA,"0.1.4"
"43860","646",2023-12-01 20:45:00,-28005,1913,29918,907,TRUE,NA,"0.1.4"
"43861","646",2023-12-01 21:00:00,-28045,1913,29958,907,TRUE,NA,"0.1.4"
"43862","646",2023-12-01 21:15:00,-28195,1913,30108,907,TRUE,NA,"0.1.4"
"43863","646",2023-12-01 21:30:00,-28272,1913,30185,907,TRUE,NA,"0.1.4"
"43864","646",2023-12-01 21:45:00,-28042,1913,29955,907,TRUE,NA,"0.1.4"
"43865","646",2023-12-01 22:00:00,-28233,1913,30146,907,TRUE,"out1, fill","0.1.4"
"43866","646",2023-12-01 22:15:00,-28424,1913,30337,907,TRUE,NA,"0.1.4"
"43867","646",2023-12-01 22:30:00,-28438,1913,30351,907,TRUE,NA,"0.1.4"
"43868","646",2023-12-01 22:45:00,-28146,1913,30059,907,TRUE,NA,"0.1.4"
"43869","646",2023-12-01 23:00:00,-28172,1913,30085,907,TRUE,NA,"0.1.4"
"43870","646",2023-12-01 23:15:00,-28215,1913,30128,907,TRUE,NA,"0.1.4"
"43871","646",2023-12-01 23:30:00,-28120,1913,30033,907,TRUE,NA,"0.1.4"
"43872","646",2023-12-01 23:45:00,-28096,1913,30009,907,TRUE,NA,"0.1.4"
"43873","646",2023-12-02,-28132,1913,30045,907,TRUE,NA,"0.1.4"
"43874","646",2023-12-02 00:15:00,-28252,1913,30165,907,TRUE,NA,"0.1.4"
"43875","646",2023-12-02 00:30:00,-28498,1913,30411,907,TRUE,NA,"0.1.4"
"43876","646",2023-12-02 00:45:00,-28508,1913,30421,907,TRUE,NA,"0.1.4"
"43877","646",2023-12-02 01:00:00,-28415,1913,30328,907,TRUE,NA,"0.1.4"
"43878","646",2023-12-02 01:15:00,-28329,1913,30242,907,TRUE,NA,"0.1.4"
"43879","646",2023-12-02 01:30:00,-28124,1913,30037,907,TRUE,NA,"0.1.4"
"43880","646",2023-12-02 01:45:00,-28182,1913,30095,907,TRUE,NA,"0.1.4"
"43881","646",2023-12-02 02:00:00,-28514,1913,30427,907,TRUE,NA,"0.1.4"
"43882","646",2023-12-02 02:15:00,-28240,1913,30153,907,TRUE,"out1, fill","0.1.4"
"43883","646",2023-12-02 02:30:00,-27966,1913,29879,907,TRUE,NA,"0.1.4"
"43884","646",2023-12-02 02:45:00,-27908,1913,29821,907,TRUE,NA,"0.1.4"
"43885","646",2023-12-02 03:00:00,-27946,1913,29859,907,TRUE,NA,"0.1.4"
"43886","646",2023-12-02 03:15:00,-27935,1913,29848,907,TRUE,NA,"0.1.4"
"43887","646",2023-12-02 03:30:00,-27930,1913,29843,907,TRUE,NA,"0.1.4"
"43888","646",2023-12-02 03:45:00,-27935,1913,29848,907,TRUE,NA,"0.1.4"
"43889","646",2023-12-02 04:00:00,-27924,1913,29837,907,TRUE,NA,"0.1.4"
"43890","646",2023-12-02 04:15:00,-27919,1913,29832,907,TRUE,NA,"0.1.4"
"43891","646",2023-12-02 04:30:00,-27919,1913,29832,907,TRUE,NA,"0.1.4"
"43892","646",2023-12-02 04:45:00,-27922,1913,29835,907,TRUE,NA,"0.1.4"
"43893","646",2023-12-02 05:00:00,-27918,1913,29831,907,TRUE,NA,"0.1.4"
"43894","646",2023-12-02 05:15:00,-27919,1913,29832,907,TRUE,NA,"0.1.4"
"43895","646",2023-12-02 05:30:00,-27916,1913,29829,907,TRUE,NA,"0.1.4"
"43896","646",2023-12-02 05:45:00,-27917,1913,29830,907,TRUE,NA,"0.1.4"
"43897","646",2023-12-02 06:00:00,-27918,1913,29831,907,TRUE,NA,"0.1.4"
"43898","646",2023-12-02 06:15:00,-27917,1913,29830,907,TRUE,NA,"0.1.4"
"43899","646",2023-12-02 06:30:00,-27918,1913,29831,907,TRUE,NA,"0.1.4"
"43900","646",2023-12-02 06:45:00,-27917,1913,29830,907,TRUE,NA,"0.1.4"
"43901","646",2023-12-02 07:00:00,-27918,1913,29831,907,TRUE,NA,"0.1.4"
"43902","646",2023-12-02 07:15:00,-27918,1913,29831,907,TRUE,NA,"0.1.4"
"43903","646",2023-12-02 07:30:00,-27917,1913,29830,907,TRUE,NA,"0.1.4"
"43904","646",2023-12-02 07:45:00,-27918,1913,29831,907,TRUE,NA,"0.1.4"
"43905","646",2023-12-02 08:00:00,-27917,1913,29830,907,TRUE,NA,"0.1.4"
"43906","646",2023-12-02 08:15:00,-27917,1913,29830,907,TRUE,NA,"0.1.4"
"43907","646",2023-12-02 08:30:00,-27916,1913,29829,907,TRUE,NA,"0.1.4"
"43908","646",2023-12-02 08:45:00,-27918,1913,29831,907,TRUE,NA,"0.1.4"
"43909","646",2023-12-02 09:00:00,-27920,1913,29833,907,TRUE,NA,"0.1.4"
"43910","646",2023-12-02 09:15:00,-27918,1913,29831,907,TRUE,NA,"0.1.4"
"43911","646",2023-12-02 09:30:00,-27917,1913,29830,907,TRUE,NA,"0.1.4"
"43912","646",2023-12-02 09:45:00,-27918,1913,29831,907,TRUE,NA,"0.1.4"
"43913","646",2023-12-02 10:00:00,-27919,1913,29832,907,TRUE,NA,"0.1.4"
"43914","646",2023-12-02 10:15:00,-27919,1913,29832,907,TRUE,NA,"0.1.4"
"43915","646",2023-12-02 10:30:00,-27919,1913,29832,907,TRUE,NA,"0.1.4"
"43916","646",2023-12-02 10:45:00,-27919,1913,29832,907,TRUE,NA,"0.1.4"
"43917","646",2023-12-02 11:00:00,-27932,1913,29845,907,TRUE,NA,"0.1.4"
"43918","646",2023-12-02 11:15:00,-27931,1913,29844,907,TRUE,NA,"0.1.4"
"43919","646",2023-12-02 11:30:00,-27932,1913,29845,907,TRUE,NA,"0.1.4"
"43920","646",2023-12-02 11:45:00,-27932,1913,29845,907,TRUE,NA,"0.1.4"
"43921","646",2023-12-02 12:00:00,-27931,1913,29844,907,TRUE,NA,"0.1.4"
"43922","646",2023-12-02 12:15:00,-27931,1913,29844,907,TRUE,NA,"0.1.4"
"43923","646",2023-12-02 12:30:00,-27929,1913,29842,907,TRUE,NA,"0.1.4"
"43924","646",2023-12-02 12:45:00,-27921,1913,29834,907,TRUE,NA,"0.1.4"
"43925","646",2023-12-02 13:00:00,-27920,1913,29833,907,TRUE,NA,"0.1.4"
"43926","646",2023-12-02 13:15:00,-27920,1913,29833,907,TRUE,NA,"0.1.4"
"43927","646",2023-12-02 13:30:00,-27919,1913,29832,907,TRUE,NA,"0.1.4"
"43928","646",2023-12-02 13:45:00,-27922,1913,29835,907,TRUE,NA,"0.1.4"
"43929","646",2023-12-02 14:00:00,-27929,1913,29842,907,TRUE,NA,"0.1.4"
"43930","646",2023-12-02 14:15:00,-27922,1913,29835,907,TRUE,NA,"0.1.4"
"43931","646",2023-12-02 14:30:00,-27924,1913,29837,907,TRUE,NA,"0.1.4"
"43932","646",2023-12-02 14:45:00,-27920,1913,29833,907,TRUE,NA,"0.1.4"
"43933","646",2023-12-02 15:00:00,-27919,1913,29832,907,TRUE,NA,"0.1.4"
"43934","646",2023-12-02 15:15:00,-27914,1913,29827,907,TRUE,NA,"0.1.4"
"43935","646",2023-12-02 15:30:00,-27913,1913,29826,907,TRUE,NA,"0.1.4"
"43936","646",2023-12-02 15:45:00,-27897,1913,29810,907,TRUE,NA,"0.1.4"
"43937","646",2023-12-02 16:00:00,-27918,1913,29831,907,TRUE,"out1, fill","0.1.4"
"43938","646",2023-12-02 16:15:00,-27939,1913,29852,907,TRUE,"out1, fill","0.1.4"
"43939","646",2023-12-02 16:30:00,-27960,1913,29873,907,FALSE,"out1, fill","0.1.4"
"43940","646",2023-12-02 16:45:00,-27981,1913,29894,907,FALSE,"out1, fill","0.1.4"
"43941","646",2023-12-02 17:00:00,-28002,1913,29915,907,FALSE,NA,"0.1.4"
"43942","646",2023-12-02 17:15:00,-28002,1913,29915,907,FALSE,NA,"0.1.4"
"43943","646",2023-12-02 17:30:00,-28002,1913,29915,907,FALSE,NA,"0.1.4"
"43944","646",2023-12-02 17:45:00,-28000,1913,29913,907,FALSE,NA,"0.1.4"
"43945","646",2023-12-02 18:00:00,-28015,1913,29928,907,FALSE,NA,"0.1.4"
"43946","646",2023-12-02 18:15:00,-28000,1913,29913,907,FALSE,NA,"0.1.4"
"43947","646",2023-12-02 18:30:00,-28000,1913,29913,907,FALSE,NA,"0.1.4"
"43948","646",2023-12-02 18:45:00,-28000,1913,29913,907,FALSE,NA,"0.1.4"
"43949","646",2023-12-02 19:00:00,-28000,1913,29913,907,FALSE,NA,"0.1.4"
"43950","646",2023-12-02 19:15:00,-28000,1913,29913,907,FALSE,NA,"0.1.4"
"43951","646",2023-12-02 19:30:00,-28240,1913,30153,907,FALSE,"out1, fill","0.1.4"
"43952","646",2023-12-02 19:45:00,-28480,1913,30393,907,FALSE,NA,"0.1.4"
"43953","646",2023-12-02 20:00:00,-28126,1913,30039,907,FALSE,NA,"0.1.4"
"43954","646",2023-12-02 20:15:00,-28035,1913,29948,907,FALSE,NA,"0.1.4"
"43955","646",2023-12-02 20:30:00,-28037,1913,29950,907,FALSE,NA,"0.1.4"
"43956","646",2023-12-02 20:45:00,-28072,1913,29985,907,FALSE,NA,"0.1.4"
"43957","646",2023-12-02 21:00:00,-28154,1913,30067,907,FALSE,NA,"0.1.4"
"43958","646",2023-12-02 21:15:00,-28165,1913,30078,907,FALSE,NA,"0.1.4"
"43959","646",2023-12-02 21:30:00,-28243,1913,30156,907,FALSE,NA,"0.1.4"
"43960","646",2023-12-02 21:45:00,-28346,1913,30259,907,FALSE,NA,"0.1.4"
"43961","646",2023-12-02 22:00:00,-28490,1913,30403,907,FALSE,NA,"0.1.4"
"43962","646",2023-12-02 22:15:00,-28453,1913,30366,907,FALSE,NA,"0.1.4"
"43963","646",2023-12-02 22:30:00,-28524,1913,30437,907,FALSE,NA,"0.1.4"
"43964","646",2023-12-02 22:45:00,-28603,1913,30516,907,FALSE,NA,"0.1.4"
"43965","646",2023-12-02 23:00:00,-28622,1913,30535,907,FALSE,NA,"0.1.4"
"43966","646",2023-12-02 23:15:00,-28240,1913,30153,907,FALSE,NA,"0.1.4"
"43967","646",2023-12-02 23:30:00,-28382,1913,30295,907,FALSE,NA,"0.1.4"
"43968","646",2023-12-02 23:45:00,-28592,1913,30505,907,FALSE,NA,"0.1.4"
"43969","646",2023-12-03,-28592,1913,30505,907,FALSE,"jump1","0.1.4"
"43970","646",2023-12-03 00:15:00,-28592,1913,30505,907,FALSE,"jump1","0.1.4"
"43971","646",2023-12-03 00:30:00,-28208.5,1913,30121.5,907,FALSE,"out1, fill","0.1.4"
"43972","646",2023-12-03 00:45:00,-27825,1913,29738,907,FALSE,NA,"0.1.4"
"43973","646",2023-12-03 01:00:00,-27822,1913,29735,907,FALSE,NA,"0.1.4"
"43974","646",2023-12-03 01:15:00,-27821,1913,29734,907,FALSE,NA,"0.1.4"
"43975","646",2023-12-03 01:30:00,-27821,1913,29734,907,FALSE,NA,"0.1.4"
"43976","646",2023-12-03 01:45:00,-27820,1913,29733,907,FALSE,NA,"0.1.4"
"43977","646",2023-12-03 02:00:00,-27820,1913,29733,907,FALSE,NA,"0.1.4"
"43978","646",2023-12-03 02:15:00,-27820,1913,29733,907,FALSE,NA,"0.1.4"
"43979","646",2023-12-03 02:30:00,-27820,1913,29733,907,FALSE,NA,"0.1.4"
"43980","646",2023-12-03 02:45:00,-27820,1913,29733,907,FALSE,NA,"0.1.4"
"43981","646",2023-12-03 03:00:00,-27819,1913,29732,907,FALSE,NA,"0.1.4"
"43982","646",2023-12-03 03:15:00,-27819,1913,29732,907,FALSE,NA,"0.1.4"
"43983","646",2023-12-03 03:30:00,-27819,1913,29732,907,FALSE,NA,"0.1.4"
"43984","646",2023-12-03 03:45:00,-27834,1913,29747,907,FALSE,NA,"0.1.4"
"43985","646",2023-12-03 04:00:00,-27831,1913,29744,907,FALSE,NA,"0.1.4"
"43986","646",2023-12-03 04:15:00,-27829,1913,29742,907,FALSE,NA,"0.1.4"
"43987","646",2023-12-03 04:30:00,-27825,1913,29738,907,FALSE,NA,"0.1.4"
"43988","646",2023-12-03 04:45:00,-27822,1913,29735,907,FALSE,NA,"0.1.4"
"43989","646",2023-12-03 05:00:00,-27819,1913,29732,907,FALSE,NA,"0.1.4"
"43990","646",2023-12-03 05:15:00,-27819,1913,29732,907,FALSE,NA,"0.1.4"
"43991","646",2023-12-03 05:30:00,-27819,1913,29732,907,FALSE,NA,"0.1.4"
"43992","646",2023-12-03 05:45:00,-27819,1913,29732,907,FALSE,NA,"0.1.4"
"43993","646",2023-12-03 06:00:00,-27819,1913,29732,907,FALSE,NA,"0.1.4"
"43994","646",2023-12-03 06:15:00,-27819,1913,29732,907,FALSE,NA,"0.1.4"
"43995","646",2023-12-03 06:30:00,-27819,1913,29732,907,FALSE,NA,"0.1.4"
"43996","646",2023-12-03 06:45:00,-27819,1913,29732,907,FALSE,NA,"0.1.4"
"43997","646",2023-12-03 07:00:00,-27819,1913,29732,907,FALSE,NA,"0.1.4"
"43998","646",2023-12-03 07:15:00,-27819,1913,29732,907,FALSE,NA,"0.1.4"
"43999","646",2023-12-03 07:30:00,-27819,1913,29732,907,FALSE,NA,"0.1.4"
"44000","646",2023-12-03 07:45:00,-27819,1913,29732,907,FALSE,NA,"0.1.4"
"44001","646",2023-12-03 08:00:00,-27819,1913,29732,907,FALSE,NA,"0.1.4"
"44002","646",2023-12-03 08:15:00,-27819,1913,29732,907,FALSE,NA,"0.1.4"
"44003","646",2023-12-03 08:30:00,-27819,1913,29732,907,FALSE,NA,"0.1.4"
"44004","646",2023-12-03 08:45:00,-27819,1913,29732,907,FALSE,NA,"0.1.4"
"44005","646",2023-12-03 09:00:00,-27819,1913,29732,907,FALSE,NA,"0.1.4"
"44006","646",2023-12-03 09:15:00,-27819,1913,29732,907,FALSE,NA,"0.1.4"
"44007","646",2023-12-03 09:30:00,-27819,1913,29732,907,TRUE,NA,"0.1.4"
"44008","646",2023-12-03 09:45:00,-27819,1913,29732,907,TRUE,NA,"0.1.4"
"44009","646",2023-12-03 10:00:00,-27870,1913,29783,907,FALSE,NA,"0.1.4"
"44010","646",2023-12-03 10:15:00,-27866,1913,29779,907,TRUE,NA,"0.1.4"
"44011","646",2023-12-03 10:30:00,-27860,1913,29773,907,TRUE,NA,"0.1.4"
"44012","646",2023-12-03 10:45:00,-27863,1913,29776,907,TRUE,NA,"0.1.4"
"44013","646",2023-12-03 11:00:00,-27835,1913,29748,907,TRUE,NA,"0.1.4"
"44014","646",2023-12-03 11:15:00,-27833,1913,29746,907,TRUE,NA,"0.1.4"
"44015","646",2023-12-03 11:30:00,-27834,1913,29747,907,TRUE,NA,"0.1.4"
"44016","646",2023-12-03 11:45:00,-27834,1913,29747,907,TRUE,NA,"0.1.4"
"44017","646",2023-12-03 12:00:00,-27836,1913,29749,907,TRUE,NA,"0.1.4"
"44018","646",2023-12-03 12:15:00,-27835,1913,29748,907,TRUE,NA,"0.1.4"
"44019","646",2023-12-03 12:30:00,-27820,1913,29733,907,TRUE,NA,"0.1.4"
"44020","646",2023-12-03 12:45:00,-27826,1913,29739,907,FALSE,NA,"0.1.4"
"44021","646",2023-12-03 13:00:00,-27823,1913,29736,907,TRUE,NA,"0.1.4"
"44022","646",2023-12-03 13:15:00,-27829,1913,29742,907,FALSE,NA,"0.1.4"
"44023","646",2023-12-03 13:30:00,-27829,1913,29742,907,FALSE,NA,"0.1.4"
"44024","646",2023-12-03 13:45:00,-27839,1913,29752,907,FALSE,NA,"0.1.4"
"44025","646",2023-12-03 14:00:00,-27842,1913,29755,907,FALSE,NA,"0.1.4"
"44026","646",2023-12-03 14:15:00,-27847,1913,29760,907,FALSE,NA,"0.1.4"
"44027","646",2023-12-03 14:30:00,-27852,1913,29765,907,FALSE,NA,"0.1.4"
"44028","646",2023-12-03 14:45:00,-27831,1913,29744,907,FALSE,NA,"0.1.4"
"44029","646",2023-12-03 15:00:00,-27819,1913,29732,907,FALSE,NA,"0.1.4"
"44030","646",2023-12-03 15:15:00,-27819,1913,29732,907,FALSE,NA,"0.1.4"
"44031","646",2023-12-03 15:30:00,-27819,1913,29732,907,FALSE,NA,"0.1.4"
"44032","646",2023-12-03 15:45:00,-27816,1913,29729,907,FALSE,NA,"0.1.4"
"44033","646",2023-12-03 16:00:00,-27819,1913,29732,907,FALSE,NA,"0.1.4"
"44034","646",2023-12-03 16:15:00,-27819,1913,29732,907,FALSE,NA,"0.1.4"
"44035","646",2023-12-03 16:30:00,-27819,1913,29732,907,FALSE,NA,"0.1.4"
"44036","646",2023-12-03 16:45:00,-27819,1913,29732,907,FALSE,NA,"0.1.4"
"44037","646",2023-12-03 17:00:00,-27955,1913,29868,907,FALSE,NA,"0.1.4"
"44038","646",2023-12-03 17:15:00,-27846,1913,29759,907,FALSE,NA,"0.1.4"
"44039","646",2023-12-03 17:30:00,-27849,1913,29762,907,FALSE,NA,"0.1.4"
"44040","646",2023-12-03 17:45:00,-27985,1913,29898,907,FALSE,NA,"0.1.4"
"44041","646",2023-12-03 18:00:00,-27822,1913,29735,907,FALSE,NA,"0.1.4"
"44042","646",2023-12-03 18:15:00,-27825,1913,29738,907,FALSE,NA,"0.1.4"
"44043","646",2023-12-03 18:30:00,-27843,1913,29756,907,FALSE,NA,"0.1.4"
"44044","646",2023-12-03 18:45:00,-27841,1913,29754,907,FALSE,NA,"0.1.4"
"44045","646",2023-12-03 19:00:00,-27822,1913,29735,907,FALSE,NA,"0.1.4"
"44046","646",2023-12-03 19:15:00,-27826,1913,29739,907,FALSE,NA,"0.1.4"
"44047","646",2023-12-03 19:30:00,-27826,1913,29739,907,FALSE,NA,"0.1.4"
"44048","646",2023-12-03 19:45:00,-27816,1913,29729,907,FALSE,NA,"0.1.4"
"44049","646",2023-12-03 20:00:00,-27822,1913,29735,907,FALSE,NA,"0.1.4"
"44050","646",2023-12-03 20:15:00,-27822,1913,29735,907,FALSE,NA,"0.1.4"
"44051","646",2023-12-03 20:30:00,-27823,1913,29736,907,FALSE,NA,"0.1.4"
"44052","646",2023-12-03 20:45:00,-27828,1913,29741,907,FALSE,NA,"0.1.4"
"44053","646",2023-12-03 21:00:00,-27832,1913,29745,907,FALSE,NA,"0.1.4"
"44054","646",2023-12-03 21:15:00,-27820,1913,29733,907,FALSE,NA,"0.1.4"
"44055","646",2023-12-03 21:30:00,-27817,1913,29730,907,FALSE,NA,"0.1.4"
"44056","646",2023-12-03 21:45:00,-27818,1913,29731,907,FALSE,NA,"0.1.4"
"44057","646",2023-12-03 22:00:00,-27817,1913,29730,907,FALSE,NA,"0.1.4"
"44058","646",2023-12-03 22:15:00,-27818,1913,29731,907,FALSE,NA,"0.1.4"
"44059","646",2023-12-03 22:30:00,-27816,1913,29729,907,FALSE,NA,"0.1.4"
"44060","646",2023-12-03 22:45:00,-27817,1913,29730,907,FALSE,NA,"0.1.4"
"44061","646",2023-12-03 23:00:00,-27817,1913,29730,907,FALSE,NA,"0.1.4"
"44062","646",2023-12-03 23:15:00,-27816,1913,29729,907,FALSE,NA,"0.1.4"
"44063","646",2023-12-03 23:30:00,-27817,1913,29730,907,FALSE,NA,"0.1.4"
"44064","646",2023-12-03 23:45:00,-27819,1913,29732,907,FALSE,NA,"0.1.4"
"44065","646",2023-12-04,-27820,1913,29733,907,FALSE,NA,"0.1.4"
"44066","646",2023-12-04 00:15:00,-27817,1913,29730,907,FALSE,NA,"0.1.4"
"44067","646",2023-12-04 00:30:00,-27816,1913,29729,907,FALSE,NA,"0.1.4"
"44068","646",2023-12-04 00:45:00,-27816,1913,29729,907,FALSE,NA,"0.1.4"
"44069","646",2023-12-04 01:00:00,-27820,1913,29733,907,FALSE,NA,"0.1.4"
"44070","646",2023-12-04 01:15:00,-27816,1913,29729,907,FALSE,NA,"0.1.4"
"44071","646",2023-12-04 01:30:00,-27819,1913,29732,907,FALSE,NA,"0.1.4"
"44072","646",2023-12-04 01:45:00,-27820,1913,29733,907,FALSE,NA,"0.1.4"
"44073","646",2023-12-04 02:00:00,-27821,1913,29734,907,FALSE,NA,"0.1.4"
"44074","646",2023-12-04 02:15:00,-27819,1913,29732,907,FALSE,NA,"0.1.4"
"44075","646",2023-12-04 02:30:00,-27822,1913,29735,907,FALSE,NA,"0.1.4"
"44076","646",2023-12-04 02:45:00,-27822,1913,29735,907,FALSE,NA,"0.1.4"
"44077","646",2023-12-04 03:00:00,-27822,1913,29735,907,FALSE,NA,"0.1.4"
"44078","646",2023-12-04 03:15:00,-27822,1913,29735,907,FALSE,NA,"0.1.4"
"44079","646",2023-12-04 03:30:00,-27821,1913,29734,907,FALSE,NA,"0.1.4"
"44080","646",2023-12-04 03:45:00,-27825,1913,29738,907,FALSE,NA,"0.1.4"
"44081","646",2023-12-04 04:00:00,-27823,1913,29736,907,FALSE,NA,"0.1.4"
"44082","646",2023-12-04 04:15:00,-27841,1913,29754,907,FALSE,NA,"0.1.4"
"44083","646",2023-12-04 04:30:00,-27839,1913,29752,907,FALSE,NA,"0.1.4"
"44084","646",2023-12-04 04:45:00,-27820,1913,29733,907,FALSE,NA,"0.1.4"
"44085","646",2023-12-04 05:00:00,-27819,1913,29732,907,FALSE,NA,"0.1.4"
"44086","646",2023-12-04 05:15:00,-27819,1913,29732,907,FALSE,NA,"0.1.4"
"44087","646",2023-12-04 05:30:00,-27820,1913,29733,907,FALSE,NA,"0.1.4"
"44088","646",2023-12-04 05:45:00,-27819,1913,29732,907,FALSE,NA,"0.1.4"
"44089","646",2023-12-04 06:00:00,-27820,1913,29733,907,FALSE,NA,"0.1.4"
"44090","646",2023-12-04 06:15:00,-27820,1913,29733,907,FALSE,NA,"0.1.4"
"44091","646",2023-12-04 06:30:00,-27820,1913,29733,907,FALSE,NA,"0.1.4"
"44092","646",2023-12-04 06:45:00,-27820,1913,29733,907,FALSE,NA,"0.1.4"
"44093","646",2023-12-04 07:00:00,-27820,1913,29733,907,FALSE,NA,"0.1.4"
"44094","646",2023-12-04 07:15:00,-27820,1913,29733,907,FALSE,NA,"0.1.4"
"44095","646",2023-12-04 07:30:00,-27827,1913,29740,907,FALSE,NA,"0.1.4"
"44096","646",2023-12-04 07:45:00,-27821,1913,29734,907,FALSE,NA,"0.1.4"
"44097","646",2023-12-04 08:00:00,-27821,1913,29734,907,FALSE,NA,"0.1.4"
"44098","646",2023-12-04 08:15:00,-27820,1913,29733,907,FALSE,NA,"0.1.4"
"44099","646",2023-12-04 08:30:00,-27821,1913,29734,907,FALSE,NA,"0.1.4"
"44100","646",2023-12-04 08:45:00,-27821,1913,29734,907,FALSE,NA,"0.1.4"
"44101","646",2023-12-04 09:00:00,-27821,1913,29734,907,FALSE,NA,"0.1.4"
"44102","646",2023-12-04 09:15:00,-27821,1913,29734,907,FALSE,NA,"0.1.4"
"44103","646",2023-12-04 09:30:00,-27821,1913,29734,907,FALSE,NA,"0.1.4"
"44104","646",2023-12-04 09:45:00,-27821,1913,29734,907,FALSE,NA,"0.1.4"
"44105","646",2023-12-04 10:00:00,-27937,1913,29850,907,FALSE,NA,"0.1.4"
"44106","646",2023-12-04 10:15:00,-27915,1913,29828,907,FALSE,NA,"0.1.4"
"44107","646",2023-12-04 10:30:00,-27839,1913,29752,907,FALSE,NA,"0.1.4"
"44108","646",2023-12-04 10:45:00,-27824,1913,29737,907,FALSE,NA,"0.1.4"
"44109","646",2023-12-04 11:00:00,-27984,1913,29897,907,FALSE,NA,"0.1.4"
"44110","646",2023-12-04 11:15:00,-28014,1913,29927,907,FALSE,NA,"0.1.4"
"44111","646",2023-12-04 11:30:00,-28014,1913,29927,907,FALSE,"out1, fill","0.1.4"
"44112","646",2023-12-04 11:45:00,-28014,1913,29927,907,FALSE,"jump1","0.1.4"
"44113","646",2023-12-04 12:00:00,-27922,1913,29835,907,FALSE,NA,"0.1.4"
"44114","646",2023-12-04 12:15:00,-27655,1913,29568,907,FALSE,NA,"0.1.4"
"44115","646",2023-12-04 12:30:00,-27888,1913,29801,907,FALSE,NA,"0.1.4"
"44116","646",2023-12-04 12:45:00,-28017,1913,29930,907,FALSE,NA,"0.1.4"
"44117","646",2023-12-04 13:00:00,-28017,1913,29930,907,FALSE,"out1, fill","0.1.4"
"44118","646",2023-12-04 13:15:00,-28017,1913,29930,907,FALSE,"jump1","0.1.4"
"44119","646",2023-12-04 13:30:00,-28016,1913,29929,907,FALSE,NA,"0.1.4"
"44120","646",2023-12-04 13:45:00,-28026,1913,29939,907,FALSE,NA,"0.1.4"
"44121","646",2023-12-04 14:00:00,-28019,1913,29932,907,FALSE,NA,"0.1.4"
"44122","646",2023-12-04 14:15:00,-28038,1913,29951,907,FALSE,NA,"0.1.4"
"44123","646",2023-12-04 14:30:00,-28038,1913,29951,907,FALSE,NA,"0.1.4"
"44124","646",2023-12-04 14:45:00,-28027,1913,29940,907,FALSE,NA,"0.1.4"
"44125","646",2023-12-04 15:00:00,-28019,1913,29932,907,FALSE,NA,"0.1.4"
"44126","646",2023-12-04 15:15:00,-28015,1913,29928,907,FALSE,NA,"0.1.4"
"44127","646",2023-12-04 15:30:00,-28015,1913,29928,907,FALSE,NA,"0.1.4"
"44128","646",2023-12-04 15:45:00,-28014,1913,29927,907,FALSE,NA,"0.1.4"
"44129","646",2023-12-04 16:00:00,-28020,1913,29933,907,FALSE,NA,"0.1.4"
"44130","646",2023-12-04 16:15:00,-28018,1913,29931,907,FALSE,NA,"0.1.4"
"44131","646",2023-12-04 16:30:00,-28016,1913,29929,907,FALSE,NA,"0.1.4"
"44132","646",2023-12-04 16:45:00,-28017,1913,29930,907,FALSE,NA,"0.1.4"
"44133","646",2023-12-04 17:00:00,-28015,1913,29928,907,FALSE,NA,"0.1.4"
"44134","646",2023-12-04 17:15:00,-28012,1913,29925,907,FALSE,NA,"0.1.4"
"44135","646",2023-12-04 17:30:00,-28012,1913,29925,907,FALSE,NA,"0.1.4"
"44136","646",2023-12-04 17:45:00,-28011,1913,29924,907,FALSE,NA,"0.1.4"
"44137","646",2023-12-04 18:00:00,-28011,1913,29924,907,FALSE,NA,"0.1.4"
"44138","646",2023-12-04 18:15:00,-28013,1913,29926,907,FALSE,NA,"0.1.4"
"44139","646",2023-12-04 18:30:00,-28013,1913,29926,907,FALSE,NA,"0.1.4"
"44140","646",2023-12-04 18:45:00,-28010,1913,29923,907,FALSE,NA,"0.1.4"
"44141","646",2023-12-04 19:00:00,-28009,1913,29922,907,FALSE,NA,"0.1.4"
"44142","646",2023-12-04 19:15:00,-28008,1913,29921,907,FALSE,NA,"0.1.4"
"44143","646",2023-12-04 19:30:00,-28008,1913,29921,907,FALSE,NA,"0.1.4"
"44144","646",2023-12-04 19:45:00,-28008,1913,29921,907,FALSE,NA,"0.1.4"
"44145","646",2023-12-04 20:00:00,-28016,1913,29929,907,FALSE,NA,"0.1.4"
"44146","646",2023-12-04 20:15:00,-28014,1913,29927,907,FALSE,NA,"0.1.4"
"44147","646",2023-12-04 20:30:00,-28014,1913,29927,907,FALSE,NA,"0.1.4"
"44148","646",2023-12-04 20:45:00,-28013,1913,29926,907,FALSE,NA,"0.1.4"
"44149","646",2023-12-04 21:00:00,-28023,1913,29936,907,FALSE,NA,"0.1.4"
"44150","646",2023-12-04 21:15:00,-28029,1913,29942,907,FALSE,NA,"0.1.4"
"44151","646",2023-12-04 21:30:00,-28029,1913,29942,907,FALSE,NA,"0.1.4"
"44152","646",2023-12-04 21:45:00,-28007,1913,29920,907,FALSE,NA,"0.1.4"
"44153","646",2023-12-04 22:00:00,-28007,1913,29920,907,FALSE,NA,"0.1.4"
"44154","646",2023-12-04 22:15:00,-28007,1913,29920,907,FALSE,NA,"0.1.4"
"44155","646",2023-12-04 22:30:00,-28013,1913,29926,907,FALSE,NA,"0.1.4"
"44156","646",2023-12-04 22:45:00,-28012,1913,29925,907,FALSE,NA,"0.1.4"
"44157","646",2023-12-04 23:00:00,-28010,1913,29923,907,FALSE,NA,"0.1.4"
"44158","646",2023-12-04 23:15:00,-28011,1913,29924,907,FALSE,NA,"0.1.4"
"44159","646",2023-12-04 23:30:00,-28010,1913,29923,907,FALSE,NA,"0.1.4"
"44160","646",2023-12-04 23:45:00,-28011,1913,29924,907,FALSE,NA,"0.1.4"
"44161","646",2023-12-05,-28001,1913,29914,907,FALSE,NA,"0.1.4"
"44162","646",2023-12-05 00:15:00,-28003,1913,29916,907,FALSE,NA,"0.1.4"
"44163","646",2023-12-05 00:30:00,-28004,1913,29917,907,FALSE,NA,"0.1.4"
"44164","646",2023-12-05 00:45:00,-28004,1913,29917,907,FALSE,NA,"0.1.4"
"44165","646",2023-12-05 01:00:00,-28004,1913,29917,907,FALSE,NA,"0.1.4"
"44166","646",2023-12-05 01:15:00,-28004,1913,29917,907,FALSE,NA,"0.1.4"
"44167","646",2023-12-05 01:30:00,-28004,1913,29917,907,FALSE,NA,"0.1.4"
"44168","646",2023-12-05 01:45:00,-28004,1913,29917,907,FALSE,NA,"0.1.4"
"44169","646",2023-12-05 02:00:00,-28004,1913,29917,907,FALSE,NA,"0.1.4"
"44170","646",2023-12-05 02:15:00,-28003,1913,29916,907,FALSE,NA,"0.1.4"
"44171","646",2023-12-05 02:30:00,-28003,1913,29916,907,FALSE,NA,"0.1.4"
"44172","646",2023-12-05 02:45:00,-28004,1913,29917,907,FALSE,NA,"0.1.4"
"44173","646",2023-12-05 03:00:00,-28004,1913,29917,907,FALSE,NA,"0.1.4"
"44174","646",2023-12-05 03:15:00,-28003,1913,29916,907,FALSE,NA,"0.1.4"
"44175","646",2023-12-05 03:30:00,-28011,1913,29924,907,FALSE,NA,"0.1.4"
"44176","646",2023-12-05 03:45:00,-28011,1913,29924,907,FALSE,NA,"0.1.4"
"44177","646",2023-12-05 04:00:00,-28010,1913,29923,907,FALSE,NA,"0.1.4"
"44178","646",2023-12-05 04:15:00,-28013,1913,29926,907,FALSE,NA,"0.1.4"
"44179","646",2023-12-05 04:30:00,-28153,1913,30066,907,FALSE,NA,"0.1.4"
"44180","646",2023-12-05 04:45:00,-28103,1913,30016,907,FALSE,NA,"0.1.4"
"44181","646",2023-12-05 05:00:00,-28100,1913,30013,907,FALSE,NA,"0.1.4"
"44182","646",2023-12-05 05:15:00,-28099,1913,30012,907,FALSE,NA,"0.1.4"
"44183","646",2023-12-05 05:30:00,-28113,1913,30026,907,FALSE,NA,"0.1.4"
"44184","646",2023-12-05 05:45:00,-28106,1913,30019,907,FALSE,NA,"0.1.4"
"44185","646",2023-12-05 06:00:00,-28123,1913,30036,907,FALSE,NA,"0.1.4"
"44186","646",2023-12-05 06:15:00,-28145,1913,30058,907,FALSE,NA,"0.1.4"
"44187","646",2023-12-05 06:30:00,-28125,1913,30038,907,FALSE,NA,"0.1.4"
"44188","646",2023-12-05 06:45:00,-28122,1913,30035,907,FALSE,NA,"0.1.4"
"44189","646",2023-12-05 07:00:00,-28126,1913,30039,907,FALSE,NA,"0.1.4"
"44190","646",2023-12-05 07:15:00,-28106,1913,30019,907,FALSE,NA,"0.1.4"
"44191","646",2023-12-05 07:30:00,-28098,1913,30011,907,FALSE,NA,"0.1.4"
"44192","646",2023-12-05 07:45:00,-28125,1913,30038,907,FALSE,NA,"0.1.4"
"44193","646",2023-12-05 08:00:00,-28090,1913,30003,907,FALSE,NA,"0.1.4"
"44194","646",2023-12-05 08:15:00,-28094,1913,30007,907,FALSE,NA,"0.1.4"
"44195","646",2023-12-05 08:30:00,-28130,1913,30043,907,FALSE,NA,"0.1.4"
"44196","646",2023-12-05 08:45:00,-28128,1913,30041,907,FALSE,NA,"0.1.4"
"44197","646",2023-12-05 09:00:00,-28124,1913,30037,907,FALSE,NA,"0.1.4"
"44198","646",2023-12-05 09:15:00,-28091,1913,30004,907,FALSE,NA,"0.1.4"
"44199","646",2023-12-05 09:30:00,-28087,1913,30000,907,FALSE,NA,"0.1.4"
"44200","646",2023-12-05 09:45:00,-28092,1913,30005,907,FALSE,NA,"0.1.4"
"44201","646",2023-12-05 10:00:00,-28082,1913,29995,907,FALSE,NA,"0.1.4"
"44202","646",2023-12-05 10:15:00,-28090,1913,30003,907,FALSE,NA,"0.1.4"
"44203","646",2023-12-05 10:30:00,-28095,1913,30008,907,FALSE,NA,"0.1.4"
"44204","646",2023-12-05 10:45:00,-28094,1913,30007,907,FALSE,NA,"0.1.4"
"44205","646",2023-12-05 11:00:00,-28096,1913,30009,907,FALSE,NA,"0.1.4"
"44206","646",2023-12-05 11:15:00,-28085,1913,29998,907,FALSE,NA,"0.1.4"
"44207","646",2023-12-05 11:30:00,-28070,1913,29983,907,FALSE,NA,"0.1.4"
"44208","646",2023-12-05 11:45:00,-28062,1913,29975,907,FALSE,NA,"0.1.4"
"44209","646",2023-12-05 12:00:00,-28065,1913,29978,907,FALSE,NA,"0.1.4"
"44210","646",2023-12-05 12:15:00,-28028,1913,29941,907,FALSE,NA,"0.1.4"
"44211","646",2023-12-05 12:30:00,-28024,1913,29937,907,FALSE,NA,"0.1.4"
"44212","646",2023-12-05 12:45:00,-28019,1913,29932,907,FALSE,NA,"0.1.4"
"44213","646",2023-12-05 13:00:00,-28017,1913,29930,907,FALSE,NA,"0.1.4"
"44214","646",2023-12-05 13:15:00,-28013,1913,29926,907,FALSE,NA,"0.1.4"
"44215","646",2023-12-05 13:30:00,-28021,1913,29934,907,FALSE,NA,"0.1.4"
"44216","646",2023-12-05 13:45:00,-28025,1913,29938,907,FALSE,NA,"0.1.4"
"44217","646",2023-12-05 14:00:00,-28033,1913,29946,907,FALSE,NA,"0.1.4"
"44218","646",2023-12-05 14:15:00,-28025,1913,29938,907,FALSE,NA,"0.1.4"
"44219","646",2023-12-05 14:30:00,-28025,1913,29938,907,FALSE,NA,"0.1.4"
"44220","646",2023-12-05 14:45:00,-28023,1913,29936,907,FALSE,NA,"0.1.4"
"44221","646",2023-12-05 15:00:00,-28022,1913,29935,907,FALSE,NA,"0.1.4"
"44222","646",2023-12-05 15:15:00,-28019,1913,29932,907,FALSE,NA,"0.1.4"
"44223","646",2023-12-05 15:30:00,-28019,1913,29932,907,FALSE,NA,"0.1.4"
"44224","646",2023-12-05 15:45:00,-28018,1913,29931,907,FALSE,NA,"0.1.4"
"44225","646",2023-12-05 16:00:00,-28021,1913,29934,907,FALSE,NA,"0.1.4"
"44226","646",2023-12-05 16:15:00,-28022,1913,29935,907,FALSE,NA,"0.1.4"
"44227","646",2023-12-05 16:30:00,-28021,1913,29934,907,FALSE,NA,"0.1.4"
"44228","646",2023-12-05 16:45:00,-28022,1913,29935,907,FALSE,NA,"0.1.4"
"44229","646",2023-12-05 17:00:00,-28022,1913,29935,907,FALSE,NA,"0.1.4"
"44230","646",2023-12-05 17:15:00,-28021,1913,29934,907,FALSE,NA,"0.1.4"
"44231","646",2023-12-05 17:30:00,-28021,1913,29934,907,FALSE,NA,"0.1.4"
"44232","646",2023-12-05 17:45:00,-28021,1913,29934,907,FALSE,NA,"0.1.4"
"44233","646",2023-12-05 18:00:00,-28022,1913,29935,907,FALSE,NA,"0.1.4"
"44234","646",2023-12-05 18:15:00,-28023,1913,29936,907,FALSE,NA,"0.1.4"
"44235","646",2023-12-05 18:30:00,-28024,1913,29937,907,FALSE,NA,"0.1.4"
"44236","646",2023-12-05 18:45:00,-28020,1913,29933,907,FALSE,NA,"0.1.4"
"44237","646",2023-12-05 19:00:00,-28021,1913,29934,907,FALSE,NA,"0.1.4"
"44238","646",2023-12-05 19:15:00,-28059,1913,29972,907,FALSE,NA,"0.1.4"
"44239","646",2023-12-05 19:30:00,-28044,1913,29957,907,FALSE,NA,"0.1.4"
"44240","646",2023-12-05 19:45:00,-28002,1913,29915,907,FALSE,NA,"0.1.4"
"44241","646",2023-12-05 20:00:00,-28000,1913,29913,907,FALSE,NA,"0.1.4"
"44242","646",2023-12-05 20:15:00,-28002,1913,29915,907,FALSE,NA,"0.1.4"
"44243","646",2023-12-05 20:30:00,-28001,1913,29914,907,FALSE,NA,"0.1.4"
"44244","646",2023-12-05 20:45:00,-27997,1913,29910,907,FALSE,NA,"0.1.4"
"44245","646",2023-12-05 21:00:00,-27997,1913,29910,907,FALSE,NA,"0.1.4"
"44246","646",2023-12-05 21:15:00,-28014,1913,29927,907,FALSE,NA,"0.1.4"
"44247","646",2023-12-05 21:30:00,-28018,1913,29931,907,FALSE,NA,"0.1.4"
"44248","646",2023-12-05 21:45:00,-28015,1913,29928,907,FALSE,NA,"0.1.4"
"44249","646",2023-12-05 22:00:00,-28016,1913,29929,907,FALSE,NA,"0.1.4"
"44250","646",2023-12-05 22:15:00,-28017,1913,29930,907,FALSE,NA,"0.1.4"
"44251","646",2023-12-05 22:30:00,-28017,1913,29930,907,FALSE,NA,"0.1.4"
"44252","646",2023-12-05 22:45:00,-28017,1913,29930,907,FALSE,NA,"0.1.4"
"44253","646",2023-12-05 23:00:00,-28016,1913,29929,907,FALSE,NA,"0.1.4"
"44254","646",2023-12-05 23:15:00,-28015,1913,29928,907,FALSE,NA,"0.1.4"
"44255","646",2023-12-05 23:30:00,-28016,1913,29929,907,FALSE,NA,"0.1.4"
"44256","646",2023-12-05 23:45:00,-28016,1913,29929,907,FALSE,NA,"0.1.4"
"44257","646",2023-12-06,-28015,1913,29928,907,FALSE,NA,"0.1.4"
"44258","646",2023-12-06 00:15:00,-28016,1913,29929,907,FALSE,NA,"0.1.4"
"44259","646",2023-12-06 00:30:00,-28016,1913,29929,907,FALSE,NA,"0.1.4"
"44260","646",2023-12-06 00:45:00,-28016,1913,29929,907,FALSE,NA,"0.1.4"
"44261","646",2023-12-06 01:00:00,-28016,1913,29929,907,FALSE,NA,"0.1.4"
"44262","646",2023-12-06 01:15:00,-28015,1913,29928,907,FALSE,NA,"0.1.4"
"44263","646",2023-12-06 01:30:00,-28014,1913,29927,907,FALSE,NA,"0.1.4"
"44264","646",2023-12-06 01:45:00,-28016,1913,29929,907,FALSE,NA,"0.1.4"
"44265","646",2023-12-06 02:00:00,-28015,1913,29928,907,FALSE,NA,"0.1.4"
"44266","646",2023-12-06 02:15:00,-28020,1913,29933,907,FALSE,NA,"0.1.4"
"44267","646",2023-12-06 02:30:00,-28015,1913,29928,907,FALSE,NA,"0.1.4"
"44268","646",2023-12-06 02:45:00,-28016,1913,29929,907,FALSE,NA,"0.1.4"
"44269","646",2023-12-06 03:00:00,-28023,1913,29936,907,FALSE,NA,"0.1.4"
"44270","646",2023-12-06 03:15:00,-28009,1913,29922,907,FALSE,NA,"0.1.4"
"44271","646",2023-12-06 03:30:00,-28175,1913,30088,907,FALSE,NA,"0.1.4"
"44272","646",2023-12-06 03:45:00,-28045,1913,29958,907,FALSE,NA,"0.1.4"
"44273","646",2023-12-06 04:00:00,-28048,1913,29961,907,FALSE,NA,"0.1.4"
"44274","646",2023-12-06 04:15:00,-28014,1913,29927,907,FALSE,NA,"0.1.4"
"44275","646",2023-12-06 04:30:00,-28016,1913,29929,907,FALSE,NA,"0.1.4"
"44276","646",2023-12-06 04:45:00,-28016,1913,29929,907,FALSE,NA,"0.1.4"
"44277","646",2023-12-06 05:00:00,-28016,1913,29929,907,FALSE,NA,"0.1.4"
"44278","646",2023-12-06 05:15:00,-28016,1913,29929,907,FALSE,NA,"0.1.4"
"44279","646",2023-12-06 05:30:00,-28025,1913,29938,907,FALSE,NA,"0.1.4"
"44280","646",2023-12-06 05:45:00,-28013,1913,29926,907,FALSE,NA,"0.1.4"
"44281","646",2023-12-06 06:00:00,-28014,1913,29927,907,FALSE,NA,"0.1.4"
"44282","646",2023-12-06 06:15:00,-28019,1913,29932,907,FALSE,NA,"0.1.4"
"44283","646",2023-12-06 06:30:00,-28014,1913,29927,907,FALSE,NA,"0.1.4"
"44284","646",2023-12-06 06:45:00,-28013,1913,29926,907,FALSE,NA,"0.1.4"
"44285","646",2023-12-06 07:00:00,-28024,1913,29937,907,FALSE,NA,"0.1.4"
"44286","646",2023-12-06 07:15:00,-28025,1913,29938,907,FALSE,NA,"0.1.4"
"44287","646",2023-12-06 07:30:00,-28023,1913,29936,907,FALSE,NA,"0.1.4"
"44288","646",2023-12-06 07:45:00,-28022,1913,29935,907,FALSE,NA,"0.1.4"
"44289","646",2023-12-06 08:00:00,-28050,1913,29963,907,FALSE,NA,"0.1.4"
"44290","646",2023-12-06 08:15:00,-28018,1913,29931,907,FALSE,NA,"0.1.4"
"44291","646",2023-12-06 08:30:00,-28016,1913,29929,907,FALSE,NA,"0.1.4"
"44292","646",2023-12-06 08:45:00,-28016,1913,29929,907,FALSE,NA,"0.1.4"
"44293","646",2023-12-06 09:00:00,-28013,1913,29926,907,FALSE,NA,"0.1.4"
"44294","646",2023-12-06 09:15:00,-28014,1913,29927,907,FALSE,NA,"0.1.4"
"44295","646",2023-12-06 09:30:00,-28014,1913,29927,907,FALSE,NA,"0.1.4"
"44296","646",2023-12-06 09:45:00,-28013,1913,29926,907,FALSE,NA,"0.1.4"
"44297","646",2023-12-06 10:00:00,-28013,1913,29926,907,FALSE,NA,"0.1.4"
"44298","646",2023-12-06 10:15:00,-28013,1913,29926,907,FALSE,NA,"0.1.4"
"44299","646",2023-12-06 10:30:00,-28014,1913,29927,907,FALSE,NA,"0.1.4"
"44300","646",2023-12-06 10:45:00,-28013,1913,29926,907,FALSE,NA,"0.1.4"
"44301","646",2023-12-06 11:00:00,-28013,1913,29926,907,FALSE,NA,"0.1.4"
"44302","646",2023-12-06 11:15:00,-28013,1913,29926,907,FALSE,NA,"0.1.4"
"44303","646",2023-12-06 11:30:00,-28014,1913,29927,907,FALSE,NA,"0.1.4"
"44304","646",2023-12-06 11:45:00,-28013,1913,29926,907,FALSE,NA,"0.1.4"
"44305","646",2023-12-06 12:00:00,-28013,1913,29926,907,FALSE,NA,"0.1.4"
"44306","646",2023-12-06 12:15:00,-28013,1913,29926,907,FALSE,NA,"0.1.4"
"44307","646",2023-12-06 12:30:00,-28014,1913,29927,907,FALSE,NA,"0.1.4"
"44308","646",2023-12-06 12:45:00,-28033,1913,29946,907,FALSE,NA,"0.1.4"
"44309","646",2023-12-06 13:00:00,-28033,1913,29946,907,FALSE,NA,"0.1.4"
"44310","646",2023-12-06 13:15:00,-28033,1913,29946,907,FALSE,NA,"0.1.4"
"44311","646",2023-12-06 13:30:00,-28023,1913,29936,907,FALSE,NA,"0.1.4"
"44312","646",2023-12-06 13:45:00,-28015,1913,29928,907,FALSE,NA,"0.1.4"
"44313","646",2023-12-06 14:00:00,-28015,1913,29928,907,FALSE,NA,"0.1.4"
"44314","646",2023-12-06 14:15:00,-28014,1913,29927,907,FALSE,NA,"0.1.4"
"44315","646",2023-12-06 14:30:00,-28014,1913,29927,907,FALSE,NA,"0.1.4"
"44316","646",2023-12-06 14:45:00,-28014,1913,29927,907,FALSE,NA,"0.1.4"
"44317","646",2023-12-06 15:00:00,-28014,1913,29927,907,FALSE,NA,"0.1.4"
"44318","646",2023-12-06 15:15:00,-28014,1913,29927,907,FALSE,NA,"0.1.4"
"44319","646",2023-12-06 15:30:00,-28014,1913,29927,907,FALSE,NA,"0.1.4"
"44320","646",2023-12-06 15:45:00,-28014,1913,29927,907,FALSE,NA,"0.1.4"
"44321","646",2023-12-06 16:00:00,-28014,1913,29927,907,FALSE,NA,"0.1.4"
"44322","646",2023-12-06 16:15:00,-28014,1913,29927,907,FALSE,NA,"0.1.4"
"44323","646",2023-12-06 16:30:00,-28014,1913,29927,907,FALSE,NA,"0.1.4"
"44324","646",2023-12-06 16:45:00,-28013,1913,29926,907,FALSE,NA,"0.1.4"
"44325","646",2023-12-06 17:00:00,-28013,1913,29926,907,FALSE,NA,"0.1.4"
"44326","646",2023-12-06 17:15:00,-28013,1913,29926,907,FALSE,NA,"0.1.4"
"44327","646",2023-12-06 17:30:00,-28013,1913,29926,907,FALSE,NA,"0.1.4"
"44328","646",2023-12-06 17:45:00,-28013,1913,29926,907,FALSE,NA,"0.1.4"
"44329","646",2023-12-06 18:00:00,-28013,1913,29926,907,FALSE,NA,"0.1.4"
"44330","646",2023-12-06 18:15:00,-28012,1913,29925,907,FALSE,NA,"0.1.4"
"44331","646",2023-12-06 18:30:00,-28012,1913,29925,907,FALSE,NA,"0.1.4"
"44332","646",2023-12-06 18:45:00,-28012,1913,29925,907,FALSE,NA,"0.1.4"
"44333","646",2023-12-06 19:00:00,-28012,1913,29925,907,FALSE,NA,"0.1.4"
"44334","646",2023-12-06 19:15:00,-28011,1913,29924,907,FALSE,NA,"0.1.4"
"44335","646",2023-12-06 19:30:00,-28011,1913,29924,907,FALSE,NA,"0.1.4"
"44336","646",2023-12-06 19:45:00,-28011,1913,29924,907,FALSE,NA,"0.1.4"
"44337","646",2023-12-06 20:00:00,-28011,1913,29924,907,FALSE,NA,"0.1.4"
"44338","646",2023-12-06 20:15:00,-28011,1913,29924,907,FALSE,NA,"0.1.4"
"44339","646",2023-12-06 20:30:00,-28009,1913,29922,907,FALSE,NA,"0.1.4"
"44340","646",2023-12-06 20:45:00,-28008,1913,29921,907,FALSE,NA,"0.1.4"
"44341","646",2023-12-06 21:00:00,-28006,1913,29919,907,FALSE,NA,"0.1.4"
"44342","646",2023-12-06 21:15:00,-28007,1913,29920,907,FALSE,NA,"0.1.4"
"44343","646",2023-12-06 21:30:00,-28006,1913,29919,907,FALSE,NA,"0.1.4"
"44344","646",2023-12-06 21:45:00,-28005,1913,29918,907,FALSE,NA,"0.1.4"
"44345","646",2023-12-06 22:00:00,-28006,1913,29919,907,FALSE,NA,"0.1.4"
"44346","646",2023-12-06 22:15:00,-28006,1913,29919,907,FALSE,NA,"0.1.4"
"44347","646",2023-12-06 22:30:00,-28006,1913,29919,907,FALSE,NA,"0.1.4"
"44348","646",2023-12-06 22:45:00,-28006,1913,29919,907,FALSE,NA,"0.1.4"
"44349","646",2023-12-06 23:00:00,-28006,1913,29919,907,FALSE,NA,"0.1.4"
"44350","646",2023-12-06 23:15:00,-28017,1913,29930,907,FALSE,NA,"0.1.4"
"44351","646",2023-12-06 23:30:00,-28106,1913,30019,907,FALSE,NA,"0.1.4"
"44352","646",2023-12-06 23:45:00,-28106,1913,30019,907,FALSE,"jump1","0.1.4"
"44353","646",2023-12-07,-27767,1913,29680,907,FALSE,NA,"0.1.4"
"44354","646",2023-12-07 00:15:00,-27355,1913,29268,907,FALSE,NA,"0.1.4"
"44355","646",2023-12-07 00:30:00,-27417,1913,29330,907,FALSE,NA,"0.1.4"
"44356","646",2023-12-07 00:45:00,-27604,1913,29517,907,FALSE,NA,"0.1.4"
"44357","646",2023-12-07 01:00:00,-28085,1913,29998,907,FALSE,NA,"0.1.4"
"44358","646",2023-12-07 01:15:00,-28091,1913,30004,907,FALSE,NA,"0.1.4"
"44359","646",2023-12-07 01:30:00,-27984,1913,29897,907,FALSE,NA,"0.1.4"
"44360","646",2023-12-07 01:45:00,-27984,1913,29897,907,FALSE,"jump1","0.1.4"
"44361","646",2023-12-07 02:00:00,-27839,1913,29752,907,FALSE,NA,"0.1.4"
"44362","646",2023-12-07 02:15:00,-27839,1913,29752,907,FALSE,NA,"0.1.4"
"44363","646",2023-12-07 02:30:00,-27860,1913,29773,907,FALSE,NA,"0.1.4"
"44364","646",2023-12-07 02:45:00,-27860,1913,29773,907,FALSE,NA,"0.1.4"
"44365","646",2023-12-07 03:00:00,-27844,1913,29757,907,FALSE,NA,"0.1.4"
"44366","646",2023-12-07 03:15:00,-27843,1913,29756,907,FALSE,NA,"0.1.4"
"44367","646",2023-12-07 03:30:00,-27844,1913,29757,907,FALSE,NA,"0.1.4"
"44368","646",2023-12-07 03:45:00,-27844,1913,29757,907,FALSE,NA,"0.1.4"
"44369","646",2023-12-07 04:00:00,-27843,1913,29756,907,FALSE,NA,"0.1.4"
"44370","646",2023-12-07 04:15:00,-27843,1913,29756,907,FALSE,NA,"0.1.4"
"44371","646",2023-12-07 04:30:00,-27841,1913,29754,907,FALSE,NA,"0.1.4"
"44372","646",2023-12-07 04:45:00,-27839,1913,29752,907,FALSE,NA,"0.1.4"
"44373","646",2023-12-07 05:00:00,-27839,1913,29752,907,FALSE,NA,"0.1.4"
"44374","646",2023-12-07 05:15:00,-27846,1913,29759,907,FALSE,NA,"0.1.4"
"44375","646",2023-12-07 05:30:00,-27979,1913,29892,907,FALSE,NA,"0.1.4"
"44376","646",2023-12-07 05:45:00,-27962,1913,29875,907,FALSE,NA,"0.1.4"
"44377","646",2023-12-07 06:00:00,-27912,1913,29825,907,FALSE,NA,"0.1.4"
"44378","646",2023-12-07 06:15:00,-28321,1913,30234,907,FALSE,NA,"0.1.4"
"44379","646",2023-12-07 06:30:00,-27841,1913,29754,907,FALSE,NA,"0.1.4"
"44380","646",2023-12-07 06:45:00,-27896,1913,29809,907,FALSE,NA,"0.1.4"
"44381","646",2023-12-07 07:00:00,-27842,1913,29755,907,FALSE,NA,"0.1.4"
"44382","646",2023-12-07 07:15:00,-27874,1913,29787,907,FALSE,NA,"0.1.4"
"44383","646",2023-12-07 07:30:00,-27868,1913,29781,907,FALSE,NA,"0.1.4"
"44384","646",2023-12-07 07:45:00,-27865,1913,29778,907,FALSE,NA,"0.1.4"
"44385","646",2023-12-07 08:00:00,-27843,1913,29756,907,FALSE,NA,"0.1.4"
"44386","646",2023-12-07 08:15:00,-27871,1913,29784,907,FALSE,NA,"0.1.4"
"44387","646",2023-12-07 08:30:00,-27844,1913,29757,907,FALSE,NA,"0.1.4"
"44388","646",2023-12-07 08:45:00,-27844,1913,29757,907,FALSE,"jump1","0.1.4"
"44389","646",2023-12-07 09:00:00,-27958,1913,29871,907,FALSE,NA,"0.1.4"
"44390","646",2023-12-07 09:15:00,-28119,1913,30032,907,FALSE,NA,"0.1.4"
"44391","646",2023-12-07 09:30:00,-27811,1913,29724,907,FALSE,NA,"0.1.4"
"44392","646",2023-12-07 09:45:00,-27811,1913,29724,907,FALSE,"jump1","0.1.4"
"44393","646",2023-12-07 10:00:00,-27694,1913,29607,907,TRUE,NA,"0.1.4"
"44394","646",2023-12-07 10:15:00,-27992,1913,29905,907,TRUE,NA,"0.1.4"
"44395","646",2023-12-07 10:30:00,-27992,1913,29905,907,TRUE,"out1, fill","0.1.4"
"44396","646",2023-12-07 10:45:00,-27992,1913,29905,907,FALSE,"jump1","0.1.4"
"44397","646",2023-12-07 11:00:00,-27992,1913,29905,907,FALSE,NA,"0.1.4"
"44398","646",2023-12-07 11:15:00,-27990,1913,29903,907,FALSE,NA,"0.1.4"
"44399","646",2023-12-07 11:30:00,-27989,1913,29902,907,FALSE,NA,"0.1.4"
"44400","646",2023-12-07 11:45:00,-27989,1913,29902,907,FALSE,NA,"0.1.4"
"44401","646",2023-12-07 12:00:00,-27989,1913,29902,907,FALSE,NA,"0.1.4"
"44402","646",2023-12-07 12:15:00,-27989,1913,29902,907,FALSE,NA,"0.1.4"
"44403","646",2023-12-07 12:30:00,-27989,1913,29902,907,FALSE,NA,"0.1.4"
"44404","646",2023-12-07 12:45:00,-27989,1913,29902,907,FALSE,NA,"0.1.4"
"44405","646",2023-12-07 13:00:00,-27989,1913,29902,907,TRUE,NA,"0.1.4"
"44406","646",2023-12-07 13:15:00,-27988,1913,29901,907,TRUE,NA,"0.1.4"
"44407","646",2023-12-07 13:30:00,-27988,1913,29901,907,TRUE,NA,"0.1.4"
"44408","646",2023-12-07 13:45:00,-28091,1913,30004,907,TRUE,NA,"0.1.4"
"44409","646",2023-12-07 14:00:00,-28134,1913,30047,907,TRUE,NA,"0.1.4"
"44410","646",2023-12-07 14:15:00,-28091,1913,30004,907,TRUE,NA,"0.1.4"
"44411","646",2023-12-07 14:30:00,-27988,1913,29901,907,TRUE,NA,"0.1.4"
"44412","646",2023-12-07 14:45:00,-27988,1913,29901,907,TRUE,NA,"0.1.4"
"44413","646",2023-12-07 15:00:00,-27989,1913,29902,907,TRUE,NA,"0.1.4"
"44414","646",2023-12-07 15:15:00,-28093,1913,30006,907,TRUE,NA,"0.1.4"
"44415","646",2023-12-07 15:30:00,-28143,1913,30056,907,TRUE,NA,"0.1.4"
"44416","646",2023-12-07 15:45:00,-28200,1913,30113,907,TRUE,NA,"0.1.4"
"44417","646",2023-12-07 16:00:00,-28188,1913,30101,907,TRUE,NA,"0.1.4"
"44418","646",2023-12-07 16:15:00,-28071,1913,29984,907,TRUE,NA,"0.1.4"
"44419","646",2023-12-07 16:30:00,-28202,1913,30115,907,TRUE,NA,"0.1.4"
"44420","646",2023-12-07 16:45:00,-28012,1913,29925,907,TRUE,NA,"0.1.4"
"44421","646",2023-12-07 17:00:00,-28073,1913,29986,907,TRUE,NA,"0.1.4"
"44422","646",2023-12-07 17:15:00,-28173,1913,30086,907,TRUE,NA,"0.1.4"
"44423","646",2023-12-07 17:30:00,-27991,1913,29904,907,TRUE,NA,"0.1.4"
"44424","646",2023-12-07 17:45:00,-27990,1913,29903,907,TRUE,NA,"0.1.4"
"44425","646",2023-12-07 18:00:00,-27989,1913,29902,907,TRUE,NA,"0.1.4"
"44426","646",2023-12-07 18:15:00,-28009,1913,29922,907,TRUE,NA,"0.1.4"
"44427","646",2023-12-07 18:30:00,-28006,1913,29919,907,TRUE,NA,"0.1.4"
"44428","646",2023-12-07 18:45:00,-28032,1913,29945,907,TRUE,NA,"0.1.4"
"44429","646",2023-12-07 19:00:00,-27990,1913,29903,907,TRUE,NA,"0.1.4"
"44430","646",2023-12-07 19:15:00,-27990,1913,29903,907,TRUE,NA,"0.1.4"
"44431","646",2023-12-07 19:30:00,-27990,1913,29903,907,TRUE,NA,"0.1.4"
"44432","646",2023-12-07 19:45:00,-27989,1913,29902,907,TRUE,NA,"0.1.4"
"44433","646",2023-12-07 20:00:00,-27989,1913,29902,907,TRUE,NA,"0.1.4"
"44434","646",2023-12-07 20:15:00,-27993,1913,29906,907,TRUE,"out1, fill","0.1.4"
"44435","646",2023-12-07 20:30:00,-27997,1913,29910,907,TRUE,"out1, fill","0.1.4"
"44436","646",2023-12-07 20:45:00,-28001,1913,29914,907,TRUE,NA,"0.1.4"
"44437","646",2023-12-07 21:00:00,-27999,1913,29912,907,TRUE,NA,"0.1.4"
"44438","646",2023-12-07 21:15:00,-28003,1913,29916,907,TRUE,NA,"0.1.4"
"44439","646",2023-12-07 21:30:00,-28000,1913,29913,907,TRUE,NA,"0.1.4"
"44440","646",2023-12-07 21:45:00,-27997,1913,29910,907,TRUE,NA,"0.1.4"
"44441","646",2023-12-07 22:00:00,-28002,1913,29915,907,TRUE,NA,"0.1.4"
"44442","646",2023-12-07 22:15:00,-28000,1913,29913,907,TRUE,NA,"0.1.4"
"44443","646",2023-12-07 22:30:00,-27998,1913,29911,907,TRUE,NA,"0.1.4"
"44444","646",2023-12-07 22:45:00,-28000,1913,29913,907,TRUE,NA,"0.1.4"
"44445","646",2023-12-07 23:00:00,-27995,1913,29908,907,TRUE,NA,"0.1.4"
"44446","646",2023-12-07 23:15:00,-27997,1913,29910,907,TRUE,NA,"0.1.4"
"44447","646",2023-12-07 23:30:00,-27997,1913,29910,907,TRUE,NA,"0.1.4"
"44448","646",2023-12-07 23:45:00,-27996,1913,29909,907,TRUE,NA,"0.1.4"
"44449","646",2023-12-08,-27995,1913,29908,907,TRUE,NA,"0.1.4"
"44450","646",2023-12-08 00:15:00,-27997,1913,29910,907,TRUE,NA,"0.1.4"
"44451","646",2023-12-08 00:30:00,-27993,1913,29906,907,TRUE,NA,"0.1.4"
"44452","646",2023-12-08 00:45:00,-27993,1913,29906,907,TRUE,NA,"0.1.4"
"44453","646",2023-12-08 01:00:00,-27992,1913,29905,907,TRUE,NA,"0.1.4"
"44454","646",2023-12-08 01:15:00,-27993,1913,29906,907,TRUE,NA,"0.1.4"
"44455","646",2023-12-08 01:30:00,-27995,1913,29908,907,TRUE,NA,"0.1.4"
"44456","646",2023-12-08 01:45:00,-27994,1913,29907,907,TRUE,NA,"0.1.4"
"44457","646",2023-12-08 02:00:00,-27991,1913,29904,907,TRUE,NA,"0.1.4"
"44458","646",2023-12-08 02:15:00,-27992,1913,29905,907,TRUE,NA,"0.1.4"
"44459","646",2023-12-08 02:30:00,-27990,1913,29903,907,TRUE,NA,"0.1.4"
"44460","646",2023-12-08 02:45:00,-27992,1913,29905,907,TRUE,NA,"0.1.4"
"44461","646",2023-12-08 03:00:00,-27991,1913,29904,907,TRUE,NA,"0.1.4"
"44462","646",2023-12-08 03:15:00,-27992,1913,29905,907,TRUE,NA,"0.1.4"
"44463","646",2023-12-08 03:30:00,-27992,1913,29905,907,TRUE,NA,"0.1.4"
"44464","646",2023-12-08 03:45:00,-27991,1913,29904,907,TRUE,NA,"0.1.4"
"44465","646",2023-12-08 04:00:00,-27992,1913,29905,907,TRUE,NA,"0.1.4"
"44466","646",2023-12-08 04:15:00,-27996,1913,29909,907,TRUE,NA,"0.1.4"
"44467","646",2023-12-08 04:30:00,-27992,1913,29905,907,TRUE,NA,"0.1.4"
"44468","646",2023-12-08 04:45:00,-27992,1913,29905,907,TRUE,NA,"0.1.4"
"44469","646",2023-12-08 05:00:00,-27992,1913,29905,907,TRUE,NA,"0.1.4"
"44470","646",2023-12-08 05:15:00,-27992,1913,29905,907,TRUE,NA,"0.1.4"
"44471","646",2023-12-08 05:30:00,-27990,1913,29903,907,TRUE,NA,"0.1.4"
"44472","646",2023-12-08 05:45:00,-27990,1913,29903,907,TRUE,NA,"0.1.4"
"44473","646",2023-12-08 06:00:00,-27990,1913,29903,907,TRUE,NA,"0.1.4"
"44474","646",2023-12-08 06:15:00,-27990,1913,29903,907,TRUE,NA,"0.1.4"
"44475","646",2023-12-08 06:30:00,-27991,1913,29904,907,TRUE,NA,"0.1.4"
"44476","646",2023-12-08 06:45:00,-27990,1913,29903,907,TRUE,NA,"0.1.4"
"44477","646",2023-12-08 07:00:00,-27990,1913,29903,907,TRUE,NA,"0.1.4"
"44478","646",2023-12-08 07:15:00,-27990,1913,29903,907,TRUE,NA,"0.1.4"
"44479","646",2023-12-08 07:30:00,-27990,1913,29903,907,TRUE,NA,"0.1.4"
"44480","646",2023-12-08 07:45:00,-27991,1913,29904,907,TRUE,NA,"0.1.4"
"44481","646",2023-12-08 08:00:00,-27990,1913,29903,907,TRUE,NA,"0.1.4"
"44482","646",2023-12-08 08:15:00,-27990,1913,29903,907,TRUE,NA,"0.1.4"
"44483","646",2023-12-08 08:30:00,-27990,1913,29903,907,TRUE,NA,"0.1.4"
"44484","646",2023-12-08 08:45:00,-27991,1913,29904,907,TRUE,NA,"0.1.4"
"44485","646",2023-12-08 09:00:00,-27990,1913,29903,907,TRUE,NA,"0.1.4"
"44486","646",2023-12-08 09:15:00,-28023,1913,29936,907,TRUE,NA,"0.1.4"
"44487","646",2023-12-08 09:30:00,-28023,1913,29936,907,TRUE,NA,"0.1.4"
"44488","646",2023-12-08 09:45:00,-28021,1913,29934,907,TRUE,NA,"0.1.4"
"44489","646",2023-12-08 10:00:00,-28022,1913,29935,907,TRUE,NA,"0.1.4"
"44490","646",2023-12-08 10:15:00,-28021,1913,29934,907,TRUE,NA,"0.1.4"
"44491","646",2023-12-08 10:30:00,-28022,1913,29935,907,TRUE,NA,"0.1.4"
"44492","646",2023-12-08 10:45:00,-28278,1913,30191,907,TRUE,NA,"0.1.4"
"44493","646",2023-12-08 11:00:00,-28554,1913,30467,907,TRUE,NA,"0.1.4"
"44494","646",2023-12-08 11:15:00,-28347.5,1913,30260.5,907,TRUE,"out1, fill","0.1.4"
"44495","646",2023-12-08 11:30:00,-28141,1913,30054,907,TRUE,NA,"0.1.4"
"44496","646",2023-12-08 11:45:00,-28208,1913,30121,907,TRUE,NA,"0.1.4"
"44497","646",2023-12-08 12:00:00,-28182,1913,30095,907,TRUE,NA,"0.1.4"
"44498","646",2023-12-08 12:15:00,-28183,1913,30096,907,TRUE,NA,"0.1.4"
"44499","646",2023-12-08 12:30:00,-28150.8333333333,1913,30063.8333333333,907,TRUE,"out1, fill","0.1.4"
"44500","646",2023-12-08 12:45:00,-28118.6666666667,1913,30031.6666666667,907,TRUE,"out1, fill","0.1.4"
"44501","646",2023-12-08 13:00:00,-28086.5,1913,29999.5,907,TRUE,"out1, fill","0.1.4"
"44502","646",2023-12-08 13:15:00,-28054.3333333333,1913,29967.3333333333,907,TRUE,"out1, fill","0.1.4"
"44503","646",2023-12-08 13:30:00,-28022.1666666667,1913,29935.1666666667,907,TRUE,"out1, fill","0.1.4"
"44504","646",2023-12-08 13:45:00,-27990,1913,29903,907,TRUE,NA,"0.1.4"
"44505","646",2023-12-08 14:00:00,-27990,1913,29903,907,TRUE,NA,"0.1.4"
"44506","646",2023-12-08 14:15:00,-27989,1913,29902,907,TRUE,NA,"0.1.4"
"44507","646",2023-12-08 14:30:00,-27989,1913,29902,907,TRUE,NA,"0.1.4"
"44508","646",2023-12-08 14:45:00,-27989,1913,29902,907,TRUE,NA,"0.1.4"
"44509","646",2023-12-08 15:00:00,-27989,1913,29902,907,TRUE,NA,"0.1.4"
"44510","646",2023-12-08 15:15:00,-27989,1913,29902,907,TRUE,NA,"0.1.4"
"44511","646",2023-12-08 15:30:00,-27989,1913,29902,907,TRUE,NA,"0.1.4"
"44512","646",2023-12-08 15:45:00,-27989,1913,29902,907,TRUE,NA,"0.1.4"
"44513","646",2023-12-08 16:00:00,-27989,1913,29902,907,TRUE,NA,"0.1.4"
"44514","646",2023-12-08 16:15:00,-27989,1913,29902,907,TRUE,NA,"0.1.4"
"44515","646",2023-12-08 16:30:00,-27989,1913,29902,907,TRUE,NA,"0.1.4"
"44516","646",2023-12-08 16:45:00,-27989,1913,29902,907,TRUE,NA,"0.1.4"
"44517","646",2023-12-08 17:00:00,-27990,1913,29903,907,TRUE,NA,"0.1.4"
"44518","646",2023-12-08 17:15:00,-27990,1913,29903,907,TRUE,NA,"0.1.4"
"44519","646",2023-12-08 17:30:00,-27990,1913,29903,907,TRUE,NA,"0.1.4"
"44520","646",2023-12-08 17:45:00,-27990,1913,29903,907,TRUE,NA,"0.1.4"
"44521","646",2023-12-08 18:00:00,-27995,1913,29908,907,TRUE,NA,"0.1.4"
"44522","646",2023-12-08 18:15:00,-28001,1913,29914,907,TRUE,NA,"0.1.4"
"44523","646",2023-12-08 18:30:00,-27990,1913,29903,907,TRUE,NA,"0.1.4"
"44524","646",2023-12-08 18:45:00,-27990,1913,29903,907,TRUE,NA,"0.1.4"
"44525","646",2023-12-08 19:00:00,-27990,1913,29903,907,TRUE,NA,"0.1.4"
"44526","646",2023-12-08 19:15:00,-27990,1913,29903,907,TRUE,NA,"0.1.4"
"44527","646",2023-12-08 19:30:00,-27990,1913,29903,907,TRUE,NA,"0.1.4"
"44528","646",2023-12-08 19:45:00,-27990,1913,29903,907,TRUE,NA,"0.1.4"
"44529","646",2023-12-08 20:00:00,-27990,1913,29903,907,TRUE,NA,"0.1.4"
"44530","646",2023-12-08 20:15:00,-27990,1913,29903,907,TRUE,NA,"0.1.4"
"44531","646",2023-12-08 20:30:00,-27990,1913,29903,907,TRUE,NA,"0.1.4"
"44532","646",2023-12-08 20:45:00,-27990,1913,29903,907,TRUE,NA,"0.1.4"
"44533","646",2023-12-08 21:00:00,-27990,1913,29903,907,TRUE,NA,"0.1.4"
"44534","646",2023-12-08 21:15:00,-27990,1913,29903,907,TRUE,NA,"0.1.4"
"44535","646",2023-12-08 21:30:00,-27990,1913,29903,907,TRUE,NA,"0.1.4"
"44536","646",2023-12-08 21:45:00,-27990,1913,29903,907,TRUE,NA,"0.1.4"
"44537","646",2023-12-08 22:00:00,-27990,1913,29903,907,TRUE,NA,"0.1.4"
"44538","646",2023-12-08 22:15:00,-27990,1913,29903,907,TRUE,NA,"0.1.4"
"44539","646",2023-12-08 22:30:00,-27990,1913,29903,907,TRUE,NA,"0.1.4"
"44540","646",2023-12-08 22:45:00,-27990,1913,29903,907,TRUE,NA,"0.1.4"
"44541","646",2023-12-08 23:00:00,-27990,1913,29903,907,TRUE,NA,"0.1.4"
"44542","646",2023-12-08 23:15:00,-27990,1913,29903,907,TRUE,NA,"0.1.4"
"44543","646",2023-12-08 23:30:00,-28021,1913,29934,907,TRUE,NA,"0.1.4"
"44544","646",2023-12-08 23:45:00,-28109,1913,30022,907,TRUE,NA,"0.1.4"
"44545","646",2023-12-09,-28262,1913,30175,907,TRUE,NA,"0.1.4"
"44546","646",2023-12-09 00:15:00,-28157,1913,30070,907,TRUE,NA,"0.1.4"
"44547","646",2023-12-09 00:30:00,-28218,1913,30131,907,TRUE,NA,"0.1.4"
"44548","646",2023-12-09 00:45:00,-28575,1913,30488,907,TRUE,NA,"0.1.4"
"44549","646",2023-12-09 01:00:00,-28830,1913,30743,907,TRUE,NA,"0.1.4"
"44550","646",2023-12-09 01:15:00,-28710,1913,30623,907,TRUE,NA,"0.1.4"
"44551","646",2023-12-09 01:30:00,-28806.3333333333,1913,30719.3333333333,907,TRUE,"out1, fill","0.1.4"
"44552","646",2023-12-09 01:45:00,-28902.6666666667,1913,30815.6666666667,907,TRUE,"out1, fill","0.1.4"
"44553","646",2023-12-09 02:00:00,-28999,1913,30912,907,TRUE,NA,"0.1.4"
"44554","646",2023-12-09 02:15:00,-28940,1913,30853,907,TRUE,NA,"0.1.4"
"44555","646",2023-12-09 02:30:00,-29286,1913,31199,907,TRUE,NA,"0.1.4"
"44556","646",2023-12-09 02:45:00,-29221,1913,31134,907,TRUE,"out1, fill","0.1.4"
"44557","646",2023-12-09 03:00:00,-29156,1913,31069,907,TRUE,"out1, fill","0.1.4"
"44558","646",2023-12-09 03:15:00,-29091,1913,31004,907,TRUE,NA,"0.1.4"
"44559","646",2023-12-09 03:30:00,-29239,1913,31152,907,TRUE,NA,"0.1.4"
"44560","646",2023-12-09 03:45:00,-29055,1913,30968,907,TRUE,NA,"0.1.4"
"44561","646",2023-12-09 04:00:00,-29127,1913,31040,907,TRUE,NA,"0.1.4"
"44562","646",2023-12-09 04:15:00,-29127,1913,31040,907,TRUE,"out1, fill","0.1.4"
"44563","646",2023-12-09 04:30:00,-29127,1913,31040,907,TRUE,"jump1","0.1.4"
"44564","646",2023-12-09 04:45:00,-29138,1913,31051,907,TRUE,NA,"0.1.4"
"44565","646",2023-12-09 05:00:00,-29128,1913,31041,907,TRUE,NA,"0.1.4"
"44566","646",2023-12-09 05:15:00,-29127,1913,31040,907,TRUE,NA,"0.1.4"
"44567","646",2023-12-09 05:30:00,-29155,1913,31068,907,TRUE,NA,"0.1.4"
"44568","646",2023-12-09 05:45:00,-29126,1913,31039,907,TRUE,NA,"0.1.4"
"44569","646",2023-12-09 06:00:00,-29127,1913,31040,907,TRUE,NA,"0.1.4"
"44570","646",2023-12-09 06:15:00,-29127,1913,31040,907,TRUE,NA,"0.1.4"
"44571","646",2023-12-09 06:30:00,-29127,1913,31040,907,TRUE,NA,"0.1.4"
"44572","646",2023-12-09 06:45:00,-29129,1913,31042,907,TRUE,NA,"0.1.4"
"44573","646",2023-12-09 07:00:00,-29132,1913,31045,907,TRUE,NA,"0.1.4"
"44574","646",2023-12-09 07:15:00,-29127,1913,31040,907,TRUE,NA,"0.1.4"
"44575","646",2023-12-09 07:30:00,-29126,1913,31039,907,TRUE,NA,"0.1.4"
"44576","646",2023-12-09 07:45:00,-29127,1913,31040,907,TRUE,NA,"0.1.4"
"44577","646",2023-12-09 08:00:00,-29126,1913,31039,907,TRUE,NA,"0.1.4"
"44578","646",2023-12-09 08:15:00,-29126,1913,31039,907,TRUE,NA,"0.1.4"
"44579","646",2023-12-09 08:30:00,-29126,1913,31039,907,TRUE,NA,"0.1.4"
"44580","646",2023-12-09 08:45:00,-29126,1913,31039,907,TRUE,NA,"0.1.4"
"44581","646",2023-12-09 09:00:00,-29127,1913,31040,907,TRUE,NA,"0.1.4"
"44582","646",2023-12-09 09:15:00,-29126,1913,31039,907,TRUE,NA,"0.1.4"
"44583","646",2023-12-09 09:30:00,-29129,1913,31042,907,TRUE,NA,"0.1.4"
"44584","646",2023-12-09 09:45:00,-29127,1913,31040,907,TRUE,NA,"0.1.4"
"44585","646",2023-12-09 10:00:00,-29139,1913,31052,907,TRUE,NA,"0.1.4"
"44586","646",2023-12-09 10:15:00,-29298,1913,31211,907,TRUE,NA,"0.1.4"
"44587","646",2023-12-09 10:30:00,-29298,1913,31211,907,TRUE,"out1, fill","0.1.4"
"44588","646",2023-12-09 10:45:00,-29298,1913,31211,907,TRUE,"jump1","0.1.4"
"44589","646",2023-12-09 11:00:00,-29044,1913,30957,907,TRUE,NA,"0.1.4"
"44590","646",2023-12-09 11:15:00,-28982,1913,30895,907,TRUE,NA,"0.1.4"
"44591","646",2023-12-09 11:30:00,-29111,1913,31024,907,TRUE,NA,"0.1.4"
"44592","646",2023-12-09 11:45:00,-29064,1913,30977,907,TRUE,NA,"0.1.4"
"44593","646",2023-12-09 12:00:00,-29106,1913,31019,907,TRUE,NA,"0.1.4"
"44594","646",2023-12-09 12:15:00,-28877,1913,30790,907,TRUE,NA,"0.1.4"
"44595","646",2023-12-09 12:30:00,-28966,1913,30879,907,TRUE,NA,"0.1.4"
"44596","646",2023-12-09 12:45:00,-28997,1913,30910,907,TRUE,NA,"0.1.4"
"44597","646",2023-12-09 13:00:00,-29041,1913,30954,907,TRUE,NA,"0.1.4"
"44598","646",2023-12-09 13:15:00,-29052,1913,30965,907,TRUE,NA,"0.1.4"
"44599","646",2023-12-09 13:30:00,-29027,1913,30940,907,TRUE,NA,"0.1.4"
"44600","646",2023-12-09 13:45:00,-29131,1913,31044,907,TRUE,NA,"0.1.4"
"44601","646",2023-12-09 14:00:00,-29059,1913,30972,907,TRUE,NA,"0.1.4"
"44602","646",2023-12-09 14:15:00,-28971,1913,30884,907,TRUE,NA,"0.1.4"
"44603","646",2023-12-09 14:30:00,-29130,1913,31043,907,TRUE,NA,"0.1.4"
"44604","646",2023-12-09 14:45:00,-29021,1913,30934,907,TRUE,NA,"0.1.4"
"44605","646",2023-12-09 15:00:00,-28936,1913,30849,907,TRUE,NA,"0.1.4"
"44606","646",2023-12-09 15:15:00,-29098,1913,31011,907,TRUE,NA,"0.1.4"
"44607","646",2023-12-09 15:30:00,-29080,1913,30993,907,TRUE,NA,"0.1.4"
"44608","646",2023-12-09 15:45:00,-29036,1913,30949,907,TRUE,NA,"0.1.4"
"44609","646",2023-12-09 16:00:00,-28988,1913,30901,907,TRUE,NA,"0.1.4"
"44610","646",2023-12-09 16:15:00,-28752,1913,30665,907,TRUE,NA,"0.1.4"
"44611","646",2023-12-09 16:30:00,-28332,1913,30245,907,TRUE,"out1, fill","0.1.4"
"44612","646",2023-12-09 16:45:00,-27912,1913,29825,907,TRUE,NA,"0.1.4"
"44613","646",2023-12-09 17:00:00,-27933,1913,29846,907,TRUE,NA,"0.1.4"
"44614","646",2023-12-09 17:15:00,-27918,1913,29831,907,TRUE,NA,"0.1.4"
"44615","646",2023-12-09 17:30:00,-27917,1913,29830,907,TRUE,NA,"0.1.4"
"44616","646",2023-12-09 17:45:00,-27919,1913,29832,907,TRUE,NA,"0.1.4"
"44617","646",2023-12-09 18:00:00,-27917.6666666667,1913,29830.6666666667,907,TRUE,"out1, fill","0.1.4"
"44618","646",2023-12-09 18:15:00,-27916.3333333333,1913,29829.3333333333,907,TRUE,"out1, fill","0.1.4"
"44619","646",2023-12-09 18:30:00,-27915,1913,29828,907,TRUE,NA,"0.1.4"
"44620","646",2023-12-09 18:45:00,-27914,1913,29827,907,TRUE,NA,"0.1.4"
"44621","646",2023-12-09 19:00:00,-27915,1913,29828,907,TRUE,NA,"0.1.4"
"44622","646",2023-12-09 19:15:00,-27915,1913,29828,907,TRUE,NA,"0.1.4"
"44623","646",2023-12-09 19:30:00,-27914,1913,29827,907,TRUE,NA,"0.1.4"
"44624","646",2023-12-09 19:45:00,-27914,1913,29827,907,TRUE,NA,"0.1.4"
"44625","646",2023-12-09 20:00:00,-27917,1913,29830,907,TRUE,NA,"0.1.4"
"44626","646",2023-12-09 20:15:00,-27950,1913,29863,907,TRUE,NA,"0.1.4"
"44627","646",2023-12-09 20:30:00,-27937.6666666667,1913,29850.6666666667,907,TRUE,"out1, fill","0.1.4"
"44628","646",2023-12-09 20:45:00,-27925.3333333333,1913,29838.3333333333,907,TRUE,"out1, fill","0.1.4"
"44629","646",2023-12-09 21:00:00,-27913,1913,29826,907,TRUE,NA,"0.1.4"
"44630","646",2023-12-09 21:15:00,-27913,1913,29826,907,TRUE,NA,"0.1.4"
"44631","646",2023-12-09 21:30:00,-27912,1913,29825,907,TRUE,NA,"0.1.4"
"44632","646",2023-12-09 21:45:00,-27912,1913,29825,907,TRUE,NA,"0.1.4"
"44633","646",2023-12-09 22:00:00,-27912,1913,29825,907,TRUE,NA,"0.1.4"
"44634","646",2023-12-09 22:15:00,-27912,1913,29825,907,TRUE,NA,"0.1.4"
"44635","646",2023-12-09 22:30:00,-27912,1913,29825,907,TRUE,NA,"0.1.4"
"44636","646",2023-12-09 22:45:00,-27912,1913,29825,907,TRUE,NA,"0.1.4"
"44637","646",2023-12-09 23:00:00,-27912,1913,29825,907,TRUE,NA,"0.1.4"
"44638","646",2023-12-09 23:15:00,-27912,1913,29825,907,TRUE,NA,"0.1.4"
"44639","646",2023-12-09 23:30:00,-27912,1913,29825,907,TRUE,NA,"0.1.4"
"44640","646",2023-12-09 23:45:00,-27912,1913,29825,907,TRUE,NA,"0.1.4"
"44641","646",2023-12-10,-27912,1913,29825,907,TRUE,NA,"0.1.4"
"44642","646",2023-12-10 00:15:00,-27912,1913,29825,907,TRUE,NA,"0.1.4"
"44643","646",2023-12-10 00:30:00,-27912,1913,29825,907,TRUE,NA,"0.1.4"
"44644","646",2023-12-10 00:45:00,-27912,1913,29825,907,TRUE,NA,"0.1.4"
"44645","646",2023-12-10 01:00:00,-27912,1913,29825,907,TRUE,NA,"0.1.4"
"44646","646",2023-12-10 01:15:00,-27912,1913,29825,907,TRUE,NA,"0.1.4"
"44647","646",2023-12-10 01:30:00,-27912,1913,29825,907,TRUE,NA,"0.1.4"
"44648","646",2023-12-10 01:45:00,-27912,1913,29825,907,TRUE,NA,"0.1.4"
"44649","646",2023-12-10 02:00:00,-27912,1913,29825,907,TRUE,NA,"0.1.4"
"44650","646",2023-12-10 02:15:00,-27911,1913,29824,907,TRUE,NA,"0.1.4"
"44651","646",2023-12-10 02:30:00,-27911,1913,29824,907,TRUE,NA,"0.1.4"
"44652","646",2023-12-10 02:45:00,-27911,1913,29824,907,TRUE,NA,"0.1.4"
"44653","646",2023-12-10 03:00:00,-27911,1913,29824,907,TRUE,NA,"0.1.4"
"44654","646",2023-12-10 03:15:00,-27911,1913,29824,907,TRUE,NA,"0.1.4"
"44655","646",2023-12-10 03:30:00,-27911,1913,29824,907,TRUE,NA,"0.1.4"
"44656","646",2023-12-10 03:45:00,-27911,1913,29824,907,TRUE,NA,"0.1.4"
"44657","646",2023-12-10 04:00:00,-27911,1913,29824,907,TRUE,NA,"0.1.4"
"44658","646",2023-12-10 04:15:00,-27911,1913,29824,907,TRUE,NA,"0.1.4"
"44659","646",2023-12-10 04:30:00,-27911,1913,29824,907,TRUE,NA,"0.1.4"
"44660","646",2023-12-10 04:45:00,-27911,1913,29824,907,TRUE,NA,"0.1.4"
"44661","646",2023-12-10 05:00:00,-27911,1913,29824,907,TRUE,NA,"0.1.4"
"44662","646",2023-12-10 05:15:00,-27911,1913,29824,907,TRUE,NA,"0.1.4"
"44663","646",2023-12-10 05:30:00,-27912,1913,29825,907,TRUE,NA,"0.1.4"
"44664","646",2023-12-10 05:45:00,-27912,1913,29825,907,TRUE,NA,"0.1.4"
"44665","646",2023-12-10 06:00:00,-27912,1913,29825,907,TRUE,NA,"0.1.4"
"44666","646",2023-12-10 06:15:00,-27912,1913,29825,907,TRUE,NA,"0.1.4"
"44667","646",2023-12-10 06:30:00,-27912,1913,29825,907,TRUE,NA,"0.1.4"
"44668","646",2023-12-10 06:45:00,-27912,1913,29825,907,TRUE,NA,"0.1.4"
"44669","646",2023-12-10 07:00:00,-27912,1913,29825,907,TRUE,NA,"0.1.4"
"44670","646",2023-12-10 07:15:00,-27912,1913,29825,907,TRUE,NA,"0.1.4"
"44671","646",2023-12-10 07:30:00,-27912,1913,29825,907,TRUE,NA,"0.1.4"
"44672","646",2023-12-10 07:45:00,-27912,1913,29825,907,TRUE,NA,"0.1.4"
"44673","646",2023-12-10 08:00:00,-27912,1913,29825,907,TRUE,NA,"0.1.4"
"44674","646",2023-12-10 08:15:00,-27911,1913,29824,907,TRUE,NA,"0.1.4"
"44675","646",2023-12-10 08:30:00,-27911,1913,29824,907,TRUE,NA,"0.1.4"
"44676","646",2023-12-10 08:45:00,-27911,1913,29824,907,TRUE,NA,"0.1.4"
"44677","646",2023-12-10 09:00:00,-27911,1913,29824,907,TRUE,NA,"0.1.4"
"44678","646",2023-12-10 09:15:00,-27911,1913,29824,907,TRUE,NA,"0.1.4"
"44679","646",2023-12-10 09:30:00,-27911,1913,29824,907,TRUE,NA,"0.1.4"
"44680","646",2023-12-10 09:45:00,-27911,1913,29824,907,TRUE,NA,"0.1.4"
"44681","646",2023-12-10 10:00:00,-27911,1913,29824,907,TRUE,NA,"0.1.4"
"44682","646",2023-12-10 10:15:00,-27911,1913,29824,907,TRUE,NA,"0.1.4"
"44683","646",2023-12-10 10:30:00,-27911,1913,29824,907,TRUE,NA,"0.1.4"
"44684","646",2023-12-10 10:45:00,-27911,1913,29824,907,TRUE,NA,"0.1.4"
"44685","646",2023-12-10 11:00:00,-27911,1913,29824,907,TRUE,NA,"0.1.4"
"44686","646",2023-12-10 11:15:00,-27911,1913,29824,907,TRUE,NA,"0.1.4"
"44687","646",2023-12-10 11:30:00,-27911,1913,29824,907,TRUE,NA,"0.1.4"
"44688","646",2023-12-10 11:45:00,-27911,1913,29824,907,TRUE,NA,"0.1.4"
"44689","646",2023-12-10 12:00:00,-27911,1913,29824,907,TRUE,NA,"0.1.4"
"44690","646",2023-12-10 12:15:00,-27911,1913,29824,907,TRUE,NA,"0.1.4"
"44691","646",2023-12-10 12:30:00,-27911,1913,29824,907,TRUE,NA,"0.1.4"
"44692","646",2023-12-10 12:45:00,-27911,1913,29824,907,TRUE,NA,"0.1.4"
"44693","646",2023-12-10 13:00:00,-27911,1913,29824,907,TRUE,NA,"0.1.4"
"44694","646",2023-12-10 13:15:00,-27911,1913,29824,907,TRUE,NA,"0.1.4"
"44695","646",2023-12-10 13:30:00,-27911,1913,29824,907,TRUE,NA,"0.1.4"
"44696","646",2023-12-10 13:45:00,-27911,1913,29824,907,TRUE,NA,"0.1.4"
"44697","646",2023-12-10 14:00:00,-27911,1913,29824,907,TRUE,NA,"0.1.4"
"44698","646",2023-12-10 14:15:00,-27911,1913,29824,907,TRUE,NA,"0.1.4"
"44699","646",2023-12-10 14:30:00,-27911,1913,29824,907,TRUE,NA,"0.1.4"
"44700","646",2023-12-10 14:45:00,-27911,1913,29824,907,TRUE,NA,"0.1.4"
"44701","646",2023-12-10 15:00:00,-27911,1913,29824,907,TRUE,NA,"0.1.4"
"44702","646",2023-12-10 15:15:00,-27911,1913,29824,907,TRUE,NA,"0.1.4"
"44703","646",2023-12-10 15:30:00,-27911,1913,29824,907,TRUE,NA,"0.1.4"
"44704","646",2023-12-10 15:45:00,-27911,1913,29824,907,TRUE,NA,"0.1.4"
"44705","646",2023-12-10 16:00:00,-27911,1913,29824,907,TRUE,NA,"0.1.4"
"44706","646",2023-12-10 16:15:00,-27911,1913,29824,907,TRUE,NA,"0.1.4"
"44707","646",2023-12-10 16:30:00,-27911,1913,29824,907,TRUE,NA,"0.1.4"
"44708","646",2023-12-10 16:45:00,-27911,1913,29824,907,TRUE,NA,"0.1.4"
"44709","646",2023-12-10 17:00:00,-27911,1913,29824,907,TRUE,NA,"0.1.4"
"44710","646",2023-12-10 17:15:00,-27911,1913,29824,907,TRUE,NA,"0.1.4"
"44711","646",2023-12-10 17:30:00,-27911,1913,29824,907,TRUE,NA,"0.1.4"
"44712","646",2023-12-10 17:45:00,-27911,1913,29824,907,TRUE,NA,"0.1.4"
"44713","646",2023-12-10 18:00:00,-27911,1913,29824,907,TRUE,NA,"0.1.4"
"44714","646",2023-12-10 18:15:00,-27911,1913,29824,907,TRUE,NA,"0.1.4"
"44715","646",2023-12-10 18:30:00,-27911,1913,29824,907,TRUE,NA,"0.1.4"
"44716","646",2023-12-10 18:45:00,-27911,1913,29824,907,TRUE,NA,"0.1.4"
"44717","646",2023-12-10 19:00:00,-27911,1913,29824,907,TRUE,NA,"0.1.4"
"44718","646",2023-12-10 19:15:00,-27911,1913,29824,907,TRUE,NA,"0.1.4"
"44719","646",2023-12-10 19:30:00,-27911,1913,29824,907,TRUE,NA,"0.1.4"
"44720","646",2023-12-10 19:45:00,-27911,1913,29824,907,TRUE,NA,"0.1.4"
"44721","646",2023-12-10 20:00:00,-27911,1913,29824,907,TRUE,NA,"0.1.4"
"44722","646",2023-12-10 20:15:00,-27911,1913,29824,907,TRUE,NA,"0.1.4"
"44723","646",2023-12-10 20:30:00,-27911,1913,29824,907,TRUE,NA,"0.1.4"
"44724","646",2023-12-10 20:45:00,-27911,1913,29824,907,TRUE,NA,"0.1.4"
"44725","646",2023-12-10 21:00:00,-27911,1913,29824,907,TRUE,NA,"0.1.4"
"44726","646",2023-12-10 21:15:00,-27911,1913,29824,907,TRUE,NA,"0.1.4"
"44727","646",2023-12-10 21:30:00,-27911,1913,29824,907,TRUE,NA,"0.1.4"
"44728","646",2023-12-10 21:45:00,-27911,1913,29824,907,TRUE,NA,"0.1.4"
"44729","646",2023-12-10 22:00:00,-27911,1913,29824,907,TRUE,NA,"0.1.4"
"44730","646",2023-12-10 22:15:00,-27911,1913,29824,907,TRUE,NA,"0.1.4"
"44731","646",2023-12-10 22:30:00,-27911,1913,29824,907,FALSE,NA,"0.1.4"
"44732","646",2023-12-10 22:45:00,-27911,1913,29824,907,FALSE,NA,"0.1.4"
"44733","646",2023-12-10 23:00:00,-27911,1913,29824,907,FALSE,NA,"0.1.4"
"44734","646",2023-12-10 23:15:00,-27911,1913,29824,907,FALSE,NA,"0.1.4"
"44735","646",2023-12-10 23:30:00,-27911,1913,29824,907,FALSE,NA,"0.1.4"
"44736","646",2023-12-10 23:45:00,-27911,1913,29824,907,FALSE,NA,"0.1.4"
"44737","646",2023-12-11,-27911,1913,29824,907,FALSE,NA,"0.1.4"
"44738","646",2023-12-11 00:15:00,-27911,1913,29824,907,FALSE,NA,"0.1.4"
"44739","646",2023-12-11 00:30:00,-27911,1913,29824,907,FALSE,NA,"0.1.4"
"44740","646",2023-12-11 00:45:00,-27911,1913,29824,907,FALSE,NA,"0.1.4"
"44741","646",2023-12-11 01:00:00,-27911,1913,29824,907,FALSE,NA,"0.1.4"
"44742","646",2023-12-11 01:15:00,-27911,1913,29824,907,FALSE,NA,"0.1.4"
"44743","646",2023-12-11 01:30:00,-27911,1913,29824,907,FALSE,NA,"0.1.4"
"44744","646",2023-12-11 01:45:00,-27911,1913,29824,907,FALSE,NA,"0.1.4"
"44745","646",2023-12-11 02:00:00,-27911,1913,29824,907,FALSE,NA,"0.1.4"
"44746","646",2023-12-11 02:15:00,-27911,1913,29824,907,FALSE,NA,"0.1.4"
"44747","646",2023-12-11 02:30:00,-27911,1913,29824,907,FALSE,NA,"0.1.4"
"44748","646",2023-12-11 02:45:00,-27911,1913,29824,907,FALSE,NA,"0.1.4"
"44749","646",2023-12-11 03:00:00,-27912,1913,29825,907,FALSE,NA,"0.1.4"
"44750","646",2023-12-11 03:15:00,-27912,1913,29825,907,FALSE,NA,"0.1.4"
"44751","646",2023-12-11 03:30:00,-27911,1913,29824,907,FALSE,NA,"0.1.4"
"44752","646",2023-12-11 03:45:00,-27911,1913,29824,907,FALSE,NA,"0.1.4"
"44753","646",2023-12-11 04:00:00,-27911,1913,29824,907,FALSE,NA,"0.1.4"
"44754","646",2023-12-11 04:15:00,-27911,1913,29824,907,FALSE,NA,"0.1.4"
"44755","646",2023-12-11 04:30:00,-27911,1913,29824,907,FALSE,NA,"0.1.4"
"44756","646",2023-12-11 04:45:00,-27911,1913,29824,907,FALSE,NA,"0.1.4"
"44757","646",2023-12-11 05:00:00,-27911,1913,29824,907,FALSE,NA,"0.1.4"
"44758","646",2023-12-11 05:15:00,-27911,1913,29824,907,FALSE,NA,"0.1.4"
"44759","646",2023-12-11 05:30:00,-27911,1913,29824,907,FALSE,NA,"0.1.4"
"44760","646",2023-12-11 05:45:00,-27911,1913,29824,907,FALSE,NA,"0.1.4"
"44761","646",2023-12-11 06:00:00,-27911,1913,29824,907,FALSE,NA,"0.1.4"
"44762","646",2023-12-11 06:15:00,-27911,1913,29824,907,FALSE,NA,"0.1.4"
"44763","646",2023-12-11 06:30:00,-27911,1913,29824,907,FALSE,NA,"0.1.4"
"44764","646",2023-12-11 06:45:00,-27911,1913,29824,907,FALSE,NA,"0.1.4"
"44765","646",2023-12-11 07:00:00,-27911,1913,29824,907,FALSE,NA,"0.1.4"
"44766","646",2023-12-11 07:15:00,-27911,1913,29824,907,FALSE,NA,"0.1.4"
"44767","646",2023-12-11 07:30:00,-27911,1913,29824,907,FALSE,NA,"0.1.4"
"44768","646",2023-12-11 07:45:00,-27911,1913,29824,907,FALSE,NA,"0.1.4"
"44769","646",2023-12-11 08:00:00,-27911,1913,29824,907,FALSE,NA,"0.1.4"
"44770","646",2023-12-11 08:15:00,-27911,1913,29824,907,FALSE,NA,"0.1.4"
"44771","646",2023-12-11 08:30:00,-27911,1913,29824,907,FALSE,NA,"0.1.4"
"44772","646",2023-12-11 08:45:00,-27911,1913,29824,907,FALSE,NA,"0.1.4"
"44773","646",2023-12-11 09:00:00,-27911,1913,29824,907,FALSE,NA,"0.1.4"
"44774","646",2023-12-11 09:15:00,-27911,1913,29824,907,FALSE,NA,"0.1.4"
"44775","646",2023-12-11 09:30:00,-27911,1913,29824,907,FALSE,NA,"0.1.4"
"44776","646",2023-12-11 09:45:00,-27911,1913,29824,907,FALSE,NA,"0.1.4"
"44777","646",2023-12-11 10:00:00,-27911,1913,29824,907,FALSE,NA,"0.1.4"
"44778","646",2023-12-11 10:15:00,-27911,1913,29824,907,FALSE,NA,"0.1.4"
"44779","646",2023-12-11 10:30:00,-27911,1913,29824,907,FALSE,NA,"0.1.4"
"44780","646",2023-12-11 10:45:00,-27911,1913,29824,907,FALSE,NA,"0.1.4"
"44781","646",2023-12-11 11:00:00,-27911,1913,29824,907,FALSE,NA,"0.1.4"
"44782","646",2023-12-11 11:15:00,-27911,1913,29824,907,FALSE,NA,"0.1.4"
"44783","646",2023-12-11 11:30:00,-27911,1913,29824,907,FALSE,NA,"0.1.4"
"44784","646",2023-12-11 11:45:00,-27911,1913,29824,907,FALSE,NA,"0.1.4"
"44785","646",2023-12-11 12:00:00,-27911,1913,29824,907,FALSE,NA,"0.1.4"
"44786","646",2023-12-11 12:15:00,-27911,1913,29824,907,FALSE,NA,"0.1.4"
"44787","646",2023-12-11 12:30:00,-27911,1913,29824,907,FALSE,NA,"0.1.4"
"44788","646",2023-12-11 12:45:00,-27911,1913,29824,907,FALSE,NA,"0.1.4"
"44789","646",2023-12-11 13:00:00,-27911,1913,29824,907,FALSE,NA,"0.1.4"
"44790","646",2023-12-11 13:15:00,-27911,1913,29824,907,FALSE,NA,"0.1.4"
"44791","646",2023-12-11 13:30:00,-27911,1913,29824,907,FALSE,NA,"0.1.4"
"44792","646",2023-12-11 13:45:00,-27911,1913,29824,907,FALSE,NA,"0.1.4"
"44793","646",2023-12-11 14:00:00,-27911,1913,29824,907,FALSE,NA,"0.1.4"
"44794","646",2023-12-11 14:15:00,-27911,1913,29824,907,FALSE,NA,"0.1.4"
"44795","646",2023-12-11 14:30:00,-27911,1913,29824,907,FALSE,NA,"0.1.4"
"44796","646",2023-12-11 14:45:00,-27911,1913,29824,907,FALSE,NA,"0.1.4"
"44797","646",2023-12-11 15:00:00,-27911,1913,29824,907,FALSE,NA,"0.1.4"
"44798","646",2023-12-11 15:15:00,-27911,1913,29824,907,FALSE,NA,"0.1.4"
"44799","646",2023-12-11 15:30:00,-27911,1913,29824,907,FALSE,NA,"0.1.4"
"44800","646",2023-12-11 15:45:00,-27911,1913,29824,907,FALSE,NA,"0.1.4"
"44801","646",2023-12-11 16:00:00,-27911,1913,29824,907,FALSE,NA,"0.1.4"
"44802","646",2023-12-11 16:15:00,-27911,1913,29824,907,FALSE,NA,"0.1.4"
"44803","646",2023-12-11 16:30:00,-27911,1913,29824,907,FALSE,NA,"0.1.4"
"44804","646",2023-12-11 16:45:00,-27911,1913,29824,907,FALSE,NA,"0.1.4"
"44805","646",2023-12-11 17:00:00,-27911,1913,29824,907,FALSE,NA,"0.1.4"
"44806","646",2023-12-11 17:15:00,-27911,1913,29824,907,FALSE,NA,"0.1.4"
"44807","646",2023-12-11 17:30:00,-27911,1913,29824,907,FALSE,NA,"0.1.4"
"44808","646",2023-12-11 17:45:00,-27911,1913,29824,907,FALSE,NA,"0.1.4"
"44809","646",2023-12-11 18:00:00,-27911,1913,29824,907,FALSE,NA,"0.1.4"
"44810","646",2023-12-11 18:15:00,-27911,1913,29824,907,FALSE,NA,"0.1.4"
"44811","646",2023-12-11 18:30:00,-27912,1913,29825,907,FALSE,NA,"0.1.4"
"44812","646",2023-12-11 18:45:00,-27913,1913,29826,907,FALSE,NA,"0.1.4"
"44813","646",2023-12-11 19:00:00,-27912,1913,29825,907,FALSE,NA,"0.1.4"
"44814","646",2023-12-11 19:15:00,-27912,1913,29825,907,FALSE,NA,"0.1.4"
"44815","646",2023-12-11 19:30:00,-27912,1913,29825,907,FALSE,NA,"0.1.4"
"44816","646",2023-12-11 19:45:00,-27915,1913,29828,907,FALSE,NA,"0.1.4"
"44817","646",2023-12-11 20:00:00,-27919,1913,29832,907,FALSE,"out1, fill","0.1.4"
"44818","646",2023-12-11 20:15:00,-27923,1913,29836,907,FALSE,"out1, fill","0.1.4"
"44819","646",2023-12-11 20:30:00,-27927,1913,29840,907,FALSE,NA,"0.1.4"
"44820","646",2023-12-11 20:45:00,-27915,1913,29828,907,FALSE,NA,"0.1.4"
"44821","646",2023-12-11 21:00:00,-27916,1913,29829,907,FALSE,NA,"0.1.4"
"44822","646",2023-12-11 21:15:00,-27912,1913,29825,907,FALSE,NA,"0.1.4"
"44823","646",2023-12-11 21:30:00,-27912,1913,29825,907,FALSE,NA,"0.1.4"
"44824","646",2023-12-11 21:45:00,-27912,1913,29825,907,FALSE,NA,"0.1.4"
"44825","646",2023-12-11 22:00:00,-27915,1913,29828,907,FALSE,NA,"0.1.4"
"44826","646",2023-12-11 22:15:00,-27917,1913,29830,907,FALSE,NA,"0.1.4"
"44827","646",2023-12-11 22:30:00,-27914,1913,29827,907,FALSE,NA,"0.1.4"
"44828","646",2023-12-11 22:45:00,-27913,1913,29826,907,FALSE,NA,"0.1.4"
"44829","646",2023-12-11 23:00:00,-27914,1913,29827,907,FALSE,NA,"0.1.4"
"44830","646",2023-12-11 23:15:00,-27912,1913,29825,907,FALSE,NA,"0.1.4"
"44831","646",2023-12-11 23:30:00,-27912,1913,29825,907,FALSE,NA,"0.1.4"
"44832","646",2023-12-11 23:45:00,-27912,1913,29825,907,FALSE,NA,"0.1.4"
"44833","646",2023-12-12,-27912,1913,29825,907,FALSE,NA,"0.1.4"
"44834","646",2023-12-12 00:15:00,-27913,1913,29826,907,FALSE,NA,"0.1.4"
"44835","646",2023-12-12 00:30:00,-27913,1913,29826,907,FALSE,NA,"0.1.4"
"44836","646",2023-12-12 00:45:00,-27915,1913,29828,907,FALSE,NA,"0.1.4"
"44837","646",2023-12-12 01:00:00,-27912,1913,29825,907,FALSE,NA,"0.1.4"
"44838","646",2023-12-12 01:15:00,-27912,1913,29825,907,FALSE,NA,"0.1.4"
"44839","646",2023-12-12 01:30:00,-27912,1913,29825,907,FALSE,NA,"0.1.4"
"44840","646",2023-12-12 01:45:00,-27911,1913,29824,907,FALSE,NA,"0.1.4"
"44841","646",2023-12-12 02:00:00,-27912,1913,29825,907,FALSE,NA,"0.1.4"
"44842","646",2023-12-12 02:15:00,-27912,1913,29825,907,FALSE,NA,"0.1.4"
"44843","646",2023-12-12 02:30:00,-27919,1913,29832,907,FALSE,NA,"0.1.4"
"44844","646",2023-12-12 02:45:00,-27914,1913,29827,907,FALSE,NA,"0.1.4"
"44845","646",2023-12-12 03:00:00,-27912,1913,29825,907,FALSE,NA,"0.1.4"
"44846","646",2023-12-12 03:15:00,-27912,1913,29825,907,FALSE,NA,"0.1.4"
"44847","646",2023-12-12 03:30:00,-27912,1913,29825,907,FALSE,NA,"0.1.4"
"44848","646",2023-12-12 03:45:00,-27912,1913,29825,907,FALSE,NA,"0.1.4"
"44849","646",2023-12-12 04:00:00,-27912,1913,29825,907,FALSE,NA,"0.1.4"
"44850","646",2023-12-12 04:15:00,-27916,1913,29829,907,FALSE,NA,"0.1.4"
"44851","646",2023-12-12 04:30:00,-27912,1913,29825,907,FALSE,NA,"0.1.4"
"44852","646",2023-12-12 04:45:00,-27912,1913,29825,907,FALSE,NA,"0.1.4"
"44853","646",2023-12-12 05:00:00,-27912,1913,29825,907,FALSE,NA,"0.1.4"
"44854","646",2023-12-12 05:15:00,-27912,1913,29825,907,FALSE,NA,"0.1.4"
"44855","646",2023-12-12 05:30:00,-27912,1913,29825,907,FALSE,NA,"0.1.4"
"44856","646",2023-12-12 05:45:00,-27912,1913,29825,907,FALSE,NA,"0.1.4"
"44857","646",2023-12-12 06:00:00,-27912,1913,29825,907,FALSE,NA,"0.1.4"
"44858","646",2023-12-12 06:15:00,-27912,1913,29825,907,FALSE,NA,"0.1.4"
"44859","646",2023-12-12 06:30:00,-27929,1913,29842,907,FALSE,NA,"0.1.4"
"44860","646",2023-12-12 06:45:00,-27913,1913,29826,907,FALSE,NA,"0.1.4"
"44861","646",2023-12-12 07:00:00,-27912.3333333333,1913,29825.3333333333,907,FALSE,"out1, fill","0.1.4"
"44862","646",2023-12-12 07:15:00,-27911.6666666667,1913,29824.6666666667,907,TRUE,"out1, fill","0.1.4"
"44863","646",2023-12-12 07:30:00,-27911,1913,29824,907,TRUE,NA,"0.1.4"
"44864","646",2023-12-12 07:45:00,-27915,1913,29828,907,TRUE,NA,"0.1.4"
"44865","646",2023-12-12 08:00:00,-27911,1913,29824,907,TRUE,NA,"0.1.4"
"44866","646",2023-12-12 08:15:00,-27911,1913,29824,907,TRUE,NA,"0.1.4"
"44867","646",2023-12-12 08:30:00,-27912,1913,29825,907,TRUE,NA,"0.1.4"
"44868","646",2023-12-12 08:45:00,-27913,1913,29826,907,TRUE,NA,"0.1.4"
"44869","646",2023-12-12 09:00:00,-27916,1913,29829,907,TRUE,NA,"0.1.4"
"44870","646",2023-12-12 09:15:00,-27922,1913,29835,907,TRUE,NA,"0.1.4"
"44871","646",2023-12-12 09:30:00,-27918.6666666667,1913,29831.6666666667,907,TRUE,"out1, fill","0.1.4"
"44872","646",2023-12-12 09:45:00,-27915.3333333333,1913,29828.3333333333,907,TRUE,"out1, fill","0.1.4"
"44873","646",2023-12-12 10:00:00,-27912,1913,29825,907,TRUE,NA,"0.1.4"
"44874","646",2023-12-12 10:15:00,-27950,1913,29863,907,TRUE,NA,"0.1.4"
"44875","646",2023-12-12 10:30:00,-27931,1913,29844,907,TRUE,NA,"0.1.4"
"44876","646",2023-12-12 10:45:00,-27932,1913,29845,907,TRUE,NA,"0.1.4"
"44877","646",2023-12-12 11:00:00,-27949.3333333333,1913,29862.3333333333,907,TRUE,"out1, fill","0.1.4"
"44878","646",2023-12-12 11:15:00,-27966.6666666667,1913,29879.6666666667,907,TRUE,"out1, fill","0.1.4"
"44879","646",2023-12-12 11:30:00,-27984,1913,29897,907,TRUE,NA,"0.1.4"
"44880","646",2023-12-12 11:45:00,-27994,1913,29907,907,TRUE,NA,"0.1.4"
"44881","646",2023-12-12 12:00:00,-27913,1913,29826,907,TRUE,NA,"0.1.4"
"44882","646",2023-12-12 12:15:00,-27912,1913,29825,907,TRUE,NA,"0.1.4"
"44883","646",2023-12-12 12:30:00,-27913,1913,29826,907,TRUE,NA,"0.1.4"
"44884","646",2023-12-12 12:45:00,-27911,1913,29824,907,TRUE,NA,"0.1.4"
"44885","646",2023-12-12 13:00:00,-27913,1913,29826,907,TRUE,NA,"0.1.4"
"44886","646",2023-12-12 13:15:00,-27913.3333333333,1913,29826.3333333333,907,TRUE,"out1, fill","0.1.4"
"44887","646",2023-12-12 13:30:00,-27913.6666666667,1913,29826.6666666667,907,TRUE,"out1, fill","0.1.4"
"44888","646",2023-12-12 13:45:00,-27914,1913,29827,907,TRUE,NA,"0.1.4"
"44889","646",2023-12-12 14:00:00,-27912,1913,29825,907,TRUE,NA,"0.1.4"
"44890","646",2023-12-12 14:15:00,-27914,1913,29827,907,TRUE,NA,"0.1.4"
"44891","646",2023-12-12 14:30:00,-27911,1913,29824,907,TRUE,NA,"0.1.4"
"44892","646",2023-12-12 14:45:00,-27912,1913,29825,907,TRUE,NA,"0.1.4"
"44893","646",2023-12-12 15:00:00,-27914,1913,29827,907,TRUE,NA,"0.1.4"
"44894","646",2023-12-12 15:15:00,-27912,1913,29825,907,TRUE,NA,"0.1.4"
"44895","646",2023-12-12 15:30:00,-27913,1913,29826,907,TRUE,NA,"0.1.4"
"44896","646",2023-12-12 15:45:00,-27913,1913,29826,907,TRUE,NA,"0.1.4"
"44897","646",2023-12-12 16:00:00,-28092,1913,30005,907,TRUE,NA,"0.1.4"
"44898","646",2023-12-12 16:15:00,-28398,1913,30311,907,TRUE,NA,"0.1.4"
"44899","646",2023-12-12 16:30:00,-28327,1913,30240,907,TRUE,NA,"0.1.4"
"44900","646",2023-12-12 16:45:00,-28310,1913,30223,907,TRUE,NA,"0.1.4"
"44901","646",2023-12-12 17:00:00,-28305,1913,30218,907,TRUE,NA,"0.1.4"
"44902","646",2023-12-12 17:15:00,-28300,1913,30213,907,TRUE,NA,"0.1.4"
"44903","646",2023-12-12 17:30:00,-28313,1913,30226,907,TRUE,NA,"0.1.4"
"44904","646",2023-12-12 17:45:00,-28320,1913,30233,907,TRUE,NA,"0.1.4"
"44905","646",2023-12-12 18:00:00,-28308,1913,30221,907,TRUE,NA,"0.1.4"
"44906","646",2023-12-12 18:15:00,-28321,1913,30234,907,TRUE,NA,"0.1.4"
"44907","646",2023-12-12 18:30:00,-28332,1913,30245,907,TRUE,NA,"0.1.4"
"44908","646",2023-12-12 18:45:00,-28291,1913,30204,907,TRUE,NA,"0.1.4"
"44909","646",2023-12-12 19:00:00,-28352,1913,30265,907,TRUE,NA,"0.1.4"
"44910","646",2023-12-12 19:15:00,-28369,1913,30282,907,TRUE,NA,"0.1.4"
"44911","646",2023-12-12 19:30:00,-28621,1913,30534,907,TRUE,NA,"0.1.4"
"44912","646",2023-12-12 19:45:00,-28257,1913,30170,907,TRUE,NA,"0.1.4"
"44913","646",2023-12-12 20:00:00,-28142,1913,30055,907,TRUE,"out1, fill","0.1.4"
"44914","646",2023-12-12 20:15:00,-28027,1913,29940,907,TRUE,"out1, fill","0.1.4"
"44915","646",2023-12-12 20:30:00,-27912,1913,29825,907,TRUE,NA,"0.1.4"
"44916","646",2023-12-12 20:45:00,-27911,1913,29824,907,TRUE,NA,"0.1.4"
"44917","646",2023-12-12 21:00:00,-27911,1913,29824,907,TRUE,NA,"0.1.4"
"44918","646",2023-12-12 21:15:00,-27912,1913,29825,907,TRUE,NA,"0.1.4"
"44919","646",2023-12-12 21:30:00,-27912,1913,29825,907,TRUE,NA,"0.1.4"
"44920","646",2023-12-12 21:45:00,-27912,1913,29825,907,TRUE,NA,"0.1.4"
"44921","646",2023-12-12 22:00:00,-27912,1913,29825,907,TRUE,NA,"0.1.4"
"44922","646",2023-12-12 22:15:00,-27912,1913,29825,907,TRUE,NA,"0.1.4"
"44923","646",2023-12-12 22:30:00,-27912,1913,29825,907,TRUE,NA,"0.1.4"
"44924","646",2023-12-12 22:45:00,-27912,1913,29825,907,TRUE,NA,"0.1.4"
"44925","646",2023-12-12 23:00:00,-27912,1913,29825,907,TRUE,NA,"0.1.4"
"44926","646",2023-12-12 23:15:00,-27912,1913,29825,907,TRUE,NA,"0.1.4"
"44927","646",2023-12-12 23:30:00,-27912,1913,29825,907,TRUE,NA,"0.1.4"
"44928","646",2023-12-12 23:45:00,-27912,1913,29825,907,TRUE,NA,"0.1.4"
"44929","646",2023-12-13,-27912,1913,29825,907,TRUE,NA,"0.1.4"
"44930","646",2023-12-13 00:15:00,-27911,1913,29824,907,TRUE,NA,"0.1.4"
"44931","646",2023-12-13 00:30:00,-27912,1913,29825,907,TRUE,NA,"0.1.4"
"44932","646",2023-12-13 00:45:00,-27912,1913,29825,907,TRUE,NA,"0.1.4"
"44933","646",2023-12-13 01:00:00,-27912,1913,29825,907,TRUE,NA,"0.1.4"
"44934","646",2023-12-13 01:15:00,-27914,1913,29827,907,TRUE,NA,"0.1.4"
"44935","646",2023-12-13 01:30:00,-27913,1913,29826,907,TRUE,NA,"0.1.4"
"44936","646",2023-12-13 01:45:00,-28151,1913,30064,907,TRUE,NA,"0.1.4"
"44937","646",2023-12-13 02:00:00,-27924,1913,29837,907,TRUE,NA,"0.1.4"
"44938","646",2023-12-13 02:15:00,-27935,1913,29848,907,TRUE,NA,"0.1.4"
"44939","646",2023-12-13 02:30:00,-27935.2,1913,29848.2,907,TRUE,"out1, fill","0.1.4"
"44940","646",2023-12-13 02:45:00,-27935.4,1913,29848.4,907,TRUE,"out1, fill","0.1.4"
"44941","646",2023-12-13 03:00:00,-27935.6,1913,29848.6,907,TRUE,"out1, fill","0.1.4"
"44942","646",2023-12-13 03:15:00,-27935.8,1913,29848.8,907,TRUE,"out1, fill","0.1.4"
"44943","646",2023-12-13 03:30:00,-27936,1913,29849,907,TRUE,"out1, fill","0.1.4"
"44944","646",2023-12-13 03:45:00,-27936.2,1913,29849.2,907,TRUE,"out1, fill","0.1.4"
"44945","646",2023-12-13 04:00:00,-27936.4,1913,29849.4,907,TRUE,"out1, fill","0.1.4"
"44946","646",2023-12-13 04:15:00,-27936.6,1913,29849.6,907,TRUE,"out1, fill","0.1.4"
"44947","646",2023-12-13 04:30:00,-27936.8,1913,29849.8,907,TRUE,"out1, fill","0.1.4"
"44948","646",2023-12-13 04:45:00,-27937,1913,29850,907,TRUE,NA,"0.1.4"
"44949","646",2023-12-13 05:00:00,-27912,1913,29825,907,TRUE,NA,"0.1.4"
"44950","646",2023-12-13 05:15:00,-27912,1913,29825,907,TRUE,NA,"0.1.4"
"44951","646",2023-12-13 05:30:00,-27911,1913,29824,907,TRUE,NA,"0.1.4"
"44952","646",2023-12-13 05:45:00,-27912,1913,29825,907,TRUE,NA,"0.1.4"
"44953","646",2023-12-13 06:00:00,-27912,1913,29825,907,TRUE,NA,"0.1.4"
"44954","646",2023-12-13 06:15:00,-27912,1913,29825,907,TRUE,NA,"0.1.4"
"44955","646",2023-12-13 06:30:00,-28210,1913,30123,907,TRUE,NA,"0.1.4"
"44956","646",2023-12-13 06:45:00,-27913,1913,29826,907,TRUE,NA,"0.1.4"
"44957","646",2023-12-13 07:00:00,-27914.1428571429,1913,29827.1428571429,907,TRUE,"out1, fill","0.1.4"
"44958","646",2023-12-13 07:15:00,-27915.2857142857,1913,29828.2857142857,907,TRUE,"out1, fill","0.1.4"
"44959","646",2023-12-13 07:30:00,-27916.4285714286,1913,29829.4285714286,907,TRUE,"out1, fill","0.1.4"
"44960","646",2023-12-13 07:45:00,-27917.5714285714,1913,29830.5714285714,907,TRUE,"out1, fill","0.1.4"
"44961","646",2023-12-13 08:00:00,-27918.7142857143,1913,29831.7142857143,907,TRUE,"out1, fill","0.1.4"
"44962","646",2023-12-13 08:15:00,-27919.8571428571,1913,29832.8571428571,907,TRUE,"out1, fill","0.1.4"
"44963","646",2023-12-13 08:30:00,-27921,1913,29834,907,TRUE,NA,"0.1.4"
"44964","646",2023-12-13 08:45:00,-27912,1913,29825,907,TRUE,NA,"0.1.4"
"44965","646",2023-12-13 09:00:00,-27912,1913,29825,907,TRUE,NA,"0.1.4"
"44966","646",2023-12-13 09:15:00,-27912,1913,29825,907,TRUE,NA,"0.1.4"
"44967","646",2023-12-13 09:30:00,-27912,1913,29825,907,TRUE,NA,"0.1.4"
"44968","646",2023-12-13 09:45:00,-27912,1913,29825,907,TRUE,NA,"0.1.4"
"44969","646",2023-12-13 10:00:00,-27912,1913,29825,907,TRUE,NA,"0.1.4"
"44970","646",2023-12-13 10:15:00,-27912,1913,29825,907,TRUE,NA,"0.1.4"
"44971","646",2023-12-13 10:30:00,-27912,1913,29825,907,TRUE,NA,"0.1.4"
"44972","646",2023-12-13 10:45:00,-27912,1913,29825,907,TRUE,NA,"0.1.4"
"44973","646",2023-12-13 11:00:00,-27911,1913,29824,907,TRUE,NA,"0.1.4"
"44974","646",2023-12-13 11:15:00,-27912,1913,29825,907,TRUE,NA,"0.1.4"
"44975","646",2023-12-13 11:30:00,-27912,1913,29825,907,TRUE,NA,"0.1.4"
"44976","646",2023-12-13 11:45:00,-27912,1913,29825,907,TRUE,NA,"0.1.4"
"44977","646",2023-12-13 12:00:00,-27912,1913,29825,907,TRUE,NA,"0.1.4"
"44978","646",2023-12-13 12:15:00,-27912,1913,29825,907,TRUE,NA,"0.1.4"
"44979","646",2023-12-13 12:30:00,-27912,1913,29825,907,TRUE,NA,"0.1.4"
"44980","646",2023-12-13 12:45:00,-27912,1913,29825,907,TRUE,NA,"0.1.4"
"44981","646",2023-12-13 13:00:00,-27912,1913,29825,907,TRUE,NA,"0.1.4"
"44982","646",2023-12-13 13:15:00,-27912,1913,29825,907,TRUE,NA,"0.1.4"
"44983","646",2023-12-13 13:30:00,-27911,1913,29824,907,TRUE,NA,"0.1.4"
"44984","646",2023-12-13 13:45:00,-27911,1913,29824,907,TRUE,NA,"0.1.4"
"44985","646",2023-12-13 14:00:00,-27911,1913,29824,907,TRUE,NA,"0.1.4"
"44986","646",2023-12-13 14:15:00,-27911,1913,29824,907,TRUE,NA,"0.1.4"
"44987","646",2023-12-13 14:30:00,-27912,1913,29825,907,TRUE,NA,"0.1.4"
"44988","646",2023-12-13 14:45:00,-27912,1913,29825,907,TRUE,NA,"0.1.4"
"44989","646",2023-12-13 15:00:00,-27912,1913,29825,907,TRUE,NA,"0.1.4"
"44990","646",2023-12-13 15:15:00,-27912,1913,29825,907,TRUE,NA,"0.1.4"
"44991","646",2023-12-13 15:30:00,-27912,1913,29825,907,TRUE,NA,"0.1.4"
"44992","646",2023-12-13 15:45:00,-27912,1913,29825,907,TRUE,NA,"0.1.4"
"44993","646",2023-12-13 16:00:00,-27912,1913,29825,907,TRUE,NA,"0.1.4"
"44994","646",2023-12-13 16:15:00,-27912,1913,29825,907,TRUE,NA,"0.1.4"
"44995","646",2023-12-13 16:30:00,-27912,1913,29825,907,TRUE,NA,"0.1.4"
"44996","646",2023-12-13 16:45:00,-27912,1913,29825,907,TRUE,NA,"0.1.4"
"44997","646",2023-12-13 17:00:00,-27912,1913,29825,907,TRUE,NA,"0.1.4"
"44998","646",2023-12-13 17:15:00,-27912,1913,29825,907,TRUE,NA,"0.1.4"
"44999","646",2023-12-13 17:30:00,-27912,1913,29825,907,TRUE,NA,"0.1.4"
"45000","646",2023-12-13 17:45:00,-27912,1913,29825,907,TRUE,NA,"0.1.4"
"45001","646",2023-12-13 18:00:00,-27911,1913,29824,907,TRUE,NA,"0.1.4"
"45002","646",2023-12-13 18:15:00,-27912,1913,29825,907,TRUE,NA,"0.1.4"
"45003","646",2023-12-13 18:30:00,-27912,1913,29825,907,TRUE,NA,"0.1.4"
"45004","646",2023-12-13 18:45:00,-27912,1913,29825,907,TRUE,NA,"0.1.4"
"45005","646",2023-12-13 19:00:00,-27912,1913,29825,907,TRUE,NA,"0.1.4"
"45006","646",2023-12-13 19:15:00,-27912,1913,29825,907,TRUE,NA,"0.1.4"
"45007","646",2023-12-13 19:30:00,-27911,1913,29824,907,TRUE,NA,"0.1.4"
"45008","646",2023-12-13 19:45:00,-27911,1913,29824,907,TRUE,NA,"0.1.4"
"45009","646",2023-12-13 20:00:00,-27912,1913,29825,907,TRUE,NA,"0.1.4"
"45010","646",2023-12-13 20:15:00,-27912,1913,29825,907,TRUE,NA,"0.1.4"
"45011","646",2023-12-13 20:30:00,-27912,1913,29825,907,TRUE,NA,"0.1.4"
"45012","646",2023-12-13 20:45:00,-27911,1913,29824,907,TRUE,NA,"0.1.4"
"45013","646",2023-12-13 21:00:00,-27911,1913,29824,907,TRUE,NA,"0.1.4"
"45014","646",2023-12-13 21:15:00,-27913,1913,29826,907,TRUE,NA,"0.1.4"
"45015","646",2023-12-13 21:30:00,-27913,1913,29826,907,TRUE,NA,"0.1.4"
"45016","646",2023-12-13 21:45:00,-27912,1913,29825,907,TRUE,NA,"0.1.4"
"45017","646",2023-12-13 22:00:00,-27912,1913,29825,907,TRUE,NA,"0.1.4"
"45018","646",2023-12-13 22:15:00,-27912,1913,29825,907,TRUE,NA,"0.1.4"
"45019","646",2023-12-13 22:30:00,-27912,1913,29825,907,TRUE,NA,"0.1.4"
"45020","646",2023-12-13 22:45:00,-27912,1913,29825,907,TRUE,NA,"0.1.4"
"45021","646",2023-12-13 23:00:00,-27912,1913,29825,907,TRUE,NA,"0.1.4"
"45022","646",2023-12-13 23:15:00,-27912,1913,29825,907,TRUE,NA,"0.1.4"
"45023","646",2023-12-13 23:30:00,-27912,1913,29825,907,TRUE,NA,"0.1.4"
"45024","646",2023-12-13 23:45:00,-27912,1913,29825,907,TRUE,NA,"0.1.4"
"45025","646",2023-12-14,-27912,1913,29825,907,TRUE,NA,"0.1.4"
"45026","646",2023-12-14 00:15:00,-27912,1913,29825,907,TRUE,NA,"0.1.4"
"45027","646",2023-12-14 00:30:00,-27912,1913,29825,907,TRUE,NA,"0.1.4"
"45028","646",2023-12-14 00:45:00,-27912,1913,29825,907,TRUE,NA,"0.1.4"
"45029","646",2023-12-14 01:00:00,-27912,1913,29825,907,TRUE,NA,"0.1.4"
"45030","646",2023-12-14 01:15:00,-27912,1913,29825,907,TRUE,NA,"0.1.4"
"45031","646",2023-12-14 01:30:00,-27912,1913,29825,907,TRUE,NA,"0.1.4"
"45032","646",2023-12-14 01:45:00,-27912,1913,29825,907,TRUE,NA,"0.1.4"
"45033","646",2023-12-14 02:00:00,-27912,1913,29825,907,TRUE,NA,"0.1.4"
"45034","646",2023-12-14 02:15:00,-27912,1913,29825,907,TRUE,NA,"0.1.4"
"45035","646",2023-12-14 02:30:00,-27912,1913,29825,907,TRUE,NA,"0.1.4"
"45036","646",2023-12-14 02:45:00,-27912,1913,29825,907,TRUE,NA,"0.1.4"
"45037","646",2023-12-14 03:00:00,-27912,1913,29825,907,TRUE,NA,"0.1.4"
"45038","646",2023-12-14 03:15:00,-27912,1913,29825,907,TRUE,NA,"0.1.4"
"45039","646",2023-12-14 03:30:00,-27912,1913,29825,907,TRUE,NA,"0.1.4"
"45040","646",2023-12-14 03:45:00,-27912,1913,29825,907,TRUE,NA,"0.1.4"
"45041","646",2023-12-14 04:00:00,-27912,1913,29825,907,TRUE,NA,"0.1.4"
"45042","646",2023-12-14 04:15:00,-27912,1913,29825,907,TRUE,NA,"0.1.4"
"45043","646",2023-12-14 04:30:00,-27912,1913,29825,907,TRUE,NA,"0.1.4"
"45044","646",2023-12-14 04:45:00,-27912,1913,29825,907,TRUE,NA,"0.1.4"
"45045","646",2023-12-14 05:00:00,-27912,1913,29825,907,TRUE,NA,"0.1.4"
"45046","646",2023-12-14 05:15:00,-27912,1913,29825,907,TRUE,NA,"0.1.4"
"45047","646",2023-12-14 05:30:00,-27912,1913,29825,907,TRUE,NA,"0.1.4"
"45048","646",2023-12-14 05:45:00,-27912,1913,29825,907,TRUE,NA,"0.1.4"
"45049","646",2023-12-14 06:00:00,-27912,1913,29825,907,TRUE,NA,"0.1.4"
"45050","646",2023-12-14 06:15:00,-27912,1913,29825,907,TRUE,NA,"0.1.4"
"45051","646",2023-12-14 06:30:00,-27912,1913,29825,907,TRUE,NA,"0.1.4"
"45052","646",2023-12-14 06:45:00,-27912,1913,29825,907,TRUE,NA,"0.1.4"
"45053","646",2023-12-14 07:00:00,-27912,1913,29825,907,TRUE,NA,"0.1.4"
"45054","646",2023-12-14 07:15:00,-27912,1913,29825,907,TRUE,NA,"0.1.4"
"45055","646",2023-12-14 07:30:00,-27912,1913,29825,907,TRUE,NA,"0.1.4"
"45056","646",2023-12-14 07:45:00,-27912,1913,29825,907,TRUE,NA,"0.1.4"
"45057","646",2023-12-14 08:00:00,-27912,1913,29825,907,TRUE,NA,"0.1.4"
"45058","646",2023-12-14 08:15:00,-27912,1913,29825,907,TRUE,NA,"0.1.4"
"45059","646",2023-12-14 08:30:00,-27912,1913,29825,907,TRUE,NA,"0.1.4"
"45060","646",2023-12-14 08:45:00,-27912,1913,29825,907,TRUE,NA,"0.1.4"
"45061","646",2023-12-14 09:00:00,-27912,1913,29825,907,TRUE,NA,"0.1.4"
"45062","646",2023-12-14 09:15:00,-27912,1913,29825,907,TRUE,NA,"0.1.4"
"45063","646",2023-12-14 09:30:00,-27912,1913,29825,907,TRUE,NA,"0.1.4"
"45064","646",2023-12-14 09:45:00,-27912,1913,29825,907,TRUE,NA,"0.1.4"
"45065","646",2023-12-14 10:00:00,-27912,1913,29825,907,TRUE,NA,"0.1.4"
"45066","646",2023-12-14 10:15:00,-27912,1913,29825,907,TRUE,NA,"0.1.4"
"45067","646",2023-12-14 10:30:00,-27912,1913,29825,907,TRUE,NA,"0.1.4"
"45068","646",2023-12-14 10:45:00,-27912,1913,29825,907,TRUE,NA,"0.1.4"
"45069","646",2023-12-14 11:00:00,-27912,1913,29825,907,TRUE,NA,"0.1.4"
"45070","646",2023-12-14 11:15:00,-27912,1913,29825,907,TRUE,NA,"0.1.4"
"45071","646",2023-12-14 11:30:00,-27912,1913,29825,907,TRUE,NA,"0.1.4"
"45072","646",2023-12-14 11:45:00,-27912,1913,29825,907,TRUE,NA,"0.1.4"
"45073","646",2023-12-14 12:00:00,-27912,1913,29825,907,TRUE,NA,"0.1.4"
"45074","646",2023-12-14 12:15:00,-27912,1913,29825,907,TRUE,NA,"0.1.4"
"45075","646",2023-12-14 12:30:00,-27912,1913,29825,907,TRUE,NA,"0.1.4"
"45076","646",2023-12-14 12:45:00,-27912,1913,29825,907,TRUE,NA,"0.1.4"
"45077","646",2023-12-14 13:00:00,-27912,1913,29825,907,TRUE,NA,"0.1.4"
"45078","646",2023-12-14 13:15:00,-27912,1913,29825,907,TRUE,NA,"0.1.4"
"45079","646",2023-12-14 13:30:00,-27912,1913,29825,907,TRUE,NA,"0.1.4"
"45080","646",2023-12-14 13:45:00,-27912,1913,29825,907,TRUE,NA,"0.1.4"
"45081","646",2023-12-14 14:00:00,-27912,1913,29825,907,TRUE,NA,"0.1.4"
"45082","646",2023-12-14 14:15:00,-27912,1913,29825,907,TRUE,NA,"0.1.4"
"45083","646",2023-12-14 14:30:00,-27914,1913,29827,907,TRUE,NA,"0.1.4"
"45084","646",2023-12-14 14:45:00,-27913,1913,29826,907,TRUE,NA,"0.1.4"
"45085","646",2023-12-14 15:00:00,-28076,1913,29989,907,TRUE,NA,"0.1.4"
"45086","646",2023-12-14 15:15:00,-27913,1913,29826,907,TRUE,NA,"0.1.4"
"45087","646",2023-12-14 15:30:00,-27913,1913,29826,907,TRUE,NA,"0.1.4"
"45088","646",2023-12-14 15:45:00,-27916,1913,29829,907,TRUE,NA,"0.1.4"
"45089","646",2023-12-14 16:00:00,-27912,1913,29825,907,TRUE,NA,"0.1.4"
"45090","646",2023-12-14 16:15:00,-27913,1913,29826,907,TRUE,NA,"0.1.4"
"45091","646",2023-12-14 16:30:00,-27913,1913,29826,907,TRUE,NA,"0.1.4"
"45092","646",2023-12-14 16:45:00,-27913,1913,29826,907,TRUE,NA,"0.1.4"
"45093","646",2023-12-14 17:00:00,-27913,1913,29826,907,TRUE,NA,"0.1.4"
"45094","646",2023-12-14 17:15:00,-27913,1913,29826,907,TRUE,NA,"0.1.4"
"45095","646",2023-12-14 17:30:00,-27912,1913,29825,907,TRUE,NA,"0.1.4"
"45096","646",2023-12-14 17:45:00,-27912,1913,29825,907,TRUE,NA,"0.1.4"
"45097","646",2023-12-14 18:00:00,-27912,1913,29825,907,TRUE,NA,"0.1.4"
"45098","646",2023-12-14 18:15:00,-27912,1913,29825,907,TRUE,NA,"0.1.4"
"45099","646",2023-12-14 18:30:00,-27912,1913,29825,907,TRUE,NA,"0.1.4"
"45100","646",2023-12-14 18:45:00,-27912,1913,29825,907,TRUE,NA,"0.1.4"
"45101","646",2023-12-14 19:00:00,-27912,1913,29825,907,TRUE,NA,"0.1.4"
"45102","646",2023-12-14 19:15:00,-27912,1913,29825,907,TRUE,NA,"0.1.4"
"45103","646",2023-12-14 19:30:00,-27912,1913,29825,907,TRUE,NA,"0.1.4"
"45104","646",2023-12-14 19:45:00,-27912,1913,29825,907,TRUE,NA,"0.1.4"
"45105","646",2023-12-14 20:00:00,-27911,1913,29824,907,TRUE,NA,"0.1.4"
"45106","646",2023-12-14 20:15:00,-27911,1913,29824,907,TRUE,NA,"0.1.4"
"45107","646",2023-12-14 20:30:00,-27910,1913,29823,907,TRUE,NA,"0.1.4"
"45108","646",2023-12-14 20:45:00,-28271,1913,30184,907,FALSE,NA,"0.1.4"
"45109","646",2023-12-14 21:00:00,-27912,1913,29825,907,FALSE,NA,"0.1.4"
"45110","646",2023-12-14 21:15:00,-27912,1913,29825,907,FALSE,"jump1","0.1.4"
"45111","646",2023-12-14 21:30:00,-27912,1913,29825,907,FALSE,"jump1","0.1.4"
"45112","646",2023-12-14 21:45:00,-27955,1913,29868,907,FALSE,NA,"0.1.4"
"45113","646",2023-12-14 22:00:00,-27935,1913,29848,907,FALSE,NA,"0.1.4"
"45114","646",2023-12-14 22:15:00,-27915,1913,29828,907,FALSE,NA,"0.1.4"
"45115","646",2023-12-14 22:30:00,-27912,1913,29825,907,FALSE,NA,"0.1.4"
"45116","646",2023-12-14 22:45:00,-27911,1913,29824,907,FALSE,NA,"0.1.4"
"45117","646",2023-12-14 23:00:00,-27910,1913,29823,907,FALSE,NA,"0.1.4"
"45118","646",2023-12-14 23:15:00,-27911,1913,29824,907,FALSE,NA,"0.1.4"
"45119","646",2023-12-14 23:30:00,-27912,1913,29825,907,FALSE,NA,"0.1.4"
"45120","646",2023-12-14 23:45:00,-27909,1913,29822,907,FALSE,NA,"0.1.4"
"45121","646",2023-12-15,-27910,1913,29823,907,FALSE,NA,"0.1.4"
"45122","646",2023-12-15 00:15:00,-27911,1913,29824,907,FALSE,NA,"0.1.4"
"45123","646",2023-12-15 00:30:00,-27913,1913,29826,907,FALSE,NA,"0.1.4"
"45124","646",2023-12-15 00:45:00,-27913,1913,29826,907,FALSE,NA,"0.1.4"
"45125","646",2023-12-15 01:00:00,-27911,1913,29824,907,FALSE,NA,"0.1.4"
"45126","646",2023-12-15 01:15:00,-27912,1913,29825,907,FALSE,NA,"0.1.4"
"45127","646",2023-12-15 01:30:00,-27913,1913,29826,907,FALSE,NA,"0.1.4"
"45128","646",2023-12-15 01:45:00,-27913,1913,29826,907,TRUE,NA,"0.1.4"
"45129","646",2023-12-15 02:00:00,-27911,1913,29824,907,TRUE,NA,"0.1.4"
"45130","646",2023-12-15 02:15:00,-27908,1913,29821,907,TRUE,NA,"0.1.4"
"45131","646",2023-12-15 02:30:00,-27907,1913,29820,907,TRUE,NA,"0.1.4"
"45132","646",2023-12-15 02:45:00,-27907,1913,29820,907,TRUE,NA,"0.1.4"
"45133","646",2023-12-15 03:00:00,-27907,1913,29820,907,TRUE,NA,"0.1.4"
"45134","646",2023-12-15 03:15:00,-27910,1913,29823,907,TRUE,NA,"0.1.4"
"45135","646",2023-12-15 03:30:00,-27909,1913,29822,907,TRUE,NA,"0.1.4"
"45136","646",2023-12-15 03:45:00,-27908,1913,29821,907,TRUE,NA,"0.1.4"
"45137","646",2023-12-15 04:00:00,-27907,1913,29820,907,TRUE,NA,"0.1.4"
"45138","646",2023-12-15 04:15:00,-27908,1913,29821,907,TRUE,NA,"0.1.4"
"45139","646",2023-12-15 04:30:00,NA,NA,NA,NA,NA,"out1","0.1.4"
"45140","646",2023-12-15 04:45:00,NA,NA,NA,NA,NA,"out1","0.1.4"
"45141","646",2023-12-15 05:00:00,NA,NA,NA,NA,NA,"out1","0.1.4"
"45142","646",2023-12-15 05:15:00,NA,NA,NA,NA,NA,"out1","0.1.4"
"45143","646",2023-12-15 05:30:00,NA,NA,NA,NA,NA,"out1","0.1.4"
"45144","646",2023-12-15 05:45:00,NA,NA,NA,NA,NA,"out1","0.1.4"
"45145","646",2023-12-15 06:00:00,NA,NA,NA,NA,NA,"out1","0.1.4"
"45146","646",2023-12-15 06:15:00,NA,NA,NA,NA,NA,"out1","0.1.4"
"45147","646",2023-12-15 06:30:00,NA,NA,NA,NA,NA,"out1","0.1.4"
"45148","646",2023-12-15 06:45:00,NA,NA,NA,NA,NA,"out1","0.1.4"
"45149","646",2023-12-15 07:00:00,NA,NA,NA,NA,NA,"out1","0.1.4"
"45150","646",2023-12-15 07:15:00,NA,NA,NA,NA,NA,"out1","0.1.4"
"45151","646",2023-12-15 07:30:00,NA,NA,NA,NA,NA,"out1","0.1.4"
"45152","646",2023-12-15 07:45:00,NA,NA,NA,NA,NA,"out1","0.1.4"
"45153","646",2023-12-15 08:00:00,NA,NA,NA,NA,NA,"out1","0.1.4"
"45154","646",2023-12-15 08:15:00,NA,NA,NA,NA,NA,"out1","0.1.4"
"45155","646",2023-12-15 08:30:00,NA,NA,NA,NA,NA,"out1","0.1.4"
"45156","646",2023-12-15 08:45:00,NA,NA,NA,NA,NA,"out1","0.1.4"
"45157","646",2023-12-15 09:00:00,NA,NA,NA,NA,NA,"out1","0.1.4"
"45158","646",2023-12-15 09:15:00,NA,NA,NA,NA,NA,"out1","0.1.4"
"45159","646",2023-12-15 09:30:00,NA,NA,NA,NA,NA,"out1","0.1.4"
"45160","646",2023-12-15 09:45:00,NA,NA,NA,NA,NA,"out1","0.1.4"
"45161","646",2023-12-15 10:00:00,NA,NA,NA,NA,NA,"out1","0.1.4"
"45162","646",2023-12-15 10:15:00,NA,NA,NA,NA,NA,"out1","0.1.4"
"45163","646",2023-12-15 10:30:00,NA,NA,NA,NA,NA,"out1","0.1.4"
"45164","646",2023-12-15 10:45:00,NA,NA,NA,NA,NA,"out1","0.1.4"
"45165","646",2023-12-15 11:00:00,NA,NA,NA,NA,NA,"out1","0.1.4"
"45166","646",2023-12-15 11:15:00,NA,NA,NA,NA,NA,"out1","0.1.4"
"45167","646",2023-12-15 11:30:00,-27907,1913,29820,907,TRUE,NA,"0.1.4"
"45168","646",2023-12-15 11:45:00,-27908,1913,29821,907,TRUE,NA,"0.1.4"
"45169","646",2023-12-15 12:00:00,-27916,1913,29829,907,TRUE,NA,"0.1.4"
"45170","646",2023-12-15 12:15:00,-27939,1913,29852,907,TRUE,NA,"0.1.4"
"45171","646",2023-12-15 12:30:00,-27936,1913,29849,907,TRUE,NA,"0.1.4"
"45172","646",2023-12-15 12:45:00,-28012,1913,29925,907,TRUE,NA,"0.1.4"
"45173","646",2023-12-15 13:00:00,-28015,1913,29928,907,TRUE,NA,"0.1.4"
"45174","646",2023-12-15 13:15:00,-28019,1913,29932,907,TRUE,NA,"0.1.4"
"45175","646",2023-12-15 13:30:00,-28015,1913,29928,907,TRUE,NA,"0.1.4"
"45176","646",2023-12-15 13:45:00,-28080,1913,29993,907,TRUE,NA,"0.1.4"
"45177","646",2023-12-15 14:00:00,-28053,1913,29966,907,TRUE,NA,"0.1.4"
"45178","646",2023-12-15 14:15:00,-28133,1913,30046,907,TRUE,NA,"0.1.4"
"45179","646",2023-12-15 14:30:00,-28075,1913,29988,907,TRUE,NA,"0.1.4"
"45180","646",2023-12-15 14:45:00,-27976,1913,29889,907,TRUE,NA,"0.1.4"
"45181","646",2023-12-15 15:00:00,-27986,1913,29899,907,TRUE,NA,"0.1.4"
"45182","646",2023-12-15 15:15:00,-27999,1913,29912,907,TRUE,NA,"0.1.4"
"45183","646",2023-12-15 15:30:00,-28289,1913,30202,907,TRUE,NA,"0.1.4"
"45184","646",2023-12-15 15:45:00,-28362,1913,30275,907,TRUE,NA,"0.1.4"
"45185","646",2023-12-15 16:00:00,-28503,1913,30416,907,TRUE,NA,"0.1.4"
"45186","646",2023-12-15 16:15:00,-28574,1913,30487,907,TRUE,NA,"0.1.4"
"45187","646",2023-12-15 16:30:00,-28613,1913,30526,907,TRUE,NA,"0.1.4"
"45188","646",2023-12-15 16:45:00,-28598,1913,30511,907,TRUE,NA,"0.1.4"
"45189","646",2023-12-15 17:00:00,-28656,1913,30569,907,TRUE,NA,"0.1.4"
"45190","646",2023-12-15 17:15:00,-28347,1913,30260,907,TRUE,NA,"0.1.4"
"45191","646",2023-12-15 17:30:00,-28566,1913,30479,907,TRUE,NA,"0.1.4"
"45192","646",2023-12-15 17:45:00,-28616,1913,30529,907,TRUE,NA,"0.1.4"
"45193","646",2023-12-15 18:00:00,-28550,1913,30463,907,TRUE,NA,"0.1.4"
"45194","646",2023-12-15 18:15:00,-28695,1913,30608,907,TRUE,NA,"0.1.4"
"45195","646",2023-12-15 18:30:00,-28700,1913,30613,907,TRUE,NA,"0.1.4"
"45196","646",2023-12-15 18:45:00,-28641,1913,30554,907,TRUE,NA,"0.1.4"
"45197","646",2023-12-15 19:00:00,-28614,1913,30527,907,TRUE,NA,"0.1.4"
"45198","646",2023-12-15 19:15:00,-28264.5,1913,30177.5,907,TRUE,"out1, fill","0.1.4"
"45199","646",2023-12-15 19:30:00,-27915,1913,29828,907,TRUE,NA,"0.1.4"
"45200","646",2023-12-15 19:45:00,-27986,1913,29899,907,TRUE,NA,"0.1.4"
"45201","646",2023-12-15 20:00:00,-27908,1913,29821,907,TRUE,NA,"0.1.4"
"45202","646",2023-12-15 20:15:00,-27907,1913,29820,907,TRUE,NA,"0.1.4"
"45203","646",2023-12-15 20:30:00,-27908,1913,29821,907,TRUE,NA,"0.1.4"
"45204","646",2023-12-15 20:45:00,-27905,1913,29818,907,TRUE,NA,"0.1.4"
"45205","646",2023-12-15 21:00:00,-27908,1913,29821,907,TRUE,NA,"0.1.4"
"45206","646",2023-12-15 21:15:00,-27907,1913,29820,907,TRUE,NA,"0.1.4"
"45207","646",2023-12-15 21:30:00,-27907,1913,29820,907,TRUE,NA,"0.1.4"
"45208","646",2023-12-15 21:45:00,-27907,1913,29820,907,TRUE,NA,"0.1.4"
"45209","646",2023-12-15 22:00:00,-27907,1913,29820,907,TRUE,NA,"0.1.4"
"45210","646",2023-12-15 22:15:00,-27907,1913,29820,907,TRUE,NA,"0.1.4"
"45211","646",2023-12-15 22:30:00,-27907,1913,29820,907,TRUE,NA,"0.1.4"
"45212","646",2023-12-15 22:45:00,-27907,1913,29820,907,TRUE,NA,"0.1.4"
"45213","646",2023-12-15 23:00:00,-27907,1913,29820,907,TRUE,NA,"0.1.4"
"45214","646",2023-12-15 23:15:00,-27907,1913,29820,907,TRUE,NA,"0.1.4"
"45215","646",2023-12-15 23:30:00,-27907,1913,29820,907,TRUE,NA,"0.1.4"
"45216","646",2023-12-15 23:45:00,-27907,1913,29820,907,TRUE,NA,"0.1.4"
"45217","646",2023-12-16,-27907,1913,29820,907,TRUE,NA,"0.1.4"
"45218","646",2023-12-16 00:15:00,-27907,1913,29820,907,TRUE,NA,"0.1.4"
"45219","646",2023-12-16 00:30:00,-27907,1913,29820,907,TRUE,NA,"0.1.4"
"45220","646",2023-12-16 00:45:00,-27907,1913,29820,907,TRUE,NA,"0.1.4"
"45221","646",2023-12-16 01:00:00,-27907,1913,29820,907,TRUE,NA,"0.1.4"
"45222","646",2023-12-16 01:15:00,-27907,1913,29820,907,TRUE,NA,"0.1.4"
"45223","646",2023-12-16 01:30:00,-27907,1913,29820,907,TRUE,NA,"0.1.4"
"45224","646",2023-12-16 01:45:00,-27908,1913,29821,907,TRUE,NA,"0.1.4"
"45225","646",2023-12-16 02:00:00,-27908,1913,29821,907,TRUE,NA,"0.1.4"
"45226","646",2023-12-16 02:15:00,-27908,1913,29821,907,TRUE,NA,"0.1.4"
"45227","646",2023-12-16 02:30:00,-27907,1913,29820,907,TRUE,NA,"0.1.4"
"45228","646",2023-12-16 02:45:00,-27907,1913,29820,907,TRUE,NA,"0.1.4"
"45229","646",2023-12-16 03:00:00,-27907,1913,29820,907,TRUE,NA,"0.1.4"
"45230","646",2023-12-16 03:15:00,-27908,1913,29821,907,TRUE,NA,"0.1.4"
"45231","646",2023-12-16 03:30:00,-27909,1913,29822,907,TRUE,NA,"0.1.4"
"45232","646",2023-12-16 03:45:00,-27909,1913,29822,907,TRUE,NA,"0.1.4"
"45233","646",2023-12-16 04:00:00,-27908,1913,29821,907,TRUE,NA,"0.1.4"
"45234","646",2023-12-16 04:15:00,-27911,1913,29824,907,TRUE,NA,"0.1.4"
"45235","646",2023-12-16 04:30:00,-27910,1913,29823,907,TRUE,NA,"0.1.4"
"45236","646",2023-12-16 04:45:00,-27922,1913,29835,907,TRUE,NA,"0.1.4"
"45237","646",2023-12-16 05:00:00,-28057,1913,29970,907,TRUE,NA,"0.1.4"
"45238","646",2023-12-16 05:15:00,-27995,1913,29908,907,TRUE,NA,"0.1.4"
"45239","646",2023-12-16 05:30:00,-27909,1913,29822,907,TRUE,NA,"0.1.4"
"45240","646",2023-12-16 05:45:00,-27908,1913,29821,907,TRUE,NA,"0.1.4"
"45241","646",2023-12-16 06:00:00,-27910,1913,29823,907,TRUE,NA,"0.1.4"
"45242","646",2023-12-16 06:15:00,-27908,1913,29821,907,TRUE,NA,"0.1.4"
"45243","646",2023-12-16 06:30:00,-27910,1913,29823,907,TRUE,NA,"0.1.4"
"45244","646",2023-12-16 06:45:00,-27913,1913,29826,907,TRUE,NA,"0.1.4"
"45245","646",2023-12-16 07:00:00,-27910,1913,29823,907,TRUE,NA,"0.1.4"
"45246","646",2023-12-16 07:15:00,-27909.8181818182,1913,29822.8181818182,907,TRUE,"out1, fill","0.1.4"
"45247","646",2023-12-16 07:30:00,-27909.6363636364,1913,29822.6363636364,907,TRUE,"out1, fill","0.1.4"
"45248","646",2023-12-16 07:45:00,-27909.4545454545,1913,29822.4545454545,907,TRUE,"out1, fill","0.1.4"
"45249","646",2023-12-16 08:00:00,-27909.2727272727,1913,29822.2727272727,907,TRUE,"out1, fill","0.1.4"
"45250","646",2023-12-16 08:15:00,-27909.0909090909,1913,29822.0909090909,907,TRUE,"out1, fill","0.1.4"
"45251","646",2023-12-16 08:30:00,-27908.9090909091,1913,29821.9090909091,907,TRUE,"out1, fill","0.1.4"
"45252","646",2023-12-16 08:45:00,-27908.7272727273,1913,29821.7272727273,907,TRUE,"out1, fill","0.1.4"
"45253","646",2023-12-16 09:00:00,-27908.5454545455,1913,29821.5454545455,907,TRUE,"out1, fill","0.1.4"
"45254","646",2023-12-16 09:15:00,-27908.3636363636,1913,29821.3636363636,907,TRUE,"out1, fill","0.1.4"
"45255","646",2023-12-16 09:30:00,-27908.1818181818,1913,29821.1818181818,907,TRUE,"out1, fill","0.1.4"
"45256","646",2023-12-16 09:45:00,-27908,1913,29821,907,TRUE,NA,"0.1.4"
"45257","646",2023-12-16 10:00:00,-27908,1913,29821,907,TRUE,NA,"0.1.4"
"45258","646",2023-12-16 10:15:00,-27908,1913,29821,907,TRUE,NA,"0.1.4"
"45259","646",2023-12-16 10:30:00,-27908,1913,29821,907,TRUE,NA,"0.1.4"
"45260","646",2023-12-16 10:45:00,-27932,1913,29845,907,TRUE,NA,"0.1.4"
"45261","646",2023-12-16 11:00:00,-27908,1913,29821,907,TRUE,NA,"0.1.4"
"45262","646",2023-12-16 11:15:00,-27908,1913,29821,907,TRUE,NA,"0.1.4"
"45263","646",2023-12-16 11:30:00,-27951.3333333333,1913,29864.3333333333,907,TRUE,"out1, fill","0.1.4"
"45264","646",2023-12-16 11:45:00,-27994.6666666667,1913,29907.6666666667,907,TRUE,"out1, fill","0.1.4"
"45265","646",2023-12-16 12:00:00,-28038,1913,29951,907,TRUE,NA,"0.1.4"
"45266","646",2023-12-16 12:15:00,-27910,1913,29823,907,TRUE,NA,"0.1.4"
"45267","646",2023-12-16 12:30:00,-27915,1913,29828,907,TRUE,NA,"0.1.4"
"45268","646",2023-12-16 12:45:00,-27916,1913,29829,907,TRUE,NA,"0.1.4"
"45269","646",2023-12-16 13:00:00,-27916,1913,29829,907,TRUE,NA,"0.1.4"
"45270","646",2023-12-16 13:15:00,-27916,1913,29829,907,TRUE,NA,"0.1.4"
"45271","646",2023-12-16 13:30:00,-27917,1913,29830,907,TRUE,NA,"0.1.4"
"45272","646",2023-12-16 13:45:00,-27916,1913,29829,907,TRUE,NA,"0.1.4"
"45273","646",2023-12-16 14:00:00,-27916,1913,29829,907,TRUE,NA,"0.1.4"
"45274","646",2023-12-16 14:15:00,-27916,1913,29829,907,TRUE,NA,"0.1.4"
"45275","646",2023-12-16 14:30:00,-27916,1913,29829,907,TRUE,NA,"0.1.4"
"45276","646",2023-12-16 14:45:00,-27916,1913,29829,907,TRUE,NA,"0.1.4"
"45277","646",2023-12-16 15:00:00,-27917,1913,29830,907,TRUE,NA,"0.1.4"
"45278","646",2023-12-16 15:15:00,-27918,1913,29831,907,TRUE,NA,"0.1.4"
"45279","646",2023-12-16 15:30:00,-27917,1913,29830,907,TRUE,NA,"0.1.4"
"45280","646",2023-12-16 15:45:00,-27917,1913,29830,907,TRUE,NA,"0.1.4"
"45281","646",2023-12-16 16:00:00,-27917,1913,29830,907,TRUE,NA,"0.1.4"
"45282","646",2023-12-16 16:15:00,-27918,1913,29831,907,TRUE,NA,"0.1.4"
"45283","646",2023-12-16 16:30:00,-27917,1913,29830,907,TRUE,NA,"0.1.4"
"45284","646",2023-12-16 16:45:00,-27917,1913,29830,907,TRUE,NA,"0.1.4"
"45285","646",2023-12-16 17:00:00,-27916,1913,29829,907,TRUE,NA,"0.1.4"
"45286","646",2023-12-16 17:15:00,-27916,1913,29829,907,TRUE,NA,"0.1.4"
"45287","646",2023-12-16 17:30:00,-27916,1913,29829,907,TRUE,NA,"0.1.4"
"45288","646",2023-12-16 17:45:00,-27915,1913,29828,907,TRUE,NA,"0.1.4"
"45289","646",2023-12-16 18:00:00,-27916,1913,29829,907,TRUE,NA,"0.1.4"
"45290","646",2023-12-16 18:15:00,-27916,1913,29829,907,TRUE,NA,"0.1.4"
"45291","646",2023-12-16 18:30:00,-27916,1913,29829,907,TRUE,NA,"0.1.4"
"45292","646",2023-12-16 18:45:00,-27911,1913,29824,907,TRUE,NA,"0.1.4"
"45293","646",2023-12-16 19:00:00,-27911,1913,29824,907,TRUE,NA,"0.1.4"
"45294","646",2023-12-16 19:15:00,-27911,1913,29824,907,TRUE,NA,"0.1.4"
"45295","646",2023-12-16 19:30:00,-27915,1913,29828,907,TRUE,NA,"0.1.4"
"45296","646",2023-12-16 19:45:00,-27912,1913,29825,907,TRUE,NA,"0.1.4"
"45297","646",2023-12-16 20:00:00,-27912,1913,29825,907,TRUE,NA,"0.1.4"
"45298","646",2023-12-16 20:15:00,-27913,1913,29826,907,TRUE,NA,"0.1.4"
"45299","646",2023-12-16 20:30:00,-27913,1913,29826,907,TRUE,NA,"0.1.4"
"45300","646",2023-12-16 20:45:00,-27913,1913,29826,907,TRUE,NA,"0.1.4"
"45301","646",2023-12-16 21:00:00,-27913,1913,29826,907,TRUE,NA,"0.1.4"
"45302","646",2023-12-16 21:15:00,-27911,1913,29824,907,TRUE,NA,"0.1.4"
"45303","646",2023-12-16 21:30:00,-27960,1913,29873,907,TRUE,NA,"0.1.4"
"45304","646",2023-12-16 21:45:00,-28118,1913,30031,907,TRUE,NA,"0.1.4"
"45305","646",2023-12-16 22:00:00,-27908,1913,29821,907,TRUE,NA,"0.1.4"
"45306","646",2023-12-16 22:15:00,-28016.5,1913,29929.5,907,TRUE,"out1, fill","0.1.4"
"45307","646",2023-12-16 22:30:00,-28125,1913,30038,907,TRUE,NA,"0.1.4"
"45308","646",2023-12-16 22:45:00,-27909,1913,29822,907,TRUE,NA,"0.1.4"
"45309","646",2023-12-16 23:00:00,-27907,1913,29820,907,TRUE,NA,"0.1.4"
"45310","646",2023-12-16 23:15:00,-27907,1913,29820,907,TRUE,NA,"0.1.4"
"45311","646",2023-12-16 23:30:00,-27907,1913,29820,907,TRUE,NA,"0.1.4"
"45312","646",2023-12-16 23:45:00,-27907,1913,29820,907,TRUE,NA,"0.1.4"
"45313","646",2023-12-17,-27907,1913,29820,907,TRUE,NA,"0.1.4"
"45314","646",2023-12-17 00:15:00,-27907,1913,29820,907,TRUE,NA,"0.1.4"
"45315","646",2023-12-17 00:30:00,-27907,1913,29820,907,TRUE,NA,"0.1.4"
"45316","646",2023-12-17 00:45:00,-27907,1913,29820,907,TRUE,NA,"0.1.4"
"45317","646",2023-12-17 01:00:00,-27907,1913,29820,907,TRUE,NA,"0.1.4"
"45318","646",2023-12-17 01:15:00,-27906,1913,29819,907,TRUE,NA,"0.1.4"
"45319","646",2023-12-17 01:30:00,-27911,1913,29824,907,TRUE,NA,"0.1.4"
"45320","646",2023-12-17 01:45:00,-27915,1913,29828,907,TRUE,NA,"0.1.4"
"45321","646",2023-12-17 02:00:00,-27914,1913,29827,907,TRUE,NA,"0.1.4"
"45322","646",2023-12-17 02:15:00,-27913,1913,29826,907,TRUE,NA,"0.1.4"
"45323","646",2023-12-17 02:30:00,-27917,1913,29830,907,TRUE,NA,"0.1.4"
"45324","646",2023-12-17 02:45:00,-27921,1913,29834,907,TRUE,NA,"0.1.4"
"45325","646",2023-12-17 03:00:00,-27918,1913,29831,907,TRUE,NA,"0.1.4"
"45326","646",2023-12-17 03:15:00,-28086,1913,29999,907,TRUE,NA,"0.1.4"
"45327","646",2023-12-17 03:30:00,-28063.1428571429,1913,29976.1428571429,907,TRUE,"out1, fill","0.1.4"
"45328","646",2023-12-17 03:45:00,-28040.2857142857,1913,29953.2857142857,907,TRUE,"out1, fill","0.1.4"
"45329","646",2023-12-17 04:00:00,-28017.4285714286,1913,29930.4285714286,907,TRUE,"out1, fill","0.1.4"
"45330","646",2023-12-17 04:15:00,-27994.5714285714,1913,29907.5714285714,907,TRUE,"out1, fill","0.1.4"
"45331","646",2023-12-17 04:30:00,-27971.7142857143,1913,29884.7142857143,907,TRUE,"out1, fill","0.1.4"
"45332","646",2023-12-17 04:45:00,-27948.8571428571,1913,29861.8571428571,907,TRUE,"out1, fill","0.1.4"
"45333","646",2023-12-17 05:00:00,-27926,1913,29839,907,TRUE,NA,"0.1.4"
"45334","646",2023-12-17 05:15:00,-27910,1913,29823,907,TRUE,NA,"0.1.4"
"45335","646",2023-12-17 05:30:00,-27909,1913,29822,907,TRUE,NA,"0.1.4"
"45336","646",2023-12-17 05:45:00,-27902,1913,29815,907,TRUE,NA,"0.1.4"
"45337","646",2023-12-17 06:00:00,-27930,1913,29843,907,TRUE,NA,"0.1.4"
"45338","646",2023-12-17 06:15:00,-27956.1428571429,1913,29869.1428571429,907,TRUE,"out1, fill","0.1.4"
"45339","646",2023-12-17 06:30:00,-27982.2857142857,1913,29895.2857142857,907,TRUE,"out1, fill","0.1.4"
"45340","646",2023-12-17 06:45:00,-28008.4285714286,1913,29921.4285714286,907,TRUE,"out1, fill","0.1.4"
"45341","646",2023-12-17 07:00:00,-28034.5714285714,1913,29947.5714285714,907,TRUE,"out1, fill","0.1.4"
"45342","646",2023-12-17 07:15:00,-28060.7142857143,1913,29973.7142857143,907,TRUE,"out1, fill","0.1.4"
"45343","646",2023-12-17 07:30:00,-28086.8571428571,1913,29999.8571428571,907,TRUE,"out1, fill","0.1.4"
"45344","646",2023-12-17 07:45:00,-28113,1913,30026,907,TRUE,NA,"0.1.4"
"45345","646",2023-12-17 08:00:00,-27915,1913,29828,907,TRUE,NA,"0.1.4"
"45346","646",2023-12-17 08:15:00,-28199,1913,30112,907,TRUE,NA,"0.1.4"
"45347","646",2023-12-17 08:30:00,-28058,1913,29971,907,TRUE,NA,"0.1.4"
"45348","646",2023-12-17 08:45:00,-28058,1913,29971,907,TRUE,"out1, fill","0.1.4"
"45349","646",2023-12-17 09:00:00,-28058,1913,29971,907,TRUE,"jump1","0.1.4"
"45350","646",2023-12-17 09:15:00,-27903,1913,29816,907,TRUE,NA,"0.1.4"
"45351","646",2023-12-17 09:30:00,-27987,1913,29900,907,TRUE,NA,"0.1.4"
"45352","646",2023-12-17 09:45:00,-27882,1913,29795,907,TRUE,NA,"0.1.4"
"45353","646",2023-12-17 10:00:00,-28035,1913,29948,907,TRUE,NA,"0.1.4"
"45354","646",2023-12-17 10:15:00,-27979,1913,29892,907,TRUE,NA,"0.1.4"
"45355","646",2023-12-17 10:30:00,-27989,1913,29902,907,TRUE,NA,"0.1.4"
"45356","646",2023-12-17 10:45:00,-27990,1913,29903,907,TRUE,NA,"0.1.4"
"45357","646",2023-12-17 11:00:00,-27972,1913,29885,907,TRUE,NA,"0.1.4"
"45358","646",2023-12-17 11:15:00,-27994,1913,29907,907,TRUE,NA,"0.1.4"
"45359","646",2023-12-17 11:30:00,-28007,1913,29920,907,TRUE,NA,"0.1.4"
"45360","646",2023-12-17 11:45:00,-28028,1913,29941,907,TRUE,NA,"0.1.4"
"45361","646",2023-12-17 12:00:00,-28009,1913,29922,907,TRUE,NA,"0.1.4"
"45362","646",2023-12-17 12:15:00,-27985,1913,29898,907,TRUE,NA,"0.1.4"
"45363","646",2023-12-17 12:30:00,-28001,1913,29914,907,TRUE,NA,"0.1.4"
"45364","646",2023-12-17 12:45:00,-27959,1913,29872,907,TRUE,NA,"0.1.4"
"45365","646",2023-12-17 13:00:00,-27947,1913,29860,907,TRUE,NA,"0.1.4"
"45366","646",2023-12-17 13:15:00,-27950,1913,29863,907,TRUE,NA,"0.1.4"
"45367","646",2023-12-17 13:30:00,-27973,1913,29886,907,TRUE,NA,"0.1.4"
"45368","646",2023-12-17 13:45:00,-27962,1913,29875,907,TRUE,NA,"0.1.4"
"45369","646",2023-12-17 14:00:00,-27978,1913,29891,907,TRUE,NA,"0.1.4"
"45370","646",2023-12-17 14:15:00,-27981,1913,29894,907,TRUE,NA,"0.1.4"
"45371","646",2023-12-17 14:30:00,-27978,1913,29891,907,TRUE,NA,"0.1.4"
"45372","646",2023-12-17 14:45:00,-27983,1913,29896,907,TRUE,NA,"0.1.4"
"45373","646",2023-12-17 15:00:00,-27974,1913,29887,907,TRUE,NA,"0.1.4"
"45374","646",2023-12-17 15:15:00,-27968,1913,29881,907,TRUE,NA,"0.1.4"
"45375","646",2023-12-17 15:30:00,-27937,1913,29850,907,TRUE,NA,"0.1.4"
"45376","646",2023-12-17 15:45:00,-27963,1913,29876,907,TRUE,NA,"0.1.4"
"45377","646",2023-12-17 16:00:00,-27974,1913,29887,907,TRUE,NA,"0.1.4"
"45378","646",2023-12-17 16:15:00,-27972,1913,29885,907,TRUE,NA,"0.1.4"
"45379","646",2023-12-17 16:30:00,-27983,1913,29896,907,TRUE,NA,"0.1.4"
"45380","646",2023-12-17 16:45:00,-27820,1913,29733,907,TRUE,NA,"0.1.4"
"45381","646",2023-12-17 17:00:00,-27928,1913,29841,907,TRUE,NA,"0.1.4"
"45382","646",2023-12-17 17:15:00,-27946,1913,29859,907,TRUE,NA,"0.1.4"
"45383","646",2023-12-17 17:30:00,-27932,1913,29845,907,TRUE,NA,"0.1.4"
"45384","646",2023-12-17 17:45:00,-27903,1913,29816,907,TRUE,NA,"0.1.4"
"45385","646",2023-12-17 18:00:00,-27867,1913,29780,907,TRUE,NA,"0.1.4"
"45386","646",2023-12-17 18:15:00,-27600,1913,29513,907,TRUE,NA,"0.1.4"
"45387","646",2023-12-17 18:30:00,-27795,1913,29708,907,TRUE,NA,"0.1.4"
"45388","646",2023-12-17 18:45:00,-27478.8333333333,1913,29391.8333333333,907,TRUE,"out1, fill","0.1.4"
"45389","646",2023-12-17 19:00:00,-27162.6666666667,1913,29075.6666666667,907,TRUE,"out1, fill","0.1.4"
"45390","646",2023-12-17 19:15:00,-26846.5,1913,28759.5,907,TRUE,"out1, fill","0.1.4"
"45391","646",2023-12-17 19:30:00,-26530.3333333333,1913,28443.3333333333,907,TRUE,"out1, fill","0.1.4"
"45392","646",2023-12-17 19:45:00,-26214.1666666667,1913,28127.1666666667,907,TRUE,"out1, fill","0.1.4"
"45393","646",2023-12-17 20:00:00,-25898,1913,27811,907,TRUE,NA,"0.1.4"
"45394","646",2023-12-17 20:15:00,-25885,1913,27798,907,TRUE,NA,"0.1.4"
"45395","646",2023-12-17 20:30:00,-25946,1913,27859,907,TRUE,NA,"0.1.4"
"45396","646",2023-12-17 20:45:00,-26023,1913,27936,907,TRUE,NA,"0.1.4"
"45397","646",2023-12-17 21:00:00,-26027,1913,27940,907,TRUE,NA,"0.1.4"
"45398","646",2023-12-17 21:15:00,-25979.3333333333,1913,27892.3333333333,907,TRUE,"out1, fill","0.1.4"
"45399","646",2023-12-17 21:30:00,-25931.6666666667,1913,27844.6666666667,907,TRUE,"out1, fill","0.1.4"
"45400","646",2023-12-17 21:45:00,-25884,1913,27797,907,TRUE,NA,"0.1.4"
"45401","646",2023-12-17 22:00:00,-25883,1913,27796,907,TRUE,NA,"0.1.4"
"45402","646",2023-12-17 22:15:00,-25883,1913,27796,907,TRUE,NA,"0.1.4"
"45403","646",2023-12-17 22:30:00,-25886,1913,27799,907,TRUE,NA,"0.1.4"
"45404","646",2023-12-17 22:45:00,-25884,1913,27797,907,TRUE,NA,"0.1.4"
"45405","646",2023-12-17 23:00:00,-25884,1913,27797,907,TRUE,NA,"0.1.4"
"45406","646",2023-12-17 23:15:00,-25883,1913,27796,907,FALSE,NA,"0.1.4"
"45407","646",2023-12-17 23:30:00,-25883,1913,27796,907,TRUE,NA,"0.1.4"
"45408","646",2023-12-17 23:45:00,-25883,1913,27796,907,TRUE,NA,"0.1.4"
"45409","646",2023-12-18,-25883,1913,27796,907,TRUE,NA,"0.1.4"
"45410","646",2023-12-18 00:15:00,-25883,1913,27796,907,TRUE,NA,"0.1.4"
"45411","646",2023-12-18 00:30:00,-25883,1913,27796,907,TRUE,NA,"0.1.4"
"45412","646",2023-12-18 00:45:00,-25883,1913,27796,907,FALSE,NA,"0.1.4"
"45413","646",2023-12-18 01:00:00,-25883,1913,27796,907,FALSE,NA,"0.1.4"
"45414","646",2023-12-18 01:15:00,-25885,1913,27798,907,FALSE,NA,"0.1.4"
"45415","646",2023-12-18 01:30:00,-25885,1913,27798,907,FALSE,NA,"0.1.4"
"45416","646",2023-12-18 01:45:00,-25885,1913,27798,907,FALSE,NA,"0.1.4"
"45417","646",2023-12-18 02:00:00,-25886,1913,27799,907,TRUE,NA,"0.1.4"
"45418","646",2023-12-18 02:15:00,-25885,1913,27798,907,TRUE,NA,"0.1.4"
"45419","646",2023-12-18 02:30:00,-25885,1913,27798,907,TRUE,NA,"0.1.4"
"45420","646",2023-12-18 02:45:00,-25885,1913,27798,907,TRUE,NA,"0.1.4"
"45421","646",2023-12-18 03:00:00,-25885,1913,27798,907,TRUE,NA,"0.1.4"
"45422","646",2023-12-18 03:15:00,-25885,1913,27798,907,TRUE,NA,"0.1.4"
"45423","646",2023-12-18 03:30:00,-25885,1913,27798,907,TRUE,NA,"0.1.4"
"45424","646",2023-12-18 03:45:00,-25886,1913,27799,907,TRUE,NA,"0.1.4"
"45425","646",2023-12-18 04:00:00,-25886,1913,27799,907,TRUE,NA,"0.1.4"
"45426","646",2023-12-18 04:15:00,-25886,1913,27799,907,TRUE,NA,"0.1.4"
"45427","646",2023-12-18 04:30:00,-25886,1913,27799,907,TRUE,NA,"0.1.4"
"45428","646",2023-12-18 04:45:00,-25886,1913,27799,907,TRUE,NA,"0.1.4"
"45429","646",2023-12-18 05:00:00,-25886,1913,27799,907,TRUE,NA,"0.1.4"
"45430","646",2023-12-18 05:15:00,-25886,1913,27799,907,TRUE,NA,"0.1.4"
"45431","646",2023-12-18 05:30:00,-25886,1913,27799,907,TRUE,NA,"0.1.4"
"45432","646",2023-12-18 05:45:00,-25886,1913,27799,907,TRUE,NA,"0.1.4"
"45433","646",2023-12-18 06:00:00,-25886,1913,27799,907,TRUE,NA,"0.1.4"
"45434","646",2023-12-18 06:15:00,-25886,1913,27799,907,TRUE,NA,"0.1.4"
"45435","646",2023-12-18 06:30:00,-25886,1913,27799,907,TRUE,NA,"0.1.4"
"45436","646",2023-12-18 06:45:00,-25886,1913,27799,907,TRUE,NA,"0.1.4"
"45437","646",2023-12-18 07:00:00,-25886,1913,27799,907,TRUE,NA,"0.1.4"
"45438","646",2023-12-18 07:15:00,-25886,1913,27799,907,TRUE,NA,"0.1.4"
"45439","646",2023-12-18 07:30:00,-25886,1913,27799,907,TRUE,NA,"0.1.4"
"45440","646",2023-12-18 07:45:00,-25886,1913,27799,907,TRUE,NA,"0.1.4"
"45441","646",2023-12-18 08:00:00,-25886,1913,27799,907,TRUE,NA,"0.1.4"
"45442","646",2023-12-18 08:15:00,-25886,1913,27799,907,TRUE,NA,"0.1.4"
"45443","646",2023-12-18 08:30:00,-25886,1913,27799,907,TRUE,NA,"0.1.4"
"45444","646",2023-12-18 08:45:00,-25886,1913,27799,907,TRUE,NA,"0.1.4"
"45445","646",2023-12-18 09:00:00,-25886,1913,27799,907,TRUE,NA,"0.1.4"
"45446","646",2023-12-18 09:15:00,-25886,1913,27799,907,TRUE,NA,"0.1.4"
"45447","646",2023-12-18 09:30:00,-25886,1913,27799,907,TRUE,NA,"0.1.4"
"45448","646",2023-12-18 09:45:00,-25885,1913,27798,907,TRUE,NA,"0.1.4"
"45449","646",2023-12-18 10:00:00,-25885,1913,27798,907,TRUE,NA,"0.1.4"
"45450","646",2023-12-18 10:15:00,-25885,1913,27798,907,TRUE,NA,"0.1.4"
"45451","646",2023-12-18 10:30:00,-25885,1913,27798,907,TRUE,NA,"0.1.4"
"45452","646",2023-12-18 10:45:00,-25885,1913,27798,907,TRUE,NA,"0.1.4"
"45453","646",2023-12-18 11:00:00,-25885,1913,27798,907,TRUE,NA,"0.1.4"
"45454","646",2023-12-18 11:15:00,-25885,1913,27798,907,TRUE,NA,"0.1.4"
"45455","646",2023-12-18 11:30:00,-25885,1913,27798,907,TRUE,NA,"0.1.4"
"45456","646",2023-12-18 11:45:00,-25885,1913,27798,907,TRUE,NA,"0.1.4"
"45457","646",2023-12-18 12:00:00,-25885,1913,27798,907,TRUE,NA,"0.1.4"
"45458","646",2023-12-18 12:15:00,-25885,1913,27798,907,TRUE,NA,"0.1.4"
"45459","646",2023-12-18 12:30:00,-25885,1913,27798,907,TRUE,NA,"0.1.4"
"45460","646",2023-12-18 12:45:00,-25885,1913,27798,907,TRUE,NA,"0.1.4"
"45461","646",2023-12-18 13:00:00,-25886,1913,27799,907,TRUE,NA,"0.1.4"
"45462","646",2023-12-18 13:15:00,-25885,1913,27798,907,TRUE,NA,"0.1.4"
"45463","646",2023-12-18 13:30:00,-25886,1913,27799,907,TRUE,NA,"0.1.4"
"45464","646",2023-12-18 13:45:00,-25887,1913,27800,907,TRUE,NA,"0.1.4"
"45465","646",2023-12-18 14:00:00,-25888,1913,27801,907,TRUE,NA,"0.1.4"
"45466","646",2023-12-18 14:15:00,-25888,1913,27801,907,TRUE,NA,"0.1.4"
"45467","646",2023-12-18 14:30:00,-25888,1913,27801,907,TRUE,NA,"0.1.4"
"45468","646",2023-12-18 14:45:00,-25890,1913,27803,907,TRUE,NA,"0.1.4"
"45469","646",2023-12-18 15:00:00,-25887,1913,27800,907,TRUE,NA,"0.1.4"
"45470","646",2023-12-18 15:15:00,-25948,1913,27861,907,TRUE,NA,"0.1.4"
"45471","646",2023-12-18 15:30:00,-25955,1913,27868,907,TRUE,NA,"0.1.4"
"45472","646",2023-12-18 15:45:00,-25955,1913,27868,907,TRUE,NA,"0.1.4"
"45473","646",2023-12-18 16:00:00,-25968,1913,27881,907,TRUE,NA,"0.1.4"
"45474","646",2023-12-18 16:15:00,-25957,1913,27870,907,TRUE,NA,"0.1.4"
"45475","646",2023-12-18 16:30:00,-25965,1913,27878,907,TRUE,NA,"0.1.4"
"45476","646",2023-12-18 16:45:00,-25936,1913,27849,907,TRUE,NA,"0.1.4"
"45477","646",2023-12-18 17:00:00,-25945,1913,27858,907,TRUE,NA,"0.1.4"
"45478","646",2023-12-18 17:15:00,-25956,1913,27869,907,TRUE,NA,"0.1.4"
"45479","646",2023-12-18 17:30:00,-25950,1913,27863,907,TRUE,NA,"0.1.4"
"45480","646",2023-12-18 17:45:00,-25948,1913,27861,907,TRUE,NA,"0.1.4"
"45481","646",2023-12-18 18:00:00,-25973,1913,27886,907,TRUE,NA,"0.1.4"
"45482","646",2023-12-18 18:15:00,-25953,1913,27866,907,TRUE,NA,"0.1.4"
"45483","646",2023-12-18 18:30:00,-25933,1913,27846,907,TRUE,NA,"0.1.4"
"45484","646",2023-12-18 18:45:00,-25919,1913,27832,907,FALSE,NA,"0.1.4"
"45485","646",2023-12-18 19:00:00,-25906,1913,27819,907,FALSE,NA,"0.1.4"
"45486","646",2023-12-18 19:15:00,-25893,1913,27806,907,FALSE,NA,"0.1.4"
"45487","646",2023-12-18 19:30:00,-25893,1913,27806,907,FALSE,NA,"0.1.4"
"45488","646",2023-12-18 19:45:00,-25912,1913,27825,907,FALSE,NA,"0.1.4"
"45489","646",2023-12-18 20:00:00,-25888,1913,27801,907,FALSE,NA,"0.1.4"
"45490","646",2023-12-18 20:15:00,-25910,1913,27823,907,FALSE,NA,"0.1.4"
"45491","646",2023-12-18 20:30:00,-25924,1913,27837,907,FALSE,NA,"0.1.4"
"45492","646",2023-12-18 20:45:00,-25903,1913,27816,907,FALSE,NA,"0.1.4"
"45493","646",2023-12-18 21:00:00,-25902,1913,27815,907,FALSE,NA,"0.1.4"
"45494","646",2023-12-18 21:15:00,-25906,1913,27819,907,FALSE,NA,"0.1.4"
"45495","646",2023-12-18 21:30:00,-26295,1913,28208,907,FALSE,NA,"0.1.4"
"45496","646",2023-12-18 21:45:00,-26091,1913,28004,907,FALSE,NA,"0.1.4"
"45497","646",2023-12-18 22:00:00,-25901,1913,27814,907,FALSE,NA,"0.1.4"
"45498","646",2023-12-18 22:15:00,-25886,1913,27799,907,FALSE,NA,"0.1.4"
"45499","646",2023-12-18 22:30:00,-25885,1913,27798,907,FALSE,NA,"0.1.4"
"45500","646",2023-12-18 22:45:00,-25885,1913,27798,907,FALSE,NA,"0.1.4"
"45501","646",2023-12-18 23:00:00,-25886,1913,27799,907,FALSE,NA,"0.1.4"
"45502","646",2023-12-18 23:15:00,-25882,1913,27795,907,FALSE,NA,"0.1.4"
"45503","646",2023-12-18 23:30:00,-25884,1913,27797,907,FALSE,NA,"0.1.4"
"45504","646",2023-12-18 23:45:00,-25883,1913,27796,907,FALSE,NA,"0.1.4"
"45505","646",2023-12-19,-25883,1913,27796,907,FALSE,NA,"0.1.4"
"45506","646",2023-12-19 00:15:00,-25883,1913,27796,907,FALSE,NA,"0.1.4"
"45507","646",2023-12-19 00:30:00,-25884,1913,27797,907,FALSE,NA,"0.1.4"
"45508","646",2023-12-19 00:45:00,-25884,1913,27797,907,FALSE,NA,"0.1.4"
"45509","646",2023-12-19 01:00:00,-25885,1913,27798,907,FALSE,NA,"0.1.4"
"45510","646",2023-12-19 01:15:00,-25885,1913,27798,907,FALSE,NA,"0.1.4"
"45511","646",2023-12-19 01:30:00,-25885,1913,27798,907,FALSE,NA,"0.1.4"
"45512","646",2023-12-19 01:45:00,-25885,1913,27798,907,FALSE,NA,"0.1.4"
"45513","646",2023-12-19 02:00:00,-25885,1913,27798,907,FALSE,NA,"0.1.4"
"45514","646",2023-12-19 02:15:00,-25885,1913,27798,907,FALSE,NA,"0.1.4"
"45515","646",2023-12-19 02:30:00,-25885,1913,27798,907,FALSE,NA,"0.1.4"
"45516","646",2023-12-19 02:45:00,-25885,1913,27798,907,FALSE,NA,"0.1.4"
"45517","646",2023-12-19 03:00:00,-25885,1913,27798,907,FALSE,NA,"0.1.4"
"45518","646",2023-12-19 03:15:00,-25885,1913,27798,907,FALSE,NA,"0.1.4"
"45519","646",2023-12-19 03:30:00,-25885,1913,27798,907,FALSE,NA,"0.1.4"
"45520","646",2023-12-19 03:45:00,-25885,1913,27798,907,FALSE,NA,"0.1.4"
"45521","646",2023-12-19 04:00:00,-25885,1913,27798,907,FALSE,NA,"0.1.4"
"45522","646",2023-12-19 04:15:00,-25885,1913,27798,907,FALSE,NA,"0.1.4"
"45523","646",2023-12-19 04:30:00,-25885,1913,27798,907,FALSE,NA,"0.1.4"
"45524","646",2023-12-19 04:45:00,-25885,1913,27798,907,FALSE,NA,"0.1.4"
"45525","646",2023-12-19 05:00:00,-25885,1913,27798,907,FALSE,NA,"0.1.4"
"45526","646",2023-12-19 05:15:00,-25885,1913,27798,907,FALSE,NA,"0.1.4"
"45527","646",2023-12-19 05:30:00,-25885,1913,27798,907,FALSE,NA,"0.1.4"
"45528","646",2023-12-19 05:45:00,-25885,1913,27798,907,FALSE,NA,"0.1.4"
"45529","646",2023-12-19 06:00:00,-25885,1913,27798,907,FALSE,NA,"0.1.4"
"45530","646",2023-12-19 06:15:00,-25885,1913,27798,907,FALSE,NA,"0.1.4"
"45531","646",2023-12-19 06:30:00,-25885,1913,27798,907,FALSE,NA,"0.1.4"
"45532","646",2023-12-19 06:45:00,-25885,1913,27798,907,FALSE,NA,"0.1.4"
"45533","646",2023-12-19 07:00:00,-25885,1913,27798,907,FALSE,NA,"0.1.4"
"45534","646",2023-12-19 07:15:00,-25885,1913,27798,907,FALSE,NA,"0.1.4"
"45535","646",2023-12-19 07:30:00,-25885,1913,27798,907,FALSE,NA,"0.1.4"
"45536","646",2023-12-19 07:45:00,-25885,1913,27798,907,FALSE,NA,"0.1.4"
"45537","646",2023-12-19 08:00:00,-25885,1913,27798,907,FALSE,NA,"0.1.4"
"45538","646",2023-12-19 08:15:00,-25885,1913,27798,907,FALSE,NA,"0.1.4"
"45539","646",2023-12-19 08:30:00,-25885,1913,27798,907,FALSE,NA,"0.1.4"
"45540","646",2023-12-19 08:45:00,-25885,1913,27798,907,FALSE,NA,"0.1.4"
"45541","646",2023-12-19 09:00:00,-25885,1913,27798,907,FALSE,NA,"0.1.4"
"45542","646",2023-12-19 09:15:00,-25885,1913,27798,907,FALSE,NA,"0.1.4"
"45543","646",2023-12-19 09:30:00,-25885,1913,27798,907,FALSE,NA,"0.1.4"
"45544","646",2023-12-19 09:45:00,-25885,1913,27798,907,FALSE,NA,"0.1.4"
"45545","646",2023-12-19 10:00:00,-25885,1913,27798,907,FALSE,NA,"0.1.4"
"45546","646",2023-12-19 10:15:00,-25885,1913,27798,907,FALSE,NA,"0.1.4"
"45547","646",2023-12-19 10:30:00,-25885,1913,27798,907,FALSE,NA,"0.1.4"
"45548","646",2023-12-19 10:45:00,-25885,1913,27798,907,FALSE,NA,"0.1.4"
"45549","646",2023-12-19 11:00:00,-25885,1913,27798,907,FALSE,NA,"0.1.4"
"45550","646",2023-12-19 11:15:00,-25885,1913,27798,907,FALSE,NA,"0.1.4"
"45551","646",2023-12-19 11:30:00,-25885,1913,27798,907,FALSE,NA,"0.1.4"
"45552","646",2023-12-19 11:45:00,-25885,1913,27798,907,FALSE,NA,"0.1.4"
"45553","646",2023-12-19 12:00:00,-25885,1913,27798,907,FALSE,NA,"0.1.4"
"45554","646",2023-12-19 12:15:00,-25885,1913,27798,907,FALSE,NA,"0.1.4"
"45555","646",2023-12-19 12:30:00,-25885,1913,27798,907,FALSE,NA,"0.1.4"
"45556","646",2023-12-19 12:45:00,-25885,1913,27798,907,FALSE,NA,"0.1.4"
"45557","646",2023-12-19 13:00:00,-25885,1913,27798,907,FALSE,NA,"0.1.4"
"45558","646",2023-12-19 13:15:00,-25885,1913,27798,907,FALSE,NA,"0.1.4"
"45559","646",2023-12-19 13:30:00,-25885,1913,27798,907,FALSE,NA,"0.1.4"
"45560","646",2023-12-19 13:45:00,-25885,1913,27798,907,FALSE,NA,"0.1.4"
"45561","646",2023-12-19 14:00:00,-25885,1913,27798,907,FALSE,NA,"0.1.4"
"45562","646",2023-12-19 14:15:00,-25885,1913,27798,907,FALSE,NA,"0.1.4"
"45563","646",2023-12-19 14:30:00,-25885,1913,27798,907,FALSE,NA,"0.1.4"
"45564","646",2023-12-19 14:45:00,-25885,1913,27798,907,FALSE,NA,"0.1.4"
"45565","646",2023-12-19 15:00:00,-25885,1913,27798,907,FALSE,NA,"0.1.4"
"45566","646",2023-12-19 15:15:00,-25885,1913,27798,907,FALSE,NA,"0.1.4"
"45567","646",2023-12-19 15:30:00,-25885,1913,27798,907,FALSE,NA,"0.1.4"
"45568","646",2023-12-19 15:45:00,-25885,1913,27798,907,FALSE,NA,"0.1.4"
"45569","646",2023-12-19 16:00:00,-25885,1913,27798,907,FALSE,NA,"0.1.4"
"45570","646",2023-12-19 16:15:00,-25885,1913,27798,907,FALSE,NA,"0.1.4"
"45571","646",2023-12-19 16:30:00,-25885,1913,27798,907,FALSE,NA,"0.1.4"
"45572","646",2023-12-19 16:45:00,-25885,1913,27798,907,FALSE,NA,"0.1.4"
"45573","646",2023-12-19 17:00:00,-25885,1913,27798,907,FALSE,NA,"0.1.4"
"45574","646",2023-12-19 17:15:00,-25883,1913,27796,907,FALSE,NA,"0.1.4"
"45575","646",2023-12-19 17:30:00,-25882,1913,27795,907,FALSE,NA,"0.1.4"
"45576","646",2023-12-19 17:45:00,-25884,1913,27797,907,FALSE,NA,"0.1.4"
"45577","646",2023-12-19 18:00:00,-25885,1913,27798,907,FALSE,NA,"0.1.4"
"45578","646",2023-12-19 18:15:00,-25883,1913,27796,907,FALSE,NA,"0.1.4"
"45579","646",2023-12-19 18:30:00,-25885,1913,27798,907,FALSE,NA,"0.1.4"
"45580","646",2023-12-19 18:45:00,-25885,1913,27798,907,FALSE,NA,"0.1.4"
"45581","646",2023-12-19 19:00:00,-25882,1913,27795,907,FALSE,NA,"0.1.4"
"45582","646",2023-12-19 19:15:00,-25879,1913,27792,907,FALSE,NA,"0.1.4"
"45583","646",2023-12-19 19:30:00,-25878,1913,27791,907,FALSE,NA,"0.1.4"
"45584","646",2023-12-19 19:45:00,-25882,1913,27795,907,FALSE,NA,"0.1.4"
"45585","646",2023-12-19 20:00:00,-25883,1913,27796,907,FALSE,NA,"0.1.4"
"45586","646",2023-12-19 20:15:00,-25881,1913,27794,907,FALSE,NA,"0.1.4"
"45587","646",2023-12-19 20:30:00,-25882,1913,27795,907,FALSE,NA,"0.1.4"
"45588","646",2023-12-19 20:45:00,-25885,1913,27798,907,FALSE,NA,"0.1.4"
"45589","646",2023-12-19 21:00:00,-25885,1913,27798,907,FALSE,NA,"0.1.4"
"45590","646",2023-12-19 21:15:00,-25885,1913,27798,907,FALSE,NA,"0.1.4"
"45591","646",2023-12-19 21:30:00,-25885,1913,27798,907,FALSE,NA,"0.1.4"
"45592","646",2023-12-19 21:45:00,-25885,1913,27798,907,FALSE,NA,"0.1.4"
"45593","646",2023-12-19 22:00:00,-25885,1913,27798,907,FALSE,NA,"0.1.4"
"45594","646",2023-12-19 22:15:00,-25885,1913,27798,907,FALSE,NA,"0.1.4"
"45595","646",2023-12-19 22:30:00,-25885,1913,27798,907,FALSE,NA,"0.1.4"
"45596","646",2023-12-19 22:45:00,-25885,1913,27798,907,FALSE,NA,"0.1.4"
"45597","646",2023-12-19 23:00:00,-25885,1913,27798,907,FALSE,NA,"0.1.4"
"45598","646",2023-12-19 23:15:00,-25885,1913,27798,907,FALSE,NA,"0.1.4"
"45599","646",2023-12-19 23:30:00,-25886,1913,27799,907,FALSE,NA,"0.1.4"
"45600","646",2023-12-19 23:45:00,-25886,1913,27799,907,FALSE,NA,"0.1.4"
"45601","646",2023-12-20,-25886,1913,27799,907,FALSE,NA,"0.1.4"
"45602","646",2023-12-20 00:15:00,-25886,1913,27799,907,FALSE,NA,"0.1.4"
"45603","646",2023-12-20 00:30:00,-25886,1913,27799,907,FALSE,NA,"0.1.4"
"45604","646",2023-12-20 00:45:00,-25885,1913,27798,907,FALSE,NA,"0.1.4"
"45605","646",2023-12-20 01:00:00,-25884,1913,27797,907,FALSE,NA,"0.1.4"
"45606","646",2023-12-20 01:15:00,-25882,1913,27795,907,FALSE,NA,"0.1.4"
"45607","646",2023-12-20 01:30:00,-25885,1913,27798,907,FALSE,NA,"0.1.4"
"45608","646",2023-12-20 01:45:00,-25885,1913,27798,907,FALSE,NA,"0.1.4"
"45609","646",2023-12-20 02:00:00,-25883,1913,27796,907,FALSE,NA,"0.1.4"
"45610","646",2023-12-20 02:15:00,-25885,1913,27798,907,FALSE,NA,"0.1.4"
"45611","646",2023-12-20 02:30:00,-25885,1913,27798,907,FALSE,NA,"0.1.4"
"45612","646",2023-12-20 02:45:00,-25885,1913,27798,907,FALSE,NA,"0.1.4"
"45613","646",2023-12-20 03:00:00,-25885,1913,27798,907,FALSE,NA,"0.1.4"
"45614","646",2023-12-20 03:15:00,-25885,1913,27798,907,FALSE,NA,"0.1.4"
"45615","646",2023-12-20 03:30:00,-25884,1913,27797,907,FALSE,NA,"0.1.4"
"45616","646",2023-12-20 03:45:00,-25884,1913,27797,907,FALSE,NA,"0.1.4"
"45617","646",2023-12-20 04:00:00,-25886,1913,27799,907,FALSE,NA,"0.1.4"
"45618","646",2023-12-20 04:15:00,-25884,1913,27797,907,FALSE,NA,"0.1.4"
"45619","646",2023-12-20 04:30:00,-25884,1913,27797,907,FALSE,NA,"0.1.4"
"45620","646",2023-12-20 04:45:00,-25884,1913,27797,907,FALSE,NA,"0.1.4"
"45621","646",2023-12-20 05:00:00,-25884,1913,27797,907,FALSE,NA,"0.1.4"
"45622","646",2023-12-20 05:15:00,-25884,1913,27797,907,FALSE,NA,"0.1.4"
"45623","646",2023-12-20 05:30:00,-25884,1913,27797,907,FALSE,NA,"0.1.4"
"45624","646",2023-12-20 05:45:00,-25925,1913,27838,907,FALSE,NA,"0.1.4"
"45625","646",2023-12-20 06:00:00,-25925,1913,27838,907,FALSE,"jump1","0.1.4"
"45626","646",2023-12-20 06:15:00,-25576,1913,27489,907,FALSE,NA,"0.1.4"
"45627","646",2023-12-20 06:30:00,-25298,1913,27211,907,FALSE,NA,"0.1.4"
"45628","646",2023-12-20 06:45:00,-25299,1913,27212,907,FALSE,NA,"0.1.4"
"45629","646",2023-12-20 07:00:00,-25308,1913,27221,907,FALSE,NA,"0.1.4"
"45630","646",2023-12-20 07:15:00,-25298,1913,27211,907,FALSE,NA,"0.1.4"
"45631","646",2023-12-20 07:30:00,-25298,1913,27211,907,FALSE,NA,"0.1.4"
"45632","646",2023-12-20 07:45:00,-25297,1913,27210,907,FALSE,NA,"0.1.4"
"45633","646",2023-12-20 08:00:00,-25298,1913,27211,907,FALSE,NA,"0.1.4"
"45634","646",2023-12-20 08:15:00,-25298,1913,27211,907,FALSE,NA,"0.1.4"
"45635","646",2023-12-20 08:30:00,-25301,1913,27214,907,FALSE,NA,"0.1.4"
"45636","646",2023-12-20 08:45:00,-25365,1913,27278,907,FALSE,NA,"0.1.4"
"45637","646",2023-12-20 09:00:00,-25298,1913,27211,907,FALSE,NA,"0.1.4"
"45638","646",2023-12-20 09:15:00,-25298,1913,27211,907,FALSE,"out1, fill","0.1.4"
"45639","646",2023-12-20 09:30:00,-25298,1913,27211,907,FALSE,"out1, fill","0.1.4"
"45640","646",2023-12-20 09:45:00,-25298,1913,27211,907,FALSE,"out1, fill","0.1.4"
"45641","646",2023-12-20 10:00:00,-25298,1913,27211,907,FALSE,"out1, fill","0.1.4"
"45642","646",2023-12-20 10:15:00,-25298,1913,27211,907,FALSE,"out1, fill","0.1.4"
"45643","646",2023-12-20 10:30:00,-25298,1913,27211,907,TRUE,"out1, fill","0.1.4"
"45644","646",2023-12-20 10:45:00,-25298,1913,27211,907,TRUE,NA,"0.1.4"
"45645","646",2023-12-20 11:00:00,-25299,1913,27212,907,TRUE,NA,"0.1.4"
"45646","646",2023-12-20 11:15:00,-25298,1913,27211,907,TRUE,NA,"0.1.4"
"45647","646",2023-12-20 11:30:00,-25298,1913,27211,907,TRUE,NA,"0.1.4"
"45648","646",2023-12-20 11:45:00,-25310,1913,27223,907,TRUE,NA,"0.1.4"
"45649","646",2023-12-20 12:00:00,-25311,1913,27224,907,TRUE,NA,"0.1.4"
"45650","646",2023-12-20 12:15:00,-25317.8333333333,1913,27230.8333333333,907,TRUE,"out1, fill","0.1.4"
"45651","646",2023-12-20 12:30:00,-25324.6666666667,1913,27237.6666666667,907,TRUE,"out1, fill","0.1.4"
"45652","646",2023-12-20 12:45:00,-25331.5,1913,27244.5,907,TRUE,"out1, fill","0.1.4"
"45653","646",2023-12-20 13:00:00,-25338.3333333333,1913,27251.3333333333,907,TRUE,"out1, fill","0.1.4"
"45654","646",2023-12-20 13:15:00,-25345.1666666667,1913,27258.1666666667,907,TRUE,"out1, fill","0.1.4"
"45655","646",2023-12-20 13:30:00,-25352,1913,27265,907,TRUE,NA,"0.1.4"
"45656","646",2023-12-20 13:45:00,-25321,1913,27234,907,TRUE,NA,"0.1.4"
"45657","646",2023-12-20 14:00:00,-25298,1913,27211,907,TRUE,NA,"0.1.4"
"45658","646",2023-12-20 14:15:00,-25297.8,1913,27210.8,907,TRUE,"out1, fill","0.1.4"
"45659","646",2023-12-20 14:30:00,-25297.6,1913,27210.6,907,TRUE,"out1, fill","0.1.4"
"45660","646",2023-12-20 14:45:00,-25297.4,1913,27210.4,907,TRUE,"out1, fill","0.1.4"
"45661","646",2023-12-20 15:00:00,-25297.2,1913,27210.2,907,TRUE,"out1, fill","0.1.4"
"45662","646",2023-12-20 15:15:00,-25297,1913,27210,907,TRUE,NA,"0.1.4"
"45663","646",2023-12-20 15:30:00,-25561,1913,27474,907,TRUE,NA,"0.1.4"
"45664","646",2023-12-20 15:45:00,-25314,1913,27227,907,TRUE,NA,"0.1.4"
"45665","646",2023-12-20 16:00:00,-25302,1913,27215,907,TRUE,NA,"0.1.4"
"45666","646",2023-12-20 16:15:00,-25300,1913,27213,907,TRUE,NA,"0.1.4"
"45667","646",2023-12-20 16:30:00,-25301,1913,27214,907,TRUE,NA,"0.1.4"
"45668","646",2023-12-20 16:45:00,-25300,1913,27213,907,TRUE,NA,"0.1.4"
"45669","646",2023-12-20 17:00:00,-25299,1913,27212,907,TRUE,NA,"0.1.4"
"45670","646",2023-12-20 17:15:00,-25299,1913,27212,907,TRUE,NA,"0.1.4"
"45671","646",2023-12-20 17:30:00,-25300,1913,27213,907,TRUE,NA,"0.1.4"
"45672","646",2023-12-20 17:45:00,-25298,1913,27211,907,TRUE,NA,"0.1.4"
"45673","646",2023-12-20 18:00:00,-25298,1913,27211,907,TRUE,NA,"0.1.4"
"45674","646",2023-12-20 18:15:00,-25298,1913,27211,907,TRUE,NA,"0.1.4"
"45675","646",2023-12-20 18:30:00,-25298,1913,27211,907,TRUE,NA,"0.1.4"
"45676","646",2023-12-20 18:45:00,-25298,1913,27211,907,TRUE,NA,"0.1.4"
"45677","646",2023-12-20 19:00:00,-25298,1913,27211,907,TRUE,NA,"0.1.4"
"45678","646",2023-12-20 19:15:00,-25298,1913,27211,907,TRUE,NA,"0.1.4"
"45679","646",2023-12-20 19:30:00,-25297,1913,27210,907,TRUE,NA,"0.1.4"
"45680","646",2023-12-20 19:45:00,-25298,1913,27211,907,TRUE,NA,"0.1.4"
"45681","646",2023-12-20 20:00:00,-25297,1913,27210,907,TRUE,NA,"0.1.4"
"45682","646",2023-12-20 20:15:00,-25298,1913,27211,907,TRUE,NA,"0.1.4"
"45683","646",2023-12-20 20:30:00,-25298,1913,27211,907,TRUE,NA,"0.1.4"
"45684","646",2023-12-20 20:45:00,-25298,1913,27211,907,TRUE,NA,"0.1.4"
"45685","646",2023-12-20 21:00:00,-25299,1913,27212,907,FALSE,NA,"0.1.4"
"45686","646",2023-12-20 21:15:00,-25295,1913,27208,907,FALSE,NA,"0.1.4"
"45687","646",2023-12-20 21:30:00,-25295,1913,27208,907,FALSE,NA,"0.1.4"
"45688","646",2023-12-20 21:45:00,-25295,1913,27208,907,FALSE,NA,"0.1.4"
"45689","646",2023-12-20 22:00:00,-25295,1913,27208,907,FALSE,NA,"0.1.4"
"45690","646",2023-12-20 22:15:00,-25297,1913,27210,907,FALSE,NA,"0.1.4"
"45691","646",2023-12-20 22:30:00,-25297,1913,27210,907,FALSE,NA,"0.1.4"
"45692","646",2023-12-20 22:45:00,-25297,1913,27210,907,FALSE,NA,"0.1.4"
"45693","646",2023-12-20 23:00:00,-25297,1913,27210,907,FALSE,NA,"0.1.4"
"45694","646",2023-12-20 23:15:00,-25297,1913,27210,907,FALSE,NA,"0.1.4"
"45695","646",2023-12-20 23:30:00,-25297,1913,27210,907,FALSE,NA,"0.1.4"
"45696","646",2023-12-20 23:45:00,-25297,1913,27210,907,FALSE,NA,"0.1.4"
"45697","646",2023-12-21,-25297,1913,27210,907,FALSE,NA,"0.1.4"
"45698","646",2023-12-21 00:15:00,-25297,1913,27210,907,FALSE,NA,"0.1.4"
"45699","646",2023-12-21 00:30:00,-25297,1913,27210,907,FALSE,NA,"0.1.4"
"45700","646",2023-12-21 00:45:00,-25297,1913,27210,907,FALSE,NA,"0.1.4"
"45701","646",2023-12-21 01:00:00,-25296,1913,27209,907,FALSE,NA,"0.1.4"
"45702","646",2023-12-21 01:15:00,-25297,1913,27210,907,FALSE,NA,"0.1.4"
"45703","646",2023-12-21 01:30:00,-25297,1913,27210,907,FALSE,NA,"0.1.4"
"45704","646",2023-12-21 01:45:00,-25295,1913,27208,907,FALSE,NA,"0.1.4"
"45705","646",2023-12-21 02:00:00,-25295,1913,27208,907,FALSE,NA,"0.1.4"
"45706","646",2023-12-21 02:15:00,-25296,1913,27209,907,FALSE,NA,"0.1.4"
"45707","646",2023-12-21 02:30:00,-25296,1913,27209,907,FALSE,NA,"0.1.4"
"45708","646",2023-12-21 02:45:00,-25295,1913,27208,907,TRUE,NA,"0.1.4"
"45709","646",2023-12-21 03:00:00,-25296,1913,27209,907,TRUE,NA,"0.1.4"
"45710","646",2023-12-21 03:15:00,-25297,1913,27210,907,TRUE,NA,"0.1.4"
"45711","646",2023-12-21 03:30:00,-25297,1913,27210,907,TRUE,NA,"0.1.4"
"45712","646",2023-12-21 03:45:00,-25297,1913,27210,907,TRUE,NA,"0.1.4"
"45713","646",2023-12-21 04:00:00,-25295,1913,27208,907,TRUE,NA,"0.1.4"
"45714","646",2023-12-21 04:15:00,-25297,1913,27210,907,TRUE,NA,"0.1.4"
"45715","646",2023-12-21 04:30:00,-25297,1913,27210,907,TRUE,NA,"0.1.4"
"45716","646",2023-12-21 04:45:00,-25297,1913,27210,907,TRUE,NA,"0.1.4"
"45717","646",2023-12-21 05:00:00,-25308,1913,27221,907,TRUE,NA,"0.1.4"
"45718","646",2023-12-21 05:15:00,-25309,1913,27222,907,TRUE,NA,"0.1.4"
"45719","646",2023-12-21 05:30:00,-25332,1913,27245,907,TRUE,NA,"0.1.4"
"45720","646",2023-12-21 05:45:00,-25313,1913,27226,907,TRUE,NA,"0.1.4"
"45721","646",2023-12-21 06:00:00,-25307,1913,27220,907,TRUE,"out1, fill","0.1.4"
"45722","646",2023-12-21 06:15:00,-25301,1913,27214,907,TRUE,"out1, fill","0.1.4"
"45723","646",2023-12-21 06:30:00,-25295,1913,27208,907,TRUE,NA,"0.1.4"
"45724","646",2023-12-21 06:45:00,-25295,1913,27208,907,TRUE,NA,"0.1.4"
"45725","646",2023-12-21 07:00:00,-25332,1913,27245,907,TRUE,NA,"0.1.4"
"45726","646",2023-12-21 07:15:00,-25331.8181818182,1913,27244.8181818182,907,TRUE,"out1, fill","0.1.4"
"45727","646",2023-12-21 07:30:00,-25331.6363636364,1913,27244.6363636364,907,TRUE,"out1, fill","0.1.4"
"45728","646",2023-12-21 07:45:00,-25331.4545454545,1913,27244.4545454545,907,TRUE,"out1, fill","0.1.4"
"45729","646",2023-12-21 08:00:00,-25331.2727272727,1913,27244.2727272727,907,TRUE,"out1, fill","0.1.4"
"45730","646",2023-12-21 08:15:00,-25331.0909090909,1913,27244.0909090909,907,TRUE,"out1, fill","0.1.4"
"45731","646",2023-12-21 08:30:00,-25330.9090909091,1913,27243.9090909091,907,TRUE,"out1, fill","0.1.4"
"45732","646",2023-12-21 08:45:00,-25330.7272727273,1913,27243.7272727273,907,TRUE,"out1, fill","0.1.4"
"45733","646",2023-12-21 09:00:00,-25330.5454545455,1913,27243.5454545455,907,TRUE,"out1, fill","0.1.4"
"45734","646",2023-12-21 09:15:00,-25330.3636363636,1913,27243.3636363636,907,TRUE,"out1, fill","0.1.4"
"45735","646",2023-12-21 09:30:00,-25330.1818181818,1913,27243.1818181818,907,TRUE,"out1, fill","0.1.4"
"45736","646",2023-12-21 09:45:00,-25330,1913,27243,907,TRUE,NA,"0.1.4"
"45737","646",2023-12-21 10:00:00,-25302,1913,27215,907,TRUE,NA,"0.1.4"
"45738","646",2023-12-21 10:15:00,-25301,1913,27214,907,TRUE,NA,"0.1.4"
"45739","646",2023-12-21 10:30:00,-25301.3333333333,1913,27214.3333333333,907,TRUE,"out1, fill","0.1.4"
"45740","646",2023-12-21 10:45:00,-25301.6666666667,1913,27214.6666666667,907,TRUE,"out1, fill","0.1.4"
"45741","646",2023-12-21 11:00:00,-25302,1913,27215,907,TRUE,NA,"0.1.4"
"45742","646",2023-12-21 11:15:00,-25297,1913,27210,907,TRUE,NA,"0.1.4"
"45743","646",2023-12-21 11:30:00,-25297,1913,27210,907,TRUE,NA,"0.1.4"
"45744","646",2023-12-21 11:45:00,-25297,1913,27210,907,TRUE,NA,"0.1.4"
"45745","646",2023-12-21 12:00:00,-25298,1913,27211,907,TRUE,NA,"0.1.4"
"45746","646",2023-12-21 12:15:00,-25298,1913,27211,907,TRUE,NA,"0.1.4"
"45747","646",2023-12-21 12:30:00,-25298,1913,27211,907,TRUE,NA,"0.1.4"
"45748","646",2023-12-21 12:45:00,-25302,1913,27215,907,TRUE,NA,"0.1.4"
"45749","646",2023-12-21 13:00:00,-25299,1913,27212,907,TRUE,NA,"0.1.4"
"45750","646",2023-12-21 13:15:00,-25297,1913,27210,907,TRUE,NA,"0.1.4"
"45751","646",2023-12-21 13:30:00,-25302,1913,27215,907,TRUE,NA,"0.1.4"
"45752","646",2023-12-21 13:45:00,-25302,1913,27215,907,TRUE,NA,"0.1.4"
"45753","646",2023-12-21 14:00:00,-25301,1913,27214,907,TRUE,NA,"0.1.4"
"45754","646",2023-12-21 14:15:00,-25301,1913,27214,907,TRUE,NA,"0.1.4"
"45755","646",2023-12-21 14:30:00,-25304,1913,27217,907,TRUE,NA,"0.1.4"
"45756","646",2023-12-21 14:45:00,-25305,1913,27218,907,TRUE,NA,"0.1.4"
"45757","646",2023-12-21 15:00:00,-25305,1913,27218,907,TRUE,NA,"0.1.4"
"45758","646",2023-12-21 15:15:00,-25304,1913,27217,907,TRUE,NA,"0.1.4"
"45759","646",2023-12-21 15:30:00,-25305,1913,27218,907,TRUE,NA,"0.1.4"
"45760","646",2023-12-21 15:45:00,-25305,1913,27218,907,TRUE,NA,"0.1.4"
"45761","646",2023-12-21 16:00:00,-25305,1913,27218,907,TRUE,NA,"0.1.4"
"45762","646",2023-12-21 16:15:00,-25305,1913,27218,907,TRUE,NA,"0.1.4"
"45763","646",2023-12-21 16:30:00,-25305,1913,27218,907,TRUE,NA,"0.1.4"
"45764","646",2023-12-21 16:45:00,-25305,1913,27218,907,TRUE,NA,"0.1.4"
"45765","646",2023-12-21 17:00:00,-25305,1913,27218,907,TRUE,NA,"0.1.4"
"45766","646",2023-12-21 17:15:00,-25305,1913,27218,907,TRUE,NA,"0.1.4"
"45767","646",2023-12-21 17:30:00,-25305,1913,27218,907,TRUE,NA,"0.1.4"
"45768","646",2023-12-21 17:45:00,-25305,1913,27218,907,TRUE,NA,"0.1.4"
"45769","646",2023-12-21 18:00:00,-25305,1913,27218,907,TRUE,NA,"0.1.4"
"45770","646",2023-12-21 18:15:00,-25305,1913,27218,907,TRUE,NA,"0.1.4"
"45771","646",2023-12-21 18:30:00,-25305,1913,27218,907,TRUE,NA,"0.1.4"
"45772","646",2023-12-21 18:45:00,-25304,1913,27217,907,TRUE,NA,"0.1.4"
"45773","646",2023-12-21 19:00:00,-25304,1913,27217,907,TRUE,NA,"0.1.4"
"45774","646",2023-12-21 19:15:00,-25302,1913,27215,907,TRUE,NA,"0.1.4"
"45775","646",2023-12-21 19:30:00,-25301,1913,27214,907,TRUE,NA,"0.1.4"
"45776","646",2023-12-21 19:45:00,-25297,1913,27210,907,TRUE,NA,"0.1.4"
"45777","646",2023-12-21 20:00:00,-25300,1913,27213,907,TRUE,NA,"0.1.4"
"45778","646",2023-12-21 20:15:00,-25301,1913,27214,907,TRUE,NA,"0.1.4"
"45779","646",2023-12-21 20:30:00,-25300,1913,27213,907,TRUE,NA,"0.1.4"
"45780","646",2023-12-21 20:45:00,-25295,1913,27208,907,TRUE,NA,"0.1.4"
"45781","646",2023-12-21 21:00:00,-25295,1913,27208,907,TRUE,NA,"0.1.4"
"45782","646",2023-12-21 21:15:00,-25297,1913,27210,907,TRUE,NA,"0.1.4"
"45783","646",2023-12-21 21:30:00,-25296,1913,27209,907,TRUE,NA,"0.1.4"
"45784","646",2023-12-21 21:45:00,-25297,1913,27210,907,TRUE,NA,"0.1.4"
"45785","646",2023-12-21 22:00:00,-25297,1913,27210,907,FALSE,NA,"0.1.4"
"45786","646",2023-12-21 22:15:00,-25297,1913,27210,907,FALSE,NA,"0.1.4"
"45787","646",2023-12-21 22:30:00,-25297,1913,27210,907,FALSE,NA,"0.1.4"
"45788","646",2023-12-21 22:45:00,-25297,1913,27210,907,FALSE,NA,"0.1.4"
"45789","646",2023-12-21 23:00:00,-25297,1913,27210,907,FALSE,NA,"0.1.4"
"45790","646",2023-12-21 23:15:00,-25297,1913,27210,907,FALSE,NA,"0.1.4"
"45791","646",2023-12-21 23:30:00,-25297,1913,27210,907,FALSE,NA,"0.1.4"
"45792","646",2023-12-21 23:45:00,-25297,1913,27210,907,FALSE,NA,"0.1.4"
"45793","646",2023-12-22,-25297,1913,27210,907,FALSE,NA,"0.1.4"
"45794","646",2023-12-22 00:15:00,-25297,1913,27210,907,FALSE,NA,"0.1.4"
"45795","646",2023-12-22 00:30:00,-25297,1913,27210,907,FALSE,NA,"0.1.4"
"45796","646",2023-12-22 00:45:00,-25297,1913,27210,907,FALSE,NA,"0.1.4"
"45797","646",2023-12-22 01:00:00,-25297,1913,27210,907,TRUE,NA,"0.1.4"
"45798","646",2023-12-22 01:15:00,-25297,1913,27210,907,TRUE,NA,"0.1.4"
"45799","646",2023-12-22 01:30:00,-25297,1913,27210,907,TRUE,NA,"0.1.4"
"45800","646",2023-12-22 01:45:00,-25297,1913,27210,907,TRUE,NA,"0.1.4"
"45801","646",2023-12-22 02:00:00,-25297,1913,27210,907,TRUE,NA,"0.1.4"
"45802","646",2023-12-22 02:15:00,-25297,1913,27210,907,TRUE,NA,"0.1.4"
"45803","646",2023-12-22 02:30:00,-25296,1913,27209,907,TRUE,NA,"0.1.4"
"45804","646",2023-12-22 02:45:00,-25294,1913,27207,907,TRUE,NA,"0.1.4"
"45805","646",2023-12-22 03:00:00,-25296,1913,27209,907,TRUE,NA,"0.1.4"
"45806","646",2023-12-22 03:15:00,-25295,1913,27208,907,TRUE,NA,"0.1.4"
"45807","646",2023-12-22 03:30:00,-25294,1913,27207,907,TRUE,NA,"0.1.4"
"45808","646",2023-12-22 03:45:00,-25296,1913,27209,907,TRUE,NA,"0.1.4"
"45809","646",2023-12-22 04:00:00,-25296,1913,27209,907,TRUE,NA,"0.1.4"
"45810","646",2023-12-22 04:15:00,-25296,1913,27209,907,TRUE,NA,"0.1.4"
"45811","646",2023-12-22 04:30:00,-25296,1913,27209,907,TRUE,NA,"0.1.4"
"45812","646",2023-12-22 04:45:00,-25295,1913,27208,907,TRUE,NA,"0.1.4"
"45813","646",2023-12-22 05:00:00,-25297,1913,27210,907,TRUE,NA,"0.1.4"
"45814","646",2023-12-22 05:15:00,-25292,1913,27205,907,TRUE,NA,"0.1.4"
"45815","646",2023-12-22 05:30:00,-25297,1913,27210,907,TRUE,NA,"0.1.4"
"45816","646",2023-12-22 05:45:00,-25297,1913,27210,907,TRUE,NA,"0.1.4"
"45817","646",2023-12-22 06:00:00,-25297,1913,27210,907,TRUE,NA,"0.1.4"
"45818","646",2023-12-22 06:15:00,-25297,1913,27210,907,TRUE,NA,"0.1.4"
"45819","646",2023-12-22 06:30:00,-25296,1913,27209,907,TRUE,NA,"0.1.4"
"45820","646",2023-12-22 06:45:00,-25297,1913,27210,907,TRUE,NA,"0.1.4"
"45821","646",2023-12-22 07:00:00,-25297,1913,27210,907,TRUE,NA,"0.1.4"
"45822","646",2023-12-22 07:15:00,-25295,1913,27208,907,TRUE,NA,"0.1.4"
"45823","646",2023-12-22 07:30:00,-25297,1913,27210,907,TRUE,NA,"0.1.4"
"45824","646",2023-12-22 07:45:00,-25297,1913,27210,907,TRUE,NA,"0.1.4"
"45825","646",2023-12-22 08:00:00,-25299,1913,27212,907,TRUE,NA,"0.1.4"
"45826","646",2023-12-22 08:15:00,-25299,1913,27212,907,TRUE,NA,"0.1.4"
"45827","646",2023-12-22 08:30:00,-25299,1913,27212,907,TRUE,NA,"0.1.4"
"45828","646",2023-12-22 08:45:00,-25308,1913,27221,907,TRUE,NA,"0.1.4"
"45829","646",2023-12-22 09:00:00,-25306,1913,27219,907,TRUE,NA,"0.1.4"
"45830","646",2023-12-22 09:15:00,-25305,1913,27218,907,TRUE,NA,"0.1.4"
"45831","646",2023-12-22 09:30:00,-25305,1913,27218,907,TRUE,NA,"0.1.4"
"45832","646",2023-12-22 09:45:00,-25305,1913,27218,907,TRUE,NA,"0.1.4"
"45833","646",2023-12-22 10:00:00,-25305,1913,27218,907,TRUE,NA,"0.1.4"
"45834","646",2023-12-22 10:15:00,-25300,1913,27213,907,TRUE,NA,"0.1.4"
"45835","646",2023-12-22 10:30:00,-25311,1913,27224,907,TRUE,NA,"0.1.4"
"45836","646",2023-12-22 10:45:00,-25319,1913,27232,907,TRUE,NA,"0.1.4"
"45837","646",2023-12-22 11:00:00,-25315,1913,27228,907,TRUE,NA,"0.1.4"
"45838","646",2023-12-22 11:15:00,-25306,1913,27219,907,TRUE,NA,"0.1.4"
"45839","646",2023-12-22 11:30:00,-25388,1913,27301,907,TRUE,NA,"0.1.4"
"45840","646",2023-12-22 11:45:00,-25318,1913,27231,907,TRUE,NA,"0.1.4"
"45841","646",2023-12-22 12:00:00,-25313,1913,27226,907,TRUE,NA,"0.1.4"
"45842","646",2023-12-22 12:15:00,-25313,1913,27226,907,TRUE,NA,"0.1.4"
"45843","646",2023-12-22 12:30:00,-25312,1913,27225,907,TRUE,NA,"0.1.4"
"45844","646",2023-12-22 12:45:00,-25313,1913,27226,907,TRUE,NA,"0.1.4"
"45845","646",2023-12-22 13:00:00,-25312,1913,27225,907,TRUE,NA,"0.1.4"
"45846","646",2023-12-22 13:15:00,-25312,1913,27225,907,TRUE,NA,"0.1.4"
"45847","646",2023-12-22 13:30:00,-25311,1913,27224,907,TRUE,NA,"0.1.4"
"45848","646",2023-12-22 13:45:00,-25302,1913,27215,907,TRUE,NA,"0.1.4"
"45849","646",2023-12-22 14:00:00,-25300,1913,27213,907,TRUE,NA,"0.1.4"
"45850","646",2023-12-22 14:15:00,-25302,1913,27215,907,TRUE,NA,"0.1.4"
"45851","646",2023-12-22 14:30:00,-25310,1913,27223,907,TRUE,NA,"0.1.4"
"45852","646",2023-12-22 14:45:00,-25302,1913,27215,907,TRUE,NA,"0.1.4"
"45853","646",2023-12-22 15:00:00,-25299,1913,27212,907,TRUE,NA,"0.1.4"
"45854","646",2023-12-22 15:15:00,-25309,1913,27222,907,TRUE,NA,"0.1.4"
"45855","646",2023-12-22 15:30:00,-25309,1913,27222,907,TRUE,NA,"0.1.4"
"45856","646",2023-12-22 15:45:00,-25309,1913,27222,907,TRUE,NA,"0.1.4"
"45857","646",2023-12-22 16:00:00,-25308,1913,27221,907,TRUE,NA,"0.1.4"
"45858","646",2023-12-22 16:15:00,-25308,1913,27221,907,TRUE,NA,"0.1.4"
"45859","646",2023-12-22 16:30:00,-25308,1913,27221,907,TRUE,NA,"0.1.4"
"45860","646",2023-12-22 16:45:00,-25307,1913,27220,907,TRUE,NA,"0.1.4"
"45861","646",2023-12-22 17:00:00,-25297,1913,27210,907,TRUE,NA,"0.1.4"
"45862","646",2023-12-22 17:15:00,-25296,1913,27209,907,TRUE,NA,"0.1.4"
"45863","646",2023-12-22 17:30:00,-25297,1913,27210,907,TRUE,NA,"0.1.4"
"45864","646",2023-12-22 17:45:00,-25296,1913,27209,907,TRUE,NA,"0.1.4"
"45865","646",2023-12-22 18:00:00,-25297,1913,27210,907,TRUE,NA,"0.1.4"
"45866","646",2023-12-22 18:15:00,-25297,1913,27210,907,TRUE,NA,"0.1.4"
"45867","646",2023-12-22 18:30:00,-25297,1913,27210,907,TRUE,NA,"0.1.4"
"45868","646",2023-12-22 18:45:00,-25297,1913,27210,907,TRUE,NA,"0.1.4"
"45869","646",2023-12-22 19:00:00,-25297,1913,27210,907,TRUE,NA,"0.1.4"
"45870","646",2023-12-22 19:15:00,-25295,1913,27208,907,TRUE,NA,"0.1.4"
"45871","646",2023-12-22 19:30:00,-25297,1913,27210,907,TRUE,NA,"0.1.4"
"45872","646",2023-12-22 19:45:00,-25297,1913,27210,907,TRUE,NA,"0.1.4"
"45873","646",2023-12-22 20:00:00,-25297,1913,27210,907,TRUE,NA,"0.1.4"
"45874","646",2023-12-22 20:15:00,-25297,1913,27210,907,TRUE,NA,"0.1.4"
"45875","646",2023-12-22 20:30:00,-25297,1913,27210,907,TRUE,NA,"0.1.4"
"45876","646",2023-12-22 20:45:00,-25297,1913,27210,907,TRUE,NA,"0.1.4"
"45877","646",2023-12-22 21:00:00,-25297,1913,27210,907,TRUE,NA,"0.1.4"
"45878","646",2023-12-22 21:15:00,-25297,1913,27210,907,TRUE,NA,"0.1.4"
"45879","646",2023-12-22 21:30:00,-25297,1913,27210,907,TRUE,NA,"0.1.4"
"45880","646",2023-12-22 21:45:00,-25297,1913,27210,907,TRUE,NA,"0.1.4"
"45881","646",2023-12-22 22:00:00,-25297,1913,27210,907,TRUE,NA,"0.1.4"
"45882","646",2023-12-22 22:15:00,-25297,1913,27210,907,TRUE,NA,"0.1.4"
"45883","646",2023-12-22 22:30:00,-25297,1913,27210,907,TRUE,NA,"0.1.4"
"45884","646",2023-12-22 22:45:00,-25297,1913,27210,907,TRUE,NA,"0.1.4"
"45885","646",2023-12-22 23:00:00,-25297,1913,27210,907,TRUE,NA,"0.1.4"
"45886","646",2023-12-22 23:15:00,-25297,1913,27210,907,TRUE,NA,"0.1.4"
"45887","646",2023-12-22 23:30:00,-25297,1913,27210,907,TRUE,NA,"0.1.4"
"45888","646",2023-12-22 23:45:00,-25297,1913,27210,907,TRUE,NA,"0.1.4"
"45889","646",2023-12-23,-25297,1913,27210,907,TRUE,NA,"0.1.4"
"45890","646",2023-12-23 00:15:00,-25297,1913,27210,907,TRUE,NA,"0.1.4"
"45891","646",2023-12-23 00:30:00,-25297,1913,27210,907,TRUE,NA,"0.1.4"
"45892","646",2023-12-23 00:45:00,-25297,1913,27210,907,TRUE,NA,"0.1.4"
"45893","646",2023-12-23 01:00:00,-25297,1913,27210,907,TRUE,NA,"0.1.4"
"45894","646",2023-12-23 01:15:00,-25297,1913,27210,907,TRUE,NA,"0.1.4"
"45895","646",2023-12-23 01:30:00,-25297,1913,27210,907,TRUE,NA,"0.1.4"
"45896","646",2023-12-23 01:45:00,-25297,1913,27210,907,TRUE,NA,"0.1.4"
"45897","646",2023-12-23 02:00:00,-25297,1913,27210,907,TRUE,NA,"0.1.4"
"45898","646",2023-12-23 02:15:00,-25297,1913,27210,907,TRUE,NA,"0.1.4"
"45899","646",2023-12-23 02:30:00,-25297,1913,27210,907,TRUE,NA,"0.1.4"
"45900","646",2023-12-23 02:45:00,-25297,1913,27210,907,TRUE,NA,"0.1.4"
"45901","646",2023-12-23 03:00:00,-25297,1913,27210,907,TRUE,NA,"0.1.4"
"45902","646",2023-12-23 03:15:00,-25301,1913,27214,907,TRUE,NA,"0.1.4"
"45903","646",2023-12-23 03:30:00,-25398,1913,27311,907,TRUE,NA,"0.1.4"
"45904","646",2023-12-23 03:45:00,-25315,1913,27228,907,TRUE,NA,"0.1.4"
"45905","646",2023-12-23 04:00:00,-25294,1913,27207,907,TRUE,NA,"0.1.4"
"45906","646",2023-12-23 04:15:00,-25294,1913,27207,907,TRUE,NA,"0.1.4"
"45907","646",2023-12-23 04:30:00,-25294,1913,27207,907,TRUE,NA,"0.1.4"
"45908","646",2023-12-23 04:45:00,-25294,1913,27207,907,TRUE,NA,"0.1.4"
"45909","646",2023-12-23 05:00:00,-25294,1913,27207,907,TRUE,NA,"0.1.4"
"45910","646",2023-12-23 05:15:00,-25294,1913,27207,907,TRUE,NA,"0.1.4"
"45911","646",2023-12-23 05:30:00,-25294,1913,27207,907,TRUE,NA,"0.1.4"
"45912","646",2023-12-23 05:45:00,-25294,1913,27207,907,TRUE,NA,"0.1.4"
"45913","646",2023-12-23 06:00:00,-25294,1913,27207,907,TRUE,NA,"0.1.4"
"45914","646",2023-12-23 06:15:00,-25296,1913,27209,907,TRUE,NA,"0.1.4"
"45915","646",2023-12-23 06:30:00,-25296,1913,27209,907,TRUE,NA,"0.1.4"
"45916","646",2023-12-23 06:45:00,-25297,1913,27210,907,TRUE,NA,"0.1.4"
"45917","646",2023-12-23 07:00:00,-25297,1913,27210,907,TRUE,NA,"0.1.4"
"45918","646",2023-12-23 07:15:00,-25297,1913,27210,907,TRUE,NA,"0.1.4"
"45919","646",2023-12-23 07:30:00,-25297,1913,27210,907,TRUE,NA,"0.1.4"
"45920","646",2023-12-23 07:45:00,-25297,1913,27210,907,TRUE,NA,"0.1.4"
"45921","646",2023-12-23 08:00:00,-25296,1913,27209,907,TRUE,NA,"0.1.4"
"45922","646",2023-12-23 08:15:00,-25296,1913,27209,907,TRUE,NA,"0.1.4"
"45923","646",2023-12-23 08:30:00,-25297,1913,27210,907,TRUE,NA,"0.1.4"
"45924","646",2023-12-23 08:45:00,-25297,1913,27210,907,TRUE,NA,"0.1.4"
"45925","646",2023-12-23 09:00:00,-25302,1913,27215,907,TRUE,NA,"0.1.4"
"45926","646",2023-12-23 09:15:00,-25420,1913,27333,907,TRUE,NA,"0.1.4"
"45927","646",2023-12-23 09:30:00,-25365,1913,27278,907,TRUE,NA,"0.1.4"
"45928","646",2023-12-23 09:45:00,-25326,1913,27239,907,TRUE,NA,"0.1.4"
"45929","646",2023-12-23 10:00:00,-25325,1913,27238,907,TRUE,NA,"0.1.4"
"45930","646",2023-12-23 10:15:00,-25327,1913,27240,907,TRUE,NA,"0.1.4"
"45931","646",2023-12-23 10:30:00,-25328,1913,27241,907,TRUE,NA,"0.1.4"
"45932","646",2023-12-23 10:45:00,-25305,1913,27218,907,TRUE,NA,"0.1.4"
"45933","646",2023-12-23 11:00:00,-25305,1913,27218,907,TRUE,NA,"0.1.4"
"45934","646",2023-12-23 11:15:00,-25320,1913,27233,907,TRUE,NA,"0.1.4"
"45935","646",2023-12-23 11:30:00,-25318,1913,27231,907,TRUE,NA,"0.1.4"
"45936","646",2023-12-23 11:45:00,-25360,1913,27273,907,TRUE,NA,"0.1.4"
"45937","646",2023-12-23 12:00:00,-25303,1913,27216,907,TRUE,NA,"0.1.4"
"45938","646",2023-12-23 12:15:00,-25306,1913,27219,907,TRUE,NA,"0.1.4"
"45939","646",2023-12-23 12:30:00,-25297,1913,27210,907,TRUE,NA,"0.1.4"
"45940","646",2023-12-23 12:45:00,-25297,1913,27210,907,TRUE,NA,"0.1.4"
"45941","646",2023-12-23 13:00:00,-25297,1913,27210,907,TRUE,NA,"0.1.4"
"45942","646",2023-12-23 13:15:00,-25297,1913,27210,907,TRUE,NA,"0.1.4"
"45943","646",2023-12-23 13:30:00,-25297,1913,27210,907,TRUE,NA,"0.1.4"
"45944","646",2023-12-23 13:45:00,-25297,1913,27210,907,TRUE,NA,"0.1.4"
"45945","646",2023-12-23 14:00:00,-25297,1913,27210,907,TRUE,NA,"0.1.4"
"45946","646",2023-12-23 14:15:00,-25297,1913,27210,907,TRUE,NA,"0.1.4"
"45947","646",2023-12-23 14:30:00,-25297,1913,27210,907,TRUE,NA,"0.1.4"
"45948","646",2023-12-23 14:45:00,-25533,1913,27446,907,TRUE,NA,"0.1.4"
"45949","646",2023-12-23 15:00:00,-25533,1913,27446,907,TRUE,"out1, fill","0.1.4"
"45950","646",2023-12-23 15:15:00,-25533,1913,27446,907,TRUE,"jump1","0.1.4"
"45951","646",2023-12-23 15:30:00,-25552,1913,27465,907,TRUE,NA,"0.1.4"
"45952","646",2023-12-23 15:45:00,-25593,1913,27506,907,TRUE,NA,"0.1.4"
"45953","646",2023-12-23 16:00:00,-25401.5,1913,27314.5,907,TRUE,"out1, fill","0.1.4"
"45954","646",2023-12-23 16:15:00,-25210,1913,27123,907,TRUE,NA,"0.1.4"
"45955","646",2023-12-23 16:30:00,-24837,1913,26750,907,TRUE,NA,"0.1.4"
"45956","646",2023-12-23 16:45:00,-24952,1913,26865,907,TRUE,NA,"0.1.4"
"45957","646",2023-12-23 17:00:00,-24954,1913,26867,907,TRUE,NA,"0.1.4"
"45958","646",2023-12-23 17:15:00,-24869,1913,26782,907,TRUE,NA,"0.1.4"
"45959","646",2023-12-23 17:30:00,-24785,1913,26698,907,TRUE,NA,"0.1.4"
"45960","646",2023-12-23 17:45:00,-24785,1913,26698,907,TRUE,"out1, fill","0.1.4"
"45961","646",2023-12-23 18:00:00,-24785,1913,26698,907,TRUE,"jump1","0.1.4"
"45962","646",2023-12-23 18:15:00,-24766,1913,26679,907,TRUE,NA,"0.1.4"
"45963","646",2023-12-23 18:30:00,-24725,1913,26638,907,TRUE,NA,"0.1.4"
"45964","646",2023-12-23 18:45:00,-24740,1913,26653,907,TRUE,NA,"0.1.4"
"45965","646",2023-12-23 19:00:00,-24736,1913,26649,907,TRUE,NA,"0.1.4"
"45966","646",2023-12-23 19:15:00,-24581,1913,26494,907,TRUE,NA,"0.1.4"
"45967","646",2023-12-23 19:30:00,-24571,1913,26484,907,TRUE,NA,"0.1.4"
"45968","646",2023-12-23 19:45:00,-24567,1913,26480,907,TRUE,NA,"0.1.4"
"45969","646",2023-12-23 20:00:00,-24562,1913,26475,907,TRUE,NA,"0.1.4"
"45970","646",2023-12-23 20:15:00,-24562,1913,26475,907,TRUE,NA,"0.1.4"
"45971","646",2023-12-23 20:30:00,-24563,1913,26476,907,TRUE,NA,"0.1.4"
"45972","646",2023-12-23 20:45:00,-24564,1913,26477,907,TRUE,NA,"0.1.4"
"45973","646",2023-12-23 21:00:00,-24563.3333333333,1913,26476.3333333333,907,TRUE,"out1, fill","0.1.4"
"45974","646",2023-12-23 21:15:00,-24562.6666666667,1913,26475.6666666667,907,TRUE,"out1, fill","0.1.4"
"45975","646",2023-12-23 21:30:00,-24562,1913,26475,907,TRUE,"out1, fill","0.1.4"
"45976","646",2023-12-23 21:45:00,-24561.3333333333,1913,26474.3333333333,907,TRUE,"out1, fill","0.1.4"
"45977","646",2023-12-23 22:00:00,-24560.6666666667,1913,26473.6666666667,907,TRUE,"out1, fill","0.1.4"
"45978","646",2023-12-23 22:15:00,-24560,1913,26473,907,TRUE,NA,"0.1.4"
"45979","646",2023-12-23 22:30:00,-24562,1913,26475,907,TRUE,NA,"0.1.4"
"45980","646",2023-12-23 22:45:00,-24581,1913,26494,907,TRUE,NA,"0.1.4"
"45981","646",2023-12-23 23:00:00,-24581,1913,26494,907,TRUE,"out1, fill","0.1.4"
"45982","646",2023-12-23 23:15:00,-24581,1913,26494,907,TRUE,"jump1","0.1.4"
"45983","646",2023-12-23 23:30:00,-24530,1913,26443,907,TRUE,NA,"0.1.4"
"45984","646",2023-12-23 23:45:00,-24338,1913,26251,907,TRUE,NA,"0.1.4"
"45985","646",2023-12-24,-24418,1913,26331,907,TRUE,NA,"0.1.4"
"45986","646",2023-12-24 00:15:00,-24421,1913,26334,907,TRUE,NA,"0.1.4"
"45987","646",2023-12-24 00:30:00,-24410,1913,26323,907,TRUE,NA,"0.1.4"
"45988","646",2023-12-24 00:45:00,-24599,1913,26512,907,TRUE,NA,"0.1.4"
"45989","646",2023-12-24 01:00:00,-24281,1913,26194,907,TRUE,NA,"0.1.4"
"45990","646",2023-12-24 01:15:00,-24527,1913,26440,907,TRUE,NA,"0.1.4"
"45991","646",2023-12-24 01:30:00,-24288.8,1913,26201.8,907,TRUE,"out1, fill","0.1.4"
"45992","646",2023-12-24 01:45:00,-24050.6,1913,25963.6,907,TRUE,"out1, fill","0.1.4"
"45993","646",2023-12-24 02:00:00,-23812.4,1913,25725.4,907,TRUE,"out1, fill","0.1.4"
"45994","646",2023-12-24 02:15:00,-23574.2,1913,25487.2,907,TRUE,"out1, fill","0.1.4"
"45995","646",2023-12-24 02:30:00,-23336,1913,25249,907,TRUE,NA,"0.1.4"
"45996","646",2023-12-24 02:45:00,-23333,1913,25246,907,TRUE,NA,"0.1.4"
"45997","646",2023-12-24 03:00:00,-23326,1913,25239,907,TRUE,NA,"0.1.4"
"45998","646",2023-12-24 03:15:00,-23405,1913,25318,907,TRUE,NA,"0.1.4"
"45999","646",2023-12-24 03:30:00,-23405,1913,25318,907,TRUE,"out1, fill","0.1.4"
"46000","646",2023-12-24 03:45:00,-23405,1913,25318,907,TRUE,"jump1","0.1.4"
"46001","646",2023-12-24 04:00:00,-23524,1913,25437,907,TRUE,NA,"0.1.4"
"46002","646",2023-12-24 04:15:00,-23344,1913,25257,907,TRUE,NA,"0.1.4"
"46003","646",2023-12-24 04:30:00,-23315,1913,25228,907,TRUE,"out1, fill","0.1.4"
"46004","646",2023-12-24 04:45:00,-23286,1913,25199,907,TRUE,"out1, fill","0.1.4"
"46005","646",2023-12-24 05:00:00,-23257,1913,25170,907,TRUE,"out1, fill","0.1.4"
"46006","646",2023-12-24 05:15:00,-23228,1913,25141,907,TRUE,NA,"0.1.4"
"46007","646",2023-12-24 05:30:00,-23099,1913,25012,907,TRUE,NA,"0.1.4"
"46008","646",2023-12-24 05:45:00,-23244,1913,25157,907,TRUE,NA,"0.1.4"
"46009","646",2023-12-24 06:00:00,-22910.6666666667,1913,24823.6666666667,907,TRUE,"out1, fill","0.1.4"
"46010","646",2023-12-24 06:15:00,-22577.3333333333,1913,24490.3333333333,907,TRUE,"out1, fill","0.1.4"
"46011","646",2023-12-24 06:30:00,-22244,1913,24157,907,TRUE,NA,"0.1.4"
"46012","646",2023-12-24 06:45:00,-22197,1913,24110,907,TRUE,NA,"0.1.4"
"46013","646",2023-12-24 07:00:00,-22196,1913,24109,907,TRUE,NA,"0.1.4"
"46014","646",2023-12-24 07:15:00,-22268,1913,24181,907,TRUE,NA,"0.1.4"
"46015","646",2023-12-24 07:30:00,-22459,1913,24372,907,TRUE,NA,"0.1.4"
"46016","646",2023-12-24 07:45:00,-22461,1913,24374,907,TRUE,NA,"0.1.4"
"46017","646",2023-12-24 08:00:00,-22419,1913,24332,907,TRUE,NA,"0.1.4"
"46018","646",2023-12-24 08:15:00,-22259,1913,24172,907,TRUE,NA,"0.1.4"
"46019","646",2023-12-24 08:30:00,-22428,1913,24341,907,TRUE,NA,"0.1.4"
"46020","646",2023-12-24 08:45:00,-22431,1913,24344,907,TRUE,NA,"0.1.4"
"46021","646",2023-12-24 09:00:00,-22424,1913,24337,907,TRUE,NA,"0.1.4"
"46022","646",2023-12-24 09:15:00,-22433,1913,24346,907,TRUE,NA,"0.1.4"
"46023","646",2023-12-24 09:30:00,-22512,1913,24425,907,TRUE,NA,"0.1.4"
"46024","646",2023-12-24 09:45:00,-22501,1913,24414,907,TRUE,NA,"0.1.4"
"46025","646",2023-12-24 10:00:00,-22548,1913,24461,907,TRUE,NA,"0.1.4"
"46026","646",2023-12-24 10:15:00,-22513,1913,24426,907,TRUE,NA,"0.1.4"
"46027","646",2023-12-24 10:30:00,-22542,1913,24455,907,TRUE,NA,"0.1.4"
"46028","646",2023-12-24 10:45:00,-22632,1913,24545,907,TRUE,NA,"0.1.4"
"46029","646",2023-12-24 11:00:00,-22598,1913,24511,907,TRUE,NA,"0.1.4"
"46030","646",2023-12-24 11:15:00,-22586,1913,24499,907,TRUE,NA,"0.1.4"
"46031","646",2023-12-24 11:30:00,-22661,1913,24574,907,TRUE,NA,"0.1.4"
"46032","646",2023-12-24 11:45:00,-22599,1913,24512,907,TRUE,NA,"0.1.4"
"46033","646",2023-12-24 12:00:00,-22541,1913,24454,907,TRUE,NA,"0.1.4"
"46034","646",2023-12-24 12:15:00,-22588,1913,24501,907,TRUE,NA,"0.1.4"
"46035","646",2023-12-24 12:30:00,-22571,1913,24484,907,TRUE,NA,"0.1.4"
"46036","646",2023-12-24 12:45:00,-22547,1913,24460,907,TRUE,NA,"0.1.4"
"46037","646",2023-12-24 13:00:00,-22515,1913,24428,907,TRUE,NA,"0.1.4"
"46038","646",2023-12-24 13:15:00,-22522,1913,24435,907,TRUE,NA,"0.1.4"
"46039","646",2023-12-24 13:30:00,-22526,1913,24439,907,TRUE,NA,"0.1.4"
"46040","646",2023-12-24 13:45:00,-22590,1913,24503,907,TRUE,NA,"0.1.4"
"46041","646",2023-12-24 14:00:00,-22642,1913,24555,907,TRUE,NA,"0.1.4"
"46042","646",2023-12-24 14:15:00,-22604,1913,24517,907,TRUE,NA,"0.1.4"
"46043","646",2023-12-24 14:30:00,-22598,1913,24511,907,TRUE,NA,"0.1.4"
"46044","646",2023-12-24 14:45:00,-22587,1913,24500,907,TRUE,NA,"0.1.4"
"46045","646",2023-12-24 15:00:00,-22675,1913,24588,907,TRUE,NA,"0.1.4"
"46046","646",2023-12-24 15:15:00,-22637,1913,24550,907,TRUE,NA,"0.1.4"
"46047","646",2023-12-24 15:30:00,-22537,1913,24450,907,TRUE,NA,"0.1.4"
"46048","646",2023-12-24 15:45:00,-22558,1913,24471,907,TRUE,NA,"0.1.4"
"46049","646",2023-12-24 16:00:00,-22507,1913,24420,907,TRUE,NA,"0.1.4"
"46050","646",2023-12-24 16:15:00,-22479,1913,24392,907,TRUE,NA,"0.1.4"
"46051","646",2023-12-24 16:30:00,-22427,1913,24340,907,TRUE,NA,"0.1.4"
"46052","646",2023-12-24 16:45:00,-22256,1913,24169,907,TRUE,NA,"0.1.4"
"46053","646",2023-12-24 17:00:00,-22257,1913,24170,907,TRUE,NA,"0.1.4"
"46054","646",2023-12-24 17:15:00,-22253,1913,24166,907,TRUE,NA,"0.1.4"
"46055","646",2023-12-24 17:30:00,-22441,1913,24354,907,TRUE,NA,"0.1.4"
"46056","646",2023-12-24 17:45:00,-22270,1913,24183,907,TRUE,NA,"0.1.4"
"46057","646",2023-12-24 18:00:00,-22271,1913,24184,907,TRUE,NA,"0.1.4"
"46058","646",2023-12-24 18:15:00,-22206,1913,24119,907,TRUE,NA,"0.1.4"
"46059","646",2023-12-24 18:30:00,-22240,1913,24153,907,TRUE,NA,"0.1.4"
"46060","646",2023-12-24 18:45:00,-22212,1913,24125,907,TRUE,NA,"0.1.4"
"46061","646",2023-12-24 19:00:00,-22281,1913,24194,907,TRUE,NA,"0.1.4"
"46062","646",2023-12-24 19:15:00,-22201,1913,24114,907,TRUE,NA,"0.1.4"
"46063","646",2023-12-24 19:30:00,-22215,1913,24128,907,TRUE,NA,"0.1.4"
"46064","646",2023-12-24 19:45:00,-22205,1913,24118,907,TRUE,NA,"0.1.4"
"46065","646",2023-12-24 20:00:00,-22198,1913,24111,907,TRUE,NA,"0.1.4"
"46066","646",2023-12-24 20:15:00,-22197,1913,24110,907,TRUE,NA,"0.1.4"
"46067","646",2023-12-24 20:30:00,-22195,1913,24108,907,TRUE,NA,"0.1.4"
"46068","646",2023-12-24 20:45:00,-22196,1913,24109,907,TRUE,NA,"0.1.4"
"46069","646",2023-12-24 21:00:00,-22201,1913,24114,907,TRUE,NA,"0.1.4"
"46070","646",2023-12-24 21:15:00,-22200,1913,24113,907,TRUE,NA,"0.1.4"
"46071","646",2023-12-24 21:30:00,-22269,1913,24182,907,TRUE,NA,"0.1.4"
"46072","646",2023-12-24 21:45:00,-22195,1913,24108,907,TRUE,NA,"0.1.4"
"46073","646",2023-12-24 22:00:00,-22195,1913,24108,907,TRUE,NA,"0.1.4"
"46074","646",2023-12-24 22:15:00,-22195,1913,24108,907,TRUE,NA,"0.1.4"
"46075","646",2023-12-24 22:30:00,-22210,1913,24123,907,TRUE,NA,"0.1.4"
"46076","646",2023-12-24 22:45:00,-22202,1913,24115,907,TRUE,NA,"0.1.4"
"46077","646",2023-12-24 23:00:00,-22236,1913,24149,907,TRUE,NA,"0.1.4"
"46078","646",2023-12-24 23:15:00,-22194,1913,24107,907,TRUE,NA,"0.1.4"
"46079","646",2023-12-24 23:30:00,-22194,1913,24107,907,TRUE,NA,"0.1.4"
"46080","646",2023-12-24 23:45:00,-22194,1913,24107,907,TRUE,NA,"0.1.4"
"46081","646",2023-12-25,-22194,1913,24107,907,TRUE,NA,"0.1.4"
"46082","646",2023-12-25 00:15:00,-22194,1913,24107,907,TRUE,NA,"0.1.4"
"46083","646",2023-12-25 00:30:00,-22194,1913,24107,907,TRUE,NA,"0.1.4"
"46084","646",2023-12-25 00:45:00,-22194,1913,24107,907,TRUE,NA,"0.1.4"
"46085","646",2023-12-25 01:00:00,-22194,1913,24107,907,TRUE,NA,"0.1.4"
"46086","646",2023-12-25 01:15:00,-22194,1913,24107,907,TRUE,NA,"0.1.4"
"46087","646",2023-12-25 01:30:00,-22194,1913,24107,907,TRUE,NA,"0.1.4"
"46088","646",2023-12-25 01:45:00,-22195,1913,24108,907,TRUE,NA,"0.1.4"
"46089","646",2023-12-25 02:00:00,-22194,1913,24107,907,TRUE,NA,"0.1.4"
"46090","646",2023-12-25 02:15:00,-22194,1913,24107,907,TRUE,NA,"0.1.4"
"46091","646",2023-12-25 02:30:00,-22195,1913,24108,907,TRUE,NA,"0.1.4"
"46092","646",2023-12-25 02:45:00,-22196,1913,24109,907,TRUE,NA,"0.1.4"
"46093","646",2023-12-25 03:00:00,-22196,1913,24109,907,TRUE,NA,"0.1.4"
"46094","646",2023-12-25 03:15:00,-22196,1913,24109,907,TRUE,NA,"0.1.4"
"46095","646",2023-12-25 03:30:00,-22197,1913,24110,907,TRUE,NA,"0.1.4"
"46096","646",2023-12-25 03:45:00,-22195,1913,24108,907,TRUE,NA,"0.1.4"
"46097","646",2023-12-25 04:00:00,-22195,1913,24108,907,TRUE,NA,"0.1.4"
"46098","646",2023-12-25 04:15:00,-22197,1913,24110,907,TRUE,NA,"0.1.4"
"46099","646",2023-12-25 04:30:00,-22197,1913,24110,907,TRUE,NA,"0.1.4"
"46100","646",2023-12-25 04:45:00,-22197,1913,24110,907,TRUE,NA,"0.1.4"
"46101","646",2023-12-25 05:00:00,-22195,1913,24108,907,TRUE,NA,"0.1.4"
"46102","646",2023-12-25 05:15:00,-22195,1913,24108,907,TRUE,NA,"0.1.4"
"46103","646",2023-12-25 05:30:00,-22195,1913,24108,907,TRUE,NA,"0.1.4"
"46104","646",2023-12-25 05:45:00,-22194,1913,24107,907,TRUE,NA,"0.1.4"
"46105","646",2023-12-25 06:00:00,-22195,1913,24108,907,TRUE,NA,"0.1.4"
"46106","646",2023-12-25 06:15:00,-22194,1913,24107,907,TRUE,NA,"0.1.4"
"46107","646",2023-12-25 06:30:00,-22194,1913,24107,907,TRUE,NA,"0.1.4"
"46108","646",2023-12-25 06:45:00,-22195,1913,24108,907,TRUE,NA,"0.1.4"
"46109","646",2023-12-25 07:00:00,-22199,1913,24112,907,TRUE,NA,"0.1.4"
"46110","646",2023-12-25 07:15:00,-22200,1913,24113,907,TRUE,NA,"0.1.4"
"46111","646",2023-12-25 07:30:00,-22200,1913,24113,907,TRUE,NA,"0.1.4"
"46112","646",2023-12-25 07:45:00,-22197,1913,24110,907,TRUE,NA,"0.1.4"
"46113","646",2023-12-25 08:00:00,-22199,1913,24112,907,TRUE,NA,"0.1.4"
"46114","646",2023-12-25 08:15:00,-22194,1913,24107,907,TRUE,NA,"0.1.4"
"46115","646",2023-12-25 08:30:00,-22194,1913,24107,907,TRUE,NA,"0.1.4"
"46116","646",2023-12-25 08:45:00,-22194,1913,24107,907,TRUE,NA,"0.1.4"
"46117","646",2023-12-25 09:00:00,-22195,1913,24108,907,TRUE,NA,"0.1.4"
"46118","646",2023-12-25 09:15:00,-22194,1913,24107,907,TRUE,NA,"0.1.4"
"46119","646",2023-12-25 09:30:00,-22194,1913,24107,907,TRUE,NA,"0.1.4"
"46120","646",2023-12-25 09:45:00,-22195,1913,24108,907,TRUE,NA,"0.1.4"
"46121","646",2023-12-25 10:00:00,-22195,1913,24108,907,TRUE,NA,"0.1.4"
"46122","646",2023-12-25 10:15:00,-22196,1913,24109,907,TRUE,NA,"0.1.4"
"46123","646",2023-12-25 10:30:00,-22193,1913,24106,907,TRUE,NA,"0.1.4"
"46124","646",2023-12-25 10:45:00,-22192,1913,24105,907,TRUE,NA,"0.1.4"
"46125","646",2023-12-25 11:00:00,-22192,1913,24105,907,TRUE,NA,"0.1.4"
"46126","646",2023-12-25 11:15:00,-22192,1913,24105,907,TRUE,NA,"0.1.4"
"46127","646",2023-12-25 11:30:00,-22193,1913,24106,907,TRUE,NA,"0.1.4"
"46128","646",2023-12-25 11:45:00,-22193,1913,24106,907,TRUE,NA,"0.1.4"
"46129","646",2023-12-25 12:00:00,-22199,1913,24112,907,TRUE,NA,"0.1.4"
"46130","646",2023-12-25 12:15:00,-22199,1913,24112,907,TRUE,NA,"0.1.4"
"46131","646",2023-12-25 12:30:00,-22199,1913,24112,907,TRUE,NA,"0.1.4"
"46132","646",2023-12-25 12:45:00,-22199,1913,24112,907,TRUE,NA,"0.1.4"
"46133","646",2023-12-25 13:00:00,-22196,1913,24109,907,TRUE,NA,"0.1.4"
"46134","646",2023-12-25 13:15:00,-22196,1913,24109,907,TRUE,NA,"0.1.4"
"46135","646",2023-12-25 13:30:00,-22196,1913,24109,907,TRUE,NA,"0.1.4"
"46136","646",2023-12-25 13:45:00,-22199,1913,24112,907,TRUE,NA,"0.1.4"
"46137","646",2023-12-25 14:00:00,-22197,1913,24110,907,TRUE,NA,"0.1.4"
"46138","646",2023-12-25 14:15:00,-22197,1913,24110,907,TRUE,NA,"0.1.4"
"46139","646",2023-12-25 14:30:00,-22196,1913,24109,907,TRUE,NA,"0.1.4"
"46140","646",2023-12-25 14:45:00,-22195,1913,24108,907,TRUE,NA,"0.1.4"
"46141","646",2023-12-25 15:00:00,-22198,1913,24111,907,TRUE,NA,"0.1.4"
"46142","646",2023-12-25 15:15:00,-22195,1913,24108,907,TRUE,NA,"0.1.4"
"46143","646",2023-12-25 15:30:00,-22193,1913,24106,907,TRUE,NA,"0.1.4"
"46144","646",2023-12-25 15:45:00,-22194,1913,24107,907,TRUE,NA,"0.1.4"
"46145","646",2023-12-25 16:00:00,-22194,1913,24107,907,TRUE,NA,"0.1.4"
"46146","646",2023-12-25 16:15:00,-22194,1913,24107,907,TRUE,NA,"0.1.4"
"46147","646",2023-12-25 16:30:00,-22194,1913,24107,907,TRUE,NA,"0.1.4"
"46148","646",2023-12-25 16:45:00,-22194,1913,24107,907,TRUE,NA,"0.1.4"
"46149","646",2023-12-25 17:00:00,-22194,1913,24107,907,TRUE,NA,"0.1.4"
"46150","646",2023-12-25 17:15:00,-22227,1913,24140,907,TRUE,NA,"0.1.4"
"46151","646",2023-12-25 17:30:00,-22231,1913,24144,907,TRUE,NA,"0.1.4"
"46152","646",2023-12-25 17:45:00,-22201,1913,24114,907,TRUE,NA,"0.1.4"
"46153","646",2023-12-25 18:00:00,-22195,1913,24108,907,TRUE,NA,"0.1.4"
"46154","646",2023-12-25 18:15:00,-22195,1913,24108,907,TRUE,NA,"0.1.4"
"46155","646",2023-12-25 18:30:00,-22195,1913,24108,907,TRUE,NA,"0.1.4"
"46156","646",2023-12-25 18:45:00,-22194,1913,24107,907,TRUE,NA,"0.1.4"
"46157","646",2023-12-25 19:00:00,-22195,1913,24108,907,TRUE,NA,"0.1.4"
"46158","646",2023-12-25 19:15:00,-22195,1913,24108,907,TRUE,NA,"0.1.4"
"46159","646",2023-12-25 19:30:00,-22194,1913,24107,907,TRUE,NA,"0.1.4"
"46160","646",2023-12-25 19:45:00,-22194,1913,24107,907,TRUE,NA,"0.1.4"
"46161","646",2023-12-25 20:00:00,-22194,1913,24107,907,TRUE,NA,"0.1.4"
"46162","646",2023-12-25 20:15:00,-22195,1913,24108,907,TRUE,NA,"0.1.4"
"46163","646",2023-12-25 20:30:00,-22195,1913,24108,907,TRUE,NA,"0.1.4"
"46164","646",2023-12-25 20:45:00,-22195,1913,24108,907,TRUE,NA,"0.1.4"
"46165","646",2023-12-25 21:00:00,-22195,1913,24108,907,TRUE,NA,"0.1.4"
"46166","646",2023-12-25 21:15:00,-22194,1913,24107,907,FALSE,NA,"0.1.4"
"46167","646",2023-12-25 21:30:00,-22193,1913,24106,907,FALSE,NA,"0.1.4"
"46168","646",2023-12-25 21:45:00,-22193,1913,24106,907,FALSE,NA,"0.1.4"
"46169","646",2023-12-25 22:00:00,-22193,1913,24106,907,FALSE,NA,"0.1.4"
"46170","646",2023-12-25 22:15:00,-22193,1913,24106,907,FALSE,NA,"0.1.4"
"46171","646",2023-12-25 22:30:00,-22193,1913,24106,907,FALSE,NA,"0.1.4"
"46172","646",2023-12-25 22:45:00,-22194,1913,24107,907,FALSE,NA,"0.1.4"
"46173","646",2023-12-25 23:00:00,-22194,1913,24107,907,FALSE,NA,"0.1.4"
"46174","646",2023-12-25 23:15:00,-22195,1913,24108,907,FALSE,NA,"0.1.4"
"46175","646",2023-12-25 23:30:00,-22195,1913,24108,907,FALSE,NA,"0.1.4"
"46176","646",2023-12-25 23:45:00,-22195,1913,24108,907,FALSE,NA,"0.1.4"
"46177","646",2023-12-26,-22195,1913,24108,907,FALSE,NA,"0.1.4"
"46178","646",2023-12-26 00:15:00,-22195,1913,24108,907,FALSE,NA,"0.1.4"
"46179","646",2023-12-26 00:30:00,-22195,1913,24108,907,FALSE,NA,"0.1.4"
"46180","646",2023-12-26 00:45:00,-22195,1913,24108,907,FALSE,NA,"0.1.4"
"46181","646",2023-12-26 01:00:00,-22195,1913,24108,907,FALSE,NA,"0.1.4"
"46182","646",2023-12-26 01:15:00,-22195,1913,24108,907,FALSE,NA,"0.1.4"
"46183","646",2023-12-26 01:30:00,-22195,1913,24108,907,FALSE,NA,"0.1.4"
"46184","646",2023-12-26 01:45:00,-22195,1913,24108,907,FALSE,NA,"0.1.4"
"46185","646",2023-12-26 02:00:00,-22195,1913,24108,907,TRUE,NA,"0.1.4"
"46186","646",2023-12-26 02:15:00,-22195,1913,24108,907,FALSE,NA,"0.1.4"
"46187","646",2023-12-26 02:30:00,-22195,1913,24108,907,TRUE,NA,"0.1.4"
"46188","646",2023-12-26 02:45:00,-22195,1913,24108,907,TRUE,NA,"0.1.4"
"46189","646",2023-12-26 03:00:00,-22195,1913,24108,907,TRUE,NA,"0.1.4"
"46190","646",2023-12-26 03:15:00,-22195,1913,24108,907,TRUE,NA,"0.1.4"
"46191","646",2023-12-26 03:30:00,-22195,1913,24108,907,TRUE,NA,"0.1.4"
"46192","646",2023-12-26 03:45:00,-22194,1913,24107,907,TRUE,NA,"0.1.4"
"46193","646",2023-12-26 04:00:00,-22194,1913,24107,907,TRUE,NA,"0.1.4"
"46194","646",2023-12-26 04:15:00,-22193,1913,24106,907,TRUE,NA,"0.1.4"
"46195","646",2023-12-26 04:30:00,-22194,1913,24107,907,TRUE,NA,"0.1.4"
"46196","646",2023-12-26 04:45:00,-22194,1913,24107,907,TRUE,NA,"0.1.4"
"46197","646",2023-12-26 05:00:00,-22193,1913,24106,907,TRUE,NA,"0.1.4"
"46198","646",2023-12-26 05:15:00,-22194,1913,24107,907,FALSE,NA,"0.1.4"
"46199","646",2023-12-26 05:30:00,-22194,1913,24107,907,TRUE,NA,"0.1.4"
"46200","646",2023-12-26 05:45:00,-22194,1913,24107,907,TRUE,NA,"0.1.4"
"46201","646",2023-12-26 06:00:00,-22193,1913,24106,907,TRUE,NA,"0.1.4"
"46202","646",2023-12-26 06:15:00,-22193,1913,24106,907,TRUE,NA,"0.1.4"
"46203","646",2023-12-26 06:30:00,-22193,1913,24106,907,TRUE,NA,"0.1.4"
"46204","646",2023-12-26 06:45:00,-22193,1913,24106,907,TRUE,NA,"0.1.4"
"46205","646",2023-12-26 07:00:00,-22193,1913,24106,907,TRUE,NA,"0.1.4"
"46206","646",2023-12-26 07:15:00,-22193,1913,24106,907,TRUE,NA,"0.1.4"
"46207","646",2023-12-26 07:30:00,-22193,1913,24106,907,TRUE,NA,"0.1.4"
"46208","646",2023-12-26 07:45:00,-22194,1913,24107,907,TRUE,NA,"0.1.4"
"46209","646",2023-12-26 08:00:00,-22194,1913,24107,907,TRUE,NA,"0.1.4"
"46210","646",2023-12-26 08:15:00,-22194,1913,24107,907,FALSE,NA,"0.1.4"
"46211","646",2023-12-26 08:30:00,-22194,1913,24107,907,TRUE,NA,"0.1.4"
"46212","646",2023-12-26 08:45:00,-22194,1913,24107,907,TRUE,NA,"0.1.4"
"46213","646",2023-12-26 09:00:00,-22194,1913,24107,907,FALSE,NA,"0.1.4"
"46214","646",2023-12-26 09:15:00,-22194,1913,24107,907,FALSE,NA,"0.1.4"
"46215","646",2023-12-26 09:30:00,-22194,1913,24107,907,TRUE,NA,"0.1.4"
"46216","646",2023-12-26 09:45:00,-22194,1913,24107,907,FALSE,NA,"0.1.4"
"46217","646",2023-12-26 10:00:00,-22194,1913,24107,907,FALSE,NA,"0.1.4"
"46218","646",2023-12-26 10:15:00,-22194,1913,24107,907,FALSE,NA,"0.1.4"
"46219","646",2023-12-26 10:30:00,-22194,1913,24107,907,FALSE,NA,"0.1.4"
"46220","646",2023-12-26 10:45:00,-22194,1913,24107,907,FALSE,NA,"0.1.4"
"46221","646",2023-12-26 11:00:00,-22194,1913,24107,907,FALSE,NA,"0.1.4"
"46222","646",2023-12-26 11:15:00,-22194,1913,24107,907,FALSE,NA,"0.1.4"
"46223","646",2023-12-26 11:30:00,-22194,1913,24107,907,FALSE,NA,"0.1.4"
"46224","646",2023-12-26 11:45:00,-22193,1913,24106,907,FALSE,NA,"0.1.4"
"46225","646",2023-12-26 12:00:00,-22193,1913,24106,907,FALSE,NA,"0.1.4"
"46226","646",2023-12-26 12:15:00,-22193,1913,24106,907,FALSE,NA,"0.1.4"
"46227","646",2023-12-26 12:30:00,-22194,1913,24107,907,FALSE,NA,"0.1.4"
"46228","646",2023-12-26 12:45:00,-22194,1913,24107,907,FALSE,NA,"0.1.4"
"46229","646",2023-12-26 13:00:00,-22194,1913,24107,907,FALSE,NA,"0.1.4"
"46230","646",2023-12-26 13:15:00,-22194,1913,24107,907,FALSE,NA,"0.1.4"
"46231","646",2023-12-26 13:30:00,-22193,1913,24106,907,FALSE,NA,"0.1.4"
"46232","646",2023-12-26 13:45:00,-22194,1913,24107,907,FALSE,NA,"0.1.4"
"46233","646",2023-12-26 14:00:00,-22194,1913,24107,907,FALSE,NA,"0.1.4"
"46234","646",2023-12-26 14:15:00,-22194,1913,24107,907,FALSE,NA,"0.1.4"
"46235","646",2023-12-26 14:30:00,-22194,1913,24107,907,FALSE,NA,"0.1.4"
"46236","646",2023-12-26 14:45:00,-22194,1913,24107,907,FALSE,NA,"0.1.4"
"46237","646",2023-12-26 15:00:00,-22194,1913,24107,907,FALSE,NA,"0.1.4"
"46238","646",2023-12-26 15:15:00,-22194,1913,24107,907,FALSE,NA,"0.1.4"
"46239","646",2023-12-26 15:30:00,-22194,1913,24107,907,FALSE,NA,"0.1.4"
"46240","646",2023-12-26 15:45:00,-22194,1913,24107,907,FALSE,NA,"0.1.4"
"46241","646",2023-12-26 16:00:00,-22194,1913,24107,907,FALSE,NA,"0.1.4"
"46242","646",2023-12-26 16:15:00,-22194,1913,24107,907,FALSE,NA,"0.1.4"
"46243","646",2023-12-26 16:30:00,-22193,1913,24106,907,FALSE,NA,"0.1.4"
"46244","646",2023-12-26 16:45:00,-22194,1913,24107,907,FALSE,NA,"0.1.4"
"46245","646",2023-12-26 17:00:00,-22194,1913,24107,907,FALSE,NA,"0.1.4"
"46246","646",2023-12-26 17:15:00,-22194,1913,24107,907,FALSE,NA,"0.1.4"
"46247","646",2023-12-26 17:30:00,-22195,1913,24108,907,FALSE,NA,"0.1.4"
"46248","646",2023-12-26 17:45:00,-22195,1913,24108,907,FALSE,NA,"0.1.4"
"46249","646",2023-12-26 18:00:00,-22195,1913,24108,907,FALSE,NA,"0.1.4"
"46250","646",2023-12-26 18:15:00,-22195,1913,24108,907,FALSE,NA,"0.1.4"
"46251","646",2023-12-26 18:30:00,-22195,1913,24108,907,FALSE,NA,"0.1.4"
"46252","646",2023-12-26 18:45:00,-22195,1913,24108,907,FALSE,NA,"0.1.4"
"46253","646",2023-12-26 19:00:00,-22195,1913,24108,907,FALSE,NA,"0.1.4"
"46254","646",2023-12-26 19:15:00,-22195,1913,24108,907,FALSE,NA,"0.1.4"
"46255","646",2023-12-26 19:30:00,-22195,1913,24108,907,FALSE,NA,"0.1.4"
"46256","646",2023-12-26 19:45:00,-22194,1913,24107,907,FALSE,NA,"0.1.4"
"46257","646",2023-12-26 20:00:00,-22194,1913,24107,907,FALSE,NA,"0.1.4"
"46258","646",2023-12-26 20:15:00,-22195,1913,24108,907,FALSE,NA,"0.1.4"
"46259","646",2023-12-26 20:30:00,-22195,1913,24108,907,FALSE,NA,"0.1.4"
"46260","646",2023-12-26 20:45:00,-22195,1913,24108,907,FALSE,NA,"0.1.4"
"46261","646",2023-12-26 21:00:00,-22195,1913,24108,907,FALSE,NA,"0.1.4"
"46262","646",2023-12-26 21:15:00,-22195,1913,24108,907,FALSE,NA,"0.1.4"
"46263","646",2023-12-26 21:30:00,-22195,1913,24108,907,FALSE,NA,"0.1.4"
"46264","646",2023-12-26 21:45:00,-22195,1913,24108,907,FALSE,NA,"0.1.4"
"46265","646",2023-12-26 22:00:00,-22195,1913,24108,907,FALSE,NA,"0.1.4"
"46266","646",2023-12-26 22:15:00,-22195,1913,24108,907,FALSE,NA,"0.1.4"
"46267","646",2023-12-26 22:30:00,-22195,1913,24108,907,FALSE,NA,"0.1.4"
"46268","646",2023-12-26 22:45:00,-22195,1913,24108,907,FALSE,NA,"0.1.4"
"46269","646",2023-12-26 23:00:00,-22195,1913,24108,907,FALSE,NA,"0.1.4"
